caption,unfunny,somewhat_funny,funny,count,contest,target_id
My next selection sounds just like the last one.,177,66,57,300,644,1487
This next song is pretty much the same as the last one.,169,65,45,279,644,4127
You may have heard your children play this next piece.,179,76,41,296,644,2783
"And now, my musical interpretation of the Trump presidency...",192,51,52,295,644,2966
Anyone else forget to turn off their cellphone?,177,77,36,290,644,4131
I could have been a conductor.,181,68,39,288,644,4262
My next piece may sound a little bit like the last one.,206,75,44,325,644,3183
This next piece is dedicated to my ex-wife.,188,79,36,303,644,1676
They say dress for the job you want; not the job you have.,181,77,34,292,644,2940
That's right. I'm just that good.,166,55,36,257,644,3458
You may have heard this little number before...if you have a cat and a piano.,196,74,39,309,644,1792
"And now, I've got an old score to settle.",184,73,35,292,644,5049
This next piece was written by my cat.,194,56,43,293,644,4059
Hit it!,177,91,25,293,644,4363
And now Gershwin’s lesser-known ‘Rhapsody in Black and Blue’,184,71,34,289,644,2555
After a few drinks we agreed to swap jobs for the evening. I guarantee the pianist is NOT having fun.,187,55,40,282,644,25
And now the famous sonata for piano and concussion.,155,69,25,249,644,1288
I just play the hits.,183,73,32,288,644,2748
This next one’s dedicated to my ex-wife.,185,71,33,289,644,300
I will now play Trump's étude in diplomacy,178,41,41,260,644,2436
I'll conclude with Gershwin's Rhapsody in Black and Blue.,199,77,35,311,644,1724
I coulda been a contata.,173,62,32,267,644,4581
I’m just going to hit a few notes.,177,59,34,270,644,1033
I always hate this part of the dream.,180,67,32,279,644,2164
I will now play Sonata for Trump’s First Two Years.,199,54,42,295,644,951
I would like to dedicate this to my ex-wife.,177,57,34,268,644,1729
My final encore is for the gentleman asleep in Row 3.,187,68,33,288,644,5000
I'm gonna need a page turner.,182,75,29,286,644,3063
You don't understand.  I coulda had class.  I coulda been a conductor.,168,74,25,267,644,4623
"Alexa, play literally anything.",185,57,36,278,644,2647
"Ok, that's it!  Who forgot to silence their cell phone?",202,77,34,313,644,1658
"Every night it's the same dream.  I'm onstage, seated at a piano wearing box gloves, and no pants.",198,76,33,307,644,1645
Would the guy who booed please stand up?,182,76,28,286,644,659
"Oh, you said ""Bach's""",205,58,41,304,644,3045
To make it even more interesting my Assistant will now blindfold me.,201,74,34,309,644,2316
"Cough one more time, I dare you.",169,58,30,257,644,4615
Now a tribute to our current President,189,55,37,281,644,2670
"No, that was Für Elise. Now try to name this tune...",182,66,31,279,644,3518
"You may laugh, but the last time I had the lid drop on my hands I couldn’t play for a month.",190,69,32,291,644,4241
"After a month of Christmas songs,
 I'd like to play one for Boxing Day!",196,68,34,298,644,685
Someone stole my tip jar last night. That’ll never happen again.,176,65,29,270,644,1427
"Ladies and Gentlemen,.. Rhapsody in Black and Blue.",196,67,34,297,644,2462
"For my next selection, Gershwin's ""Rhapsody in Black and Blue""",177,62,30,269,644,940
"When we change to C sharp major, the gloves come off.",198,65,35,298,644,4781
"Sorry for the gloves, but some of the notes are sharp.",201,73,33,307,644,3131
The conductor and I have worked out our artistic differences.,193,86,26,305,644,4838
Please join me in the Julliard School fight song,208,70,36,314,644,5374
I wasn't joking about the cell phones,180,71,27,278,644,3965
And now here's something for those of you who slept through the Mozart.,181,66,29,276,644,4794
"If you think this looks difficult, wait till you see me play the harp.",206,69,35,310,644,3049
"Now, “Rhapsody in Black and Blue.”",183,75,26,284,644,925
"And now, here’s one that pretty much anybody can play.",200,66,34,300,644,4545
We'll have a brief intermission while I make a pretty big career decision.,185,62,31,278,644,1057
I find the piece goes quickly if I can hit a bunch of notes at the same time.,167,55,28,250,644,1015
I'm going to need someone to turn the pages for me.,201,68,33,302,644,5576
I play the anthem the way he runs the country,192,44,39,275,644,203
Please hold your applause until the final bell,197,78,28,303,644,2209
Please turn on your cell phones.,186,63,30,279,644,1126
"And now, because you're drunk and not listening anyway...",201,60,35,296,644,2660
Handel with care,179,62,28,269,644,5175
It hasn't been a smooth career transition,204,75,30,309,644,4340
My cat composed this next one.,194,56,34,284,644,3917
"Sir, would you mind not ringing that bell before every movement?",186,72,26,284,644,4906
"Finally, Ravel's Bolero is going to get what it deserves.",182,52,32,266,644,847
Sit back and relax -  tonight it's nothing but the hits!,190,74,26,290,644,3877
No need to turn off your cell phones.,194,66,30,290,644,4442
What it lacks in subtlety it gains in punch.,165,74,19,258,644,2079
"For my encore, Rhapsody in Black and Blue.",208,57,37,302,644,3498
I dedicate this song to my father and mother who had different plans for me.,190,68,28,286,644,1417
I've suffered for my art. Now it's your turn.,203,64,33,300,644,597
And this next piece is for my ex-wife.,186,62,29,277,644,4544
"And now, a request from the drunks at table three.",186,67,27,280,644,2326
"This next piece is forte. Very, very forte.",187,73,25,285,644,2862
And consider that a warning. Anyone else wanna answer their phone?,200,58,34,292,644,2639
I call it Requiem for a Heavyweight,207,77,29,313,644,2846
I trust the jurors will consider degree of difficulty.,188,65,28,281,644,4419
"If I hear one more cell phone ringing, the gloves come off!",190,61,30,281,644,5700
I'll be delighted to meet with the critics after the show.,194,86,22,302,644,585
Any other stupid requests?,183,61,28,272,644,831
And now a piece by Sugar Ray Leonard Bernstein.,185,68,26,279,644,1058
I’m just gonna knock out a few tunes for you.,197,63,31,291,644,4777
Can I get a page turner in here??,192,61,30,283,644,4283
I started out tickling the ivories ... now I like to beat the crap out of them!,211,69,32,312,644,5580
You think this was bad?  You should hear me play the violin.,204,61,33,298,644,2305
I shall say this only once. Cell phones off!,186,58,29,273,644,256
This next piece was written as a round...actually ten rounds.,192,54,32,278,644,3847
Beethoven’s going down in the 5th,212,66,33,311,644,2218
This is dedicated to the critics who thought my last performance lacked finesse.,208,74,29,311,644,4390
I was told to be careful - some of the keys are sharp.,178,60,26,264,644,3597
"You want to step up on the stage and say that, sir?",203,64,31,298,644,995
I'm not so much tickling the ivory as I am pounding them into submission.,205,79,26,310,644,4077
"This is Mozart's Concerto in G minor, A major, D minor and C#.",217,60,36,313,644,873
These stay on until the tip jar is full.,189,75,23,287,644,5226
This one's going out to my ex-wife and her attorney.,207,69,30,306,644,3291
And now a piece by Punchini.,195,65,28,288,644,2718
"Now, for the grand finale—my blindfold, please.",212,69,31,312,644,1772
I was told to expect a tough crowd.,187,75,22,284,644,1953
I guarantee: Beethoven is going down in the 5th.,188,62,27,277,644,1376
I composed my next piece after my divorce.,166,46,27,239,644,3398
What?  It’s FLIGHT of the Bumblebee?,189,54,30,273,644,4058
I coulda been a conductor.,200,67,28,295,644,524
Maim that tune.,204,56,33,293,644,3053
"Now for my take on Gershwin, “Rhapsody in Black and Blue”.",191,63,27,281,644,2415
Would the gentleman in the balcony care to repeat that remark?,191,63,27,281,644,2905
And now Rhapsody in Black and Blue.,207,82,24,313,644,498
"The next piece is a new work titled ""A day at the White House"".",191,57,29,277,644,3532
"This next piece features dense chords, unusual harmonies, and a pounding rhythm.",209,67,30,306,644,3817
I will now play a piece inspired by my visit to the White House,178,45,30,253,644,5062
"For my next piece, the gloves are coming off.",194,67,26,287,644,5418
Is there nothing atonal enough that you snobs wouldn't pretend to like?,191,59,28,278,644,2260
"Could you turn the page, please?",200,68,27,295,644,1250
One of my greatest hits...,208,70,28,306,644,1956
I will now perform Bach's little-know Golden Gloves Variations.,182,57,26,265,644,4137
"Go on, request Piano Man man again. I dare you.",197,62,28,287,644,1728
"And now, Mozart's Requiem for a Heavyweight.",198,60,29,287,644,5524
"I call this next number, ‘Rhapsody in Black and Blue’.",192,45,33,270,644,5111
It's Shostakovich.  You won't notice the difference.,201,59,30,290,644,1165
"No, Franz is my elder brother...I'm Pugi Liszt.",183,49,29,261,644,339
"Tonight, only hits.",207,76,25,308,644,5694
This next little number will knock you out.,176,57,24,257,644,1123
Who requested a fight song?,183,67,22,272,644,1899
This piece is called 'Flight of the Elephant.',199,51,32,282,644,3771
"You mean it isn't ""'Fight'"" of the Bumblebee?""",192,62,26,280,644,4141
Requiem for a Heavyweight,197,60,28,285,644,3362
"After all those Christmas carols, this one is for Boxing Day",207,64,29,300,644,2398
Just wait until after intermission; that’s when the gloves come off!,209,76,25,310,644,2360
I’ll be playing this in pugilissimo.,183,58,25,266,644,705
Anyone can play blindfolded.,194,60,27,281,644,429
Here’s the tricky part.,207,82,22,311,644,3243
I plan to take Beethoven in the Ninth.,192,61,26,279,644,4199
The ski boots are making it difficult to work the pedals.,198,57,29,284,644,1750
It'll be three rounds of Bach and then the gloves come off.,201,67,26,294,644,5087
"Tonight I'll be playing Chopin's Nocturne in C#, D, D#, E, and F Minor.",217,51,36,304,644,1180
For this next fugue I am going to take the gloves off.,196,58,28,282,644,2378
"It was at that moment,Ted realized he had put his boxing gloves on instead of his tuxedo pants. Again.",200,58,29,287,644,1869
And now for a little Rockymaninoff.,196,66,25,287,644,2605
You don't understand.  I could've played a cadenza.  I could've been somebody!,204,58,30,292,644,3844
"And now, a Chopin nocturne in C, D, E, F and very probably G.",223,60,34,317,644,3812
This next one goes out to all my critics,194,67,24,285,644,3290
I will only be playing my hits.,207,57,31,295,644,438
This one goes out to my ex wife.,185,58,25,268,644,3678
"This next piece is titled ""Ode To My Parents Who Could Not Agree On After School Activities""",191,62,25,278,644,530
And now a little piece I wrote watching the news.,199,54,30,283,644,1249
"And now, The Ill-Tempered Clavier.",202,56,30,288,644,196
Bach off.,204,60,29,293,644,4847
Could somebody scratch my nose?,205,71,25,301,644,1983
I'm sorry. All I know are fight songs.,186,66,22,274,644,3695
"The next selection is my own composition,'Rhapsody in Black and Blue'.",207,72,25,304,644,126
I am now going to play a piano interpretation of Donald Trump’s presidency.,204,43,35,282,644,2610
"And now the theme from Rocky, as it was meant to be played.",201,57,29,287,644,3762
I tend to fight Bach.,198,68,24,290,644,2413
Yeah. I’m that good.,207,63,28,298,644,1205
"Next, Gershwin's Rhapsody in Black and Blue",205,67,26,298,644,5045
Anyone can play with his bare hands.,192,69,22,283,644,3055
"The next piece is entitled, ""The Trump White House.""",197,51,30,278,644,3749
This last piece is from my boxed set.,192,61,25,278,644,3902
"And now, the hits.",176,45,27,248,644,3126
Any other hecklers out there?  I thought not.,201,72,23,296,644,1553
Next critic?,203,68,25,296,644,4388
Tonight I'll be performing some of my greatest hits.,194,54,28,276,644,1850
This next piece is for the critic who called me a 'lightweight.',207,81,21,309,644,183
This tune is dedicated to the President,203,65,26,294,644,2429
"And now, time to knock out a few classics.",205,61,28,294,644,3839
I dedicate this piece to the Times critic in the second row.,196,68,23,287,644,3225
It’s not like you can hear me over your phones anyhow.,187,46,29,262,644,138
The inspiration for my next piece comes from being bullied on my way to piano lessons.,192,73,20,285,644,3574
You'll find this next piece has a little extra punch.,177,55,23,255,644,1221
"And now, the 1812 Overture as it was meant to be played.",178,58,22,258,644,820
I'm done tickling them.,204,67,25,296,644,1864
"I coulda been a cadenza.""",176,46,26,248,644,2661
"I will now perform ""Dance of the Sugar Ray Plum Fairy"".",196,67,23,286,644,2624
I like to play this one Pugilisimo,197,62,25,284,644,135
"This next piece is called
A Presidential Press Conference.",205,59,28,292,644,3295
Let's see how many of youse remember dis one…,218,70,27,315,644,3082
"Let's have a clean fugue, and no hitting below middle C.",207,60,28,295,644,1801
I thought you said FIGHT of the bumblebee.,179,55,23,257,644,4848
"And now, my rendition of the crap these kids are listening to nowadays.",197,56,27,280,644,381
I coulda been a composer,214,67,27,308,644,1745
And now for a piece my two year old son wrote,194,62,24,280,644,4150
This next tune may ring a bell.,206,67,25,298,644,2431
"This next tune was written by Mike Tyson, who, I'm told, plays by ear.",235,75,29,339,644,1861
"And for my next piece, ""Requiem for a Heavyweight.""",211,70,25,306,644,3960
I was misled about how duelling pianos worked.,192,63,23,278,644,509
This next piece is dedicated to those critics who say I lacked a deft touch and attacked the piano with a pugilistic style.,195,49,29,273,644,2362
"Good evening and welcome to our first 
Mixed Musical Arts competition.",184,63,21,268,644,938
"Tonight, I've a score to settle with the piano.",212,65,27,304,644,3650
And now... a medley of big hits.,197,50,29,276,644,2037
"For my final piece, I'd like to play for you Mozart's 'Requiem for a Heavyweight.'",212,57,30,299,644,2968
The critic from the Times will not be joining us this evening.,194,48,29,271,644,5044
"And now, my latest composition:”Requiem For a Heavyweight.”",221,60,31,312,644,5248
"I will now play for you Mozart's little-known ""Requiem for a Heavyweight.""",205,55,29,289,644,2830
Could I have a volunteer from the audience to come scratch my nose?,203,64,25,292,644,167
"And now, my tribute to Philip Glass.",203,56,28,287,644,2695
"I call it ""Fur Ali.""",200,67,23,290,644,589
I call it pugilissimo.,200,67,23,290,644,664
"And now, Mozart's ""A Little Fight Music""",208,64,26,298,644,217
I will now perform 'Rhapsody in Black & Blue',219,71,26,316,644,4146
What would you have done if your teacher kept hitting your fingers?,204,64,25,293,644,4662
And now something for the critics,213,59,29,301,644,4135
"This next piece is called Sonata in C, D, E, F, G, and B Flat Minor.",176,46,25,247,644,2874
"Sorry sir, but ""My Way"" means my way.",202,65,24,291,644,4038
"And now, Beethoven in the 5th.",203,63,25,291,644,5278
I'd like to knock out a few tunes for you,209,56,29,294,644,5522
My father wanted me to box and my mother wanted me to play the piano. I call this piece The Regrettable Compromise.,216,63,28,307,644,220
"And now the Minuet in C, C sharp, D, D sharp, E, F, F sharp",206,54,29,289,644,1132
Give me a minute while I break in this new piano.,204,70,23,297,644,4672
Tonight I’d like to play a medley of my hits.,193,56,25,274,644,4207
Alex Ross wrote last week that I played as if wearing boxing gloves.  This next piece is for Alex.,218,77,23,318,644,5149
Can ANYONE name that tune ?? Anyone ?? Anyone ??,219,59,30,308,644,4839
I give you Rockymaninoff.,206,56,28,290,644,5084
"Before  I begin I want to thank my piano teacher, Mike Tyson.",179,60,20,259,644,1812
Can somebody adjust my tie?,169,51,21,241,644,853
It’s an experimental piece.,187,62,21,270,644,468
There are no white notes; there are no black notes; there are just... notes.,187,62,21,270,644,3806
I was told my tunes weren't punchy enough.,173,61,18,252,644,5505
"""Do I hear a request for Rhapsody in Black and Blue?""",215,61,28,304,644,823
For this next one I'll need a volunteer.,211,61,27,299,644,98
"And next, a piece written by President Trump.",187,46,27,260,644,3781
And the hits just keep coming.,210,63,26,299,644,4183
"Oh, THAT kind of dueling pianos.",201,65,23,289,644,4297
And now. Gershwin as you've never heard him.,189,60,22,271,644,1722
Now I'd like to knock out a few requests.,182,53,23,258,644,5144
This next piece is a knockout.,182,66,18,266,644,614
"We've had a request for ""Hit Me With Your Best Shot.""",202,60,25,287,644,4567
"Tonight, I will finally give this piano what it has deserved for years.",195,53,26,274,644,3919
The ivories have announced they no longer want to be tickled.,217,64,27,308,644,4158
"If you don't like my playing, I suggest you keep your mouth shut.",203,71,21,295,644,4510
I float like a butterfly and sting like a B-sharp.,183,53,23,259,644,4890
"And now, a Victor Borge etude  from his deconstructive period.",193,67,20,280,644,1285
We're recording this one as a boxed set.,217,79,21,317,644,4423
I dedicate this last tune to the guy snoring in row one,216,60,28,304,644,1112
"And for my next piece, I will need a new piano.",188,61,21,270,644,4337
I'm done tickling the ivories.,208,68,23,299,644,4522
I call this number “Rhapsody in Black and Blue”,180,69,16,265,644,2005
"Oh, sure, when Glenn Gould does it it's 'eccentric,' but when I do it you say 'Larry has dementia pugilistica.'",193,48,27,268,644,4259
"And as promised, my finale is a real knockout.",200,73,19,292,644,4917
"Ladies and Gentlemen, welcome to my first ever Pay-Per-View event...",201,63,23,287,644,5238
"And now, as promised, a knockout performance",207,64,24,295,644,2683
"Howard had gravely misunderstood what the club manager meant by ""dueling pianos.""",199,46,29,274,644,1203
I like to think that I legato like a butterfly and staccato like bee.,203,51,28,282,644,5410
"And now, the Gold’s Gym Variations",209,57,27,293,644,2340
This song is dedicated to my mother-in-law....,186,69,17,272,644,4064
"And now, 'Requiem for a Heavyweight.'",207,45,31,283,644,361
"...and now Piano Concerto No. 2 in C Minor. And also in A Major, B Minor, D Minor, E Minor, F Major and G Major. Just because I can.",208,56,27,291,644,5397
Subtlety and nuance are so overrated.,177,58,19,254,644,673
"And now, an ode to my ex-wife.",197,57,24,278,644,1390
You should see the other piano,202,60,24,286,644,5052
"Why yes, it IS a player piano. Why do you ask?",213,64,25,302,644,5335
We're doing the 1812 .... couldn't afford the cannons,187,61,20,268,644,909
And now for the main event. Brahm's Requiem for a Heavyweight.,191,66,19,276,644,3344
The next piece is scheduled to go four rounds.,189,70,17,276,644,3937
My next piece will be “Fight of the Bumblebee”,195,58,23,276,644,3959
I call this one 'Crippling the Ivories'.,219,62,27,308,644,1710
"I will now play The Boxer by Simon & Garfunkel, as it's never been played before.",215,70,23,308,644,2007
I wish to prove wrong the critic who said I played as if I were wearing boxing gloves,212,76,20,308,644,2219
You wanna come up here and say that?,219,62,27,308,644,2780
"And now, 'Toddlers Pounding on Piano', an original score by my 3-year old twins.",199,68,20,287,644,2949
"I call this next piece ""Beethoven's Fist"".",223,59,29,311,644,2274
"For my next song I'll play something from the early Trump years, Covfefe, in g-minor.",198,49,27,274,644,1237
"And now, Rossini's earlier and lesser-known work, The Boxer of Seville.",191,63,20,274,644,1735
"I tell ya, I coulda been somebody...
I coulda been a conductor!",196,53,25,274,644,3235
I love pounding the ivories.,204,63,23,290,644,5267
And now for another piece composed by Donald J Trump,217,50,31,298,644,3103
I will be performing the cannon solo from Tchaikovsky's 1812 Overture transcribed for piano.,191,55,23,269,644,3511
"If you’re looking for treble, you found it.",193,64,20,277,644,2727
"Ladies and gentleman, I will now play for you, ""The Ill-Tempered Clavier""",205,53,27,285,644,490
The finale is a knockout.,208,65,23,296,644,91
"This will be easy, tying my tie was the difficult task.",200,68,20,288,644,478
Tickling isn't what these ivories like.,193,56,23,272,644,1107
"And now, Liszt's sonata in B minor, B major, A minor, C major... All of the keys, really.",205,58,25,288,644,2452
My other instrument is the hammered dulcimer.,189,51,24,264,644,3542
I am also a neurosurgeon.,208,65,23,296,644,4753
Now I'd like to pound out some old favorites.,211,64,24,299,644,2059
It's a variation I call 'The Fight of the Bumblebee.',217,62,26,305,644,807
Will someone ring the bell so I can start?,207,69,21,297,644,3631
"Tonight, I go 10 rounds with Liszt",189,66,18,273,644,2186
I dedicate this next number to everyone who believed  I coulda been a contender.,184,63,18,265,644,2278
"Oh, 'boo' yourself! Let's see you try it!",204,67,21,292,644,4954
So what? Beethoven was deaf.,193,50,25,268,644,719
I am very happy to be back here in Madison Square Garden,219,68,24,311,644,5182
I need another page-turner.,198,45,28,271,644,441
"I have wrestled with Tchaikovsky my entire life, but tonight I'm going to clobber him!""",205,67,21,293,644,2220
I dare you to keep your cell phone on.,189,60,20,269,644,2819
Hecklers are welcome to join me onstage.,201,54,25,280,644,4341
"For you, Mr. President, very large clumps of only white keys.",196,51,25,272,644,1589
I shall select Rhapsody in Black and Blue,198,65,20,283,644,5119
"It's a percussion instrument, dammit!",199,63,21,283,644,5430
This is going to hurt you more than it hurts me.,207,52,27,286,644,4002
"First, I like to show the piano who’s boss.",190,60,20,270,644,1275
This is my concerto in 15 rounds.,205,71,19,295,644,2194
The next piece is from the Maestro's black and blue period.,191,55,22,268,644,3347
I'll begin our evening of Wagner with 15 rounds in The Ring.,216,67,23,306,644,1668
This last movement opens with a mandatory eight count.,189,64,18,271,644,737
This might sound a little rocky.,194,54,23,271,644,1455
"We'll start on the count of three -- and, of course, finish on the count of ten.",206,61,23,290,644,5532
"I will next perform Rachmaninoff's piano concerto No. 2, in the key of B-flat, A-flat and D-sharp.",208,49,28,285,644,2831
And now for some Phillip Glass.,204,62,22,288,644,3514
Rhapsody in black and blue.,182,75,12,269,644,5029
This next piece is titled Beethoven's Fifth Round.,223,60,27,310,644,1640
I seem to have Baroque the piano.,216,48,30,294,644,137
It’s my reminder to think outside the Bachs.,197,55,23,275,644,4156
"I shall now play ""Flight of the elephant.""",212,43,31,286,644,1709
"Inspired by a recent court order, I call this piece 
""Anger Management""",177,51,20,248,644,1498
"And now, “Flight of the butterfly, by Muhammad Ali.",202,50,26,278,644,5244
And now for something a little more dissonant.,187,59,19,265,644,242
Can I get a volunteer to turn pages....?,188,57,20,265,644,2014
"Still, a man hears what he wants to hear, and disregards the rest.",193,65,18,276,644,5479
And here's a little something that I knocked out this afternoon...,196,64,19,279,644,3251
This next piece is my homage to cognitive dissonance.,206,62,22,290,644,3614
For my next hit...,211,70,20,301,644,3450
"I am going to play an original composition that I am sure you will love, if you know what's good for you.",193,57,21,271,644,2523
"I dedicate this next piece to the critics.""",200,61,21,282,644,657
"My next piece is entitled...""To Hell With Nuance"" .",202,57,23,282,644,1791
"I’ve finished writing the verses, but I still need the right hook.",214,56,26,296,644,3984
"And now for my sonata in C, C sharp, D, E, and F.",203,47,27,277,644,4333
"For my encore, I will play a little-known piece by George Gershwin and Joe Louis.",202,67,19,288,644,4505
And now I shall play Beethoven's Fist.,209,53,26,288,644,5221
"Next, Variations on a Theme by Pugilisti.",215,59,25,299,644,5077
Next I am going to play one of my smash hits,207,62,22,291,644,2466
I can't start without my page turner!,193,59,20,272,644,5696
"And now, Beethoven's 5th Round!",203,57,23,283,644,2280
I call this next one “An Ode to 2018.”,213,55,26,294,644,2557
Next I'll perform a few classical hits.,207,67,20,294,644,5004
I've been told you're a tough audience.,217,70,21,308,644,3348
Here are some of my greatest hits.,216,54,27,297,644,4209
"I'm warning you coughers, one more sound and the gloves are coming off.",210,53,26,289,644,4251
That last Christmas concerto was by Rachmaninoff.  And a now a little something for Boxing Day.,195,52,23,270,644,2983
"And now, a rarely-performed work by an obscure composer ...",205,55,24,284,644,3750
This piece calls for more force and less precision.,192,63,18,273,644,303
This first piece will be a knockout.,232,60,28,320,644,2827
"'This piece knocked me out the first time I heard it.""",215,58,25,298,644,5473
That's it! The gloves are coming off.,198,56,22,276,644,2564
It's hard to follow a banjo-playing elephant,194,64,18,276,644,3383
"My version of ""Hit Me With Your Best Shot"".",208,59,23,290,644,3668
"Now, I’d like to hit you with something new!",189,61,18,268,644,695
And now for George Gershwin's 'Rhapsody in Bruise.',189,43,25,257,644,2861
"And now, I will play the theme from Rocky  as it was originally composed.",212,74,18,304,644,1517
This piece is a knockout.,203,61,21,285,644,192
I shall legato like a butterfly and staccato like a bee.',208,51,26,285,644,3794
Turns out the ivories prefer to be roughed up a little.,221,66,23,310,644,3096
"And now, mauler",189,53,21,263,644,3496
Now I’ll play for you a medley of hits.,228,57,28,313,644,4759
No other pianist would even attempt this.,217,61,24,302,644,1796
I will now play Chopin's Nocturne in Be-Flattened.,202,55,23,280,644,4791
"My first selection is ""Blunt Force Trauma, in E-Minor.""",235,58,29,322,644,3421
"This next tune is called ""Fight of the Bumblebee.""",204,71,17,292,644,3321
I call this piece Beethoven's Fifth Round.,212,55,25,292,644,5151
I haven't practiced this piece much.  I figured I'd just knock it out.,197,67,17,281,644,341
"'I'd like to dedicate this next number to my ex-wife.""",195,58,20,273,644,4130
"This one's called ""Eine Kleine Knockout-musik.""",209,53,25,287,644,5133
LLLET'S GET READY TO CRESCENDOOOOOOO!!!!,220,54,27,301,644,3030
And now I’d like to bang out a few of my favorite tunes.,189,52,21,262,644,1105
My next number may lack subtlety but it more than makes up for it in punch.,186,58,18,262,644,3584
"And now, my new arrangement of 'Hail to the Chief.'",195,40,27,262,644,4121
Time to break in the new piano,217,65,22,304,644,3573
This next piece consists of twelve rounds.,186,63,16,265,644,607
"Float like a butterfly, sting like a B flat.",199,60,20,279,644,376
And now for Beethoven's Ninth Round.,208,65,20,293,644,2114
"And now, I’ll be playing the hits.",179,59,16,254,644,3023
This next song begins with a standing eight count,177,63,14,254,644,5286
I can't Handel this.,233,61,27,321,644,3609
"And for the finale, here’s a little something that my 3 year old banged out.",199,65,18,282,644,4274
"And now, a flurry of left jabs in G-minor.",216,59,24,299,644,4996
"And now, if you don't mind, I'd like to knock out a little Chopin.",216,64,22,302,644,4128
And now for Eine kleine Knockout Musik.,195,65,17,277,644,3333
Wait...wait...for the punch line!,194,59,19,272,644,4403
And now for some Rockymaninoff.,198,56,21,275,644,626
I get a lot of criticism for this next one.,199,54,22,275,644,1403
My next number is a knock out.,219,65,22,306,644,2213
"I'll play your request, maam, but for future reference it's ""*Flight* of the Bumblebee""",213,54,25,292,644,1149
Oh!  You meant BACH'S music?,203,51,24,278,644,1287
Tonight The 1812 Overture. Just the cannons firing part.,178,55,17,250,644,5293
And now for a punchy tune!,219,70,20,309,644,4621
"Everyone else tickles the ivories""",200,67,17,284,644,5132
This should settle the score!,209,59,22,290,644,5012
Now a little something from Dukes Ellington.,199,56,21,276,644,1040
Beethoven’s 9th Round,213,56,24,293,644,751
And now for something with a bit of a punch.,196,67,16,279,644,567
I thought this piece could use a little more punch.,190,56,19,265,644,4214
"...and now, ""The Black and Blue Danube"".",217,63,22,302,644,1457
Because I'm tired of wrestling with my muse.,224,59,25,308,644,790
One more comment like that and these gloves are coming off.,210,64,20,294,644,2580
I call this next piece 'Losing a Bet',210,41,29,280,644,1942
"For my next number, I’ll need a volunteer from the audience....",199,63,18,280,644,2073
Now for my biggest hit,219,51,27,297,644,78
Brad was asked to knock out a tune.,207,57,22,286,644,2243
All That Jabz.,196,56,20,272,644,4835
You shoulda seen the other Steinway!,223,63,23,309,644,4293
"I call it, “Rhapsody in Black and Blue.”",192,69,14,275,644,3478
"Now, the Philip Glass variations on Paul Simon's ""The Boxer.""",205,53,23,281,644,4515
Where is my page turner?,202,59,20,281,644,5506
I think you'll find this one less subtle than my earlier works,215,66,20,301,644,62
I'm just going to punch it up a bit.,201,66,17,284,644,2418
Now I’d like to knock out a little tune for you.,205,63,19,287,644,3301
"And, now for something completely different.",217,72,18,307,644,634
"Now, for the fight song.",197,56,20,273,644,94
This tune should ring a bell.,199,52,22,273,644,479
I'm going to regale you folks with a few of my best hits.,210,63,20,293,644,1236
This one was written by my three-year-old,213,57,23,293,644,2887
And now a piece by Sugar Ray Charles...,201,58,20,279,644,1242
And now a selection from my boxed set.,205,50,24,279,644,5273
"And now Beethoven’s sonata in C, B, Bb, A and G#.",223,57,25,305,644,1143
"Now is there ANYONE ELSE who thinks
they want to leave before my recital is over ???",207,61,20,288,644,2914
This next piece is a bit heavy-handed.,222,69,20,311,644,5368
This piece was composed when Mozart was only two.,200,52,22,274,644,1950
"Next up, Theme From Rocky.",194,64,16,274,644,3065
"For this next piece, I’ll be taking the gloves off!",207,71,16,294,644,3927
While I drink a glass of water.,218,64,21,303,644,1255
Will someone hit the bell?,218,64,21,303,644,2093
"I'd like to dedicate the next song to my ex-wife. Trudy, this one's for you.",218,64,21,303,644,4187
You said you wanted a fight song.,222,66,21,309,644,713
A brief pause while I respond to a recent review.,214,49,26,289,644,5342
"Ladies and gentlemen, I am so sorry, I just realized that these are my violin gloves.",196,52,21,269,644,4883
And now J.S. Bach's – The Ill-Tempered Clavier,195,59,18,272,644,564
This next piece is gonna knock you out.,228,64,23,315,644,2645
And for my next round...,179,58,15,252,644,5316
And now for some of my boxer shorts.,216,55,24,295,644,226
And now for a punchy little number.,214,59,22,295,644,4311
I'm the guest pianist at the Trump Family Christmas Party.,202,50,23,275,644,3731
"and now, from the ring cycle...",235,55,28,318,644,4695
I'd like to dedicate this next piece to my wife of 36 years.,199,61,18,278,644,2743
"And now, the Fight of the Bumblebee.",223,51,27,301,644,372
And now... a medley of my favorite hits,218,61,22,301,644,1325
My next composition is played in twelve 3 minute rounds.,217,63,21,301,644,3996
This next one is a punchy little tune….”,225,57,25,307,644,1477
"And now, a little Rockymaninoff.",196,44,24,264,644,5629
Can you hear me now ?,195,51,21,267,644,4377
And now for some of my greatest hits.,214,56,23,293,644,14
"Most players “tickle” , 
I choose to pummel.",192,67,14,273,644,1424
I knocked out this piece in just ten minutes.,214,61,21,296,644,1866
I've found these to be enormously helpful in performing Bartok.,210,69,17,296,644,2515
This is The Bad-Tempered Clavier,208,40,28,276,644,3178
"I call this next piece, ""Pounding Headache"".",221,52,26,299,644,3942
And now for Chopin with some punch.,183,52,18,253,644,5027
And now for a few of my greatest hits...,236,65,24,325,644,625
I think I've lost this bet already.,209,53,23,285,644,5470
"Before I begin, are there any critics in the audience tonight?",195,53,20,268,644,539
"And now, a few of my greatest hits.",195,53,20,268,644,5546
"Trust me, this next song will be a knockout.",229,71,20,320,644,392
Next I will play a special piece for Boxing Day.,198,57,19,274,644,3353
"I'd like to start with the second movement, third round.",212,72,16,300,644,1171
"If you grew up on the streets of Philadelphia, you'll certainly appreciate this next piece.",200,58,19,277,644,42
I've always loved dueling pianos.,210,58,21,289,644,1756
Knock out a tune?,213,57,22,292,644,3849
You'll recognize this next piece from my boxed set.,219,55,24,298,644,5531
The insurance on my hands hasn’t been processed yet.,199,52,21,272,644,4436
I float like a butterfly and sting like B flat.,202,51,22,275,644,484
"And now Ladies and Gentlemen, a medley of my greatest hits.",176,60,13,249,644,3046
You might be surprised by how subtle and intricate this piece is.,201,58,19,278,644,2293
"My next song is ""Fight of the Bumblebee.""",213,49,25,287,644,1584
"Rachmaninoff’s Concerto No. 2,” with all notes performed simultaneously.",193,46,22,261,644,2448
I’m going to knock out some tunes for you tonight.,212,56,22,290,644,5547
"Ladies and Gentlemen,'Beethoven's 5th Round'""",216,58,22,296,644,5609
I'm ready to Bachs.,201,45,24,270,644,5320
"Believe it or not, that was a little tune I just knocked out.",221,63,21,305,644,1873
What you are about to hear has never before been played in a concert  hall.,202,63,17,282,644,968
"My next piece is Mozart's Piano Concerto 22 in E Flat Major.  Unfortunately, you will not recognize it.",205,62,18,285,644,2435
Is there a volunteer to flip the music sheet?,215,57,22,294,644,1273
I'm done with tickling the ivories.,211,65,18,294,644,1739
Rough crowd tonight,212,63,19,294,644,4250
This is it. This is the nightmare.,223,46,28,297,644,590
Ever have that dream that you went to school in your underwear?  This is my version...,216,60,21,297,644,1463
"Observe, ladies and gentlemen, as I put the 'K.O.' back in Tchaikovsky.",218,61,21,300,644,712
I will now play our new national anthem.,203,43,25,271,644,59
This is a punchy little number.,220,67,19,306,644,2223
I could've been a contender if it weren't for those damn piano lessons.,194,66,14,274,644,1264
"Opus 12, Round 7",202,55,20,277,644,2011
"Tonight, I will not be 'tickling the ivories' as they say...",201,57,19,277,644,2222
Excuse me while I knock out a few songs.,205,54,21,280,644,4898
It just looks hard.,206,57,20,283,644,483
"And now I will perform ""Fight of the Bumblebee""",201,67,15,283,644,3214
This won't be pretty.,206,57,20,283,644,4712
"I""ll start with one of my greatest hits.",181,59,14,254,644,205
And to conclude tonight's program of heavyweight composers...,203,78,11,292,644,542
"I'd like to dedicate this encore to my parents, who forced me to play piano, when I would have preferred then, as now, to be doing something else.",218,48,26,292,644,3510
"And now, a collection of my greatest hits.",217,55,23,295,644,1034
This next piece was composed by the most talented lobster I ever met.,191,49,20,260,644,2054
I do it my way!,214,71,16,301,644,736
"Did you say ""boxer"" or ""Bach, Sir""??",229,61,23,313,644,4614
"Well, fine, I don't think you're a very good audience.",200,56,19,275,644,4415
And now I'm going to knock out one of my old favorites.,198,65,15,278,644,3520
Next: 'Rhapsody In Back And Blue'.,234,61,24,319,644,1014
Now for my knockout finale.,206,59,19,284,644,4886
And now I will play all the keys at the same time.,220,51,25,296,644,276
"Clearly, I am the Greatest.",213,65,18,296,644,4908
And now Concerto No. 2 by Rocky Maninoff .,203,37,27,267,644,1144
Here’s an old standard I’d like to pound out for you,193,57,17,267,644,1681
Go ahead. Ask me to play Piano Man. I want you to.,193,57,17,267,644,4899
"Tonight folks, I'm just going to knock out a little tune. . .",196,56,18,270,644,3908
This next piece is by TKO Bach.,201,56,19,276,644,4321
"If I hear one more person request ""Piano Man'"", these gloves are coming off.",204,55,20,279,644,4102
"And now, for something a little less intricate.",206,56,20,282,644,2623
"To anyone who didn't immediately recognize it, that was Tchaikovsky's Piano Concerto in B-flat Minor.",214,50,24,288,644,1823
Does anyone else care to complain about my playing?,212,54,22,288,644,4374
"And now, J.S. Bach's BAD-Tempered Clavier.",214,55,22,291,644,755
"And now, a new composition, ""Ode to Trump.""",212,59,20,291,644,2540
Let's get ready to Rrrrrrachmaninoffff!,217,54,23,294,644,3712
"Mom, you and Dad are going to have to reach an agreement as to what you want me to be.",217,54,23,294,644,4360
I'd like to play you a little something I wrote when I was two and a half.,221,61,21,303,644,4841
Pianist? I thought you asked for a pugilist...!,227,69,19,315,644,5109
A concerto for neither left nor right hand.,201,53,20,274,644,3375
This next piece is atonal.,203,54,20,277,644,312
"First, I thought I'd knock out a few show tunes.",202,61,17,280,644,770
Thank you to the White House Correspondents' Association for inviting me to perform at this year's Correspondents' Dinner.,204,57,19,280,644,3485
This is from my box set.,204,57,19,280,644,4502
I 'm sure they said I was to take on Wagner in the ring.,209,57,20,286,644,2909
I miss the days when just tickling the ivory was enough.,213,59,20,292,644,4107
During the prestissimo the gloves come off.,214,57,21,292,644,5677
"Great, I'm having another anxiety dream.",226,48,27,301,644,704
I composed this next piece when I was two.,194,59,16,269,644,2509
"Oh, I wouldn't say that I ""tickle"" the ivories.",206,45,24,275,644,3328
"And now for ""Rhapsody in Black and Blue""",199,59,17,275,644,3649
"If you don't quiet down, your nose is going to B-flat.",199,59,17,275,644,3696
Has it been tuned?,206,55,20,281,644,855
And it goes something like this.,211,45,25,281,644,2080
"Not to worry, folks. It’s  a player piano.",218,56,22,296,644,3459
And now I’d like to play for you some of my greatest hits.,225,57,23,305,644,1280
"I'll knock out this Beethoven in the Fifth.""",231,50,27,308,644,930
And now for something a little punchier...,218,81,12,311,644,5652
Trust me. It’s all in the wrist.,193,58,16,267,644,249
Did I hear a request for a fight song?,192,60,15,267,644,3116
Due to the present social environment I can no longer tickle the ivories,204,51,21,276,644,139
This one is dedicated to my lovely ex-wife.,203,53,20,276,644,332
I would like to play this next number the way people have been saying I play it.,205,49,22,276,644,2455
"Now, a brief interlude while I make a momentous career choice.",208,53,21,282,644,1079
Who's up for another round?,205,59,18,282,644,1383
This next song is a knockout.,204,66,15,285,644,307
"Ohh, Bach? I thought you said ""box"".",206,62,17,285,644,1130
"And now, a touching musical tribute to the great Muhammad Ali.",213,48,24,285,644,1300
This is by Liszton.,207,60,18,285,644,5028
Now for a variation from Bach’s Bad-Tempered Clavier.,206,67,15,288,644,2611
My therapist told me the way to treat performance anxiety is to imagine my worst fear.,214,56,21,291,644,3662
I’ll be knocking out songs all night.,212,65,17,294,644,1184
How about a fight song?,212,65,17,294,644,2322
"That's right, I've been playing the piano with my penis the whole time!""",225,44,28,297,644,4676
I must warn you in advance about the crescendo.,230,69,19,318,644,1256
You should a looked out for me Charlie.  I could a been a conductor.,202,47,22,271,644,2821
"The next piece is my own take on ""Chopsticks"" -- I call it ""Logs.""",197,62,15,274,644,2224
Yes - It's Rocky the Musical,204,53,20,277,644,2832
"This year, instead of Christmas music, I will play a couple of Boxing Day pieces.",207,52,21,280,644,1062
And now for Beethoven’s 9th round.,207,62,17,286,644,2189
"We now present a medley of ""Madame Butterfly"" and ""Flight of the Bumblebee"" as performed by Muhammad Ali.",208,60,18,286,644,5265
And now a childhood favorite.,214,58,20,292,644,4692
Would anyone care to hear another fight song?,217,57,21,295,644,540
"This next piece - ""John Cage Match"" - is an homage.",223,55,23,301,644,2825
Piano Concerto by Pugilini,232,67,20,319,644,5129
I’m a professional. Please don’t try this at home.,194,55,17,266,644,297
"I now present ""The Fight of the Bumblebee""",202,44,23,269,644,5015
That was a knockout performance,194,60,15,269,644,5297
I will now play the theme from Rocky as it was meant to be played.,202,54,19,275,644,1533
And now it’s “time to take the gloves off”,204,65,15,284,644,1382
And how am I supposed to turn the page?,208,57,19,284,644,2900
"This next piece I call ""The old one-two""",212,59,19,290,644,4277
I can knock out any tune you name,211,66,16,293,644,5023
Why hunt and peck when you can bob and weave?,219,60,20,299,644,3885
"Well, on the plus side, it’s only a MINUTE Waltz.",220,58,21,299,644,3948
I would like to play a little song I wrote that goes nothing like this.,222,59,21,302,644,3726
This next piece is a total knock-out.,224,60,21,305,644,4255
"And now for the old, ‘One, two’",223,72,16,311,644,2736
I call this one 'Beethoven's Fifth Round.',206,63,16,285,644,57
See if you can name this one!,211,63,17,291,644,1141
I dedicate this next piece to Philip Glass.,201,43,23,267,644,1740
Bach? I thought you said Box.,221,58,21,300,644,1883
"And now, ladies and gentlemen, I shall take a jab at the piano",215,70,15,300,644,2029
I'll be going fifteen rondos.,200,55,18,273,644,2443
"My next piece is Piano Sonata No. 8 in somewhere between A Minor and E Major.""",209,52,21,282,644,3016
"Ladies and gentlemen, I've had a request for the theme from Rocky.",211,53,21,285,644,4008
And now for Philip Glass's ode to Ali.,221,48,25,294,644,4320
Could I ask someone to retrieve the mouthguard from the soundboard?,208,59,18,285,644,4330
The good thing is I finally stopped chewing my nails,219,57,21,297,644,4818
I strongly urge everyone to turn off their cell phone!,216,48,24,288,644,5231
"And now, a selection of greatest hits.",222,58,21,301,644,2613
Shall I hit it?,220,52,23,295,644,413
"OK, I get it, a little less forte.",215,62,18,295,644,519
Let me just knock out a couple of tunes for you.,210,72,13,295,644,3618
Anyone want to critique my performance now,212,63,17,292,644,3332
For my next number I am going to really pound the keys.,214,54,21,289,644,266
"And now, the Tyson Variations.",211,50,22,283,644,3638
Before my next performance I'd like to ask the Gazette's music critic to join me onstage.,211,50,22,283,644,4113
"And now, 'Eine Kleine Knock-out-musik'",206,55,19,280,644,3093
This is my fight song.,203,51,20,274,644,104
"And now Ladies and Gentlemen,
The Fight of the Bumble bee",207,43,24,274,644,4943
"And now, for a rather punchy tune . . .",195,57,16,268,644,5241
The best Opus is a good defence.,189,54,16,259,644,1968
A little help please. My fly is open.,189,49,18,256,644,1136
This piece is called Requiem for the Presidency.,192,43,21,256,644,3234
I will now demonstrate how to knock out a tune.,191,45,20,256,644,4666
"Next, a piece I composed when I was three years old.",228,43,28,299,644,2946
The next one goes something like this.,219,56,21,296,644,3463
My next piece is by the lesser known Johan Sebastian Box,215,59,19,293,644,5107
Tonight’s performance is sponsored by Everlast.,211,62,17,290,644,1516
"Indeed, I did not quit my day job.",216,52,22,290,644,4529
And now for a number with a little more punch...,210,59,18,287,644,5614
From my boxed set of recordings.,211,52,21,284,644,4950
"And now, ""Float Like a Butterfly, Sting Like a B-flat""",205,54,19,278,644,3115
The conductor said my fortissimo needs a bit more punch.,200,59,16,275,644,1078
"If you think this is bad, I'm also not wearing any pants.",203,53,19,275,644,1234
That’s the last time I write “OK” to my dyslexic agent.,208,43,24,275,644,5181
I'm just going to knock out a couple of tunes.,199,46,21,266,644,4004
This is a new piece I've worked out. Beethoven's fifth round.,185,59,13,257,644,724
Let’s get ready to pianooooooooooooooo,225,61,20,306,644,4678
I'm not the main event.,220,61,19,300,644,846
"GGGGGEEEEEEETTTTTT
RRRREEEAAAAADDDDY
TO
RACHMANINOFF!!!",215,56,20,291,644,2366
"And now, for Tyson's 5th...",216,49,23,288,644,2017
"And now ... Symphony No. 7 in C, D, and E Major.",221,39,28,288,644,5075
"And now, ""The Pugilist's Sonata,"" in a bunch of keys.",212,52,21,285,644,2034
"I dare you, ask me to play ‘Piano Man’ one more time.",205,56,18,279,644,2531
"And now, Cacophony Number 9 in E minor.",202,57,17,276,644,2372
"For my next piece,I will perform J. S. Box' Golden Glove Variations",202,57,17,276,644,4424
"And in the final movement, I take off the gloves and just go wild.",202,52,19,273,644,4844
"And to my critics, a sustained beating in D minor.""",200,51,19,270,644,644
For this next number I’d like to punch it up a bit.,194,58,15,267,644,4399
And now for my knockout number...,184,63,11,258,644,1730
"And now, ladies and gentlemen, a song about my marriage.",191,49,18,258,644,4409
"The next piece is my first composition. I first played it at the age of 6 months. My mother named it ""Knock it off"".",232,69,18,319,644,2939
"For my encore, I will now play 'Fight of the Bumblebee'.",223,52,23,298,644,3519
"And now, something  from the light heavyweight classics.",214,60,18,292,644,792
"Well, at least it's not the late and naked for the final exam dream.",223,42,27,292,644,2933
"Instead of tickling the ivories,tonight I'll be beating them.",214,50,22,286,644,3782
"And now, a quick jab at Rachmaninoff.",212,54,20,286,644,5250
"Yeah, but I don't get any more hecklers.",210,53,20,283,644,168
"You see, I only play in my spar time.",207,59,17,283,644,1946
For my next piece I’ll play Cacophony in D minor.,215,43,25,283,644,5620
Rocky-maninoff .,207,49,21,277,644,4219
This next piece is played in twelve rounds.,195,63,13,271,644,5660
Do you want the black notes or the white notes?,202,44,22,268,644,4003
"And now ""Flight of the Rhinoceros.""",198,47,20,265,644,140
This is from Beethoven's fist.,196,51,18,265,644,5209
My money's on the piano.,230,70,17,317,644,4745
My next melody is called Whack-a-Mole,225,60,20,305,644,1056
This next number is really going to knock you out.,219,67,16,302,644,103
I can only play the 'dun dun dun dun' part.,218,64,17,299,644,1638
"Look, I was told to pound the keys, and that's what I came here to do.",216,63,17,296,644,1
I'd like to play a punchy little number.,219,47,24,290,644,1386
I’ll now do my last hit,217,51,22,290,644,3724
...And it kind of goes like this.,213,59,18,290,644,3866
I always dread the Boxing Day gig.,212,61,17,290,644,3987
This next tune has quite a punch to it.,212,61,17,290,644,4455
"Beethoven, Brahms, Mozart — lightweights!",210,65,15,290,644,5260
I guess it's time to take the gloves off.,213,59,18,290,644,5443
When was the last time this piano was tuned?,216,48,23,287,644,1047
There will be no heckling tonight.,202,61,15,278,644,4352
"My record against Bartok is 10 wins, 2 losses, and one audience walkout.",236,60,22,318,644,1336
My next piece is played in three minute rounds.,195,40,22,257,644,700
"I call this ""The Old One-Two.""",222,63,18,303,644,3906
"And now, a roundhouse from T.K.O. Bach.",228,51,24,303,644,5655
I no longer play by ear.,217,58,19,294,644,262
I feel like I'm fighting the music.,214,59,18,291,644,1121
"Well, you said to make it more punchy!",208,71,12,291,644,1603
I will now float like a butterfly and sting in B.,220,47,24,291,644,3460
Welcome to the White House holiday party! And please remember to protect yourselves at all times!,215,52,21,288,644,1410
Let's get ready to rumba.,211,50,21,282,644,88
"Following this encore, I would like a word with the reviewer who has called my playing ham-fisted.",208,56,18,282,644,3850
And now ladies and gentleman “ The Trump Sonata.”,247,45,30,322,644,1225
How can I play with that bright light in my eyes?,207,48,21,276,644,3438
Round 4 will be Chopin,234,66,19,319,644,4174
"Please excuse the gloves, I'm saving my fingers for a more sophisticated audience",199,59,15,273,644,2941
"Tonight I'll be performing Beethoven's ""Moonlight Sonata"".  You may need to use your imagination.",201,50,19,270,644,1766
"A man hears what he wants to hear
And disregards the rest",197,58,15,270,644,3075
I'm going to play some Johann Sebastian Box,194,59,14,267,644,3776
"My next piece is by Rockymaninoff.""",196,55,16,267,644,5463
"No, they're not for playing. They're for dealing with anyone who criticizes the playing.",191,60,13,264,644,5431
"My next selection will be the theme from ""Rocky.""",232,50,25,307,644,931
I thought you said to play the hits,231,47,26,304,644,1624
Play chopsticks”? I can’t even hold them,223,63,18,304,644,2430
I fought the song and the song won,228,53,23,304,644,3191
"And finally, the theme from Rocky.",224,56,21,301,644,1039
This one is for you mother,229,46,26,301,644,2291
"And now, Rockymaninoff  piano concerto 3.",214,66,15,295,644,681
The music critic said my last performance lacked punch,217,60,18,295,644,4301
"And now, a more punchy tune.",215,59,18,292,644,2287
"The sound is terrible, but I get way less hecklers.",209,71,12,292,644,2951
I Only Play Fight Songs,216,57,19,292,644,5146
"And now my rendition of ""The Fight of the Bumble Bee"".",213,58,18,289,644,1404
"This is a medley of my greatest hits,",216,52,21,289,644,2839
I call this piece 'Bach-xing.',205,64,14,283,644,978
You've heard the theme. Now it's time for the variations.,214,46,23,283,644,2628
I only play the hits,211,52,20,283,644,2828
I am practicing for the White House New Year’s party.,209,51,20,280,644,1189
"And now for ""The Ill-Tempered Clavier"".",212,45,23,280,644,1943
"This next piece is called ""Fight of the Bumblebee.""",211,42,24,277,644,2697
This next one is Beethoven's fists,210,44,23,277,644,4555
"I will now play a combo of Mozart Concertos in A minor, D minor, and G major.",233,55,23,311,644,3325
"Crazy? 
Maybe. 
But you won't forget me.",197,60,14,271,644,4378
"Looks like I’m gonna have to go with the Philip Glass, not the Debussy.",199,51,18,268,644,1347
"It’s an upbeat tempo.  One, two.  One, two.",225,61,19,305,644,1186
This should be a lot better than my piccolo playing.,194,51,17,262,644,4081
I just had a manicure.,224,53,22,299,644,1335
"This next one's not subtle, but it's powerful.",216,69,14,299,644,2113
I'm asking you to please keep an open mind.,220,61,18,299,644,2688
This one's got a great hook.,193,48,18,259,644,4865
In honor of our times I'm playing dischords.,216,59,18,293,644,1488
"Now, 'The Tyson Variations.'",223,45,25,293,644,4225
"I will now play ""An etude for two fists, in three rounds""",189,51,16,256,644,2552
I will now go a couple of rounds with Shostakovich,212,62,16,290,644,711
Any other requests?,217,47,23,287,644,4797
"And now, 'How I Feel About The Little Drummer Boy.'",238,57,23,318,644,111
I'm prepared to defend tonight's choice of music.,236,61,21,318,644,526
"I shall toy with him throughout the adagio, then knock him out in the sonata.",229,75,14,318,644,5438
"I will finish with my own composition, “Fight of the Bumblebee.”",211,49,21,281,644,2
And now I’d like to belt out a little tune.,210,51,20,281,644,1366
"If Trump can claim he always tells the truth, I can claim the following is a symphony.",205,51,19,275,644,2417
"You might have heard Chopsticks before, but I’m about to punch it up a little",202,52,18,272,644,1104
"For the sake of all of us, let us hope I wake up from this nightmare any time now.",252,51,28,331,644,1461
"I thought you said play ""box""' not play  ""Bach's""!",200,41,22,263,644,2069
"When I play fortissimo, I don't fuck around.",251,48,29,328,644,4316
I'll just knock out a few tunes for you.,218,57,19,294,644,4438
"I'm now going to play 'The Fight of the Bumblebee.' """,217,54,20,291,644,4747
"So much for modern stuff. Now for Chopin, and the gloves come off.",216,51,21,288,644,2978
And now a lullabye,216,51,21,288,644,3304
I only play Fortissimo.,237,61,21,319,644,4913
Playing piano helps with my anger management issues.,227,71,15,313,644,4638
This is a concerto composed by my 2-year old.,228,64,18,310,644,2299
"Now, I shall bang out a tune.",231,58,21,310,644,4020
"Yo, Adrian--this sonata's for you.",232,56,22,310,644,5611
I’m told I have a very aggressive playing style,219,77,11,307,644,5216
And now for a punchy little tune...,205,53,18,276,644,647
It’s hammer time!,209,45,22,276,644,1331
I'd like to play you some Rocky-maninoff,205,53,18,276,644,2363
And now the theme music from 'ROCKY' the way it was meant to be heard.,221,58,19,298,644,1637
"And now, Sonata for Ali.",222,56,20,298,644,4857
Here’s a punchy little number.,196,56,15,267,644,1178
"...and for my next number, I would like to punch it up a bit.",195,58,14,267,644,5472
It's time for the greatest hits.,219,57,19,295,644,4331
"And now my original composition, ‘Float Like a Butterfly, Sting Like a B Minor.’",214,57,18,289,644,1133
I call this piece “Sonata for an Untuned Piano in A-flat minor through G major.”,215,55,19,289,644,5061
"Well, not usually, but these are my Bach-sing gloves.",210,55,18,283,644,3531
Has anyone seen my mouth guard?,226,65,17,308,644,244
Would someone be a darling and light my candelabra?,231,55,22,308,644,1437
They said my playing could use a little punch.,204,62,14,280,644,2134
Excuse me while I pound out a few notes.,220,72,13,305,644,2137
"And now, ""Float Like a Butterfly"" in B Minor.",204,57,16,277,644,4170
I lost a bet.,204,57,16,277,644,5099
"And now, I will play the 0ne-two waltz.",202,51,18,271,644,3040
The next piece is dedicated to my former agent,219,59,18,296,644,1359
"And now, for the second round...",232,65,18,315,644,1005
This is from my greatest hits album.,197,46,19,262,644,2777
I've been fighting Beethoven all my life.,213,56,18,287,644,87
"Next I will be performing Rimsky-Korsakov's ""Flight of the Bumblebee"" in the style of Muhammad Ali.",214,54,19,287,644,1426
Here’s a little number I recently knocked out.,222,65,16,303,644,4871
"In a sudden moment of panic, Mitch realizes that the Rachmaninoff concerto was actually written for a southpaw.",227,45,25,297,644,4671
You want pianissimo?  I'll give you pianissimo!,221,52,21,294,644,3918
I will now play an original piece by Frederic Chopin that he played in 1850 when he was 7 month old.,225,44,25,294,644,4683
"And now, my Muhammad Ali concerto in, well, every key at once.",219,56,19,294,644,5356
"...and so in tribute to Michael Jackson, I will ""just Beat It.""",201,50,18,269,644,4701
"Heads up, folks -- this next number's going to be a knockout.",238,55,23,316,644,5456
I’ve seen my fair share of piano bar fights.,214,61,16,291,644,171
"Ladies and Gentlemen, I'm going to pound out a few numbers for you tonight.",212,60,16,288,644,476
Tonight I’ll be going a few rounds with Beethoven,205,69,11,285,644,866
"Now, an atonal piece.",213,53,19,285,644,3066
"Now for my unique rendition of ""The Boxer"" by Paul Simon.",213,53,19,285,644,4196
...And now a selection from my new boxed set.,210,54,18,282,644,1145
This next piece is a punchy little number.,209,56,17,282,644,3044
"Did you say, ""Bach's""?",215,44,23,282,644,3106
"Float like Madame Butterfly, sting like Flight of the Bumblebee.",231,49,24,304,644,487
Another knockout performance.,206,57,16,279,644,2211
I got tired of just tickling the ivories!,205,59,15,279,644,5425
"Look mom, no hands",222,62,17,301,644,3838
My next number will knock you out.,201,62,13,276,644,3698
"Now, this next tune may ring a bell.",185,52,14,251,644,402
"""This next piece will be played in rounds.""",198,58,14,270,644,3120
Next is a punchy little tune I wrote myself...,214,63,15,292,644,2062
"Mendelssohn, Mozart, or Marciano?",220,51,21,292,644,3454
Welcome to an evening of mixed martial arts and music.,216,59,17,292,644,4040
Here's something I pounded out just this morning.,213,65,14,292,644,5350
This piece comes from the West Wing of the White House.,238,52,24,314,644,1408
This next one is going to be a round.,216,54,19,289,644,2722
My next composition is a punchy little number.,212,62,15,289,644,4015
"My next selection will be  ""Fight of the Bumblebee"".",217,52,20,289,644,4364
"Forte like a butterfly, staccato like a bee.",233,57,21,311,644,1494
"As a Jazz Pacifist, I believe it's more about the notes I don't strike",233,57,21,311,644,2857
It was a restraining order from my piano teacher!,222,37,27,286,644,4414
The next one is going to be a hit.,229,55,21,305,644,5295
"Sorry, I only do fight songs.",207,62,14,283,644,380
I'll be playing Fight of the Bumble Bees.,210,56,17,283,644,2133
"Now, i am going to play my greatest hits.",210,56,17,283,644,4572
"My next piece is entitled ""Requiem for a Heavyweight.""",227,54,21,302,644,748
And now a little-known piece by John Cage.,215,41,24,280,644,3832
Apologies for the rocky start...,208,50,19,277,644,986
"The music was lovely, but the pianist was a bit heavy-handed.",223,52,21,296,644,4246
I’m going to pound out a tune for you.,218,57,18,293,644,2308
"And for my next selection. ""The Fight of the Bumblebee""",219,55,19,293,644,4063
This next number is a round.,235,55,22,312,644,4604
Could someone please straighten my tie?,216,56,18,290,644,2336
Tonight’s bout will be a twelve rondo.,195,61,12,268,644,3915
"My next piece is dedicated to that miserable, heartless, brainless critic in the fifth row center, who had the Gaul to say I played with a heavy hand.",232,56,21,309,644,2708
"This next one, I'll play by ear.",227,61,18,306,644,5357
The Pugilist's Waltz,196,54,15,265,644,2310
"For my next selection, I have prepared an interpretive rendition of the Theme from Rocky.",214,50,20,284,644,4574
"My next number will be the ""old one two.""",205,63,13,281,644,1333
"On tonight’s program, “Float like Les Papillons, sting like Debussy.”",214,45,22,281,644,4989
You're in for a knockout performance tonight.,220,65,15,300,644,3821
Who's ready to hear my hit song?,209,50,19,278,644,463
Any fight song requests?,204,60,14,278,644,3608
What tune would you like me to knock out next?,203,62,13,278,644,3725
"Here's a mashup I call ""Eine kleine Nacht-out-musik.""",205,58,15,278,644,5615
"My next number is ""Chopfists"".",221,58,18,297,644,1937
"NOW,CLAIR DI LUNE AS YOUVE NEVER HEARD IT PLAYED BEFORE.",227,46,24,297,644,4046
Beethoven's Fifth Round.,222,56,19,297,644,4789
"For the encore, I take the gloves off.",214,72,11,297,644,5402
"On the other hand, 15 note chords are easy!",202,59,14,275,644,1064
"And now, for my next cacophony...",200,63,12,275,644,5476
This next piece was written by Victor Borge.,217,61,16,294,644,2711
Gerald was finding his two jobs were beginning to interfere with each other.,222,51,21,294,644,5674
If you all don’t stop heckling me the gloves are coming off,191,44,18,253,644,797
This next piece is by my two-year-old toddler.,216,53,19,288,644,3278
And now for my final round...,195,58,13,266,644,371
I will now play something by Rocky Maninoff.,214,52,19,285,644,1940
The full boxed set will be available after the performance.,240,64,19,323,644,2884
"Okay Jim, you got this. Float like a butterfly, sting like a B flat.",225,62,17,304,644,3331
"Not often performed,this is young Mozart’s very,very, first piece.",229,54,21,304,644,4437
"First movement, round three.",207,61,14,282,644,240
A knockout performance!,210,55,17,282,644,3603
I pity the fugue!,196,51,16,263,644,5502
Welcome to the Van Cliburn/Mike Tyson piano competition.,210,50,19,279,644,2409
"And this one's for Mother, who made me practice...",212,46,21,279,644,4049
"I know it looks odd, but it got me into Harvard.",243,43,28,314,644,5308
I call it my Concerto in 10 Rounds.,222,53,20,295,644,745
This one'll be a knock out.,202,61,13,276,644,1313
And now let me punch out a tune.,207,51,18,276,644,2104
This is a punchy little tune...,203,59,14,276,644,2352
"I will now perform Mozart's first sonata, which he composed at the age of 16 months.",210,45,21,276,644,5192
"Tonight, I thought we'd start off with a little Philip Glass",220,52,20,292,644,3495
This Will Be A Knockout Performance,212,68,12,292,644,3497
My next piece is a bout . . .,218,56,18,292,644,4628
it’s really more about my creative approach and not the actual notes,214,64,14,292,644,5386
I will now play selections from my boxed set.,208,44,21,273,644,642
"I'm going to pound one out, now.",205,50,18,273,644,832
This next exuberant piece dates to Mozart's toddler years.,216,55,18,289,644,5152
"And now, a literal rendition of Simon & Garfunkel's, ""The Boxer.""",204,47,19,270,644,274
"And now, my rendition of Mike Tyson's 'From Ear to Eternity'.",202,51,17,270,644,2010
Would the person who requested Proud Mary please come forward?,214,54,18,286,644,885
"And now, the Sonata in Me Minor, by D. J. Trump.",221,40,25,286,644,5073
"Playing isn't the problem, who's going to help me if I need to use the bathroom?",232,45,25,302,644,4322
"I will now play ""Fight of the Bumblebee.""",211,55,17,283,644,667
"For my next number, I’ll be pummeling the ivories...",210,57,16,283,644,2120
Here's a little tune I recently knocked out.,210,57,16,283,644,4478
"Alright, the next time someone throws a tomato, the gloves are coming off.",195,55,14,264,644,4804
"And now, the Trump Suite of Dementias, in F Major.",226,52,21,299,644,2285
"This next piece is rather punchy, but softly incorporates many, many notes close to one another.",210,52,18,280,644,1947
I float like Madame Butterfly and sting like Flight of the Bumble Bee,207,58,15,280,644,3270
"Trump asked me to do the musical score for the ""Chuck & Nancy"" meeting.",212,48,20,280,644,3515
I took a piano to the zoo to see if elephants could compose as well as paint. This is what they wrote.,209,54,17,280,644,4381
"If I hear a cell-phone ring, watch  out!",193,54,14,261,644,2313
This next song is a round.,218,58,17,293,644,1769
Welcome to Mixed Musical Arts.,190,55,13,258,644,4691
"No, but I can hum a few bars.",235,51,23,309,644,2421
This is going to suck.,210,42,22,274,644,1585
I’m just going to pound this one out.,220,49,21,290,644,3500
All a song needs is a good hook.,221,47,22,290,644,4599
"Next up is the theme from ""Requiem for a Heavyweight"" in the keys of A, C, and F",229,58,19,306,644,3203
I'll just punch out a little number,199,59,13,271,644,917
"And now, a sonata in twelve rounds.",214,56,17,287,644,5510
I am now going to play for you a medley of works by Rockymaninoff.,190,45,17,252,644,1220
"And now, for my last number I will play the title song on my new album Trump Year 2.",203,46,19,268,644,3932
"And for my last number this evening, I'll be performing, ""Rhapsody in Black And Blue.""",213,53,18,284,644,448
I will now play The Minute Waltz in ten seconds.,228,50,22,300,644,5220
"Chopin, Nocturne No. 2 in every key.",240,53,23,316,644,1843
"And now, with your kind indulgence, I'll change the mood a bit.",184,52,13,249,644,1888
Yet another dream where I don't have my underwear on.,212,50,19,281,644,969
It says forte.,222,57,18,297,644,1761
This is a piece I just knocked off.,214,73,10,297,644,4840
Now a little music for Boxing Day.,195,52,15,262,644,5681
And now for a little fight music.,221,54,19,294,644,2559
"Now I shall play, 'The Fight of the Bumblebee'.",235,53,22,310,644,1855
Just hitting a few notes,229,60,18,307,644,1736
Any more requests? I could pound out tunes all night.,224,65,15,304,644,329
And it goes a little bit like this...,201,57,14,272,644,1535
"Float like ‘Madame Butterfly,’ sting like ‘Flight of the Bumblebee.’",217,52,19,288,644,2174
"Any requests, Mister President?",209,41,22,272,644,2475
"Mesdames et Messieurs, la sonate pour Donald Trump.",218,50,20,288,644,2556
Piano no problem. Tying bow tie is a totally different challenge.,227,54,20,301,644,4669
And for my next selection....Cacaphony in G-major.,215,51,19,285,644,3095
This next piece is from Beethoven's welterweight period.,208,60,14,282,644,2692
Okay. let's knock out a few tunes on the piano. Any request?,197,55,14,266,644,3594
"And now, Paul Simon's ""The Boxer""",221,56,18,295,644,2781
My parole officer wasn’t clear on the type of community services I’d be performing tonight.,208,55,16,279,644,3800
"And in this corner, playing in at 185 lbs., ...",209,53,17,279,644,5168
"That was in the key of C minor, give or take...",216,61,15,292,644,4700
And now for a touch of Wagner.,206,49,18,273,644,3100
I will now play 12 rounds of Chopin.,232,73,13,318,644,2728
As for the reviewer who suggested my repertoire lacked punch.…,226,58,18,302,644,1349
Trying to knock out a few tunes,221,68,13,302,644,1360
Here's my rendition of Beethoven's Fifth – Round.,210,63,13,286,644,1962
"For this number, I float like a butterfly, sting like a B flat major.",201,54,15,270,644,514
And now for something a little more punchy.,232,68,15,315,644,1753
Any last requests?,213,52,18,283,644,1964
Any requests before I start pounding on the keys?,212,54,17,283,644,3173
Now I will pummel the ivories.,230,67,15,312,644,3715
Anyone else want to face the music?,201,49,17,267,644,4843
"After 30 years of tickling the ivories, I’ve decided to try something new.",198,50,16,264,644,2856
"My Dad wanted me to box, and Mom wanted me to play the piano.",219,57,17,293,644,586
Who coughed?,226,43,24,293,644,591
"And now, a fugue by T.K.O. Bach.",223,49,21,293,644,2908
I had to fight for this gig.,218,59,16,293,644,5487
"Ladies and gentlemen, I will now perform a medley of my greatest hits.",240,64,18,322,644,2606
Here's a new tune that will knock you out.,207,54,16,277,644,5526
"Yes, the whole piece is to be played Fortissimo.",223,44,23,290,644,461
The score says attacca con forza.,219,52,19,290,644,1471
"This sonata is called, “Yo, Adrian.”",198,45,18,261,644,1580
"Concerto in A, B, C, D, E, F, and G",203,57,14,274,644,2550
I play by ear.,204,55,15,274,644,2787
Welcome to our First Annual Boxing Day Concert!,192,52,14,258,644,4813
Let’s get ready to rrrrubato!,205,48,18,271,644,2297
Thank you. That was Rockymaninoff's Piano Concerto in Round No. 2.,204,50,17,271,644,2860
"Before I start playing the theme from ""Rocky"", can somebody come up here and zip up my pants?",219,42,23,284,644,204
"John Cage's 4'33, as played by Rocky Balboa.",217,46,21,284,644,1699
They made me give up the harp.,212,56,16,284,644,3228
"Pianissimo like a butterfly, fortissimo like a bee.",214,52,18,284,644,5007
I'd like to begin with a little warm up exercise.,191,49,15,255,644,3140
And now for something modern.,227,48,22,297,644,4829
They’re rather tired of being tickled.,209,57,15,281,644,1111
I will now play a piece from my boxed set.,212,51,18,281,644,3032
I shall now perform Beethoven's 10th Round Piano Concerto.,225,47,22,294,644,3273
Tonight we present dueling pianos...,225,47,22,294,644,3922
For an encore I will play Beethoven's Hammerklavier Sonata.,218,61,15,294,644,4477
I will now play a round by Johann Sebastian Box.,221,55,18,294,644,4912
Does anyone else have any criticism?,208,54,16,278,644,1070
This piece is dedicated to those that did not like my previous one,222,48,21,291,644,4751
The second movement begins with delightful arpeggios and ends with an uppercut.,218,56,17,291,644,4971
Who clapped?,195,53,14,262,644,409
"And now, I shall perform my impressions of what some of you call ""jazz"".",204,57,14,275,644,1439
"And now I shall play for your listening pleasure a few pieces from my latest recording, ‘Atonal Bludgeoning Cacophony.’",220,47,21,288,644,85
This is ridiculous.  How do you possibly expect me to play the piano without my mouthpiece?,214,59,15,288,644,5678
"This next piece was composed by my cat, Barnabas.",200,38,21,259,644,4273
He was told tickling the ivory is no longer workplace appropriate.,200,60,12,272,644,1616
"I said I’d play for a Grand, baby! Not play a baby-grand!",258,54,25,337,644,3436
. . and I've taken the liberty of consolidating all individual notes so as to not offend the listener who might be sensitive to borrowed folk melodies of identifiable ethnicity.,200,55,14,269,644,1620
Who said I play with a heavy hand​?,221,57,17,295,644,1910
So I promised the composer not to pull any punches.,222,55,18,295,644,3396
"and now, Beethoven's Fist Symphony in C Minor...",202,46,18,266,644,1125
This next number is a knock out.,203,44,19,266,644,1859
This piano is going down by the second movement.,198,54,14,266,644,4707
"A piece titled, ""The Next Election",222,50,20,292,644,5314
I'm gonna add a little punch to this one,200,45,18,263,644,3933
I'd like to pound out a few tunes.,214,61,14,289,644,5539
This next one's an opus in ten rounds.,224,63,15,302,644,3322
Tell the conductor I'm ready to punch it up a little.,228,55,19,302,644,4279
"And for my next piece, I'll add a blindfold as well!",222,62,15,299,644,639
"I like to call this one, ,'You're Gonna B-flat-tened.'",217,50,19,286,644,1696
"Makes ""hitting"" those notes much easier.",222,62,15,299,644,2434
"My next song is The Boxer, by Simon and Garfunkle.",225,56,18,299,644,3538
Didn’t you ask me to bang out a tune”,206,50,17,273,644,4425
"Next, ""Dance of the Butterflies,"" by Muhammad Ali.",212,60,14,286,644,5322
"Please be quiet, or I’ll take the gloves off",232,59,18,309,644,4047
"And now, Balboa's variations on ""Eine Kleine Knock-musik""",221,59,16,296,644,4748
"As soon as my opponent arrives, we can begin.",194,69,7,270,644,445
Let's knock out some tunes!,241,58,20,319,644,5451
For my next attempt I will fight my way through Rachmaninoff's 3rd.,233,52,21,306,644,5204
This next one's a knockout.,209,56,15,280,644,1896
"To start with, I'll just knock out a little sonata.",209,56,15,280,644,4894
"And now , I coulda been somebody concerto in A minor.",200,52,15,267,644,2249
The melody could use a little more punch.,198,56,13,267,644,2664
And for my second piece I will also be wearing handcuffs.,199,54,14,267,644,4935
My next piece is by Johann Sebastian Boxer.,251,55,23,329,644,1063
The gloves come off for the Rachmaninoff!,234,45,24,303,644,884
Next comes a number that only a two-year-old will appreciate.,218,55,17,290,644,474
I will now perform Mike Tyson's concerto in B flat.,223,45,22,290,644,1971
I’m told this next piece is a knockout.,221,49,20,290,644,3547
"LIMERICK: There was a pianist named Billy...A heavy weight singer from Philly...His tunes packed a punch...And he delivered a bunch...But personally, I found them silly.",216,59,15,290,644,5399
"Next - Michael Jackson's ""Beat It""",206,57,14,277,644,1890
"I now present a new piece entitled ""Modern Diplomacy.""",229,50,21,300,644,459
That's the last time I schedule a concert on Boxing Day.,227,54,19,300,644,4884
"And now, by Rimsky-Korsakov, The Fight of the Bumblebee.",216,54,17,287,644,1447
This is a heavyweight sonata,209,68,10,287,644,1816
"Next, I shall perform George Foreman's Symphony in A Minor",219,48,20,287,644,2724
This next piece is another punchy little number.,216,54,17,287,644,4842
Tickling the ivories is not enough for me.,202,60,12,274,644,1805
I'll knock out a quick tune.,205,54,15,274,644,3318
They call him the Manassa Mahler,238,49,23,310,644,3775
"Hey, don't laugh. It's a lot easier than Chief of Staff.",216,49,19,284,644,3644
"Go ahead,ask me if I'll play Misty for you.",205,49,17,271,644,5035
This next one is by Rockymaninoff,193,51,14,258,644,1243
My next piece is George Foreman's concerto for pianos with really fat keys.,214,48,19,281,644,2359
My playing style is known to be rather aggressive.,239,59,19,317,644,159
_Pass the tip jar and the gloves come off.,202,50,16,268,644,4552
"For my next selection I will play ""Fight of the Bumblebees""",213,45,20,278,644,708
I forgot the punch line!,215,41,22,278,644,3373
"And now, selections from ""The Ring Cycle.""",208,55,15,278,644,5682
"To close, a traditional Boxing Day tune.",206,54,15,275,644,1672
"Next, a tune I composed in tribute to Muhammed Ali, Fight of the Bumblebee""",209,48,18,275,644,3335
Here's a song that packs a punch.,204,58,13,275,644,4957
"And now, a little something from Punchini.",210,46,19,275,644,5581
"Don't prejudge.""",223,59,16,298,644,291
How do you expect me to play without sheet music?,209,65,11,285,644,1100
And now a tune by Henry “Boom Boom” Mancini.,206,49,17,272,644,2449
Next I'll perform Rockymaninoff's arrangement of Bach's concerto,206,49,17,272,644,4159
"I went to a tough music school. The keys were black and blue. But seriously, take my arranger. Please!",197,45,17,259,644,3664
The next number is a real hit song.,217,44,21,282,644,1619
I'm waiting for the opening bell.,212,54,16,282,644,2747
ARE ... YOU ... READY...TO ........GLISSANDO!!!!!,214,50,18,282,644,5066
"Ladies and gentlemen, I plan to do more than just ""tickle the ivories.""",198,60,11,269,644,1551
My next number will be The Fight of the Bumblebee.,223,49,20,292,644,1918
And now a punchy tune,220,55,17,292,644,3102
"Ladies and gentlemen, let me knock out a little number for you.",236,62,17,315,644,4216
And now the hard way.,215,43,21,279,644,1470
"The record shows I took the blows 
And did it my way",212,49,18,279,644,1581
"Don't worry, I can Handel myself",209,55,15,279,644,1747
I thought I’d punch up this last number just a bit.,199,53,14,266,644,3316
This next piece will be very hit and miss,230,69,13,312,644,1614
It's called Bach-sing.,239,51,22,312,644,2035
I was told to take a dive in the third cadenza.,203,62,11,276,644,1183
"Any more requests ,except ""go to hell""?",247,52,23,322,644,3207
And now a song that floats like Madame Butterfly and stings like the Flight of the Bumblebee,225,57,17,299,644,3351
What?  I got tired of tickling them.,220,67,12,299,644,4684
I will next do battle with Rachmaninoff's No. 3,215,55,16,286,644,3397
And now for a little not music.,211,58,14,283,644,1017
Please have patience as I fight my way through the always difficult Rachmaninoff  3rd piano concerto.,242,52,22,316,644,432
My next piece is Chopin's Noc-out-turne opus 9,237,62,17,316,644,4394
"Sir, I submit that you would not know a fugue if it hit you in the face.",221,55,17,293,644,306
What? You've never seen Bach-sing gloves?,229,39,25,293,644,4411
"Thank you, ladies and gentlemen.  Tonight, I don't plan to tickle the ivories as much as smash 'em to bits.",204,50,16,270,644,789
"And now a contemporary rendition of Schoenberg's transcription of LL Cool J's ""Mama Said Knock You Out""",232,50,21,303,644,3946
"You said pugilisimo, right?",213,49,18,280,644,1087
"Are you sure about this, Mr. Cage?",215,45,20,280,644,3785
I shall now play my interpretation of Beethoven’s Hammerklavier sonata.,219,37,24,280,644,4205
And now a little something from the Ring Cycle.,237,57,19,313,644,22
Let's see you bring your booing up here.,222,48,20,290,644,2848
"Float like a butterfly
Sting like a B major",210,50,17,277,644,680
This next piece is called 'Ode to Percussion',207,56,14,277,644,1448
This next piece I composed for Boxing Day.,210,50,17,277,644,3426
This piece will knock you out.,212,63,12,287,644,4448
They laughed when I sat down at the piano.,228,48,21,297,644,2513
"You want me to come in one measure after the bell, right?",231,59,17,307,644,575
I gift from my piano teacher just moment ago.,238,45,24,307,644,2272
"And now....""Flight of the Butterfly/Sting like a B flat.""",208,49,17,274,644,2617
And now Beethoven's Moonlight Sonata...molto pugilissimo!,207,51,16,274,644,3816
"This is a lessor known but musically athletic Bach piece, the poundo and feud in three rounds.",208,49,17,274,644,5675
I thought you said Box Prelude and Fugue.,219,44,21,284,644,1936
Next I'm going to knock out a few favorites...,213,56,15,284,644,5070
I coulda been a concerto.,224,51,19,294,644,2871
This next one goes out to  ADRIAAAAAAN!,222,50,19,291,644,4507
"We take ""dueling pianos"" very seriously.",227,57,17,301,644,3080
Tickling got me nowhere.,231,49,21,301,644,3619
"And now, I will sock it to you.",189,60,9,258,644,5261
My next piece is by Rocky Marcianinoff,212,48,18,278,644,668
"And now, for your enjoyment....The Ring Cycle.",213,46,19,278,644,1559
"I predict it will end in the sixth measure.""",208,56,14,278,644,4041
This next number will be a real knockout.,207,58,13,278,644,4109
"And finally, the punchline.",219,51,18,288,644,2242
That coulda been a concerto.,223,43,22,288,644,5514
"That was the fury, now comes the sound.",200,50,15,265,644,3755
My teacher said it's time to take the gloves off.,210,47,18,275,644,3359
They told me to come up with a punchy number.,208,51,16,275,644,4795
This is a little something my three-year-old wrote...,195,55,12,262,644,3411
Rondo Two!,196,53,13,262,644,5330
I guess I can try to knock out some tunes!,212,55,15,282,644,2510
This next piece will be performed in 12 rounds.,225,63,14,302,644,5573
What do you mean there's no punchline?,206,45,18,269,644,5046
I dare you to cough one more time!,221,49,19,289,644,4154
Now I’d like to pummel my own interpretation of  ‘Rhapsody in Black and Blue’.”,195,45,16,256,644,1452
"I'm sure you'll all recognise my next song, it has a ring to it.",203,46,17,266,644,5471
"I present my new composition ""Trumps attempts to hit the right chords""",214,41,21,276,644,1304
I thought the conductor said he wanted a little more punch?,206,57,13,276,644,4680
The first number I'll be playing this evening is going to sound like hell.,220,46,20,286,644,933
"Once more, with feeling",191,48,14,253,644,5021
For my final piece I'd like to play Schubert's  Four Impromptus D899 but I can't.  So instead I'll just beat the crap out of this thing.,202,43,18,263,644,1993
"And, for the final match, it’s me against Steinway.",205,54,14,273,644,1641
"Next, the World Premiere of ""Get Your Ass Out of Bed!"" composed this afternoon by my very own wife.",209,46,18,273,644,4307
Potential hecklers should take note...,210,61,12,283,644,9
And now for a piece that sounds like something a toddler could play.,213,55,15,283,644,164
Prepare to be knocked out!,225,65,13,303,644,239
They said my performance was a knockout!,207,62,11,280,644,1327
I will begin with Rhapsody in Ear Flat by Mike Tyson.,223,47,20,290,644,2182
"And now, my rendition of the theme song from ""Rocky"".",200,42,18,260,644,2545
The next piece is dedicated to my ex-wife who said I wasn't masculine enough.,213,50,17,280,644,3310
This next piece was composed by a 2 yr. old with no formal training.,206,47,17,270,644,3840
I really don't think it's been properly tuned,207,62,11,280,644,4786
I Am The Greatest!,209,58,13,280,644,4939
"After all, the piano is a percussion instrument.",218,52,17,287,644,904
Tickling the ivories! I think not.,201,52,14,267,644,1131
This next piece will knock you out!,200,54,13,267,644,1228
Too punchy?,230,57,17,304,644,470
"Tonight, I'll be going fifteeen rounds with the Schoenberg.",232,53,19,304,644,5283
"Any requests for ""Fight of the Bumblebee?""",217,66,11,294,644,4727
YOU FORGOT THE BLINDFOLD.,218,30,26,274,644,5334
And now a selection from Madame Float-like-a-Butterfly.,238,53,20,311,644,3433
I had to fight my way to the top.,230,52,19,301,644,3153
I would ask that you suspend disbelief,203,55,13,271,644,1389
"Next, I'll play you a punchy little tune.",202,57,12,271,644,1822
"And now I will play, ""The Fight of the Bumblebee """,205,51,15,271,644,3995
"And now,    Eine Kleine Nacht Out  Musi",209,43,19,271,644,5460
"And now a new take on a classic: ""Beating You Senseless With My Song.""",198,48,15,261,644,5483
"For my next selection, I will play the 'Theme from Rocky'.",194,39,18,251,644,3468
Gimme a mandatory eight count.,223,61,14,298,644,444
Some people said my hands were too small to play piano. Not true. I'm a very good player. Nobody better than me at piano...,227,53,18,298,644,2451
This is Stravinsky - Symphony in three rounds.,224,59,15,298,644,5019
The following selection will be played in B-flatten.,219,52,17,288,644,2391
'We're now going to take the gloves off.',208,57,13,278,644,254
How better to pound the ivories?,196,47,15,258,644,1080
"And now for my next piece, ‘Float Like a Butterfly, Sting Like a Bee.’",200,39,19,258,644,5575
"I call this one, 'Fight of the Bumblebees'.",233,53,19,305,644,1419
"A Paul Simon song, sir ?   Any one in particular ?",228,46,21,295,644,1444
"For my next number I would like to play a new composition I call ""The Fight of the Bumblebee""",214,57,14,285,644,3419
"I think you will all recognize the theme from ""Requiem for a Heavyweight.""",205,58,12,275,644,661
I think you'll all recognize this Paul Simon tune.,211,46,18,275,644,3600
And now a little number by Schoenberg—please feel free to hum along.,235,44,23,302,644,1018
"If the bartender is listening, I'm ready for another round.",228,58,16,302,644,4983
"Wait, downbeat? I thought you said beat-down.",223,51,18,292,644,1467
"'I'll knock out a few melodies.""",211,58,13,282,644,2148
"For my next selection, I'm going to play 'Chopsticks' again.  Anybody got a problem with that?",208,47,17,272,644,4704
"And now, the lovely Sonata in G-flat, composed by Michael Tyson",198,50,14,262,644,4968
Now here's one from a real heavyweight.,226,57,16,299,644,2765
It’s not as delicate a piece as one might think.,227,55,17,299,644,4017
"For tonight's encore, I am pleased to present  to you 'Fight of the Bumblebee'",210,55,14,279,644,49
This next piece packs quite a punch,211,53,15,279,644,525
Let’s get ready to RE-CI-TAAAAL!,207,44,18,269,644,1046
I will now pound out my favorite Soussa march.,221,62,13,296,644,5536
OSHA regulations.,218,51,17,286,644,2687
Get ready for my latest hit...,217,53,16,286,644,4494
A method pianist prepares to play the score of Rocky.,207,56,13,276,644,5097
And it sounds a little something like this....,208,54,14,276,644,5324
Heavy handed—me?,245,55,20,320,644,677
"And now, ""Fight of the Bumblebee.""",215,52,16,283,644,95
I will now play something from my boxed set.,208,49,16,273,644,2560
"Well, this is going to be rocky.",232,47,21,300,644,3073
This number will be a knockout!,250,57,20,327,644,720
All I’m asking is that you give me a fighting chance.,218,58,14,290,644,646
Tonight I will be playing selections from Wagner’s Ring Cycle,222,50,18,290,644,3151
"And now, a rarely heard Boxing Day carol.",214,49,17,280,644,1650
"Float like a melody, sting like a B-flat.",204,69,7,280,644,1743
"Yo, Hayydnnn!",219,51,17,287,644,989
Paganini's Pugilisto In D Minor,194,55,11,260,644,4801
"And now, Rachmaninov in three rounds.",228,62,14,304,644,4245
"Then what precisely DO you mean by ""Punch it up a little""?",211,50,16,277,644,3993
"If Billy Joel claims to be the piano man one more time, I swear I'm going to deck him.",214,44,19,277,644,5025
Tonight the ivories have begged not to be tickled.,224,53,17,294,644,1530
I have A Minor problem,223,55,16,294,644,2694
Uhhh...I kinda lost a bet.,224,53,17,294,644,4542
Let's get ready to Handel,208,51,15,274,644,118
I call this one Rach'em-Sock'em-Maninoff.,220,56,15,291,644,594
This Flight of the Bumblebee is in honor of Muhammad Ali.,224,48,19,291,644,5202
"And now, Shostakovich’s Piano Concerto No.2, as if played by your two year old niece.",202,46,16,264,644,3586
I'm making Mozart great again.,219,41,21,281,644,34
Tonight I'll begin with the Fight of the Bumble Bees.,213,53,15,281,644,651
And my next song is sure to be a hit!,221,49,18,288,644,5307
"Should anyone in the audience fail to appreciate this beautiful musical piece, I must advise you that there will be consequences.",211,52,15,278,644,1929
"I call this next number ""The Critic's Face"".",214,46,18,278,644,2390
"I apologize, the gloves proved much more difficult to take off than to put on.",208,58,12,278,644,5327
I think I'm on the wrong stage.,234,64,14,312,644,2762
And now for the Cantata Pugilisto,218,50,17,285,644,1025
"And now, the theme from ‘Rocky’ as it was originally composed...",219,48,18,285,644,1262
For my next piece...the theme from Rocky,214,41,20,275,644,3070
"And now, Rockymaninoff 's concerto #2",213,43,19,275,644,3565
This is a little tune I learned when I studied under Sonny Liston,218,62,12,292,644,1007
"My next number will be in the key of E, G, and C.",227,44,21,292,644,1916
Round three goes something like this.,214,53,15,282,644,598
"And now, something a little more lightweight.",208,65,9,282,644,3294
And a little bit softer now...,216,49,17,282,644,4956
"And now, an interpretation of Liszt based on my true feelings.",228,54,17,299,644,3413
"Trust me, this next piece was a real knockout at my last recital",219,55,15,289,644,2738
And now one of Schönberg's more challenging pieces...,226,41,22,289,644,3021
It was at this moment he realized delivering a knockout performance did not require boxing gloves.,220,53,16,289,644,5657
How do you folks feel about tone clusters?,223,59,14,296,644,5507
This next piece is going to be a little punchier,228,61,14,303,644,2522
My insurance carrier insists I take special care to protect my hands since my career depends on it.,192,46,14,252,644,4888
"And now, the Hammerklavier Sonata like it's never been hammered before.",222,56,15,293,644,875
Just how fortissimo do you want it?,209,53,14,276,644,74
I see you're as confused as I am.,210,51,15,276,644,2620
"Folks, this won't be my usual performance. I'm not wearing any pants tonight.",213,45,18,276,644,3720
I just knocked this last piece out last night.,231,50,19,300,644,2716
This next piece is a technical knockout.,212,59,12,283,644,580
And Now Tyson's Ninf Symphony,219,45,19,283,644,619
"Having defeated all challengers, I will now continue with the Chopin.",216,51,16,283,644,1339
Good evening folks....Thought I'd belt out a tune for you.,192,70,4,266,644,874
Here's a little number I punched out this morning.,202,50,14,266,644,4160
And now for my box set.....,190,45,14,249,644,1913
"Now for the main event, ...",231,62,14,307,644,4994
"And now, my interpretation of Wagner's ""The Ring.""",232,60,15,307,644,5268
Here's a punchy tune I wrote to celebrate the Senate Judiciary Committee Hearings,225,45,20,290,644,844
This rendition will really knock you out.,219,57,14,290,644,2255
Sit back and relax while I pummel the ivories.,208,50,15,273,644,2098
"Ladies and Gentlemen, Rockymaninoff No. 3.",243,50,21,314,644,1073
I'm still working on the hook.,227,53,17,297,644,4639
"Next I'll play a John Cage adaption of the theme from the movie ""Rocky"".",202,45,16,263,644,4506
I'm hoping to be saved by the bell.,228,63,13,304,644,4984
This one is by Rockymaninov.,218,54,15,287,644,3
"And now, here's one for you lovers of polytonality....",220,50,17,287,644,2950
"And now, a new piece by John Cage...",210,41,19,270,644,4780
Power chords are my forté!,228,58,15,301,644,2955
The first movement is to be played ‘molto aggressivo.’,216,53,15,284,644,635
"This next piece I call, ""Float like a butterfly, sting like a Bee-thoven.""",219,47,18,284,644,1357
It is the best way to keep my hands insured.,215,55,14,284,644,4990
"I will now play a version of ""Flight of the Bumblebee"" , that I have restyled as ""Romp of the Hippopotamus""",218,49,17,284,644,5280
I'll just knock out a quick sonata before dinner.,236,54,18,308,644,486
I have entitled this next piece: Dischord,221,55,15,291,644,1445
Is there someone who can read music and turn pages for me?,217,63,11,291,644,2474
"Well, tickling the ivories wasn't working!",242,54,19,315,644,5100
Now here's a little ditty from my boxed set.,207,54,13,274,644,1848
"And finally, I'd like to knock out a few.""",209,50,15,274,644,2676
I felt this tune needed some punch!,209,50,15,274,644,3338
This next piece was composed by my toddler,230,49,19,298,644,1012
"Tickling the ivories, has never been my forte.",224,61,13,298,644,1785
I will now play the Theme from Rocky...badly.,230,49,19,298,644,3339
I call this next one 'Beethoven's Fists.',230,49,19,298,644,3936
Mind if I punch out a tune?,221,67,10,298,644,4596
"What?? No, the contract definitely said glove songs...",220,40,21,281,644,3246
This is the best way I have found to knock out a tune.,209,62,10,281,644,3865
This evening instead of tickling the ivories I will be punching them.,218,56,14,288,644,1607
Yo Adrian!!!! This one's for you.,209,45,17,271,644,2187
Now I will play the theme from the movie Rocky.,208,47,16,271,644,3062
"Next up, the Theme from Rocky.",206,51,14,271,644,4940
"And for my final number, I present Concerto: The Thrilla in Manila, Round 4, in B flat",226,64,12,302,644,881
"At your request: Tyson's ""Fight of the Bumblebee""",213,49,16,278,644,3527
"This is the point in the program at which I respond to requests for ""Feelings"" or ""Piano Man"".",236,56,17,309,644,342
"For my encore I will play Opus 7 in A, B and C Major",247,46,23,316,644,3245
Raymond is undefeated in the spinet division but now faces a big challenge in a higher weight class.,223,53,16,292,644,1639
"And now, Balboa's piano concerto in C, B, B flat, A, A flat and G""",230,39,23,292,644,3526
Wasn't the program Rockymaninoff?,225,49,18,292,644,4349
"For my next piece, I will explore the roots of the piano as a percussion instrument.",203,52,13,268,644,1844
"No, this is NOT to compensate for small hands.",205,48,15,268,644,5092
And now a special arrangement of the Battle Hymn of the Republic.,213,56,13,282,644,1673
"For an encore, I've chosen to knock out a few bars of Beethoven's Ninth.",235,65,13,313,644,5542
"Good  Evening Folks, this is the first time I've played at a ""Fight Club.""",194,53,11,258,644,1880
A pugilistic concerto in B flat. Round one.,195,51,12,258,644,2621
"Good evening, Ladies and Gentlemen. I’m Down for the Count Basie!",195,51,12,258,644,4977
I will now play 'Temper Tantrum in C Minor'.,218,58,13,289,644,4176
It needed the right hook.,222,50,17,289,644,4710
And now... “Make America Great Again!”,205,43,17,265,644,3034
Doesn’t”matter now if it’s tuned or not.,206,41,18,265,644,3054
"And now, Requiem for a Heavyweight for piano and gloves!",203,47,15,265,644,4782
I'll start on the count of three and stop on the count of ten.,223,60,13,296,644,331
Let me knock out a number for you!,213,51,15,279,644,701
The ivories aren't being tickled tonight.,219,51,16,286,644,2341
"This next piece is called Holidays at the In-Laws.""",196,44,15,255,644,5398
"My next selection is Beethoven's ""Hammerklavier""",224,53,16,293,644,877
The insurance on my fingers was outrageous!,224,53,16,293,644,1211
We shall now experience the atonal grandeur of the Rocky Variations.,209,54,13,276,644,1098
Anyone else got any smart remarks ?,212,48,16,276,644,1297
I would like to play now a little something composed by the late Marquess of Queensberry.,215,42,19,276,644,2151
"Unfortunately, the necessity of dealing with hecklers has placed certain…constraints…on my artistry.",221,42,20,283,644,710
I am also Blind!,222,52,16,290,644,5227
I will now play some Black & Blues.,227,54,16,297,644,3683
"And now, reimagined for pianoforte, the theme from Rocky.",231,46,20,297,644,4166
"Oh, ho, yes, I’m the great contender.",203,49,14,266,644,4619
"Next, my take on the theme from ""Rocky.""",241,50,20,311,644,2665
"Personally, I thought it was a knock-out performance.",205,57,11,273,644,275
"And now, I will do a rendition of ""The Boxer,"" by Simon & Garfunkel.",207,53,13,273,644,799
"Well, this is unique. In the last one I was naked!",222,47,18,287,644,4978
And now Bach’s Golden Glove Variations.,233,49,19,301,644,867
And now for Round 2 of tonight's performance.,234,59,15,308,644,828
I call this 'Fight of the Bumblebee'.,216,42,19,277,644,545
"Yes, it's a fight song!",212,62,10,284,644,1124
Let me give you a tune with some punch!,216,54,14,284,644,2937
Here’s a little something for all you boxing fans”.,226,46,19,291,644,2338
"Chopin Piano Concerto, round 3.",224,62,12,298,644,1397
Nobody talks during my performance.,198,49,13,260,644,1235
"I shall now play Float Like A Butterfly, Sting Like A Bee Flat",243,48,21,312,644,3564
I just got tired of tickling the ivories...,199,59,9,267,644,2139
Let's get ready to Pianooo!,211,47,16,274,644,5224
My next piece is played fortissississimo.,220,41,20,281,644,123
I’m all thumbs tonight.,214,53,14,281,644,4371
My encore is a real knockout!,218,45,18,281,644,4606
'I will now play 'Silent Night'.,226,41,21,288,644,2735
"No, Dad. I told you before: I want to play piano.",224,57,14,295,644,3604
And I'm wearing flippers.,226,53,16,295,644,3798
"I've never butchered a tune in my life. Bruised one, occasionally.",218,69,8,295,644,4636
"An now, a medley of “Rocky” theme songs.",242,57,17,316,644,1090
This is for the table that requested the theme from “Rocky”!,193,54,10,257,644,2388
Here comes the hook.,201,50,13,264,644,1454
Boxing. It helps me think outside of the piano.,210,44,17,271,644,3637
Before I take the gloves off are there any requests?,203,58,10,271,644,5309
Let's get rrready to rrrubato!,212,52,14,278,644,8
We'll have a brief intermission while I decide my future.,217,42,19,278,644,2086
"And now, Muhammad Ali's fifth symphony.",221,46,18,285,644,1208
"And now, my Concerto in A-B-C-D-E-F-G minor.""",216,56,13,285,644,4139
Any requests for another Round?,225,50,17,292,644,3857
I would like to now play a piece by Rocky Maninoff.,225,50,17,292,644,5666
"Unlike Phillip Glass, I’m a maximist. I hit as many keys as I can at once.",229,54,16,299,644,1159
"Now, my rendition of Fight of the Bumble Bee.",212,47,16,275,644,2625
"For my next piece, I shall float like a butterfly and sting in the key of B flat.",211,49,15,275,644,3505
I present to you now a finale that floats like Madame Butterfly yet stings like Flight of the Bumblebee.,217,49,16,282,644,798
"And now, a recently discovered composition by John Cage.",220,43,19,282,644,5176
I love playing Beethoven's 'Hammerklavier Sonata',217,61,11,289,644,2615
"And now, by request, LaMotta Sonata.",235,49,19,303,644,3113
Welcome to Fight Club.,196,50,12,258,644,2226
This one's from the boxed set.,207,40,18,265,644,2424
My next selection is a real knockout.,203,48,14,265,644,2498
I said I could punch out a tune.,206,54,12,272,644,4449
This next number will be a little Rocky,214,50,15,279,644,888
"I call this one, “A Fistful of Keys.”",212,54,13,279,644,5047
"Actually, it's all in the technique.",225,52,16,293,644,161
And now in the key of Ali.,232,50,18,300,644,843
"When I told the host of this show, I'd play for free, he said 'sure, knock yourself out.'""",230,54,16,300,644,5079
Let me welcome you to our annual Boxing Day concert,235,56,16,307,644,2337
"Well, technique isn't everything.",253,68,14,335,644,3792
"And now, ladies and gentlemen, Chopin and I will duke it out.",188,49,11,248,644,5651
"And now, if I may, my rendition of “Hail to the Chief”.",210,29,23,262,644,1214
I am going to float like a butterfly and sting like a B major,202,45,15,262,644,3164
Wait until the gloves come off.,201,59,9,269,644,4344
I could a been a contender...,210,53,13,276,644,609
Many of you know this from my box set.,211,51,14,276,644,2536
It's worse than it looks.  They're thumbless gloves.,218,49,16,283,644,977
This next round is from the work of TKOvsky,215,55,13,283,644,1541
"Ladies and Gentlemen, I will now perform for you Ali's concerto in the keys of A,B,C , D and E.",214,57,12,283,644,4217
"Oh, I'll hit the right note alright!",216,53,14,283,644,5420
This next selection is a real knockout.,223,51,16,290,644,4511
This next one is also by Stravinsky.,237,47,20,304,644,3381
"Yes, I can do ""Eye of the Tiger""",249,54,19,322,644,325
My next piece is in one-two time.,237,54,17,308,644,535
"Tonight, you’ll hear DeBussy with some punch!",228,60,13,301,644,1156
Pianist!? I could've swore the classified sought a pugilist.,225,42,20,287,644,1920
"And now, my rendition of the ""The Theme From Rocky'.",246,60,16,322,644,2844
"Let's see if you can guess who composed this piece.""",213,42,18,273,644,3283
Who tuned this?,206,44,16,266,644,3380
"Now for Chopin’s Etude in G# minor, Op.25; No.6 the hard way.",203,50,13,266,644,3985
"*“Alas, ebony and ivory don’t always live together in perfect harmony.”",246,55,18,319,644,1991
"I call the next piece ""The Ring Cycle"".",240,55,17,312,644,3677
Here's a punchy little etude...,224,63,11,298,644,348
"'The Boxer by Paul Simon.""",227,57,14,298,644,1010
"And now, for your listening pleasure, I will attempt chopsticks.",232,47,19,298,644,4153
...in the key of b-c-d-e-f,231,49,18,298,644,4368
I’m just going to knock-out this new piece for you.,224,51,16,291,644,1266
"Anvil Chorus, anyone?",219,61,11,291,644,3374
I think I misunderstood the phrase 'hitting the right notes'.,216,55,13,284,644,3517
"Contrary to what others believe, Mr. Trump believes a pianist plays just as well with boxing gloves as without.  While I don't expect to convince him, I will try to prove to others this just isn't true.",216,55,13,284,644,4085
"This next song, is a total knock-out!",213,49,15,277,644,3241
There will be a 1 minute intermission between each of my 10 pieces.,213,49,15,277,644,4418
This next piece is a real knock out.,206,51,13,270,644,3663
I'm going to play Erik Satie's Aperçus désagréables for two gloved hands.,248,58,17,323,644,810
"Etude"" by Muhammad Ali..",247,48,21,316,644,2099
WOULD YOU LIKE ME TO KNOCKOUT ANOTHER TUNE?,233,52,17,302,644,4923
Just wait until I take the gloves off!,228,50,17,295,644,1353
I'm hoping this will strike a chord with you.,228,50,17,295,644,1776
"...and now an original composition that I 
like to call  ""Thrilla in Manila""",226,54,15,295,644,5515
"I call this next piece, Ali vs. Frazier, in B minor.",221,52,15,288,644,4242
Why do I do this?  Because I can't sing or dance.,216,50,15,281,644,3058
For this next piece you might want to turn down the volume on your cellphones.,206,46,15,267,644,2897
This one was my first big HIT!,239,47,20,306,644,191
"Now I will play, “Domm, Domm, Domm,...Dommmm..",239,47,20,306,644,1969
I will now perform Beat It.,234,57,15,306,644,5263
"I will now play ""The Boxer""  by Paul Simon.",229,55,15,299,644,630
"And for you Brits, ""A Ballad for Boxing Day.""",229,55,15,299,644,3910
"And now, I'll play selections from my box set.",222,45,18,285,644,92
They call me Johann Sebastian Box.,214,61,10,285,644,618
The next piece will be a bit bombastic....,218,53,14,285,644,650
I shall now play Bach in the combative style.,216,57,12,285,644,1217
Oddsmakers have ebony over ivory in the third round .,215,47,16,278,644,915
"And now, an eight-count piece by Mauler",217,43,18,278,644,1142
This one's in the key of Knock You Flat.,214,49,15,278,644,2535
"Ladies and gentlemen, tonight's piece is a real knock-out.",211,55,12,278,644,3868
"Now, the punchier rendition .",212,53,13,278,644,4254
I'm afraid my performance will be a little rocky,213,39,19,271,644,3764
Rachmaninoff’s Concerto no. 2- twelfth round.,206,41,17,264,644,5644
Box variations.,240,52,18,310,644,1190
"Ladies and Gentlemen, the Fight of the Bumblebee.",247,38,25,310,644,4531
"Its Rimsky-Korsakov with a postmodern vibe: I call it ""Fight of the Bumblebee""",236,48,19,303,644,4927
I'm really gonna pound this one out!,230,48,18,296,644,3966
"And now, the theme song to 'Rocky'",223,50,16,289,644,2241
If you hum a few bars I can probably punch it out.,223,50,16,289,644,3078
"Next will be my Mohammed Ali ""Flight of the Butterfly""",223,50,16,289,644,5068
Welcome to our Boxng Day concert.,222,40,20,282,644,56
My next piece consists of ten rounds.,219,46,17,282,644,1459
"And then I realized, my fight with the music IS the music",219,46,17,282,644,2633
"And now, I will batter the ivories.",218,48,16,282,644,4869
"and now,  I'll knock out one your old favorites.",216,52,14,282,644,4911
"For this next piece, use of your mobile phones is encouraged.",212,48,15,275,644,2689
"Brahms? A minor punch. Rachmaninov, fell flat. But Beethoven? Kills in the fifth.",232,51,17,300,644,3094
"And next, the theme from Rocky.",230,43,20,293,644,2731
"...And in the right corner, hailing from the Steinway factory in Queens, weighing in at 1200 pounds, it's GRAND PIANO!!!",224,55,14,293,644,3399
Now I will do the piece I played for Harvard’s Admissions Committee.,226,51,16,293,644,3423
"And now for the younger members of the audience, a few death metal classics.",227,49,17,293,644,4389
This combines the artistry of Joe Louis and Louis Armstrong.,219,53,14,286,644,3606
You should see the keys!!,213,53,13,279,644,258
The theme from Rocky,216,47,16,279,644,1464
The latest OSHA regulation.,217,45,17,279,644,2351
let's hit it again,208,51,13,272,644,4945
It's an unfinished piece if anyone's cellphone goes off.,246,54,18,318,644,5186
Is my tie crooked?,236,50,18,304,644,19
Today I shall be playing 'Concussion in fist major',238,46,20,304,644,4106
Are you certain these are the same gloves Glenn Gould used?,231,48,18,297,644,1662
"And now, my final number will just knock you out!",227,56,14,297,644,2707
And here's a knockout hit I wrote recently...,223,52,15,290,644,209
"I call this next piece,
“The Fight of The Bumblebee “.",227,44,19,290,644,584
"And now, Madam Butterfly, Stings Like A Bee.",227,44,19,290,644,5169
You were right. This does sound a little better.,216,54,13,283,644,537
"This next piece is ""'Requiem' for a Heavyweight,"" my homage to Mozart.",221,44,18,283,644,2075
I'm just not that in to melodies,215,56,12,283,644,5098
Now for my knockout piece as the encore.,208,58,10,276,644,2755
This next sonata is a real knock out.,205,52,12,269,644,964
And now a tribute to the late great Muhammad Ali.,206,50,13,269,644,3552
"Hey, it's flu season.",234,49,18,301,644,1853
I first learned my next number from my three year old.,227,51,16,294,644,641
One note requests please.,227,51,16,294,644,3691
And now for something 'molto energetico e furioso' !,224,45,18,287,644,73
"In tune, but out of touch.",223,47,17,287,644,1241
When you asked if I could pound the keys...,223,47,17,287,644,1326
I used to play by ear.,229,35,23,287,644,2118
"this next piece is from ""Rocky"".",218,57,12,287,644,3320
"And now, Ladies and Gentleman, I will take a stab at the notoriously difficult ""Etude Brute.""",216,49,15,280,644,787
"3, 2, 1... Hit It!",216,49,15,280,644,921
Victor Borge in his final round,215,51,14,280,644,4580
And now I'd like to bang out a little ditty of my own...,245,58,16,319,644,99
I will now perform Round 3.,235,66,11,312,644,879
I will now play Sonata in B Flat by Mike Tyson.,242,52,18,312,644,1317
They're required by my insurance company.,208,53,12,273,644,2492
"And now, the Dempsey Sonata",200,45,14,259,644,5336
This next work is entitled “Symphony in Three Rounds.”,222,56,13,291,644,841
"And now, for The Fight of the Bumblebee!",226,48,17,291,644,911
I will now play Rachy 3.,231,38,22,291,644,2423
"And now, in memory of Rod Serling, Anthony Quinn, Jackie Gleason and Mickey Rooney: Requiem for a Heavyweight",219,62,10,291,644,4402
My next piece really packs a punch.,214,60,10,284,644,503
"This one is called 'I'm gonna smash your face', in G minor.",224,40,20,284,644,1091
I will now play Box Prelude and Fugue in G Minor,224,40,20,284,644,2504
"Which one of you yelled, 'I want the hits'?",218,52,14,284,644,4276
Good evening and welcome to 'Boxers Got Talent'!,219,50,15,284,644,4410
"And now, Rockymanenough Piano Concerto no. 2",246,51,19,316,644,3286
The nightmare before the concert.,191,39,15,245,644,5663
This next one has a hook that will be in your head for days.,214,48,15,277,644,270
This way I don't have to insure my hands.,212,52,13,277,644,4073
"Ladies and gentlemen, The Palooka Polka.",216,44,17,277,644,5676
"Now, I’d like to play you a selection of my greatest hits.",239,53,17,309,644,753
I'll be playing Beethoven's Symphony No. 7 in A major.  It may take awhile.,204,56,10,270,644,2321
Everyone now...supercali-pugilistic-expialidocious...,234,51,17,302,644,393
And now for some Wagner.,226,55,14,295,644,2283
This will be 1812 like you've never heard.,225,57,13,295,644,3279
This time I'm not going to tickle the ivories!,223,61,11,295,644,3504
Would you care to join me in a round?,231,45,19,295,644,3545
"And now, a couple of rounds with Shoenberg.",223,49,16,288,644,5191
"And now a little piece I call the ""The Fight of the Bumblebee.""",219,45,17,281,644,3544
I'm in between careers.,233,60,13,306,644,1003
My next number will be a one hit wonder.,211,49,14,274,644,1557
What does Beethoven being deaf have to do with it?,217,37,20,274,644,4123
My next selection is a Rockymaninoff,215,41,18,274,644,4642
"Begging your indulgence, my New Year's resolution is to stop biting my nails.",206,47,14,267,644,3231
This next number will really knock you out!,223,56,13,292,644,955
I will now play for you a piece by Donald J. Trump called ‘Bing Bing Bong Bong’,245,55,17,317,644,569
This next piece may sound a little dissonant....,216,58,11,285,644,189
Chopsticks?,224,42,19,285,644,769
"And now I will perform""Horowitz at age 2""",221,48,16,285,644,1960
The next is a request from Mike Tyson,239,55,16,310,644,3259
"And now, I shall play Beethoven's Fifth Round",209,60,9,278,644,3465
My counter punch is much better than my counter point.,237,47,19,303,644,4941
They told me it was Boxing Day.,232,57,14,303,644,5365
"Despite his millions earned, Rocky Balboa eventually went baroque.",208,50,13,271,644,1784
"For my next number, I will play the theme from ""Rocky.""",214,38,19,271,644,5292
When was this piano tuned?,234,41,21,296,644,1342
I  coulda had class. I coulda been a conductor. I coulda been somebody. Instead of a bum. Which is what I am.,231,47,18,296,644,4849
In honor of Boxing Day . . .,204,46,14,264,644,3815
And now my tribute to Jerry Lee Lewis.,222,53,14,289,644,212
It’s not The Fight of The Bumblebee?,227,43,19,289,644,493
I thought they said pugilist.,223,51,15,289,644,1504
"For this Inaugural Dance, I will now play I Did It My Way.",220,57,12,289,644,2329
This concert is off to a Rocky start.,219,59,11,289,644,5459
"And now ladies and gentlemen, Tchaikovsky’s ‘Incompetent Piano Movers’ in G Minor.",241,46,20,307,644,190
"When I said I wanted to hit the ivories...""",252,55,18,325,644,121
I hope you enjoy this next number. I knocked it out last night.,234,48,18,300,644,3036
"I will now perform a more faithful interpretation of ""Baby Elephant Walk"".",211,51,13,275,644,3334
I'm a lover and a fighter.,226,64,10,300,644,5379
"Sonata for two boxing gloves on three keys at a time, molto grandissimo.",204,53,11,268,644,1004
"For my next selection, I will be playing the theme from ""Rocky"".",240,55,16,311,644,5656
"This evening’s performance, of Tyson’s 1st, is also available on a box set.",220,52,14,286,644,330
"And now, in the key of B flat, the theme from Rocky",222,48,16,286,644,1321
"What did you think ""Ring Cycle""  meant?",222,48,16,286,644,4933
I think you'll agree this next tune is a real knockout.,196,57,8,261,644,3536
"And now, a special request from my piano professor.",234,55,15,304,644,1957
"And for my next selection, a round.",218,44,17,279,644,3416
"Ladies and gentlemen, we are recording tonight's performance which, I expect, will be released as a boxed set.",216,48,15,279,644,3685
Real men don't tickle the ivories.,218,44,17,279,644,4045
I don’t exactly tickle the ivories anymore.,215,50,14,279,644,4576
It is the insurance company's rule.,230,51,16,297,644,3742
"Remember students, always practice safe sax, and don't forget to put a glove on your pianist.",229,41,20,290,644,494
It worked for my cat.,224,51,15,290,644,1340
...and for my next piece I will play “Bling Blong Blaap Blorp” in C-minor,227,45,18,290,644,4373
"Now, a new work, “Brexit Compromise,” in B flat minor.",208,40,17,265,644,2808
"My next piece is titled 'Yo Adriana' """,222,43,18,283,644,2404
I will be playing fight of the bumblebee.,214,47,15,276,644,129
"I will now play 'Sonata in D minor', by George Foreman.",213,49,14,276,644,133
The ivory is going to be black and blue after I'm done with it,225,56,13,294,644,622
A copy of my new album to whoever guesses what I'm playing,228,50,16,294,644,3809
"No dad, I'm giving up on your dream",240,57,15,312,644,5318
Why tickle the ivories? Pound them with passion!,217,60,10,287,644,5020
"I would now like to play Ravel's ""Concerto for No Hands.""",234,57,14,305,644,1388
I call this next piece 'Fight of the Jumbled Keys'.,203,45,14,262,644,5558
"Tonight I will perform ""Fight of the bumblebees""",218,46,16,280,644,5469
"And now, as requested, the theme from Rocky...",231,51,16,298,644,4068
"This next piece is called ""the fight of the bumble bees"".",233,47,18,298,644,4559
They said the keys would be larger,243,58,15,316,644,3521
My next piece is a real knockout.,207,56,10,273,644,48
I float like DeBussy and sting like Rimsky-Korsakov,213,44,16,273,644,4014
I invite you to sing along while I  punch out a few notes.,208,54,11,273,644,5551
Now for a thumping good tune,222,57,12,291,644,5056
I'm working on my fortissimos.,223,55,13,291,644,5567
And now for round three.,237,58,14,309,644,3779
This song was composed by my two year old son on the pots and pans.,197,33,18,248,644,513
"I think this piece will really knock you out, folks.""",191,45,12,248,644,1500
"This will be on the forte end of pianoforte, okay?""",204,50,12,266,644,1951
That was John Cage. Any questions?,208,42,16,266,644,3042
No hitting below b-flat,219,51,14,284,644,5076
The next piece will be three minutes long.,196,54,9,259,644,53
"Roll over, Beethoven.",202,42,15,259,644,154
"Hey, I can knock out a tune with the best of them",201,44,14,259,644,856
I call this The Pugilissimo.,197,52,10,259,644,2838
"And now for ""The Boxer"" by Paul Simon.",201,44,14,259,644,4878
Does anybody dare to make a request?,197,52,10,259,644,5543
"And now, a visual depiction of writer's block.",226,56,13,295,644,1196
Next up is a really punchy tune.,225,58,12,295,644,3165
"It's the only way I can make it through John Cage's 4'33"" without playing a wrong note.",233,42,20,295,644,4006
I range from Marvin Hamlisch to Marvin Hagler.,227,54,14,295,644,5338
"And now, our alma mater's fight song.",244,51,18,313,644,4190
Schubert has requested a rematch.,232,63,11,306,644,1032
Chopsticks it is then!,247,64,13,324,644,1368
I'm the boxer of Seville.,205,55,10,270,644,1679
"And now, something in tempo ""pugilissimo"".",206,53,11,270,644,2826
This next song is a punchy little number ...,218,60,10,288,644,3117
"Oh, you meant BACH's Goldberg Variations?",210,45,15,270,644,3247
And for the next song from my new boxed set . . .,235,57,14,306,644,4785
These ivories need more than tickling.,233,49,17,299,644,1310
"For me, playing Chopin's Sonatas have always been a personal battle",229,57,13,299,644,3445
And we will finish off the evening with Rimsky-Korsakov’s “”Fight of the Bumblebee.”,237,41,21,299,644,5587
Yo adagio!,219,46,16,281,644,327
Franz Lizst bangs the Piano with his Fizst.,217,50,14,281,644,2796
And now I’m going to pound out an old favorite.,217,50,14,281,644,4407
I promise you a knockout performance.,202,49,12,263,644,3818
Any requests I can pound out for you?,186,50,9,245,644,2141
They're insured!,241,52,17,310,644,2446
And now for a swinging little tune with a hook that'll knock you out.,225,53,14,292,644,1375
Trump Concerto in F Minor,234,35,23,292,644,2794
"That concludes Round  1, Round 2 will begin after intermission .",222,59,11,292,644,3376
For my next number...'Requiem for a Heavyweight',211,50,13,274,644,142
"And now, especially for those of you out there with the drooping eyelids and the nodding heads, here is a little wake-up number!",209,54,11,274,644,5094
I really like to pound out the notes.,193,55,8,256,644,1466
I    consider the  piano my opponent.,231,60,12,303,644,117
"""This next one's gonna be a knockout.""",224,43,18,285,644,5333
Get me LARGER KEYS.,223,45,17,285,644,5649
"I dedicate this next piece to my manager, who needs a better understanding of what a ‘boxing day concert’ is.",208,44,15,267,644,368
This next piece I will play using only gentle jabs and delicate hooks.,209,42,16,267,644,4332
"I need a new manager.""",208,44,15,267,644,4866
"I said Bach, not box.",194,41,14,249,644,5340
You should hear me play when the gloves come off,228,54,14,296,644,4697
And now a little something I wrote for Boxing Day.,227,56,13,296,644,5466
And now my medley of college fight songs.,212,55,11,278,644,2704
"For your pleasure, “Cacophony in B flat”",199,50,11,260,644,816
"Introducing classical music for millennials. Because alone, Piano Sonata No. 29 isn't enough to maintain your attention.",238,53,16,307,644,2302
Prepare to be really impressed.,224,50,15,289,644,5672
This is going to be very postmodern.,238,41,21,300,644,4030
"For my next piece, I'll be playing the theme song from Rocky.",237,43,20,300,644,4386
"Now, I'll knock out the encore.",230,57,13,300,644,5549
This one is a little punchier.”,229,59,12,300,644,5622
"And now, The Dance of the Butterfly, by Muhammad Ali",221,44,17,282,644,2696
A boxed set of tonight’s performance will be available for purchase during the interval.,219,48,15,282,644,4315
"Well, most musicians needs two jobs",219,48,15,282,644,4872
"And now, Rocky III, Opus I.",238,60,13,311,644,2558
"Beethoven's Moonlight Sonata, Round 3.",227,51,15,293,644,462
And you thought Ray Charles had it hard!,226,53,14,293,644,1961
"Folks, please remember, I am a professional. Do not try this at home.",226,53,14,293,644,3181
"This next piece is titled, ""Theme from Rocky"".",225,55,13,293,644,3253
This next number really hits hard.,226,53,14,293,644,4290
This next piece is to be played 'molto forte.',215,44,16,275,644,3576
I was told to punch up the ending,215,44,16,275,644,3955
This one is called “Fight Of The Bumblebee”,221,51,14,286,644,2229
Punchy melody it is.,205,52,11,268,644,346
"Yes, I lost a bet and yes, you can get a ticket refund.",228,56,13,297,644,4870
This next little number is a real knockout!,230,52,15,297,644,5485
"Oh, I thought it was “Fight of the Bumblebee” !",247,56,16,319,644,2986
"If I hear one more phone ring, someone is getting knocked out!",211,47,14,272,644,36
We've had a request for the National Anthem.,220,48,15,283,644,3647
My playing can float like Madame Butterfly and sting like the Flight of the Bumblebee,223,42,18,283,644,5617
I bet you've never heard the 1812 Overture on the piano!,228,51,15,294,644,980
I shall now perform Handel with kid gloves.,207,43,15,265,644,2154
"Promise you, next song is a knockout.",230,66,9,305,644,252
And now for Beethoven's Piano Sonata Number 1 in F-Minor-ish,238,50,17,305,644,2150
I'm trying to stop tickling the ivories.,208,60,8,276,644,557
"Look ma, no fingers.",212,52,12,276,644,1889
"And now, my arrangement of Paul Simon’s ‘The Boxer.’",216,44,16,276,644,4472
"Some people say I'm a bit heavy handed.""",215,46,15,276,644,4634
And for those of you who think playing piano is for sissies...,209,58,9,276,644,5496
"And now, the 1812 Overture for solo piano",226,43,18,287,644,735
Music box?,221,53,13,287,644,2125
"In honor of Brexit, I will now play the piano version of ""Bang the Drums Slowly.""",212,40,17,269,644,5239
"And now, my own rendition of the 1812 Overture.",243,47,19,309,644,4222
"And now, ""Variation on 'Flight of the Bumble Bee'"" by Muhammad Ali",245,43,21,309,644,4253
This next one needs to be preformed with a certain amount of punch,215,53,12,280,644,3903
"I don't know why, but tonight I feel like I'm all thumbs.",212,59,9,280,644,5173
This next song may be a bit off key.,230,42,19,291,644,3956
"And now, ladies and gentlemen, I'd like to play for you my interpretation of Paul Simon's ""The Boxer.""",227,48,16,291,644,3980
"And now, for Chopin's Fight of the Bumblebee.",214,43,16,273,644,2776
"Nail fungus is nothing to chuckle about, ask the harp player.",212,47,14,273,644,4375
"Next, I will play with one hand tied behind my back.",223,44,17,284,644,2117
My other job is a hand model.,227,55,13,295,644,1222
"I can't tickle the ivories but I can pound them""",228,53,14,295,644,3204
My Rachmaninoff may be a little Rocky.,225,59,11,295,644,5101
And now for a bit of Rocky maninoff!,249,49,19,317,644,1906
"And next, a lovely little composition by Victor Borge.",207,45,14,266,644,1575
Ohhh...you said we're going to Bach's!,207,45,14,266,644,2546
I’m hoping to knockout this Sonata in the first movement.,247,72,9,328,644,4762
Let's see Mike Tyson do this!,214,50,13,277,644,1570
And now I shall attempt Fight of the Bumblebee,227,43,18,288,644,4272
I have a really great hook for this song.,239,57,14,310,644,3998
And now I go three rounds with Rachmaninoff.,208,50,12,270,644,33
I will now play the classic theme from ROCKY.,217,51,13,281,644,1762
"Next I will perform, Fight of the Bumblebee",230,44,18,292,644,173
This next piece may be a little Rocky.,229,46,17,292,644,2323
Chopin is down for the count in three -quarter time.,226,52,14,292,644,4965
The chorus will now join me  for few rounds.,226,52,14,292,644,5051
This next piece demonstrates the difficulty bumblebees actually have in flight.,244,54,16,314,644,2636
"This next piece, inspired by John Cage, is called Bruised Piano",203,48,12,263,644,3656
"I call this next piece ""The Crash of the Bumblebee.""",228,55,13,296,644,5305
"Now, the ‘Fight of the Bumblebee’",236,58,13,307,644,2750
I had to struggle with this piece...,207,47,13,267,644,4383
I like to punch out a tune for you.,213,54,11,278,644,4536
"This next piece is titled, ""Would You Please Stop F**king Playing That, Timmy?",226,47,16,289,644,804
Put up your Duke Ellingtons,222,55,12,289,644,1506
The Boxing Ring Cycle,234,50,16,300,644,1137
I will now take on Mozart,228,62,10,300,644,4826
Tonight I'll be knocking out the tunes for you.,251,54,17,322,644,3549
"And now, a fantasie by Franz Liszton.",201,47,12,260,644,4452
"As Beethoven famously asked, “Do you want a piece of me?”",211,46,14,271,644,378
I couldn't find Madison Square Garden,207,54,10,271,644,775
"Maestro, Uppercut in C Major please.",216,55,11,282,644,827
Tough piece.,220,47,15,282,644,4152
Ive had to fight my way to get here!,223,60,10,293,644,1746
Please hold your applause until I've finished.,229,48,16,293,644,5442
Let's get ready to crescendo!,223,60,10,293,644,5474
Never steal from the casino the night you’re scheduled to play piano there.,239,47,18,304,644,1654
"And now, a heavy-handed version of Jingle Bells.",235,55,14,304,644,2357
This may look easy... It is not.,242,60,13,315,644,1230
"I call this piece ""Etude in the Key of Everything.""",227,40,19,286,644,1337
It's more of a Box-trot.,211,53,11,275,644,1885
"I said Bach's work, not box work.",203,50,11,264,644,1987
This next one is more ‘Rocky’ than Rachmaninoff.,213,49,13,275,644,2419
The cacophony suite is a new work,235,62,11,308,644,2766
"This next piece is one I wrote for my ex-wife called ""you should have signed the prenup""",208,40,16,264,644,4755
"And now I present Sibulski's Concerto in A minor, D minor, and E-flat major",208,40,16,264,644,4863
"My next piece is entitled, ""The Boxer Rebellion.""",243,53,16,312,644,251
...and now for my most-difficult piece...,238,44,19,301,644,3975
"To complete this Mancini set, I’ll switch from Henry to Ray Boom Boom.",223,55,12,290,644,3072
Shall I play some selections from the boxed set?,228,45,17,290,644,5074
my plan is to pound these ivories into submission,222,57,11,290,644,5159
"And now, by request, ""Theme from Rocky."" Again.",209,45,14,268,644,1540
This one's a bit punchy.,208,47,13,268,644,2196
This one has a punchy beat,206,51,11,268,644,3051
This next number is a knockout. It packs quite a punch.,249,48,19,316,644,883
"Next is ""Flight of the Bumblebee,"" which I will also play blindfolded.",238,51,16,305,644,2282
They keys in this piece are pretty sharp.,228,52,14,294,644,3274
Just warming up,227,54,13,294,644,4484
"My next piece, Schumann's Toccata in C Major, is dedicated to my first piano teacher who told my mother I was all thumbs.",218,53,12,283,644,707
I know what you're thinking.,216,57,10,283,644,1092
"And this time, you had better applaud.",219,51,13,283,644,5382
I shall now perform Fight of the Bumblebee.,213,44,15,272,644,623
"I've had a request for ""The Boxer.""",212,46,14,272,644,1371
"And, now, something a little punchy.",207,56,9,272,644,2508
"Ravel's Piano Concerto for the Left Hand in D major,the hard way.",211,48,13,272,644,2797
"My next number will be the theme from ""Rocky.""",207,56,9,272,644,2988
And now I will transition from tickling the ivories to punching them,201,49,11,261,644,4443
I’m wearing these gloves at the request of my fans,242,50,17,309,644,2953
I never liked the piano,223,50,14,287,644,903
"And now, round four...",226,44,17,287,644,2295
"Now for a mash-up I like to call ""Float like a Butterfly; sting like the Flight of the Bumblebee.""",214,49,13,276,644,1475
"Hit it, maestro!",191,38,14,243,644,272
This next piece makes Beethoven look like a little bitch.,244,53,16,313,644,1158
"Next, I will play the theme from Rocky.",240,42,20,302,644,1364
"Ladies and Gentlemen, I will be performing Simon and Garfunkel’s, The Boxer, as it was originally conceived.",234,54,14,302,644,2319
"The record shows I took the blows 
and did it myyyyyy waaaayyyy",228,47,16,291,644,3824
"And now some Gilbert and Sullivan melodies, as they might have been played by Jack Dempsey.",214,56,10,280,644,612
And now a piece I call Für Muhammad Ali,216,52,12,280,644,2102
I play like a butterfly and sing like a bee.,213,39,17,269,644,395
This next piece floats like a butterfly and stings like a bee.,244,60,13,317,644,5140
"I will now play Simon & Garfunkel's ""The Boxer""",236,57,13,306,644,4151
I bite my nails.,231,48,16,295,644,2200
I did it myyyyyyy wayyyyyyy,220,51,13,284,644,2885
These?  They're for when I meet that #*&@* composer after the concert.,222,47,15,284,644,4048
My next piece will be ‘Chopsticks - The Hard Way,210,52,11,273,644,3129
"Yes, I'm Johann Sebastian Box.",212,48,13,273,644,3701
"For your listening pleasure, I'll knock out a few oldies.",213,46,14,273,644,3763
"Mother wanted me to be a pianist. Father wanted a pugilist, so I learned to punch the keys.",202,49,11,262,644,1435
There is no punch line!,240,56,14,310,644,1116
Now for some minimalism.,243,50,17,310,644,4752
I will now perform the Nocturne Pugilistica by Sugar Ray Mozart.,195,44,12,251,644,2554
Here’s a little something I wrote that requires playing a lot of consecutive keys at the same time.,232,53,14,299,644,3665
And my next number will really knock you out!,227,44,17,288,644,234
I am thrilled to be performing my first concert since completing my twelve step anti nose picking program.,224,50,14,288,644,4823
"Oh, it was ""Flight of the Bumblebee?""",227,44,17,288,644,5424
"Tonight's performance will be ""A Little Rocky.",214,51,12,277,644,13
And I'd like to close with a little chin music.,218,43,16,277,644,245
And not without a smattering of irony.,211,57,9,277,644,1907
"This next piece is called “Float Like a Butterfly, Sting Like a Bee.”",214,51,12,277,644,2650
This song promises to be a knock out!,207,46,13,266,644,2412
You should see what the keyboard looks like,201,58,7,266,644,2662
"Thank you, that was ""Chopsticks."" 
And now, ""Chopsticks.""",238,48,17,303,644,1657
Who brought the piano? I asked for a gong!,232,60,11,303,644,4724
"This one's for you, Mr. Stallone.",233,58,12,303,644,5413
"I call this piece,""Boxer's Rebellion.",195,51,9,255,644,1577
The next selection is by Johann Sebastian Box.,233,39,20,292,644,3217
"And now, I would like to play you something from my pugilistic period.",225,55,12,292,644,3533
"And now, Round 3 of selections from my complete boxed set!",231,43,18,292,644,4271
Ever feel like you've got the wrong job?,228,49,15,292,644,5488
I’m trying to stop biting my nails.,216,54,11,281,644,983
"Now, for a rarely-played piece from Wagner's Ring Cycle.",224,38,19,281,644,3509
Ladies and Gentlemen: Simon and Garfunkel's The Boxer.,217,52,12,281,644,5141
Let’s get ready to rondo!,210,47,13,270,644,559
My playing's been a bit Rocky of late...,240,51,16,307,644,1023
Boo me one more time - I dare you!,229,54,13,296,644,4034
My first number will be the theme from 'Rocky'.,226,41,18,285,644,882
"And now, Rockymaninoff’s IVth",222,49,14,285,644,4689
"This is a little etude for note clusters, which I composed myself.",213,48,13,274,644,2842
"And now the classic ""88 keys in .8 seconds"".",217,40,17,274,644,3442
I'm now going to pound out some Mozart.,213,48,13,274,644,5422
In this Christmas season I'd like to play a little Boxing Day number.,234,51,15,300,644,1923
A rendition of Balboa’s 5th,232,55,13,300,644,2320
"To unlock the premium concert experience, please open the app and select the $3.99 in-app upgrade.",203,49,11,263,644,1802
Tickling the ivories really isn’t my style.,215,51,12,278,644,975
Now I will play ‘Fight of the bumblebee’ better known as ‘Float like a butterfly sting like a bee.’,219,43,16,278,644,2924
My dog wrote this next piece.,217,47,14,278,644,4193
Give me a Ten Count!,214,53,11,278,644,4663
The precision may not be quite adequate but fortissimos are exeptional !,235,56,13,304,644,532
This is called he Mefisto Waltz.,220,48,14,282,644,1826
…called Migraine in A Major.,219,50,13,282,644,2157
I alone can play it.,219,50,13,282,644,4761
"This one's for my Pop, who always wanted me to become a fighter",208,53,10,271,644,928
This concert is going the full twelve rounds,229,56,12,297,644,1138
Its not easy being Victor Borg's son!,232,50,15,297,644,2382
It's all in the wrist.,232,50,15,297,644,3195
"I apologize for that last prelude. 
Now, on to box the ill-tempered clavier.",229,56,12,297,644,3534
"And now I'd like to pound out a little something for you.""",253,53,17,323,644,730
Ladies and gentlemen ... I will now attempt to free my hands and play the Minute Waltz in 55 seconds or less.,253,53,17,323,644,1970
And now: Beethoven's Ninth--in the style of American democracy.,229,37,20,286,644,179
With so many Messiahs to compete with I dedicate this next piece to the Electoral College.,243,54,15,312,644,776
I’d like to now play the piano version of Simon & Garfunkel’s “The Boxer”,240,60,12,312,644,2930
This composition needs more punch.,221,53,12,286,644,4830
Degree of difficulty 9.7,233,55,13,301,644,1027
I float like a butterfly but sting in B-minor,234,53,14,301,644,3477
"1, 2, 3 - hit it!",212,52,11,275,644,322
"Pardon me for any wrong notes, folks.  These are actually my cello gloves.",214,48,13,275,644,1738
"The last time I played this next tune, someone nearly bit my ear off.",218,40,17,275,644,4145
"Now for the couple at the cozy corner table, some tunes to fight by",230,42,18,290,644,1707
Now for some Rachymaninoff.,231,40,19,290,644,2105
For my next number I shall pound the keyboard.,224,54,12,290,644,2584
"Be quiet please, I'm going to knock out a few tunes for you.",225,52,13,290,644,4295
Oh! I thought you wanted a knockout performance.,227,48,15,290,644,4673
And now I will perform 'The Theme from Rocky.',211,35,18,264,644,127
And now the concerto from 'Raging Bull',200,57,7,264,644,443
And now my knockout sonata.,235,58,12,305,644,869
"And now, the theme song I wrote for ""Rocky,"" which was unfortunately rejected.",234,60,11,305,644,2795
This is how I avoid carpal tunnel syndrome.,215,53,11,279,644,5691
What - you don't like Punchini?,195,48,10,253,644,717
It's kind of a punchy tune!,226,57,11,294,644,561
My new composition is a real knockout.,229,51,14,294,644,5607
"Evening, folks. I'm gonna knock out a few tunes for ya.",215,60,8,283,644,1748
"And now for a blow by blow rendition of Schubert's Three Military Marches, Opus 51.",225,40,18,283,644,5434
Now I will play a theme from Rocky.,202,41,14,257,644,1323
And now I'd like to play you a punchy little tune.,200,45,12,257,644,3593
And now I shall play a medley of pet-performed pieces from the Internet.,219,33,20,272,644,187
My mother wanted a pianist.....my father wanted a pugilist.,224,49,14,287,644,1602
And now I shall pummel out a pleasing polonaise for your pleasure.,224,49,14,287,644,2800
Anyone want to hear the theme from Rocky?,218,61,8,287,644,3572
Mid-career transitions are always difficult - but this one has been especially so for me.,203,46,12,261,644,943
"Yo Adrian, can you turn the music for me?",216,46,14,276,644,3329
And then The Maestro begged me to stop fighting the instrument.,217,44,15,276,644,5054
J. S. BACHINGGLOVE,227,50,14,291,644,4466
I wish my manager could enunciate. The word was Bach.,194,45,11,250,644,3143
It's the most efficient way to play twelve-tone music,212,35,18,265,644,3256
Any less abusive requests?,236,39,20,295,644,260
"Last time, Rachmaninoff won.",228,55,12,295,644,2553
"...and while I am entirely grateful to Modells for underwriting this concert, I do feel compelled to mention that there were certain strings attached....",227,57,11,295,644,3050
Time to punch this tune up a little,220,52,12,284,644,4819
This is the LAST time I do request.,245,54,15,314,644,2394
I’ll now fight my way through some more Chopin.,202,43,13,258,644,4858
"I will now play ""Hail To The Chief"".",218,37,18,273,644,3778
What do you mean it could be punchier?,215,43,15,273,644,5272
Wow! A knockout performance!,225,49,14,288,644,802
I'll now play the 3rd movement of Muhammad Ali's second symphony,226,47,15,288,644,3642
Raging Bach,220,40,17,277,644,2699
"And now for your listening pleasure, the theme from “Rocky”.",215,50,12,277,644,4889
"I call this next number ""Fight of the Bumblebee.""",229,48,15,292,644,352
"And one more time, the opening notes of Beethoven's Fifth.",227,52,13,292,644,2649
Flight of the Bumble Bee is out of the question. Any other requests?...,234,64,9,307,644,1865
Something punchy?,208,45,13,266,644,2638
I will now play the Mike Tyson Rhapsody in Black and Blue.,207,47,12,266,644,3744
Playing with ten fingers is easy.,230,53,13,296,644,232
"If Beethoven could do it deaf, then I might as well try my best.",231,51,14,296,644,4496
"And now, my latest composition in celebration of Boxing Day.",235,43,18,296,644,5566
This next piece is a hit song.,243,60,12,315,644,472
And now for a piece by Pugalini.,222,50,13,285,644,572
"When you're as great as I am, you really should have some kind of handicap.",200,42,13,255,644,1168
Due to recent OSHA regulations for Rachmaninoff...,236,48,16,300,644,1561
"And now, for your enjoyment, I will box the ivories.",238,44,18,300,644,1661
Here's a punchy little number I think you'll like.,212,44,14,270,644,1882
"Ladies and Gentlemen, I am not going to tickle the ivories; I am going to clobber the Bosendorfer.""  This is Beethoven's ""Moonlight Sonata"" without the moonlight",195,52,8,255,644,1931
And now I’d like to play a medley of my greatest hits.,224,46,15,285,644,1976
There will be copies of my box-set available in the lobby after the show!,198,46,11,255,644,2599
I will next perform the theme from Rocky.,235,57,12,304,644,3412
"Take that, Mr. Rachmaninoff......",239,49,16,304,644,4674
Get ready to rumble,221,59,9,289,644,728
"And now my rendition of Jerry Lee Lewis and ""Great Balls of Fire""",226,49,14,289,644,2502
And now something more contemporary...,229,43,17,289,644,4372
And for my next number I will play  Fight of the Bumble Bee.,217,41,16,274,644,1912
"And now, some tunes from The Ring.",219,37,18,274,644,2392
"And then I hear my ex-wife laughing in the audience, and then I wake up--every time.",218,39,17,274,644,4803
"In this final piece, I will be combining The Art of  the Fugue with the Queensberry Rules.",227,54,12,293,644,4585
"This one I call ""Float like a butterfly, sting like the flight of a bumblebee.""",212,58,8,278,644,3512
I don't know if I can play it in that key.,217,48,13,278,644,4765
I only sing,208,40,15,263,644,4358
I will now play for you “Eine Kleine Knock You Out.”,234,47,16,297,644,491
"And now, Concerto Number 4, Round 3, in B-flat minor.",220,49,13,282,644,1591
My next piece will be the theme from Rocky.,245,58,13,316,644,5378
Sonata in the key of Ali,236,50,15,301,644,1195
"For my first piece, I will be playing an adaptation of the ""Rocky Theme""",223,50,13,286,644,3139
This next piece is by John Cage.,229,38,19,286,644,3904
And now I will perform “The Fight of the Bumblebee.”,223,50,13,286,644,4066
"Piano Sonata No. 3, fortissimo",222,52,12,286,644,4929
Any request?,214,42,15,271,644,1001
"And next, I would like to pound out a tune on my old piano...",213,44,14,271,644,2807
"Now, I shall float like a butterfly and sting like the 'Flight of the Bumblebee""",245,65,10,320,644,742
"And now I'd like to play a little sonata of my own composition called ""Golden Gloves"" in the keys of C through G.",253,49,18,320,644,2843
A-minor challenge,199,46,11,256,644,4775
This next piece is by Pugiliski,222,59,9,290,644,2041
Oh and Mike Tyson can act?,229,45,16,290,644,2980
"Ready for this? I’ve decided to give it the old one, two.",226,51,13,290,644,3111
Rockymaninoff’s Piano Concerto No. V,213,51,11,275,644,3190
I will now play Rockymaninoff’s Piano Concerto No. V.,214,49,12,275,644,3979
I'd like to dedicate my next number to Muhammad Ali.,252,58,14,324,644,1501
Let the first round of the concerto begin.,204,43,13,260,644,3999
"And now I'd like to play something with absolutely no regard for talent, technique or quite frankly, for any of you my dear audience.",242,52,15,309,644,2635
"Thank you. And now, this one will just knock you out.",252,65,11,328,644,308
It's just a little number I came up with for Boxing Day this year.,220,44,15,279,644,2052
"...and now, ""Brahms' Lullaby"".",220,44,15,279,644,4733
"And now, a piece titled ""Yo Adrian!""",244,55,14,313,644,4489
"While I can't put my finger on it, my performances have somehow been a little Rocky lately.",206,46,12,264,644,79
This piano and I haven't been getting along lately...,205,48,11,264,644,4679
Tonight's performance is a tribute to Mohammad Ali,204,50,10,264,644,4934
"Next, one of the biggest hits of Rocky Moninoff.",204,50,10,264,644,5421
I love challenges!,237,43,18,298,644,2171
"Eh, my playing's a little rocky.",218,55,10,283,644,382
One cannot just tickle the ivories with Rachmaninoff.,211,43,14,268,644,5108
And now I will pound the hell out of the keys...,212,41,15,268,644,5583
The sudden realization of having forgotten to zip.,239,46,17,302,644,1415
You say the Rach 3 is difficult? I’ll show you difficult.,222,54,11,287,644,5179
Yo Amadeus...I did it.,216,40,16,272,644,555
‘Some say I am the Mike Tyson of the keys.’,208,56,8,272,644,2876
It helps with the nail-biting.,237,57,12,306,644,3859
Now I’ll knock out another song for you.,211,50,11,272,644,4116
I don't think I can play pianissimo.,242,54,14,310,644,5
"Yo, Elise! I did it!",239,60,11,310,644,1627
And now ... The Pugilist of Seville.,217,45,14,276,644,1377
"And now for my final piece, ""Float like a butterfly, sting like the flight of the bumblebee.""",219,41,16,276,644,1809
"And now, the theme from Rocky IV",228,56,11,295,644,1252
Next is a song that took Jim Morrison 8 1/2 minutes to sing. I plan to knock it out in 2.,230,52,13,295,644,5659
"I haven't worked out every note on this next piece, but I'm very passionate about it.",204,45,12,261,644,1218
"Next, I'd like to play the Ali Variations.",217,52,11,280,644,2472
Hopefully this will strike a chord with you as it did for me.,218,50,12,280,644,2859
I'll knock out one more tune prior to intermission.,220,46,14,280,644,2960
I shall now play the Rach Four using only my nose and my elbows.,218,50,12,280,644,3852
I will now play Boxmaninoff,253,46,19,318,644,3364
Down goes Mozart!,210,40,15,265,644,3986
"Okay, I guess the gloves aren’t coming off.",208,44,13,265,644,5608
This is not going to be easy.,218,57,9,284,644,2865
I thought I'd punch it up a bit,219,55,10,284,644,4093
"Oh! Bach? Yes, I suppose that does make more sense.",235,56,12,303,644,2300
This next piece is for AAAAADRIANNNNN.,238,50,15,303,644,4097
My next number is the Carpal Tunnel Suite.,212,43,14,269,644,3473
Fair warning if you don’t applaud.,226,48,14,288,644,551
Please join me for punch after the concert.,214,46,13,273,644,715
This time I'm going to play something a bit more punchy.,211,52,10,273,644,2345
"Oh no, they are expecting me to take a bow now and I'm only wearing boxer shorts.",213,48,12,273,644,5625
"And for my next number, a knockout version of Moonlight Sonata.",226,55,11,292,644,235
Minuet for two thumbs.,226,55,11,292,644,1856
And now for a sonata by Serge Rockymaninoff.,231,45,16,292,644,4719
"Shubert's Piano Sonata No. 21 in B-flat major, Trump technique.",206,36,16,258,644,4021
I just won the first part of the competition but this part is really going to be hard.,216,49,12,277,644,351
The gloves come off when you start clapping.,214,53,10,277,644,1771
"It was at that moment, Rocky knew he had to give up his dreams.",216,49,12,277,644,2407
For my next request ... The Boxer by Paul Simon,217,47,13,277,644,5050
I will now perform an experimental piece by John Cage.,237,40,19,296,644,1011
The Fight of the Bumblebee,237,40,19,296,644,3249
Ladies and Gentlemen... Let's get ready to treble.,201,53,8,262,644,425
Get ready for this hit!,208,39,15,262,644,2008
"And now for Rachmaninoff’s piano concerto in c minor.
 Better known as Rocky II",239,43,18,300,644,2996
"...and now, the theme from ‘Rocky’",221,53,11,285,644,69
This grand is fighting me all the way !!!,236,56,12,304,644,785
"Pacquiao's ""A Little Fight Music""",223,49,13,285,644,1587
"Ladies and gentlemen, let us prepare ourselves to rumble.",221,53,11,285,644,2124
Punch it again Sam.,236,56,12,304,644,4469
Otherwise I’d just be tickling the ivories,211,47,12,270,644,974
I will now play ‘the Boxer’ written by Simon and Garfunkel! In D flat.,212,45,13,270,644,1988
"And now, an unusual rendering of ""Chopsticks"".",197,42,12,251,644,1442
Can anyone help me find middle C?,235,39,19,293,644,1981
Now here's one that'll really knock your socks off,248,53,15,316,644,3599
"And now, to reprise Victor Borge's Musical Punctuation...",229,58,10,297,644,3184
I'll punch out one more before the break.,232,52,13,297,644,3774
This next one is entitled “Eine Kleine Chinmusic”,233,50,14,297,644,4926
He does a great scherzando but he needs a page turner,222,39,17,278,644,3759
"And now, ladies and gentlemen, the Theme from Rocky VII",220,43,15,278,644,4763
How about a punchy tune?,215,53,10,278,644,5449
Knocked out Bethoven's Fifth.,238,47,16,301,644,2375
I'm only playing my greatest hits.,237,49,15,301,644,4461
I'm taking requests for fight songs,218,54,10,282,644,2042
"Staccato, you said?",217,56,9,282,644,2339
"This piece is called 'Float Like a Butterfly, Flight of the Bumblebee'",218,54,10,282,644,2603
And now a piece from my hit record.,218,54,10,282,644,3216
I thought you said this was a fight song...,223,44,15,282,644,5194
This next song is alittle more up beat.,220,50,12,282,644,5234
Chopsticks?  Really.,203,51,9,263,644,5213
Tickling the ivories is for beginners. This is advanced stuff.,235,60,10,305,644,1590
And now in honor of Boxing Day...,236,58,11,305,644,2290
"Float like a butterfly, sting like a B-sharp.",223,51,12,286,644,412
"Next, The Minute Waltz in 30 seconds.",224,49,13,286,644,1086
My next piece is the two-fisted Sonata.,229,39,18,286,644,1169
and now...Brahms'  Second Concerto in Knocked Flat.,223,51,12,286,644,2389
I will now perform the Victor Borge Concerto,216,32,19,267,644,2813
"I shall now play the Concerto No. 2, Opus 18 by Rockymaninoff.",238,61,10,309,644,880
It's me against the music.,241,55,13,309,644,2402
I will now perform a piece by JS Box,228,48,14,290,644,784
"My next number is the ""beat goes on""",226,52,12,290,644,5090
Now I know what Theresa May must feel like.,216,39,16,271,644,3469
"Now a little something called ""Float like a Butterfly sting like a Bee""",230,51,13,294,644,1700
This next one really packs a punch!,229,53,12,294,644,3748
I shall now attempt the dreaded Rachy III,232,47,15,294,644,4088
And now something a little more modern: 'The Boxer' by Paul Simon.,247,57,13,317,644,1568
Now for the Fight of the Bumble Bee.,214,50,11,275,644,4439
‘I used to be a contenda’,216,46,13,275,644,5243
I have found it difficult to refrain from texting during performances.,236,46,16,298,644,1989
And now for Box' Concerto in D minor.,234,50,14,298,644,2335
"And now, a piece for ill-tempered clavier by Box.",236,46,16,298,644,2602
How else do you propose I play The Boxer?,232,54,12,298,644,3871
"Did someone request, The Boxer?",231,56,11,298,644,4201
"Now, for something softer.",219,47,13,279,644,2868
"My next number is a real knockout, in three rounds.",243,39,20,302,644,3687
Now I'm going to play 4'33'' by John Cage,244,44,18,306,644,5668
"And now for my next selection, “The fight of the bumblebee.”!",211,37,16,264,644,993
Naturally  I belt out music.,219,61,7,287,644,2123
"And now, I'll play a selection of Muhammad Ali's hits.",230,39,18,287,644,2496
And now I'd like to perform a mashup in ALL the majors and minors.,228,43,16,287,644,4743
Leeeeet's get ready to rhuuuuuumba!,244,51,15,310,644,2486
"The contract stated I was not allowed to ""tickle"" the ivories",212,42,14,268,644,1813
"And for my next number, Beethoven's ""Hammerklavier"" sonata.",210,46,12,268,644,3389
Tonight I will be playing selections from “The Divorce of Figaro”.,231,44,16,291,644,4958
"And now, ""The Boxer""",249,48,17,314,644,3137
"Now, I'll knock out a number that you all know.",212,49,11,272,644,2479
I  HAVE TO HANDAL THE NEXT NUMBER WITH KID GLOVES,215,43,14,272,644,2904
They say my performance is a knock out.,214,45,13,272,644,4072
I hope that some in the audience tonight will be able to distinguish the downbeat versus the beat down.,229,55,11,295,644,175
This one's for you in the box seats.,217,46,13,276,644,4887
I've been fighting through this song for weeks.,235,57,11,303,644,1489
This next selection is an experimental piece by Philip Glass.,235,57,11,303,644,2726
"This final movement, a rondo played in robust fortissimo, delivers a real knockout!",233,61,9,303,644,3452
It's a knockout tune.,216,55,9,280,644,108
"Quite frankly, I’m much more accustomed to pounding on an organ.",218,51,11,280,644,4960
And now the overture from the opera 'Rocky',238,58,11,307,644,391
"And now finally Mr. President, a special piece for you -- a little atonal number you might recall, 'One is the Loneliest Number.'",227,40,17,284,644,1351
This next piece is sure to be a knockout.,221,52,11,284,644,1708
Hook and Jab in D minor by Johann Sebastian Box,222,50,12,284,644,2734
For my next number: Tyson's Overture in B-Flat on Your Back.,222,50,12,284,644,5187
They complained I was all thumbs.,221,52,11,284,644,5482
"I will now play the theme song from ""Rocky"" .",202,50,9,261,644,1440
"And now, for the 'modern music' portion of our program ....",226,49,13,288,644,777
"Float like a butterfly, sing in B.",223,55,10,288,644,3028
"Next, I will perform 'Rhapsody in Black and Blue' by Deontay Wilde",227,47,14,288,644,4227
"To increase the degree of difficulty, I will put on a pair of swim fins.",231,39,18,288,644,5206
"And now, the Muhammad Allegro.",233,35,20,288,644,5564
"Yo, Adrian! I did it!",234,40,18,292,644,1839
"I must apologize for the typo in the program. My name is Bang Bang, not Lang Lang.",231,46,15,292,644,4380
That bum is going down in the second movement.,205,58,6,269,644,2740
"Ladies and Gentlemen, Flight of the Bumblebee like you have never heard played before!",214,40,15,269,644,4854
"And now, I'd like to play ""TKO for Two""",231,53,12,296,644,4875
And now for a little chin music.,213,49,11,273,644,30
"And now for my finale, Rope-a-dope fortissimo",215,45,13,273,644,610
"And now, for the Flight of the Pugilist.",212,51,10,273,644,2162
"They told me, ""Knock yourself out!""",219,37,17,273,644,2541
"My finale will be a unique, spirited medley of fight songs.",212,51,10,273,644,5367
I said I was a pugilist not a pianist!,237,48,15,300,644,1939
This rendition is going to be a knock out !,233,56,11,300,644,3645
"And for my next piece, 'Float like a butterfly, sting like the Flight of the Bumblebee.'",217,48,12,277,644,81
"They said I should ""punch it up.""",211,60,6,277,644,749
My next selection has a familiar ring to it.,215,52,10,277,644,826
"Final Fight Scene from Rocky III, in B Flat""",224,34,19,277,644,2020
"Pianissimo forget about it, Fortissimo I got.....",235,59,10,304,644,3860
And now the theme music from Rocky,219,51,11,281,644,4306
I will now knock out the theme from Rocky,224,48,13,285,644,2227
Here's a little something for those of you who like less definition.,224,48,13,285,644,3829
"And now, Chopin's Knockout-turne in B minor.",245,53,14,312,644,4504
I will now punch out this little tune..,201,54,7,262,644,2804
"I shall now play my new composition, 'Lullaby for Mike Tyson'.",210,36,16,262,644,4428
And now a little tune from Johann Sebastian Box.,208,40,14,262,644,5039
You could say I'm digitally-challenged.,230,43,16,289,644,2597
And now The Mike Tyson Overture.,229,45,15,289,644,4055
I will be playing pugilist in D Major.,206,51,9,266,644,2371
They said make the finale more punchy!,206,51,9,266,644,5500
Wait 'til I take the gloves off,252,53,15,320,644,5277
And now I would like to perform Rocky's 5th.,236,45,16,297,644,1069
Staccato?,235,47,15,297,644,2027
Would someone from the audience help me find my keys?,212,46,12,270,644,2793
"And now, a Canto from Ezra Pound.",214,42,14,270,644,3503
What?  You told me to pound it out.,212,46,12,270,644,3836
This next one’s called “I’m a failure and my wife’s leaving me.”,240,44,17,301,644,4982
"And now, Rocky's Symphony No. 5 in C minor.",212,53,9,274,644,1247
Symphonie Pugiliste?,212,53,9,274,644,1588
"Here in the final round is the theme from 'Rocky.""",215,47,12,274,644,3104
My ivories don't like to be tickled.,215,47,12,274,644,4212
"My next number will be ""Fight of the Bumble Bee"".",221,42,15,278,644,267
My next piece is the theme from ‘Rocky’!,220,44,14,278,644,663
. . . and now the theme from Rocky,223,38,17,278,644,908
"I will take off the gloves, but I want you to know how it feels to be challenged by Prokofiev.",219,46,13,278,644,2543
This next one will be a bit punchier than the last.,221,42,15,278,644,2671
"Yeah buddy?  Come down here, I'll give you discordant notes!",217,50,11,278,644,3950
Want to hear a punchy tune?,217,50,11,278,644,4292
Did I hear a request for the theme from Rocky?,241,56,12,309,644,1016
I can knock out the Minute Waltz in 45 seconds.,242,54,13,309,644,2548
"And now, I would like to play the theme song from the movie, Rocky.",227,37,18,282,644,2973
"'""and now - Franz Listz's My Fisto Waltz""",223,45,14,282,644,3752
Sharp or flat?,226,46,14,286,644,1952
Lllllllets get ready to rumbaaaaaa!,228,42,16,286,644,3219
And now my original theme for Rocky.,228,42,16,286,644,3889
I'd like to close this evening with 'Flight of the Bumblebee.',231,36,19,286,644,4959
But you said you wanted a more punchy arrangement!,201,49,9,259,644,2867
And now a little piece by Victor Borge.,226,53,11,290,644,2967
"And now, I give you Punchini's ""Madam Sting Like a Butterfly.""",252,55,14,321,644,3990
"The Boxer's Rag, by Slapsie Maxie Mendelssohn.",209,40,14,263,644,2122
"After I am done here, dis piano will be nuttin but chopstiks",204,50,9,263,644,4560
And now I will float through Madame Butterfly and sting into Flight of the Bumblebee.,210,45,12,267,644,2770
Are you ready to ruuuuumble?!!!!!,209,47,11,267,644,3211
"Not to brag, but this concerto will be over in one round.",227,65,6,298,644,374
Not to mention I've never learned to read music.,235,49,14,298,644,582
Now for the old one two,235,56,11,302,644,714
This next piece is a big hit!,219,41,15,275,644,89
Would you mind holding your coughing until after the first round?,241,51,14,306,644,5201
I've been fighting the urge to play this tune all night long.,215,56,8,279,644,568
And now my rendition of the ham-fisted symphony as inspired by Donald Trump,222,42,15,279,644,2025
My next piece will really be a knockout.,220,46,13,279,644,3914
"......and in this corner weighing in at 158 pounds in the dark tuxedo, fromVienna, Austria .....",249,49,16,314,644,2457
Let's get ready to r-u-u-u-u-u-mba!,220,53,10,283,644,1938
Gloves come off when they turn up the heat.,224,52,11,287,644,944
The real problem is my cauliflower ear.,226,48,13,287,644,3709
You asked for a heavy hitter!,224,52,11,287,644,4080
"...and to conclude, here is the Welterweight Waltz in B-flat Major.",230,47,14,291,644,5245
". . . my own composition, an atonal 'Ode to Donald' .",208,37,15,260,644,4071
My next piece is Fight of the Bumblebee.,214,32,18,264,644,893
"And now, ladies and gentlemen: ""'We Will Rock You!",211,38,15,264,644,1167
"For my next composition, ""The ill-tempered clavicle""",209,42,13,264,644,5091
This next piece is by Rocky-maninoff.,209,49,10,268,644,5083
"Okay, it doesn't work for Beethoven, but my Mahler's a knockout!",213,48,11,272,644,1174
"After 32 variations, I'll be going 12 rounds.",215,44,13,272,644,3212
May I punch out a tune for you?,212,50,10,272,644,4310
Now I'd like to knock out my latest for you!,215,51,10,276,644,699
"I'm sorry, I only play boxed sets.",220,41,15,276,644,1268
My next composition is impressionistic with a touch of violence.,224,47,13,284,644,1129
And now the punchline!,225,45,14,284,644,3071
"And now, for my rendition of Simon & Garfunkel’s “The Boxer”",227,48,13,288,644,1020
I'm going for a knockout performance of Box Sonata #1.,227,48,13,288,644,4726
Next! A college fight song composed by Joe Louis.,227,48,13,288,644,4836
I will now perform variations on a famous theme of John Cage.,227,48,13,288,644,5387
For my encore I’ll play ‘The Boxer’ by Paul Simon,202,37,14,253,644,2902
I don’t take requests.,258,54,15,327,644,3727
I'd rather be a boxer at a piano than have a piano in my boxers,239,31,22,292,644,565
"...and now,the Rocky Sonata",227,55,10,292,644,3240
In this composition I am honoring the heavy-handed approach of two masters - Wilhelm Richard Wagner and Mohammed Ali.,230,56,10,296,644,2751
"And now, by request, the theme from ""Rocky"".",235,46,15,296,644,2919
And next a rumble in the ensemble.,230,56,10,296,644,4379
"Excuse me, this piano needs tuning!",232,52,12,296,644,4768
This is how I flatten the flats.,232,59,9,300,644,4243
And now for the hook.,214,34,17,265,644,83
"Ladies and Gentlemen, this is what I learned from Viktor Borge.",206,50,9,265,644,2346
...and now another Simon and Garfunkel favorite- The Boxer.,204,54,7,265,644,3828
Box Symphony is just Bach's Symphony but with a nicer ring to it,207,48,10,265,644,5341
"My last piece is entitled ""Float Like a Butterfly, Sting Like a Bee.""",243,44,17,304,644,451
"Now one by one of my favorite composers, Sonny Liston.",234,62,8,304,644,1213
I have a love- hate relationship with the piano,238,54,12,304,644,2809
My next song is about my experience with my stockbroker and his attorney.,213,43,13,269,644,2061
Of course I play by the Queensbury rules!,211,47,11,269,644,4350
I hope you find my next number a knock-out.,210,49,10,269,644,5512
Down an octave goes Frazier! Down an octave goes Frazier!,241,55,12,308,644,3220
Welcome to Rocky in E minor,215,46,12,273,644,7
"To complete our tribute to the president, I will now play Mueller Said Knock You Out.",215,46,12,273,644,2972
"Bear with me, I just had a mani-pedi.",214,55,8,277,644,629
"I am just a poor boy
But my story is seldom told...",254,50,16,320,644,4503
Is my playing too aggressive?,249,60,11,320,644,5683
I will now play the Joe Louis lullaby.,217,56,8,281,644,935
And now I shall play Wagner...,223,44,14,281,644,3796
"With so many notes, it's always a fight to the finish!",219,52,10,281,644,4454
I’m afraid I can only take requests for something from “The Ring” cycle.,222,53,10,285,644,2459
Concerto for Raging Bull in E Minor,228,41,16,285,644,4625
"For obvious reasons, I will not be performing “Chopsticks’ tonight.",229,46,14,289,644,207
"I call it, ""Concerto in A-minor Concussion for Graziano and flute.""",227,50,12,289,644,1406
I’ve been informed that this is a piano. Thank you.,231,42,16,289,644,1914
"But the maestro said this was a 
Boxing Day concert.",225,54,10,289,644,4961
And now a new medley for those in the audience who are tone deaf,232,47,14,293,644,365
"This version of "" Flight of the bumble bee"" was inspired by the late Cassius Clay.",233,45,15,293,644,4348
"The starting note is ""ding ding ding"".",228,55,10,293,644,4922
I'm gonna play the Rocky theme.,233,52,12,297,644,2490
"So, how does your school’s fight song go?”",234,57,10,301,644,1294
For my next number I'll play the Thrilla in Manila Concerto by Frazier.,241,43,17,301,644,1338
Next will be the theme from Rocky,204,42,12,258,644,4873
A special technique is required for the arpeggios.,244,51,14,309,644,5352
It's a Cage session.,215,41,14,270,644,313
"And now, by your request, the Love Theme from 'Rocky'.",213,45,12,270,644,2094
"For my last number, Floats Like a Butterfly, Stings Like a Bee",219,47,12,278,644,4924
"Up next, my classical one-two combo.",219,54,9,282,644,1428
"Next, my rendition of The Nutcracker.",225,49,12,286,644,224
I regret auditioning for Rocky the Musical,225,49,12,286,644,5639
This song goes out to my father.,231,44,15,290,644,367
"And now, ""Mitten on the Keys.""",233,40,17,290,644,1395
And now I will play Dance Like a Butterfly and Sting Like a Bumblebee by Rimsky Ali,233,40,17,290,644,2824
"This next piece was first performed in Paris in 1913. It was quite controversial for the time, and fights broke out among the audience.",225,56,9,290,644,4179
"And now, ladies and gentlemen: Für Evander.",234,38,18,290,644,4729
"yeah,well if I could box,do you think I'd be trying to play this thing?",233,47,14,294,644,1649
"Sorry I'm late, folks! I had to fight my way through traffic.",231,51,12,294,644,2050
I'm sorry...did you say you have a request?,235,50,13,298,644,979
"Ok, I'm gonna' need an eight count for this next one...",238,44,16,298,644,2642
This next piece is from the opera “Don King Giovanni.”,236,48,14,298,644,4967
...and a special thanks to Performers Insurance Co. for finding a way to reduce my premiums.,236,48,14,298,644,5304
A little help here?,233,54,11,298,644,5383
And now I'd like to pound out a little number from Mozart.,242,50,14,306,644,1876
The optional ear plugs are under your seat.,245,51,14,310,644,1490
They all laughed when I sat down at the piano...,215,43,13,271,644,2296
Whew! Rough house!,213,54,8,275,644,355
This one will knock you off your feet.,219,42,14,275,644,1524
This next piece is from the Ring cycle.,218,44,13,275,644,4846
"And now, Sonata No. 6, by Rockymaninoff",220,47,12,279,644,1135
This next piece is titled Füry Elise.,222,43,14,279,644,1200
...and now the band and I would like to punch out a couple of old favorites.,216,55,8,279,644,1926
"I thought you requested the ""Fight of the Bumblebee""",223,41,15,279,644,2840
I need my mouthpiece!,220,47,12,279,644,3780
"Oops. Wrong venue, wrong night.",220,54,9,283,644,281
"Yo, Liberace.",225,44,14,283,644,1449
This is one I call 'Beethoven's 9th Round.',223,48,12,283,644,1478
Sugar Ray Charles,221,52,10,283,644,2238
"This piece is in ""Stallone staccato"".",220,54,9,283,644,2632
This next tune was popular during The Boxer Rebellion.,219,56,8,283,644,3385
Box Magnificat,229,36,18,283,644,4948
"This one is called  ""The Fight of The Bumble Bee.""",225,51,11,287,644,4
It's easier than the violin.,228,45,14,287,644,72
My repertory is limited...I can only play rounds,226,49,12,287,644,379
I will now try Bach-sing.,231,39,17,287,644,759
I want to get the hell  home so I'm just going to knock this piece out quickly.,227,47,13,287,644,2637
"Now, the Beethoven Piano Sonata #8 ‘Pathetique’ as interpreted by Muhammad Ali.",221,59,7,287,644,4500
"I shall now play the ""I AM THE GREATEST"" Sonata I composed in memory of Muhammad Ali.",227,47,13,287,644,4592
I will now play from Wagner's Ring Cycle. Round One.,231,53,11,295,644,2167
The Boxer Rebellion concerto,238,46,15,299,644,1810
They're called Chopsticks preventers.,240,42,17,299,644,4369
"And now our main event – Beethoven's Sonata in C minor, in 12 rounds",230,62,7,299,644,4814
Box Fugue in D minor,253,51,15,319,644,5636
I'm just going to play a little rope-a-dope until I find middle C.,201,45,10,256,644,2450
"I wanted to be a boxer, but mother made me take piano lessons.",252,60,11,323,644,3192
Clair de lune?  What key?,203,48,9,260,644,3768
"Excuse me, the keys are too small.",210,41,13,264,644,830
"And now, for your listening pleasure, I'd like to knock out this little number.",209,50,9,268,644,1787
I’m not sure Simon & Garfunkel’s “The Boxer” is supposed to be played like this.”,215,45,12,272,644,839
"I wouldn't say ""tickling the keys"" is my style.",213,49,10,272,644,3973
"The critics all say that anything I might be lacking in finesse, I more than make up for in punch.",215,45,12,272,644,4547
"And now for a nuanced little mashup I call 'Étude, Sonny Liszton?'",219,44,13,276,644,946
And now in Fortississimo.,220,49,11,280,644,5481
"And now, Ravel's Piano Concerto in D for Southpaws.",227,42,15,284,644,1352
These piece symbolizes both internal and external conflict,221,54,9,284,644,1615
Tickling the ivories got old.,218,60,6,284,644,2240
Why is this piano out of tune?,227,42,15,284,644,4519
"And now, I will take Beethoven to the 12th.""",226,44,14,284,644,5081
And now I'll perform my latest big hit.,222,52,10,284,644,5467
Oh. Bach?,226,51,11,288,644,1777
It gives the music the right hook,232,39,17,288,644,4018
Each song will be followed by a 1-minute intermission.,228,54,10,292,644,2569
This sonata will knock you out.,228,54,10,292,644,4738
This next piece is a little punchy.,227,63,6,296,644,285
"I'm just a poor boy, though my story's seldom told...",241,42,17,300,644,176
For round 1 I will be performing Fight of the Bumble Bee,240,51,13,304,644,231
I shall now bust your Chopsticks.,243,45,16,304,644,3015
"Tickling the ivories? Uh, no. I don't think so.",242,54,12,308,644,3099
"I call this next piece,""Fight of the Bumblebees.""",251,50,15,316,644,3409
"And, when the burgers are done , this George Foreman grill turns into a grand piano .""",256,54,14,324,644,4562
"And now, the impossible: Chopstix!",265,43,20,328,644,4969
My current album comes in a boxed set,198,46,9,253,644,64
"Sorry, doctor's orders to stop biting my nails.""",204,48,9,261,644,4852
Don’t Laugh! This will be a knockout!,207,42,12,261,644,5633
"My next piece will be a Concerto in 15 Movements, or Until the Referee Stops the Concert.",215,40,14,269,644,1562
DOWN goes Mahler...DOWN goes Mahler....,212,46,11,269,644,3735
playing piano is nothing compared to getting dressed.,224,36,17,277,644,500
"And next, I'll be playing,""Fight of the Bumblebees.""",219,46,12,277,644,1567
"I will now play the theme from ""Rocky"".",221,42,14,277,644,2003
"For my encore, Chopin’s lesser-known ‘Mitten Waltz’...",220,44,13,277,644,2053
"My next selection is Paul Simon's ""The Boxer"".",217,57,7,281,644,1651
It's for your protection and mine.,223,45,13,281,644,4741
"And now, Variations on Theme From Rocky.",223,45,13,281,644,4901
What happens in Piano club...stays in piano club.,228,42,15,285,644,1484
"And now, Beethoven’s Right Hook, in D.",227,44,14,285,644,2754
They laughed when I say down to play. They're not laughing now.,230,45,14,289,644,691
"In the spirit of this Holiday Concert, and to celebrate the diversity of the season, I will now perform a special Boxing Day carol.",233,39,17,289,644,2185
I thought you said you wanted me to knock out a tune?...,228,49,12,289,644,3730
Taking the gloves off is not mentioned in the composer’s original manuscript.,229,54,10,293,644,894
This piece was written for no hands.,233,46,14,293,644,1601
This is from my latest box set.,230,52,11,293,644,1886
I've never been much of a tickler.,234,44,15,293,644,4435
Now I will play for you 'Sting Like A Bee.',236,40,17,293,644,5579
I believe single notes are banal and over-rated.,235,49,13,297,644,517
"Louie, Louie"" again? Well, if you insist..",235,49,13,297,644,1480
Now for Mozart's Piano Sonata in Sting Like a Bee-Major.,236,47,14,297,644,1758
My Carpal tunnel's flaring up again.,232,55,10,297,644,1863
Welcome to Ultimate Piano Club,235,49,13,297,644,1881
This next piece needs a little punching up.,237,45,15,297,644,5236
Are you ready for some chin music,239,48,14,301,644,3738
"At least I'm no longer ""all thumbs""",238,50,13,301,644,5118
"Now that I've answered my critics, I shall play music from 'Requiem for a Heavyweight' """,235,63,7,305,644,177
And now for a slow rendition of Flight of the Bumblebee,245,43,17,305,644,971
Refunds will be available in the lobby.,242,49,14,305,644,3305
I call it Concerto Marciano.,240,60,9,309,644,4391
"Yes, of course I play by ear",202,40,12,254,644,1179
The former champ came to understand his new pursuit required a different set of skills.,200,44,10,254,644,4587
"Harolds worst nightmare, trying out for the ""L.A. PHILHARMONIC""",208,35,15,258,644,1430
This evening I will be performing The Hagler-Hearns Concerto No. 2 in Three Rounds.,206,46,10,262,644,1147
"And for the tenth,and final,round,I shall play Chopsticks.",210,38,14,262,644,1628
Let me just punch this number out.,212,41,13,266,644,1511
This is why it is called The Unfinished Symphony.,210,45,11,266,644,1908
And now for Rockymaniovs's Concerto No. 3,209,47,10,266,644,2852
"Float like a butterfly, pound on the keys.",212,41,13,266,644,3012
And now for a short Roundo by Vladimir Fisticuffski.,213,46,11,270,644,2250
This one will knock you out!,212,48,10,270,644,4589
I offer Republican Chopsticks for our times.,221,37,16,274,644,870
And now my musical portrait of Muhamad Ali...,217,45,12,274,644,4999
I will now punch out the theme from Rocky.,225,50,11,286,644,937
My next piece is John Cage's 4'33,225,50,11,286,644,2342
Let’s get ready to rumbaaaaa!,223,54,9,286,644,3085
It's a clause in my insurance contract.,225,50,11,286,644,3672
"At your request, Rocky's Fourth!",227,46,13,286,644,3719
My performance will float like Madame Butterfly and sting like Flight of the Bumble Bee.,234,39,17,290,644,2977
I prefer to pound rather than tickle the ivories!,226,55,9,290,644,5196
This is my warm-up number.,228,58,8,294,644,269
"...and next I will perform the theme from""Rocky""",233,48,13,294,644,1586
Are you suggesting there is a problem with my technique?,234,46,14,294,644,5415
"Yo, maestro!",236,49,13,298,644,2640
"Next, I'll be playing a classic piece by Muhammad Ali.",237,47,14,298,644,2788
"Once again, Henry was faced with the question: was he a lover, or a fighter?",237,47,14,298,644,3633
Tonight I’m going to play The Fight of the Bumblebee.,238,52,12,302,644,1148
Tonight and one night only: Bach-y Balboa!,239,50,13,302,644,1210
This next piece is by Sergei Knockyerblockoff.,245,52,13,310,644,5105
"I was thinking of the President when I wrote this piece, it’s really great.",255,46,17,318,644,2365
"And now, Mozart's Sonata for middleweight southpaw in A Minor",247,62,9,318,644,3989
Sometimes you just have to roll with the punches.,203,47,9,259,644,134
And now the Symphonic Dances by Rockymaninoff,206,41,12,259,644,465
"And now, Interlude, by Rocky Maninoff.",208,37,14,259,644,4760
So! I’m not all thumbs!!,215,44,12,271,644,2232
You want me to do what??,221,39,15,275,644,860
"...and for my next piece, here's 'Float Like A Butterfly, Sting Like A Bee.'",220,48,11,279,644,744
Here is the musical stylings of the Black Eyed Keys.,222,51,10,283,644,28
Last time this piece got the better of me.....,226,43,14,283,644,2208
"If anybody shouts, ""Yo, Adrian,"" you will be removed from the premises.",225,45,13,283,644,2330
This is how I knock out the hits.,223,49,11,283,644,2756
I never wanted piano lessons.,224,47,12,283,644,4737
"And now Mister President, I shall play the “Minute Waltz” in 47 seconds.",224,54,9,287,644,271
"And now, for my grand finale, Fight of the Bumblebees",227,48,12,287,644,4612
For my next performance I'd like to punch out a little ditty.,228,53,10,291,644,3479
"I'm thrilled to finally reach the ""Knock-Out Round"" of this prestigious competition.",228,53,10,291,644,5646
next round's on me...,234,48,13,295,644,688
"And now, ""Fly Like a Butterfly, Sting Like a Bee""",233,50,12,295,644,2144
"Who knew playing ""The Boxer"" would prove this challenging ?",235,46,14,295,644,2901
I would like to begin my Simon and Garfunkel medley with “The Boxer”.,228,60,7,295,644,5009
I will now play the Rachmaninoff Prelude in A through G minor.,239,45,15,299,644,950
"And now, variations on a theme by Marciano.",233,57,9,299,644,2176
"And my next piece will be ""Uppercut in D Minor""",238,47,14,299,644,3925
And in this corner...Rocky Rachmaninoff !!!,247,36,20,303,644,2216
And now: Box Fugue in D Major.,244,49,14,307,644,2538
Just in case I get in treble while playing.,246,52,13,311,644,3306
"Play it again, but this time make it punchier!",251,56,12,319,644,5089
"This isn't quite what I thought they meant by ""dueling pianos"".",231,49,12,292,644,6
"In the future, there will be fewer nuances.",246,54,12,312,644,24
"Well, you said to punch it up a bit.""",207,55,6,268,644,151
Below the belt? I'm not even using the pedals.,208,46,10,264,644,547
This one has a very catchy hook”,215,46,11,272,644,988
Get ready for something punchy.,251,44,17,312,644,2030
"And now, my unique version of  ""Sock It ToMe!",213,50,9,272,644,2145
"And now, “glovesticks”.",205,38,13,256,644,2518
We're trying for a new demographic,202,44,10,256,644,2601
They wanted me to stop tickling the ivories,225,47,12,284,644,3002
I tried facing the music but got hit with a one two.,228,41,15,284,644,3472
You should hear me play the zither.,214,48,10,272,644,3674
"Well, I only minored in music. My degree is in the martial arts.",204,47,9,260,644,4579
Any problem? Meet me outside!,224,42,14,280,644,4627
"I call this composition, 'Hey Kids, Get Away From The Piano!'",211,47,10,268,644,4808
Here’s a little number I made popular back in my club days,225,47,12,284,644,4944
It would be best if you sang in rounds.,239,54,11,304,644,5043
It was The Boxer Rebellion in C Sharp Minor.,234,43,15,292,644,5135
"No,I said I was going to play the “flight” of the bumblebee !",223,44,13,280,644,5200
Tonight I only play music from the Rocky films.,221,55,8,284,644,5521
"I will now play selections frrom ""The Ring Cycle "".",250,48,15,313,644,3886
"...And by special request, I'll be playing the theme to ""Rocky"".",239,49,13,301,644,819
I shall now perform Basie's Down For The Count.,231,58,8,297,644,122
Agreed--but wait till you hear my double glissando.,234,52,11,297,644,2851
"For my next number, I will play Beat Me Daddy, Eight to the Bar.",233,47,13,293,644,813
You were expecting maybe the guy with the candlabra?,228,50,11,289,644,1052
"This is not, what I had in mind for dueling pianos !",229,48,12,289,644,4787
I guess I'll just roll with the punches,224,51,10,285,644,1348
"And in this corner, coming in at 5'10"" and 155 pounds, his C major will bring you off your seat, the pianist from Vienna...",223,53,9,285,644,1629
My next selection will be from the Ring Cycle,221,50,10,281,644,3218
That’s OK! I’m all thumbs anyways!,219,54,8,281,644,3814
"Ladies and Gentlemen, Wagner's  'Ring Cycle.'",219,47,11,277,644,3570
"Tonight, you will hear me pound the keys like I've never done before.",222,41,14,277,644,3856
Rachmaninov: Piano Concerto No.2 as adapted by Rocky Marciano,219,47,11,277,644,4629
"And now, Muhammad Ali's ""Float of the Butterfly""",216,39,14,269,644,5002
Now a little something from Wagner’s “Ring of the Mittelveight”.,207,50,8,265,644,2903
Some consider my interpretation to be aggressive,212,40,13,265,644,3285
At least wait for the hook.,201,55,5,261,644,277
The next song I will be performing is sure to be a knockout.,209,39,13,261,644,2561
Just a little something I put together for the Boxing Day annual concert.,203,44,10,257,644,5114
It's 'Chopsticks' but with a 3.2 degree of difficulty.,255,47,16,318,644,2001
And now for the main event...,245,60,9,314,644,4098
Paderewski?  I'll moider de bum!,248,47,15,310,644,1768
For the boxed set.,248,47,15,310,644,5589
"But first, Rockymaninoff’s ‘The Pugilist’s Prelude‘ .",245,39,18,302,644,326
"Okay, who wants to hear some Mahler?",244,41,17,302,644,4416
"And for my next piece, I’ll need the assistance of someone in the audience, preferably the abusive guy in the corner...",234,54,10,298,644,1274
"And in this corner.......Liszt-loving, Bach-breaking, Mozart-mauling .....two-handed ""Steinway Tommy Tune""!!",239,44,15,298,644,5237
"The next composition is John Cage's ""Music for Muhammad Ali"".",229,50,11,290,644,754
And for my next piece; 'Rocky V' in A minor.,232,44,14,290,644,2850
Shut the fuck up.,240,28,22,290,644,5294
"For my encore, the theme from 'Rocky.'",227,47,12,286,644,648
And now a piece from Wagner's lesser-known Boxing Ring Trilogy.,230,41,15,286,644,1648
I thought you requested a Box Trot!,226,49,11,286,644,3238
I've always considered Schubert a challenge.,222,50,10,282,644,3026
It's called dueling piano.,217,53,8,278,644,3787
"My next number, a sing-along, is also a round .",216,48,10,274,644,803
Guess I grabbed the wrong bag at the airport,215,43,12,270,644,1468
Now my interpretation of Simon & Garfunkel's The Boxer.,211,51,8,270,644,3659
"For my next number, ""Baby It's Cold Outside.",217,25,20,262,644,512
"Now, for a more muscular piece.",202,55,5,262,644,2024
"He got hit pretty hard, i think he has a Percussion",212,35,15,262,644,2666
And now for my rather unique rendition of Beethoven's 5th,253,53,13,319,644,1834
"I thought you said ""bach"".",245,55,11,311,644,942
"This is my interpretation of Wagners ""Ring"" Cycle.",241,49,13,303,644,3878
Live at the Apollo Creed,242,40,17,299,644,3091
Perhaps my tribute to Boxing Day was ill-informed.,231,55,9,295,644,779
"Now, I will wear my Bach-sing gloves.",237,43,15,295,644,5650
My next selection is Beethoven's Moonlight Sonata in three rounds.,223,57,7,287,644,3162
What do you mean I am off key?,226,44,13,283,644,2928
I hope you like my version of a song made famous by Simon & Garfunkel.,219,51,9,279,644,293
It's my way of conveying the world's dissonance.,223,43,13,279,644,972
"Before I start, are there any complaints about the program?",224,41,14,279,644,1006
Knockout in the fifth movement.,226,37,16,279,644,3394
"I shall now play ""Flight of the Sting Like A Bee.""",223,43,13,279,644,4434
This next piece is from the opera 'Bin Nacht aut'.,220,42,13,275,644,4323
Now here's the main theme from Rocky.,214,54,7,275,644,5329
"For my next number, I'd like a stool, a mouthpiece and a round girl from the audience....",215,45,11,271,644,3869
The judges had warned Marcel that his habit of picking his nose between sets made the other contestants uneasy. Yet their solution seemed harsh....and made it difficult for him to compete.,217,41,13,271,644,5264
"For my next piece I will play ""The Fight of the Bumblebee""",212,44,11,267,644,5423
Lie-la-lie... lie-la-lie-lie-lie-lie-lie...,215,31,17,263,644,304
I will now play some of Beethoven's VERY early works.,211,39,13,263,644,3963
"Float like a butterfly, sting on the keys.",204,46,9,259,644,3266
And here's my rendition of Boxing Matilda.,201,45,9,255,644,1312
"Sorry, was I a little flat?",197,46,8,251,644,3797
This next number is inspired by the life of Mike Tyson.,252,50,14,316,644,414
"I'll now play a little-known Wagner piece, ""The Boxing Ring.""",243,54,11,308,644,4052
"And more, much more than this, I did it Steeeiiinway.",240,60,8,308,644,5570
It is so damn hard to follow my dreams simultaneously.,244,45,15,304,644,1314
It adds a little punch to my Bach..,240,53,11,304,644,2165
"This one is called ""Saved by the Bell""",236,54,10,300,644,435
Can somebody give me a hand?,236,54,10,300,644,3967
I'm afraid I've boxed myself into a corner with this concerto.,230,66,4,300,644,5540
Every hit song needs a memorable left hook.,230,59,7,296,644,1677
Rachmaninov wasn't challenging enough.,240,39,17,296,644,3483
"Next up is Rachmaninoff’s little known submission for the ""Theme from Rocky""",236,40,16,292,644,637
Did I hear a request for “Chopsticks”?,234,44,14,292,644,2487
I’d think twice about criticizing my playing”,231,50,11,292,644,4432
"...and the Fourth Movement: ""graziano ma non marciano.""",228,49,11,288,644,2155
"And now, Rocky-maninoff!",228,49,11,288,644,3293
I will perform ‘Variations on a theme by Liston’ composed by Ali.,229,47,12,288,644,4571
"For my next piece :""The fight of the Bumblebee",223,52,9,284,644,3737
I hope you enjoy this punchy little number.,224,43,13,280,644,697
"And now, the theme from Rocky, with a salute to Victor Borge.",223,45,12,280,644,1202
This composition is called 'The Thrilla in Manila.',224,43,13,280,644,1973
I have chosen to play The Marquess of Queensberry's First Piano Sonata in A Minor.,224,43,13,280,644,4288
...And now the theme from Raging Bull,219,46,11,276,644,4997
I'm going to dedicate this next song to the back row.,217,43,12,272,644,936
You will each find a pair of ear plugs under your seat.,215,33,16,264,644,702
I only perform once a year - On Boxers Day.,211,41,12,264,644,2202
I will now play Simon and Garfunkel’s “The Boxer”.,207,42,11,260,644,3784
"I call this one ""It's hard to sexually assault someone when you can't unzip your fly"". (Louis C.K. 2019 Comeback Tour)",260,43,18,321,644,3823
Intermission will be in three minutes.,203,43,10,256,644,660
"Tickling the ivories"" is so last century",202,38,12,252,644,1687
"My next piece will attempt to float like a butterfly, sting like a bee.",248,53,12,313,644,1114
Tonight I'll be playing the theme from Rocky XVII.,251,47,15,313,644,3562
"I call it ""Pounding on the keys like a goddamned Ape.'",243,49,13,305,644,77
Without these I’m all thumbs!,243,49,13,305,644,3791
"For tonight's performance, I will be playing 'Rocky's Theme Song' in D Minor.",195,38,11,244,644,5153
Chopin's “Etude in G# minor Has always been a battle for me...,240,48,13,301,644,2043
"And now, one of my own compositions!",240,48,13,301,644,3621
Once you hear this next song composed by Cassius Clay you will know why he changed his name to Mohammed Ali,243,42,16,301,644,3688
"And now ladies and gentlemen, you may remove the complimentary earplugs.",238,52,11,301,644,3968
let me punch out a few of my hits,239,43,15,297,644,1604
What's funny?,235,51,11,297,644,4541
I’d like to dedicate this next number to the inspirational Muhammad Ali.,235,51,11,297,644,4736
"I will now play, Float Like A Butterfly,Sting like a Bee.",238,45,14,297,644,5528
I wear them because these ivories are so ticklish.,233,48,12,293,644,3101
"Ladies and Gentleman, Bachy Balboa!",232,50,11,293,644,4732
"Would Ed Sullivan have loved this, or what!",230,47,12,289,644,1120
"And now, Pummel in Fugue in 5 rounds",228,51,10,289,644,5110
"Is this the ""sting like a bee"" part?",224,52,9,285,644,674
"I call it the “Butterfly Sonata”, in the key of Sting-Like-a-B.",230,40,15,285,644,2958
I really like to belt out a song.,222,49,10,281,644,3123
"I will now do my performance art version of ""Flight of the Bumble Bee""",216,47,10,273,644,1727
My stylist says it helps the nail polish last longer.,216,47,10,273,644,2101
"You said pianoforte, didn’t you?",218,43,12,273,644,5343
They work better on the kettle drums,213,46,10,269,644,3319
"Next, my own composition: ""The Ring.""",215,42,12,269,644,3945
"You want me to bang this one out, don't you?",214,44,11,269,644,5385
"This next piece is something I like to call ""Dueling Piano.""",254,50,14,318,644,194
"Now, "" I would like to play the theme from ""Rocky"".",252,47,15,314,644,3388
"And now, the theme for Rocky XVII",249,53,12,314,644,4346
I call this `Broken Piano`.,207,44,10,261,644,4816
of course I'm wearing a cup,250,44,16,310,644,3589
I have a request from Agnes for a punchy tune,246,52,12,310,644,3897
Which one is Middle C?,247,43,16,306,644,3248
"And now, Simon and Garfunkel's The Boxer.""",242,53,11,306,644,3350
Let's get ready to Rachmaninoff!,249,39,18,306,644,5257
"Now for tonight’ s last request :
BADDA-BING, BADDA -BANG.",242,46,14,302,644,5065
"For my finale I will play a new composition titled ""Float like a butterfly, sting like a bee.""",197,43,9,249,644,5375
"I will now perform ""Fight of the Bumblebees""",234,55,9,298,644,2709
I'm going to punch up this next number a bit.,235,53,10,298,644,2741
And now I will play my homage to John Cage.,236,51,11,298,644,4850
This next number is called 'Fists of Fury'.,236,44,14,294,644,941
"And now, a variation on ‘Flight of the Bumble Bee,’ I like to call, ‘Float Like a Butterfly, Sting Like a Bee!’",236,44,14,294,644,1119
Looks like we have a music critic in the audience!,234,48,12,294,644,4129
"I will now play the theme song from ""Requiem for a Heavy Weight.",232,52,10,294,644,5441
Here's a Gershwin favorite that really knocks me out...,231,47,12,290,644,3185
"In my next piece ... I will float like the ""Butterfly"", sing like a bee.",231,47,12,290,644,5499
Now I will play something a little softer.,231,47,12,290,644,5628
This is the only way to fight through Bach!,191,41,9,241,644,3888
I will now be playing the theme to ‘Rocky’.,227,48,11,286,644,1954
"I call this next piece, “The Stomping Elephant”",228,46,12,286,644,4568
"I  didn't literally mean ""I would 
punch out a tune""",225,52,9,286,644,5436
I hope you enjoy tonight's concert. It is a real knockout,222,51,9,282,644,1985
"And now, Nikolai Rimsky-Korsakov’s little known composition, “Float Like A Butterfly, Sting Like The Flight of The Bumblebee”.",225,45,12,282,644,5664
These are to prevent me from “tickling the ivories”....,256,62,9,327,644,4931
‘And now for a tribute to Mohammed Ali.”,217,54,7,278,644,3089
They said this piece was a sure knock-out,218,45,11,274,644,264
"We're going to pick up the pace. For the next number, I'm going to play something a little more punchy.",215,51,8,274,644,2680
"As my hero said, ""Float like a butterfly, sting like a Flight of the Bumble Bee"".",215,51,8,274,644,3554
My next number will be 'Kitten On the Keys.',223,35,16,274,644,5495
I’d like to punch out a few tunes from my new CD.,210,54,6,270,644,2400
For my next selection I shall perform for you Mozart's Rope-a-Dope Concerto in E minor.,216,42,12,270,644,2763
I was told to give the ivories a good pounding.,217,40,13,270,644,5602
"Hey, it's boxing day!",213,41,12,266,644,3418
"Some football players do ballet in the off-season, I do this",211,45,10,266,644,4203
I’ll do the next song a cappella.,212,43,11,266,644,4860
"And finally, Marciano’s Scherzo per Due Pugni",205,43,10,258,644,370
FOR HIT SONGS ONLY,205,43,10,258,644,4351
"For my encore, a knockturne by Sullivan... John L.,",241,43,15,299,644,897
"And now for my grand finale, I shall perform my very special rendition of that classic Simon and Garfunkle hit, ""The Boxer.""",236,53,10,299,644,5647
"And now, AADRIAANNN!..in C minor.",238,42,15,295,644,783
"And now, a new composition for Boxing Day.",236,46,13,295,644,4861
This next piece requires a soft touch,235,48,12,295,644,5435
Don’t make me take the gloves off.,230,51,10,291,644,690
Please ring the bell in the key of E.,227,57,7,291,644,1915
I'm putting a new spin on a John Cage classic,232,47,12,291,644,2406
My next piece is “Float like a butterfly”,232,47,12,291,644,3077
Now I will perform Rocky Maninoff's Conflicto #13 in Duh-Minor.,233,45,13,291,644,4200
"Good evening, Palookaville.  Before I begin the Mussorgsky, it is imperative you understand that I coulda been a contender.",230,51,10,291,644,5157
This next piece is called “STELLA!!!!!!!” in D minor.,227,50,10,287,644,2231
"And now, all three rounds of Beethoven’s ‘Moonlight Sonata.’",227,50,10,287,644,3200
Rachmaninoff's Third is in for the fight of its life.,228,48,11,287,644,3299
"Ladies and gentlemen, the kangaroo is off for the night.",230,44,13,287,644,4421
"I thought you said ""_Box_ Sonata""!",228,41,14,283,644,2974
I will now play the Muhammad Ali Amadeus concerto the way it was intended.,225,47,11,283,644,4521
This is just cruel.,260,42,18,320,644,5217
Because this next piece was too easy for me . . .,222,46,11,279,644,743
"OK Beethoven, lets rumble",221,48,10,279,644,2759
"Standing up....in a hammock, if you must know.",226,38,15,279,644,3741
I always wanted to beat the band.,220,43,12,275,644,4896
"I’m gonna float like Madame Butterfly, sting like the flight of the bumblebees!",220,43,12,275,644,5071
"For my finale, I will  perform: ""Float like a Butterfly, Sting like a Bee.""",252,44,16,312,644,886
How about “Flight of the Elephant”?,251,46,15,312,644,4392
I will now perform Box Prelude in C Major,216,44,11,271,644,5429
"And now, a musical tribute to the Marquess of Queensberry.",246,49,13,308,644,546
"Let's get ready to Rachmani-noffffff!""",248,45,15,308,644,2733
"My next piece is an original composition entitled ""Elephant on the Keys""",239,56,9,304,644,3502
Now I'd like to punch out a little number for you.,242,50,12,304,644,5332
"And now for 'Float like a butterfly, Flight of the Bumblebee' in A minor",236,48,12,296,644,289
Did someone move my spit bucket?,235,50,11,296,644,1536
"and now a number from my boxed collection""",235,50,11,296,644,4513
"And we start our session with
Chopin’s “Barcarrolle in F Sharp Jab to the Right.",201,53,5,259,644,5545
"And now, ‘Chopsticks.’",233,47,12,292,644,973
I’d like to slow things down a bit. Then speed back up. Then a left. A right. Another left...,235,43,14,292,644,3158
"Da ,da, da, daaa!",203,42,10,255,644,1414
It's going to be a Wagner piece.,233,40,15,288,644,2989
"And now for your listening displeasure, I will pound the ivories.",228,43,13,284,644,5247
And now an obscure piece by Rocky Mannicoff...,254,49,14,317,644,2044
"I now know what they mean when They say; 
 my written answers to Mueller’s questions were akin to that of a child playing the piano wearing boxing gloves.",222,48,10,280,644,1026
I always wear these when I play the theme song from Rocky.,219,47,10,276,644,643
Now I’ll play a fugue by Mohammed Ali,222,41,13,276,644,1088
When do I take the fall? After the first glissando?,216,53,7,276,644,3157
I've had a difficult time choosing a profession.,218,49,9,276,644,4275
"Since I’m in between rounds, there is only enough time to play Chopin’s Minute Waltz.",214,50,8,272,644,1652
"And now, an evening of glissandos.",219,40,13,272,644,5695
"And now, as I like to put it, I’m gonna go a few rounds with Ludwig van.",211,49,8,268,644,4232
...And in this corner weighing in at 1086lbs,235,52,10,297,644,1272
"Sorry, I only take requests from the box seats.",237,48,12,297,644,1814
I'd like to start tonight's Jerry Lee Lewis tribute with an old favorite,234,54,9,297,644,1924
"And now, Ladies and Gentlemen, a work by J.S. Box.",237,48,12,297,644,2465
"Last,  here's my rendition of that old favorite:     
 ""There's a Bull in the China Shop.""",237,48,12,297,644,2703
"And now I present to you: knuckle-sandwich, in C minor.",238,46,13,297,644,5103
Maybe this piano's out of tune.,211,42,11,264,644,5158
"And now, the Thrillah in Manillah",238,46,13,297,644,5497
Well you said I should attack the music!,227,61,5,293,644,560
"In my next lesson video I will demonstrate more secrets of my patented technique for avoiding repetitive injury, carpal tunnel syndrome, and tendonitis.",209,39,12,260,644,3624
"This next piece is my rendition of Simon & Garfunkle's, The Boxer.",233,42,14,289,644,1783
'Chop Sticks.' Why?,232,44,13,289,644,2210
"And now, Michael Tyson's piano concerto number one in D minor...",230,48,11,289,644,3630
"Tonight I'll be playing ""Rumble in the Jungle.""",227,54,8,289,644,3692
Here's a new song that'll really knock you out,229,50,10,289,644,5640
Let's get ready to Rondoooooo!,229,43,13,285,644,1725
"This recital will last 12 rounds, or until I’m knocked out",228,45,12,285,644,2432
This one is called ‘Sonata in ABCDEFG’,230,41,14,285,644,4681
I'm a student of Sugar Ray and Ray Charles.,228,38,15,281,644,186
You might recognize this Paul Simon cover,220,47,10,277,644,5453
"I am about to play Rockymaninoff’s
Symphonic Dances",245,48,13,306,644,3345
"While my scales may have suffered, my arpeggios are to die for!",244,50,12,306,644,4618
In this next Mixed Martial Arts bout my opponent is J S Bach,248,42,16,306,644,5032
I asked for box seats.,215,50,8,273,644,1009
This next number is why I am known as the best pound-for-pound pianist in this town.,215,50,8,273,644,1110
Raging Beethoven.”,217,46,10,273,644,2268
"This is a selection from Rockmyblokoff’s Opus 3, B-flat major, better known as The Pugilist Symphony.",219,42,12,273,644,5616
...and this next piece is sure to be a knock out!,243,45,14,302,644,2065
I glissando like a butterfly and trill like a bee!,215,43,11,269,644,3074
"This next piece is called, ""Good Enough for Government Work.""",239,46,13,298,644,4056
When you don't have time to change between your part-time jobs.,212,42,11,265,644,208
And now I will play Chopin’s Preludes all at once!,210,46,9,265,644,3068
"This one's called, ""Ode to Joe""",234,49,11,294,644,1227
It needs a good tune up.,235,47,12,294,644,1678
"And now ""The sting of the bumblebee"" by Rimsky-Korsakov-Ali.",239,39,16,294,644,1685
I hope you enjoy the tunes I am about to knock out for you.,234,49,11,294,644,1773
"My next piece is called the ""Lamotta  Cantata",231,55,8,294,644,1974
"My next piece is called ""Requiem for a Boxer.""",235,47,12,294,644,2405
A serenade for Boxing Day.,229,52,9,290,644,1201
"Manilla Thrilla"" in B flat",232,46,12,290,644,1832
I punched up the composition a little.,206,47,8,261,644,2527
"And now something with a bit more punch, Rocky's theme.",227,56,7,290,644,2965
And now I'd like to play Black and Blue Suede Shoes,231,48,11,290,644,3355
It's the only way I can play the score to any of the Rocky movies.,231,48,11,290,644,3795
And now more favorites from the life of Joe Louis!,257,47,15,319,644,4220
This next piece is a banger.,253,48,14,315,644,1356
Let me bang out some notes.,250,54,11,315,644,1817
I only play bareknuckle at dive bars,257,40,18,315,644,3718
Let me know if you don't like this one.,248,58,9,315,644,4456
Beats me.,254,46,15,315,644,5457
Please hold your applause until you count to ten.,228,47,11,286,644,481
"...and finally, by Johann Sebastian Box...",230,43,13,286,644,2895
"And now my rendering of a little ditty I wrote, ‘Thrilla in Manila’.",205,42,10,257,644,2100
The melody I'm about to play will knock you out!,249,49,13,311,644,1519
You requested more punch?,222,52,8,282,644,2767
And now for my rendition of Fight of the Bumblebee.,232,32,18,282,644,3833
"Wait, so you meant Simon and Garfunkel's The Boxer?",223,50,9,282,644,4134
"Now, from the original score, ‘The Boxer’.",224,48,10,282,644,4796
No worries.  The piano's prepared.,246,48,13,307,644,4305
"Vote for me to ""Make Music Great Again"".",249,42,16,307,644,5345
I'll take these off after my first piece and I guarantee you're  going to love the rest of my performance.,226,37,15,278,644,3097
"Sorry folks
I’m all thumbs today",221,47,10,278,644,3590
And now for my best combination.,237,59,7,303,644,3462
"Believe me, it helps with the fortissimo, but not with the piano.",239,55,9,303,644,5508
"And now, my own composition,""Le Cantique de George Foreman.""",215,52,7,274,644,1257
"As an encore, I will preform all 31 Goldberg Variations within 42 seconds.",218,46,10,274,644,1592
This is for the critic who called me ham handed,214,54,6,274,644,2096
"And now for my next number, the theme from 'Rocky'.",238,50,11,299,644,68
I call this one Too Many Notes,218,39,13,270,644,666
"Float Like a Tchaikovsky, sting like a Beethoven",215,45,10,270,644,2705
I prefer to punch out a tune,212,51,7,270,644,3944
Time to punch out a new tune.,241,37,17,295,644,1514
I'm still fighting my fear of  learning to play the piano,237,45,13,295,644,4087
"Next, a lively rendition of Fight of the Bumblebee.",233,53,9,295,644,4417
The next concerto is twelve 3-minute movements with 2 minutes of rest between movements.,213,42,11,266,644,2622
Wait till I get to the hook.,213,42,11,266,644,3069
"And now, the Lumbering Death Throes of the Bumble Bee",213,42,11,266,644,5142
I can assure you - you've never heard chopsticks as I am about to perform it!,236,40,15,291,644,1798
My next tune will be The Boxer  by Simon and Garfunkel.,229,54,8,291,644,4938
"I'll be playing ""Mitten on the Keys""",209,43,10,262,644,1418
I'm taking a dive in the 9th symphony.,212,37,13,262,644,1714
You told me to punch it up a bit.,228,49,10,287,644,299
"I managed to learn to text with these, now onto playing the piano!",229,47,11,287,644,3428
The melody of modern politics.,250,49,13,312,644,193
"And now, I will once again play the theme from Jaws",226,46,11,283,644,2511
I fought my whole life to get on a stage like this!,225,48,10,283,644,4257
This next song is a real knockout.,204,39,11,254,644,3352
"I can’t play today, I am feeling a little punchy",206,35,13,254,644,4188
Let's get ready to treble!,223,45,11,279,644,2131
Next time you clap or somebody gets hurt.,221,49,9,279,644,5127
"For my next piece, please enjoy 'Mama Said Knock You Out' in B-Flat.",219,46,10,275,644,857
Welcome to dueling pianos.,243,42,15,300,644,3402
"This next piece is called ""I am the greatest"" and is dedicated to Muhammad Ali",240,48,12,300,644,3595
My ‘knockturno’ interpretation is quite dramatic.,217,50,8,275,644,4569
Now I will play my Sonata for Boxing Day.,225,34,16,275,644,5618
I could play this with one hand tied behind my back.,235,51,10,296,644,1476
And now a tribute to Sylvester Stallone.,237,47,12,296,644,4770
"Tonight, on America's Got Talent, Thumbs Noodleman will punch out some Beethoven.",218,41,12,271,644,1825
Ladies & Gentlemen...Wolf Gang Amadeuuuuuuus Mozart !,211,48,8,267,644,1248
I only play power ballads.,253,45,15,313,644,2579
"Ladies and gentlemen, may I suggest we prepare ourselves to rumble?",226,55,7,288,644,2129
This next piece is a bit more raucous.,228,51,9,288,644,2263
It took me a while to get the right hook.,226,55,7,288,644,2525
"Float like a butterfly, play like a ham.",208,47,8,263,644,2461
"When we get to the Chopin, I'll take the gloves off.",210,43,10,263,644,3786
"Now, a tribute to the Rocky movies.",249,46,14,309,644,621
Are you ready to rumba?,229,42,13,284,644,2576
I'll now play the overture from 'Rocky' in B flat on your back.,227,46,11,284,644,2855
I float like a butterfly and sting like the key of B.,230,40,14,284,644,4987
"And now, ladies and gentlemen, I'm going to try something I don't usually do. Simon & Garfunkel's 'The Boxer'.",208,40,11,259,644,5433
Welcome to my Nightmare Sonata!,242,53,10,305,644,573
"And now for my most recent composition, a reverential homage entitled ""Beethoven's Fists""",244,49,12,305,644,1043
"Next I'll be performing Dance Like a Butterfly, Sting Like the Flight of the Bumblebee.",250,37,18,305,644,1702
Yo Adrian... this nex numbers fur you!,245,47,13,305,644,3870
It was in tune when I bought it.,238,61,6,305,644,3961
L-l-l-l-l-let's get ready to Rachmaninof-f-f-f-f!!!,228,37,15,280,644,2476
I will now perform Trump's Minuet in F flat minor.,229,35,16,280,644,3237
Thank you.  This next piece floats like a butterfly but stings like a bee.,241,48,12,301,644,821
"Next, a punchy little tune that will ring your bell.",242,46,13,301,644,2916
Sorry.  I only play Bartok.,244,42,15,301,644,3825
A new Sonata called 'Float like a Butterfly and sting like a Bee.,222,42,12,276,644,5390
I dare anyone to say that I am all thumbs.,222,42,12,276,644,5537
"I call it ""Flight of the Pugilist"".",233,57,7,297,644,3142
I should have put more thought into this career change.,218,43,11,272,644,992
"Jetzt, eine kleine Kampfmusik.",218,43,11,272,644,1175
"Ladies and Gentlemen, this part of the score needs to be punched up a bit.",232,52,9,293,644,703
"They told me it was harassment to tickle them, so I have to wear these.",236,44,13,293,644,2132
This next piece was composed by the great Muhammad Ali.,236,44,13,293,644,3802
Fortissimo?  Fortissimo is for lightweights!,234,48,11,293,644,4553
I think you'll all recognize this next little number,230,49,10,289,644,174
It's about playing to your strengths.,230,49,10,289,644,5252
I play like Duke Ellington and hum like a bee!,224,54,7,285,644,1311
"Ladies and gentlemen, a punchy little melody...",227,48,10,285,644,2521
I could of been a contender instead of the bum of pianist I am.,226,50,9,285,644,3403
"And now I'd like to play for you Paul Simon's ""The Boxer"".",207,44,9,260,644,238
You ain't heard nothin yet,208,42,10,260,644,1966
This concert comes as a boxed set,205,48,7,260,644,3302
"Si, let me pound  out a few tunes for you.",225,45,11,281,644,1362
He'd do anything for a hit song,227,41,13,281,644,1723
This next one's going to be a knock-out.,224,47,10,281,644,2184
Whaddya mean it hasn’t been tuned?,232,31,18,281,644,4988
And now my signature THREE SECOND WALTZ.,240,52,10,302,644,3827
Flogging the ivories,206,39,11,256,644,350
This next piece is by Johann Sebastian Box.,222,44,11,277,644,1996
"IT'S OK, I TUNED IT WITH THESE ON.",219,50,8,277,644,2060
"Don't play it again, Sam.",222,44,11,277,644,4267
Please Ma.  I'll never play with myself again.,224,40,13,277,644,4928
This piece is known for its uppercutsio.,239,47,12,298,644,132
"And now for my ""Boxer Rebelion Overture #1",239,47,12,298,644,4655
"Ladies & Gentlemen,
Theme from Rocky 12 in F Major.",256,50,13,319,644,1051
This next piece is in two-fists time.,254,54,11,319,644,3587
I'm doing a Victor Borge!,239,40,15,294,644,788
"The gloves, sir, are to protect my hands.",221,39,13,273,644,4328
For the person who keeps requesting Paul Simon’s “The Boxer”...,235,48,11,294,644,5358
"I call this one ""Sting like a Bee"".",247,54,10,311,644,2659
I float like Chopin and sting like Mozart,233,45,12,290,644,4223
I don't know why I can't hit that last note.,247,47,13,307,644,5128
"For my next song, I will be playing the theme from Rocky I.",230,44,12,286,644,1720
Who tuned this damn thing anyway?,231,42,13,286,644,2923
My next piece will be played on this Steinway that has never been touched by human hands.,228,48,10,286,644,4361
Management wanted me to stop tickling the ivories.,228,48,10,286,644,5031
As an encore I'll now play the Notre Dame Fight Song.,217,33,15,265,644,2358
Now this won't be easy.,243,48,12,303,644,1781
Now for the crescendo!,227,43,12,282,644,4140
"Before I begin, if you are wondering why the boxing gloves, you will find out first if you take a call before this concert ends.",211,38,12,261,644,4486
"Next my own composition,""Mitten on the Keys"".",264,36,20,320,644,3848
I will now play the Mike Tyson sonata no.3 in knocked flat opus 12 round 5.,243,41,15,299,644,3392
"Yo, Tchaikovsky!",223,44,11,278,644,1642
This next composition is written to go nine rounds.,220,50,8,278,644,2206
I am pleased to open tonight’s Masochist Society gala with a special performance of “Flight of the Bumble Bee”.,224,42,12,278,644,2248
It's only available as a boxed set.,221,48,9,278,644,4370
Tonight's performance will be included as part of my holiday box set.,206,41,10,257,644,3555
"You may notice me pounding the keys tonight with a little more punch than usual, folks.",204,45,8,257,644,5667
"And now, from Wagner's Ring Cycle....",223,37,14,274,644,2481
"As you probably guessed, the next piece is the soundtrack from ""Rocky.""",220,43,11,274,644,4057
"Yea, just pounding out a new tune.",220,43,11,274,644,4294
I used to play the violin but I find the piano a lot easier. At least I don’t drop it.,255,40,17,312,644,4603
Adrian!,235,43,13,291,644,385
My guess is this job switch is working out better for me than my partner.,233,47,11,291,644,5455
This next piece is a bit John-Cage-meets-Muhammad-Ali.,217,42,11,270,644,920
"Next, I would like to play my rendition of ""Slaughter on Tenth Avenue"".",247,49,12,308,644,3788
"I will begin with a selection from Beethoven; move to a piece from Chopin, and end with some knockout jazz.",229,48,10,287,644,5014
I was hoping they’d help me hit the right notes.,214,41,11,266,644,2083
"And now my personal rendition of  ""The Boxer"" by Simon and Garfunkel.",242,52,10,304,644,3635
"I said I could play Rachmaninov, NOT Rocky Marciano!",227,45,11,283,644,158
I'd like to dedicate this next song to Simon and Garfunkel.,228,43,12,283,644,287
"I shall now float like a butterfly, sting like a bee.",232,35,16,283,644,4703
Fortissimo!,198,36,11,245,644,913
"And now, The Ring Cycle for Dummies, in twelve rounds.",241,47,12,300,644,1301
...and now:Beethoven's Hammerklavier sonata.,209,44,9,262,644,4549
I just punched out this next piece.,223,46,10,279,644,676
And now for the ever-popular theme from Chitty Chitty Bang Bang ...,224,44,11,279,644,3456
"Sorry, I'm late. My last gig ran long.",194,37,10,241,644,4108
"Please excuse me Ladies and Gentlemen, I’m fighting a cold tonight.",238,46,12,296,644,388
"And the winner by judges decision
after 8 rounds is... Steinway.",238,46,12,296,644,2038
This will sound a little more like a concerto grosso.,249,54,10,313,644,3976
"If you don’t like how I’m playing, come up here so we can discuss it!",219,47,9,275,644,2078
"I will now play the Third Round of the Moonlight Sonata, Presto Agitato.",221,43,11,275,644,3783
This modern stuff is a real pain in the ass.,223,39,13,275,644,4616
It’s a bit gimmicky but I have to pay the rent.,219,47,9,275,644,4766
This will be my first concert in the percussion section.,223,39,13,275,644,5030
"And next, Muhammad Ali's favorite, Flight of the Bumblebee.",238,39,15,292,644,2023
I am just a poor boy ....,230,48,10,288,644,1117
"What can I say? When I play ""The Boxer"" I have to get into character.",232,44,12,288,644,4646
"My next selection will be ""The Death of the Bumblebee>""",245,48,12,305,644,3760
Rocky-maninoff Piano Concerto No. 2 you say?,215,41,11,267,644,1529
"The final piece of the evening is Piano Concerto no.1, in multiple keys, ""Rhapsody in Black and Blue"" by Mr Michael Tyson.
From his Magnum Opus, "" You better clap!""",217,37,13,267,644,4001
This is Sugar Ray Leonard's Piano Concerto No. 3 in C Minor.,217,37,13,267,644,4610
"For my next tune, similar to the first, a bunch of noise produced from banging on the keys.",228,45,11,284,644,2140
I’d like to close with The Boxer by Simon and Garfunkel.,230,41,13,284,644,2691
This last movement is quite the knock-out.,210,44,9,263,644,970
Here's a chord progression within the circle of fists.,216,32,15,263,644,3010
Now I shall play my version of Box Concerto.,226,42,12,280,644,5003
They don't respond well to tickling.....,242,40,15,297,644,433
I give you Rockymaninoff piano sequel III.,207,43,9,259,644,458
"And in this corner, our returning, dueling piano champion",219,49,8,276,644,2217
And for my next knockout performance...,223,41,12,276,644,2785
"And now, Box Prelude and Fugue in C Major.",221,45,10,276,644,3930
And now my rematch with Rachmaninov.,220,47,9,276,644,5124
"Ladies and gentlemen, you'll be glad to know that I'm about to play John Cage's '4'33'.",240,37,16,293,644,1625
My next piece is critic-proof.,236,45,12,293,644,1986
Welcome to the atonal music festival!,219,42,11,272,644,237
I will now play Ode to Ali.,245,50,11,306,644,1945
"Hey, it's like my piano teacher, Mickey, once told me: ""You'll be able to spit notes, kid. You're gonna eat sonatas and you're gonna crap concertos. You're gonna become a very musical person.""",204,42,9,255,644,2477
"And now, from the Manassa Mahler, “The Heavyweight Requiem",231,48,10,289,644,2816
„And now something little more progressive!“,230,50,9,289,644,3160
I thought you said “Box Art of Fugue.”,236,38,15,289,644,5199
Forget Horowitz.  I am the greatest!,219,42,11,272,644,5328
"I promise you, you’ll be instantly hooked.",242,49,11,302,644,110
I went to a prizefight and a sonata broke out.,242,49,11,302,644,1319
"Just so you know, I’m all thumbs.",244,45,13,302,644,1324
I'm going to float like a butterfly on Flight of the Bumblebee.,231,41,13,285,644,709
And now my Rocky overture,231,41,13,285,644,3634
This next song is known for it's hook.,230,43,12,285,644,5419
This next nocturne is scheduled for 10 rounds.,214,45,9,268,644,2204
My final encore: our college fight song,212,49,7,268,644,2681
I can’t eat with chopsticks either.,216,41,11,268,644,3851
'Introducing Baroque-y Balboa',251,54,10,315,644,4685
"Okay, so my dare is to knock out a few tunes.",238,50,10,298,644,286
You should see what I'm wearing below the belt.,237,52,9,298,644,538
"And now, the very challenging LaMotta Sonata in F minor",222,52,7,281,644,1380
You requested Roberto Duran Duran?,225,46,10,281,644,1392
My music packs a real punch.,225,46,10,281,644,1421
"For my first piece, chopsticks.",226,44,11,281,644,1659
"No, this is not a variant of the Suzuki Method; it is pure Tyson.",214,38,12,264,644,296
"This next number I shall now do on you is ""Fight of the Bumblebee.",215,36,13,264,644,4240
And now - my interpretation of a Paul Simon classic.,215,36,13,264,644,5242
"And now, the Mohammad Ali Sonata in G minor.",235,49,10,294,644,1870
It helps me keep a beat.,237,45,12,294,644,3471
"It would be unethical of me to wager, but Las Vegas has it 3:1 for Prokofiev.",224,41,12,277,644,1177
And the beat goes on.,224,41,12,277,644,2999
"And now for something pugilistic, in A minor.",220,49,8,277,644,3490
"As a composer, I have become fascinated with tone clusters.",221,47,9,277,644,4467
"And now, ""Fight of the Bumble, Sing Like a Bee"".",215,29,16,260,644,1901
The ivories tickle me.,211,37,12,260,644,4431
How does the Fight Song go?,198,33,12,243,644,1197
Rachmaninoff always makes me punchy.,233,46,11,290,644,1646
My next piece is the Muhammad Ali arrangement of ‘4’33” ’.,234,44,12,290,644,2026
And now ladies and gentlemen the Ali Fraser concerto,229,54,7,290,644,2894
"Étude No. 1 in A, B, C, D, E, F, and G, by my 18 months old son.",235,42,13,290,644,4554
Okay.  Let's do this one in the keys of ABC and D.,221,40,12,273,644,1716
I think I came to the wrong auditorium.,219,44,10,273,644,2693
"Any Requests? Anything but ""Flight of the Bumble Bee""",246,43,14,303,644,424
I am leaving.  I am leaving.,242,51,10,303,644,533
"Our next number will be a three minute score
titled - Pound of flesh.",228,49,9,286,644,2177
"In the spirit of the times, I'm now going to play a little ditty I've tentatively titled: ""Who Gives a Fuck Anymore?""",233,39,14,286,644,4962
I make no excuses.,213,49,7,269,644,3652
"How thoughtful, she gave me mittens to play  ""Baby it's Cold Outside.""",244,40,15,299,644,962
"Concerto no. 10! 9! 8!, 7!.....",240,48,11,299,644,1187
"Punchdrunk, am I? Keep smiling like that and you'll lose those 88 teeth!""",226,46,10,282,644,18
"Next, I'm going to try to pound out Liszt's Campanella.",227,44,11,282,644,4263
My next song will be a cappella,228,42,12,282,644,4367
This is it. Time to take the kid-gloves off.,251,49,12,312,644,1550
Fortissimo is my forte,213,42,10,265,644,1181
"Say again, Bach or box?",213,42,10,265,644,4165
I will now play... with your expectations.,212,44,9,265,644,4463
"Need a fellow to punch out a party tune? I'm your man.""",236,49,10,295,644,1655
"Yo, Beethoven -- I did it!",233,55,7,295,644,2779
And now Rocky Maninoff’s Suite in 12 Rounds,227,37,14,278,644,840
"It is a sonata for Boxing Day, in B flat.",220,51,7,278,644,1852
"For my next number: Here's Conti's Theme from ""Rocky.""",226,39,13,278,644,3430
Can you please give me a hand?,223,45,10,278,644,4167
Apologies to those who thought they were going to hear Bach.,222,47,9,278,644,5584
"I will now play my tribute to Simon and Garfunkel's ""The Boxer.""
It's a knockout!",250,44,14,308,644,4482
And I thought tying my bow tie was hard!,232,50,9,291,644,1611
"It may sound a little rough, but I'd like to play something new for you tonight.",195,41,8,244,644,1438
That was the 'pianissimo.',243,51,10,304,644,334
A knock out performance of Rhapsody in Black and blue.... all 15 rounds,246,45,13,304,644,5125
Who forgot to tune this piano?,205,44,8,257,644,4117
Sock it to mi?,230,47,10,287,644,2863
"Thank you.  My next piece is ""Piano as Percussion Instrument in 3 Rounds - TOPS!""",220,37,13,270,644,726
I have sensitive hands,243,44,13,300,644,852
I will now play Piano Concerto round 12.,216,45,9,270,644,1068
"I'm more of a ""tackle the ivories"" kind of guy",214,49,7,270,644,1199
"This next piece is titled 'I Could Have Been (a Contender)'.""",246,38,16,300,644,1751
Good evening. Let us prepare ourselves to rumble.,244,42,14,300,644,2121
"And now, a new and different arrangement of Brahm's Lullaby.",194,36,10,240,644,3167
And now I will knock out the rest of the ring cycle,214,49,7,270,644,4260
And now for some improvisational jabs.,213,51,6,270,644,4458
"And now from my modern version of the Nutcracker, here is ""Melee of the Sugar Plum Faries.""",229,42,12,283,644,206
I told the Times critic I would knock the hell out of that Rachmaninoff concerto!,228,44,11,283,644,1518
Are you ready to crescendo?,230,40,13,283,644,4649
"This next number is a heavyweight with an uppercut in D minor Frank Buckley Andover, MA",265,46,15,326,644,453
I'm going to give this baby a pounding.,236,51,9,296,644,323
"This next little number is called ""Float like a butterfly, sting like a bee.""",240,43,13,296,644,899
And now for my next number--The Fight of the Bumblebees.,243,37,16,296,644,4171
I will now float like Madam Butterfly then sting with the Flight of the Bumble Bee.,239,45,12,296,644,4828
Now for my rendition of the theme from Rocky.,212,46,8,266,644,3239
"Hello everybody, my name is Wolfgang Amadeus Balboa.",213,44,9,266,644,5477
"They said if I wanted a raise, the gloves had to come off.",222,49,8,279,644,383
Someone found my privilege and ability offensive.,233,50,9,292,644,3704
John Cage is a dead man.,216,31,15,262,644,811
"Quite frankly, I’ve had quite enough of tinkling the keys",246,47,12,305,644,1013
My last recital ended in a TKO in the sixth round.,221,44,10,275,644,228
And now I will attempt to go twelve rounds with the piano.,221,44,10,275,644,358
This is a new one: Rhapsody in Trump,222,42,11,275,644,2175
"It's my newest composition.  I call it ""Float Like a Butterfly"".",224,38,13,275,644,2433
Who said pound it,221,44,10,275,644,2460
"And now, ""Eine Kleine Kampfmusik"".",267,51,13,331,644,4110
"And now, Round 3.",241,50,10,301,644,1394
Who is my opponent?,241,50,10,301,644,2045
Now I know how the Democrats feel!,244,44,13,301,644,3743
"As a former boxer, I will play the next piece in my favorite key. B flat.",243,46,12,301,644,4827
"Yes, I am a heavyweight musician.",215,49,7,271,644,4475
"You see, the score calls for fortississississimo.",228,46,10,284,644,2152
Uppercut in D Minor aka Straight To The Moonlight Sonata,235,32,17,284,644,5670
"Float like a Puccini, sting like a Rimsky-Korsakov...?",198,30,13,241,644,3410
"Playing Stravinsky is always a battle, but this time I win!",274,53,13,340,644,2778
And now to play the same song softly.,247,54,9,310,644,317
I shall now demonstrate that my piano coach was right.,228,39,13,280,644,1485
"And now, from the masterful soundtrack of Rocky.",225,45,10,280,644,1917
At least I'm not all thumbs!,223,49,8,280,644,1927
Hitting the right notes.,235,48,10,293,644,4440
"You'd wear boxing gloves too, if you slammed your hands in a Grand Piano.",244,53,9,306,644,5163
I will now preform Sting of the Bumblebee,212,41,10,263,644,2742
"And now, for my Jerry Lee Lewis segment.",224,40,12,276,644,922
Hope you like this punchy number.,224,40,12,276,644,5106
I have a request to play the Rocky Theme Song.,231,49,9,289,644,2577
My next piece is by Schoenberg.,235,41,13,289,644,2883
And now for something a bit more light-weight.,239,56,7,302,644,1041
"This one's from ""Rocky: the Musical.""",254,49,12,315,644,3801
Who says I'm not playing it myself?,215,28,16,259,644,4334
Fortissimo Piano.,213,55,4,272,644,1172
Here's the hook.,220,41,11,272,644,4329
Here is my bellicose rendition of Chopin.,229,46,10,285,644,5697
"And now for a change of pace, the Pugilist's Polka.",237,53,8,298,644,2470
Let me punch out a few bars for you.,241,45,12,298,644,3537
Can I skip the black keys?,250,50,11,311,644,2713
I hate encores.,227,43,11,281,644,1060
Rockymaninoff's Rhapsody on a Theme of Pugilism.,231,35,15,281,644,4626
I'll take requests for fight songs,245,53,9,307,644,1497
"For my next number, please prepare to have your socks knocked off",246,51,10,307,644,2203
"My next offering is ""Tempest in a Trump-pot"" in F#*@ Major.",252,39,16,307,644,2596
"Bring it on, Chopin. I'm ready.",249,45,13,307,644,3244
Pugilist or Pianist? You decide.,249,45,13,307,644,4069
"And now, Rocky's Piano Concerto No. 2.",257,52,11,320,644,5008
"Float like Madama Butterfly, 
Sting like an in-flight bumblebee, 
I Am The Greatest,
Since Tchaikovsky",202,40,9,251,644,1071
"I had some minor injuries, but now I'm Bach and better than ever",218,31,15,264,644,3596
"For my encore, a little-known work by Rimsky-Korsakov:  ""Float Like a Butterfly, Sting Like a Bumblebee.""",210,47,7,264,644,4641
It's called 'The Sting of the Bumble Bee.',225,40,12,277,644,1819
"This is my own interpretation of Cage's 4'33"".",222,46,9,277,644,2890
"Beethoven's got two chances, slim and none. And slim just left town.""",235,43,12,290,644,101
"and now, the ever popular 'Mitten on the Keys'",234,45,11,290,644,3001
Anyone else want voice an opinion of my interpretation of the Grieg concerto?,246,44,13,303,644,4805
"For my encore, a little piece from the Pugilistic period.",255,49,12,316,644,5259
"Pound for pound, I'd say Tchaikovsky.",240,49,10,299,644,150
"Now for your enjoyment, ""Take that, Steinway!""",251,50,11,312,644,1799
"And now I will close with the Boxer's Lullaby.""",206,48,6,260,644,2257
This next songs gonna be a real Knockout!,240,49,10,299,644,3401
"Don't feel sorry for me.
Feel sorry for Bruiser; he's boxing with white cotton gloves.",250,45,13,308,644,2376
"This next number is a new piece I wrote, Below the Belt in B-Flat.",240,42,13,295,644,3090
I was advised to attack Schumann’s Toccata in C Major Op. 7!,224,51,7,282,644,96
"I call this “Float like a butterfly, flight of the bumblebee.”",229,41,12,282,644,1050
"For my next selection, I present an avant-garde version of Chopsticks.",227,45,10,282,644,2009
"Float like a butterfly, sting like Flight of the Bumblebee.",225,49,8,282,644,4451
"And now . . . the theme song from ""Rocky.""",227,45,10,282,644,5491
And now for the Box Set?,210,33,13,256,644,2997
"Pound for pound,  the number one pianist in the world.",248,42,14,304,644,868
It’s the theme from “Rocky.”,244,50,10,304,644,901
Let's get rrready to bumble!,248,42,14,304,644,1443
Progressing from the precision of atonal construction....,247,44,13,304,644,1548
I learned this next number from Joe Louis Armstrong.,246,46,12,304,644,3679
No worries...there only two keys,234,47,10,291,644,527
I will now improvise in the French manner.,238,39,14,291,644,5018
"left jab, right cross, left hook, arpeggio.",223,46,9,278,644,4326
Now I’d like to play music from The Ring.,216,37,12,265,644,2468
"And now, with your gracious indulgence, I'd like to bang out a new composition.""",212,45,8,265,644,5162
"I shall now play the timeless classic, ‘Moonfight Sonata’’, by the great Sugar Bee Thoven.",215,39,11,265,644,5645
I intend to knock out this song in very short measure.,213,43,9,265,644,5661
I'm preparing a Boxing Day concert for the royal family.,251,52,10,313,644,2228
This is how I played Rachmaninov's 2nd when I fooled Penn and Teller.,243,45,12,300,644,71
They're so I don't bite my nails.,242,47,11,300,644,3487
"For my final piece this evening, I will be performing Beethoven's Piano Concerto No.5, his 'Emperor,' this time moving away from the sweat style of Sugar Ray Leonard to the awe inspiring stamina and knockout artistry of Rocky Marciano.",229,50,8,287,644,442
"First, Sting like a Bee followed by Float like a Butterfly",231,46,10,287,644,1182
I'll never bet again... never,224,37,13,274,644,3180
I am really going to knock this one out!,220,45,9,274,644,3489
You seen me float like a butterfly - now here's my Flight of the Bumblebee.,214,34,13,261,644,198
This piano murdered my father.,212,38,11,261,644,982
"And now, my new arrangement of “Baby It’s Cold Outside “",247,53,9,309,644,1704
"I doubt that my challenger, Mr. Cage, could last four minutes and thirty-two seconds, let alone thirty-three...",248,51,10,309,644,2156
I've really boxed myself into this corner.,241,42,13,296,644,4265
I can't hold or play chopsticks.,240,44,12,296,644,4309
"Thank you so much.  Next, I'd like to play the theme from Rocky.",239,46,11,296,644,5210
"And now i will perform, the one note samba",236,52,8,296,644,5450
"CHOPSTICKS?
THAT'S YOUR REQUEST?
CHOPSTICKS!",231,39,13,283,644,3006
"It's the only way to play The Boxer Rebellion Symphony in D Flat.""",227,47,9,283,644,4027
The glissandos are killers.,230,41,12,283,644,5381
They call me Beathoven,217,44,9,270,644,952
And now for a lights out encore!,236,45,11,292,644,1446
"And now, my latest composition, ""Blammo, blonk, blonk.""",223,48,8,279,644,2190
"For my encore, I will play the 1812 Overture",222,50,7,279,644,4476
I'd like to close with a medley of Jack White's greatest hits.,213,45,8,266,644,5461
"Next, I shall play a new edition of John Cage's 4'33""....",259,38,17,314,644,2820
Next I will preform a piece composed by Rocky Balboa.,204,40,9,253,644,1631
The next tune is a round.,204,40,9,253,644,3643
"And now, the Rocky theme song.",248,37,16,301,644,1779
The next piece is titled 'Thrilla in Manila.',240,53,8,301,644,5535
Next up: 'Flight of the Stumblebum',231,48,9,288,644,3439
"Sam, don't play it again.",237,36,15,288,644,4126
I would describe my relationship with Debussy as tumultuous.,223,41,11,275,644,153
"Tonight, it's just me versus Mozart.",221,45,9,275,644,2267
Now my classical reinterpretation of Mama Said Knock You Out.,223,41,11,275,644,3548
I can now play five songs at once.,252,45,13,310,644,1632
Now for something a bit more heavyweight,248,53,9,310,644,3265
I'm prepared to knock you out if you ask me to play 'Piano Man' one more time...,238,50,9,297,644,616
Let's get ready to rumbaaaaaaaaaaaaa!,238,50,9,297,644,1233
"eat your heart out, Jerry Lee Lewis",202,37,10,249,644,236
"Ladies & Gents, pardon my candor, but whoever leaves their cell phone on is gonna get slugged.",224,55,5,284,644,2149
"For my encore, I shall attempt to destroy all the BLACK keys!",233,37,14,284,644,3387
"For my first trick, I will be playing Chopsticks.",232,39,13,284,644,4811
This is an atonal rendition,218,44,9,271,644,1763
"For my next performance, “Fight of the Bumblebees” by M Ali.",221,38,12,271,644,5205
"And now for my next number, “Can’t Fight This Feeling.”",214,52,5,271,644,5321
Anybody else want to throw out a request?,207,43,8,258,644,170
"Next, ""Fright of the Bumblebee"".",211,35,12,258,644,552
"And now, for my final piece, The Battle Hymn of the Republic.",233,53,7,293,644,5317
This song's going to be a knock out!,229,38,13,280,644,1150
This number I call “Sting like a bee.”,227,42,11,280,644,4353
You misunderstood I play Box not Bach.,243,49,10,302,644,1572
"And now, the theme from the Boxer Rebellion",220,33,14,267,644,631
"Float like a butterfly, sting like the Flight of the Bumblebees.",215,43,9,267,644,694
This one's simple but it has a good hook.,219,35,13,267,644,5279
"I am just a poor boy 
Though my story's seldom told ...""",235,42,12,289,644,1037
"...and now, my tribute to Rocky Balboa.",238,36,15,289,644,4180
"Currently, Rachmaninoff is winning.",207,36,11,254,644,4632
"And for our finale, the Theme from Rocky in D minor",227,35,14,276,644,2612
"He’s the best at hitting those low notes, for his weight class.",228,49,8,285,644,878
"For my encore, I will play an original piece titled, ""Rush Hour Traffic""",234,37,14,285,644,2654
"And now, for your listening pleasure: the John Philip Sousa rendition of ""Kitten on the Keys"".",230,45,10,285,644,3654
And now for a piece by a exciting new young composer.,231,43,11,285,644,4278
"And now, Duke's Waltz, in D minor, A flat, and C.",222,38,12,272,644,362
"And one, two, one two, one two,",219,44,9,272,644,2068
"Now, to break some hearts.",220,42,10,272,644,4335
"Well Jim, I agree Smith is faster, but he will be conceding over 700 pounds to Steinway.",238,45,11,294,644,4682
"Life is choices and family compromise. My dad wanted me to be a boxer, my mom a pianist, but I just wanted to play the drums.",254,52,10,316,644,1206
I once played this way at the White House. The President said he too played this way - once at Carnegie Hall. He felt he should have received a Grammy for the concert but a liberal conspiracy stole it from him.,212,35,12,259,644,765
Ooooooh.... you meant Bach's piano music?,230,38,13,281,644,4296
And now a piece by TKOkovsky,244,49,10,303,644,587
"Lets just say ""I AM a contender!""",244,49,10,303,644,2271
"And for my next selection, I would like to play Flight of the Float Like a Butterfly, Sting Like a Bumblebee.",249,39,15,303,644,5195
"This next number is called, 'Fight of the Bumble Bees',
feel free to sting along.""",245,47,11,303,644,5613
"And now, Tyson's Sonata in B Minor.",220,35,13,268,644,1703
"Well, it hurts to play Beethoven",238,38,14,290,644,2943
"No, not Fight of the Bumblebee, it’s Flight of the Bumblebee.",251,51,10,312,644,1525
I don’t use the pedal.,250,53,9,312,644,2732
"I shall now attempt to play Box Prelude in C Major""",209,34,12,255,644,4366
"Now, Beethoven's Fifth in the 3rd.",223,45,9,277,644,390
Tonight's Key Player: Rocky Man-in-Off,230,31,16,277,644,558
Glenn Gould playing the Palooka Variations.,226,39,12,277,644,605
I will now play Box Toccata and Fugue,224,43,10,277,644,1109
"I will now play ""Flight of the Muhammad Ali""",225,41,11,277,644,3361
The maître d' just asked me to sit down and pound out a few numbers.,239,52,8,299,644,156
I can knockout this Steinway in three notes....,246,38,15,299,644,2057
This rendition calls for a soft touch.,239,52,8,299,644,3475
And now for Flight of the Bumblebee.,234,39,13,286,644,581
Tonight I will be playing Box' concerto. I may B Flat,235,37,14,286,644,3855
"I shall now play ""Mitten on the Keys.""",214,40,10,264,644,4061
"This piece is to be played ""buone percosse"", which means ""with a good beating"".",229,49,8,286,644,5501
"And now, my Boxing Day Concerto.",232,43,11,286,644,5706
"Next is my original composition, Rocky Balboa Suite.",255,52,10,317,644,347
Piano-fought-e,256,50,11,317,644,3670
"Float like a butterfly, play in the key of B.”",239,45,11,295,644,721
"The following composition, titled 'Mother-in-law,' has a very striking, punchy tone.",240,43,12,295,644,2653
"My next number, is the lost classic ""Gorilla on the Keys'.",239,45,11,295,644,2877
And now my ode to Rocky… mononinoff.,223,38,12,273,644,3138
Don't fight me on this one!,222,40,11,273,644,3669
They make Chopsticks much more difficult.,221,42,10,273,644,5337
The next piece is the Knockout Sonata in B-flat major.,245,49,10,304,644,600
and now for some duke ellington!,230,40,12,282,644,692
This one goes out to the knockout in the corner.,230,40,12,282,644,1433
Well how else am I supposed to express my anger?,209,43,8,260,644,492
"Next, a medley of hits from a little known Stevie Wonder album, 'Songs in the Key of Strife.'",211,39,10,260,644,919
"That tune was from my new album, ‘Mozart on Meth!’",210,41,9,260,644,5036
This next one's got a hook that'll knock you out.,253,49,11,313,644,2920
"And now, to conclude tonight's tribute to Sylvester Stallone,
the theme from 'Rocky.'""",237,42,12,291,644,562
I call this Fight Song.,231,54,6,291,644,4261
When Liberace met John Cage.,219,39,11,269,644,687
"I'd like to play a Paul Simon tune called ""the Boxer"".",220,37,12,269,644,1399
The concert was a knockout,217,43,9,269,644,2467
It's music boxing.,220,37,12,269,644,4548
"It's Box Fugue in G Minor! Hang on, I was just getting to the hook.",218,41,10,269,644,5637
Ten rounds with Mike Tyson in D flat,241,50,9,300,644,3252
"I feel like this method captures more of the emotion, you know?",221,51,6,278,644,3130
"And now, my very own, Raging Bull Concerto in B-flat major.",223,47,8,278,644,3150
"Horace took the Jazz Meistro seriously when he shouted 
""Hit it!""",222,49,7,278,644,4125
In tribute to Ali….”Flight of the Bumblebee”,207,40,9,256,644,4092
...and now a selection from my new boxed set of CDs,232,45,10,287,644,1059
And now... the Joe Louis Suite...,232,45,10,287,644,1450
"The next piece is called, “Requiem for a Pugilist”",229,51,7,287,644,2385
"You should see him play the flute,  amazing",235,39,13,287,644,5188
"Are you sure you want to hear me play the theme from ""Rocky"" again?",210,50,5,265,644,1153
"Alright, who called me a ""pee-anus""?",217,36,12,265,644,3826
My teacher says it will remind me to not hit the keys too hard.,240,45,11,296,644,902
"I call it ""Requiem to a glass jaw""",243,39,14,296,644,3324
"And for my encore, I will  play “The Theme From Rocky!",238,49,9,296,644,3337
A brief announcement: I'll not be holding any punches in this next piece.,262,56,9,327,644,5590
"And now, a Box concerto.",205,37,10,252,644,35
This isn't The Ring I was expecting.,229,44,10,283,644,2246
"And now I'll go a few rounds with ""Chopsticks.""",227,48,8,283,644,4788
I glove a piano,236,46,10,292,644,1089
I’m not wearing any pants.,223,33,14,270,644,250
This evening I will only play octaves,217,45,8,270,644,912
This Concerto may seem a little modern for some.,223,33,14,270,644,1579
I couldn't decide between sports and music,218,43,9,270,644,3563
"The night he realized ""Put Up Your Dukes"" wasn't coined after Duke Ellington.",217,45,8,270,644,4427
"And now, as counterpoint to Beethoven's ""Moonlight"",  here's a sonata with some punch.",242,50,9,301,644,2325
"And for my next number, the theme from ""Raging Bull.",241,52,8,301,644,3561
And so to start of my Boxing Day concert...,245,44,12,301,644,3693
My next piece is Ali in C minor,228,39,12,279,644,446
Improvisation is the key.,225,45,9,279,644,518
"Ladies and gentlemen:  Counterpunch was Bach's specialty, as I shall now demonstrate",234,43,11,288,644,1867
"As you may have surmised...No, I,don’t have insurance for my hands.",234,43,11,288,644,4539
"And now ladies and gentlemen -
Let’s get ready to Rumble!!!!",211,34,12,257,644,2215
Any requests for tunes you want me to bang out?,237,53,7,297,644,2836
"And now, may I present, Rocky the Musical",244,39,14,297,644,2987
"It may be unconventional, but it is the first Mozart-meets-Muhammad-Ali performance I know of.",213,46,7,266,644,2562
Who requested Wagner’s Ring Cycle?,226,36,13,275,644,865
"...and now, I will punch it up a bit with the Anvil Chorus.",221,46,8,275,644,1076
"Concerto in Gloves hits all the right notes and most of the wrong ones, too.",223,42,10,275,644,5364
"My next selection is ""Eye of the Tiger""",256,47,12,315,644,4594
I find this is the safest way to perform the “Nutcracker”,231,42,11,284,644,2491
"For my next number, I will sting like a bee.",209,31,13,253,644,1209
And for my final work I give you Box Toccata and Fugue.,206,37,10,253,644,2837
"I call this next piece ""Float like a Butterfly, Flight of the Bumblebee.""",240,40,13,293,644,2921
"I will now play the theme song and other songs from 'Rocky'""",216,49,6,271,644,155
Oh! Not the fight of the bumblebee?,222,37,12,271,644,3789
"And now, Chopin with the gloves off....",227,43,10,280,644,806
This next song will knock your socks off!,261,46,13,320,644,2582
"And in this corner, The Challenger, Rachmaninoff Concerto No. 3--AREYOU READYTORUMBOOOOOOOOOOOL?",235,43,11,289,644,366
"Hecklers, beware!",233,47,9,289,644,3079
"If you will,a Rachmaninoff/Ali variation: Float like a butterfly,sting like a bumblebee.",239,51,8,298,644,1254
"Now, Mozart’s Piano Sonata No. 20 in B-flat major, TKO.548",240,49,9,298,644,4453
We start on the downbeat after a standing 8 count.,216,42,9,267,644,654
My next tune is ‘The Boxer’ by Simon and Garfunkel...,214,46,7,267,644,2067
You said to ‘make it punchier.’,257,47,12,316,644,4904
"And now ""he Theme from Wagner's ""THE RING""",230,30,16,276,644,991
This next event will consist of ten three-minute rounds.,221,48,7,276,644,3179
Watch and listen while I pummel the hell out of this thing.,224,42,10,276,644,3441
Let me try that again in G major.,224,42,10,276,644,3772
Flight of the bumblebee. Ohooo Kay.,227,36,13,276,644,5698
"And now, my version of Chopsticks.",231,44,10,285,644,473
"And now, a preview of the theme from Rocky VIII . . .",231,44,10,285,644,2573
"What? I thought I was supposed to play ""The Boxer""...",232,42,11,285,644,4054
And this next song is really a knockout....,231,44,10,285,644,4084
The next is a cross between Ali and Amadeus!,240,42,12,294,644,829
"My arrangement of the the new ""13th DAY OF CHRISTMAS"":  BOXING DAY!!!",241,40,13,294,644,1674
"A sacred performance of the Boxing Day classics “O Come All Ye KO” “Ring-Side Bells”, and “All I Want For Christmas Is My Two Front Teeth”.",241,40,13,294,644,3011
"And now, a Box Sonata",240,42,12,294,644,4856
Isn't this a dueling piano bar?,237,48,9,294,644,5380
"You will hear a combination of the 1812 Overture, and the Nutcracker Suite........",207,37,10,254,644,1990
I really hate this song.,208,35,11,254,644,2915
And now let me conclude with some  Beathoven.,216,35,12,263,644,4687
"And now, the Ring Cycle!",222,39,11,272,644,3834
And now for my Post-Modern interpretation of Philip Glass,219,45,8,272,644,4717
I hope you like the opening of Beethoven’s Fifth.,223,37,12,272,644,5405
"So you see, it's easy to hit the right note.",265,56,9,330,644,3020
And now for some of my Boxing Day favorites! Let me punch out a few tunes for you.,229,41,11,281,644,1509
You did say that you would box my recordings for Christmas!,225,49,7,281,644,3432
Just a brief encore... I have to get across town before the bell for the opening round.,229,41,11,281,644,3484
1-2-3-Hit It!,229,41,11,281,644,3861
The doctors said it couldn't be done.,229,41,11,281,644,4269
"For my next number, the theme from ""Rocky II.""",239,37,14,290,644,377
"The theme song from Rocky, why?",236,43,11,290,644,1578
He’ll be out by the 10th bar.,234,47,9,290,644,3872
Oh my story’s seldom told,242,47,10,299,644,5121
"This is the best way to play ""Louie, Louie"".",251,45,12,308,644,3406
Life of an artist is a constant battle,213,50,5,268,644,4658
"I'd like to play for you a sonata composed by Chucky, my golden retriever.",228,36,13,277,644,2792
Allow me to punch something out for your listening pleasure.,219,54,4,277,644,5355
Ladies and Gentlemen...The Concerto For The Nail-Biter in D-minor,230,48,8,286,644,2542
"And now I will bang out my number, 'Love is a battlefield.'",239,46,10,295,644,422
I can turn them into black and blue keys.,237,50,8,295,644,4699
"Not without the secret fingerholes, I can't!",253,34,17,304,644,1919
No refunds,248,60,5,313,644,1508
Tickling time's over.,222,41,10,273,644,343
"The day after Christmas, Harold was obviously confused.",224,37,12,273,644,349
"For the next prelude, the sheet music's dynamic said combattivissimo.",223,39,11,273,644,5013
My next piece is Mozart's Sonata in B flatten major.,230,41,11,282,644,1102
Now for my feisty version of Brahms's 'Lullaby.,232,37,13,282,644,3118
"I'm gonna knock out this tune so badly, you won't even recognize it by the time I'm done !",229,43,10,282,644,3540
"I guarantee tonight's performance will be a knockout.""",231,39,12,282,644,3813
"This piece is titled, ""Eye of the Tiger in B, C, D, G, and F.""",230,41,11,282,644,4282
So you’re not fans of avant-garde...,226,49,7,282,644,5211
Let's get ready to ready to rumble!,237,43,11,291,644,1712
"Mom, I'm having that bad dream again where they announce I'll be playing, 'Fight Of The Bumblebee.'",234,49,8,291,644,3170
"For the first round, I shall play Chopsticks.",241,35,15,291,644,3880
"Next, I'll be playing ""Great Balls of Fire """,237,43,11,291,644,3909
A few more sonatas and I will have Beethoven on the ropes.,237,43,11,291,644,4851
"See dad where  ""pounding the keys"" got me!",217,44,8,269,644,861
"As a matter of fact, I was somewhat suspicious when my manager referred to this gig as ""undercard.""",233,44,10,287,644,93
"Adrian, my music.",234,42,11,287,644,1072
Not to worry there is only one large ebony and one large ivory key,233,44,10,287,644,3494
"My left hook is quite sharp, but my right jab is flat",234,42,11,287,644,5504
The odds in Vegas are 25 to 1 that I defeat the piano.,237,52,7,296,644,2614
"Oh, you wanted something by the Bachs?",241,44,11,296,644,3280
I’ll knock out a few rounds for you now.,243,40,13,296,644,3486
I thought it should sound more bombastic.,238,50,8,296,644,3680
You guys like “Chopsticks”?,251,40,14,305,644,4593
Now for a demonstration of late 20th century classical piano compositions.,217,37,11,265,644,1543
"This next piece is called ""Two gloves on eighty-eight keys"".",214,43,8,265,644,1932
...and attempting to play Sonata No. 14 WHILE sanctioned by the Nevada State Athletic Commission...,214,43,8,265,644,3227
"Heckle me one more time and I swear you're going to be the one ""off key"".",225,37,12,274,644,1994
And now....my homage to Simon and Garfunkel.,231,41,11,283,644,1099
And now Knockout in B flat minor.,238,43,11,292,644,1597
I just can't fight this feeling anymore.,235,49,8,292,644,4009
"If you please, let us now prepare ourselves to Rumble.",240,39,13,292,644,4564
"As requested, I will now play The Boxer.",252,47,11,310,644,588
I believe I left an order for the piano with the very large keys.,251,49,10,310,644,4825
And now I shall play the theme from Rocky.,248,48,10,306,644,124
"And now “The Boxer,” by Simon and Garfunkel.",241,46,10,297,644,762
I'm thinking outside of the boxing ring.,249,46,11,306,644,987
Just sayin' The Boxer would have peaked higher than seven on Billboard's Hot 100 if Simon and Garfunkel had thought of this.,239,50,8,297,644,1346
"For my next piece, ""Rocky"" in D minor.",226,44,9,279,644,1513
Next piece is for the Poughkeepsie “his Beethoven lacked punch” Times-Herald.,221,38,11,270,644,1610
"…and now, I’d like to perform Sugar Ray’s Piano Concerto No. 2 in F Minor.",242,44,11,297,644,2138
"Oh no, I forgot the sheet music!",211,42,8,261,644,3013
"For my next piece, ""Great Balls of Fire"" by Jerry Lee Lewis.",234,44,10,288,644,3808
"And now, Mike Tyson’s favorite sonata.",251,42,13,306,644,4693
You cannot force an individual to succeed in something when their heart is desiring another.,235,42,11,288,644,4824
And now I will play something soft yet powerful.,221,38,11,270,644,5064
"Millenials are tone-deaf to high culture, so what does it matter?",255,43,13,311,644,2528
"Next,  I will play Float Like a Butterfly, Sting Like a Bee by Cassius Clay",232,41,11,284,644,2396
"For my next selection, the prelude to We Will Rock You.",228,49,7,284,644,4359
I guess I'll roll with the punches.,228,49,7,284,644,4718
"And In This Corner...""The Well Tempered Clavier"" by J.S. Bach",215,43,8,266,644,1432
And now I will perform the newly-discovered very last symphony composed by Beethoven when he was both deaf and blind.,216,41,9,266,644,2331
Be ready for something different.,254,54,8,316,644,60
"This next piece is ""Etude in B-flat"" by Joe Lewis.",251,44,12,307,644,761
My next selection is Flight of the Bumblebee.,242,46,10,298,644,3366
And we'll conclude the evening with a knock out medley from the  Lord of the Rings soundtrack.,237,40,12,289,644,2261
"For my next piece, I shall work the body, relentlessly.",235,44,10,289,644,3684
"Everybody now! 
'...float like a butterfly, sting like a bee...
My name is Muhammad... Muhammad Ali!!!'",239,36,14,289,644,3912
This is nothing.  Try using chopsticks to eat with these things on!,237,40,12,289,644,4728
I have to go to the bathroom.,230,38,12,280,644,3582
"And for my encore, I'll be playing the finale to ""The 1812 Overture"".",229,40,11,280,644,4051
Dang.These talent contests are brutal.,229,40,11,280,644,4384
I can easily cover 2 octaves this way.,220,42,9,271,644,649
Let's see if you can stand me for 12 rounds.,211,44,7,262,644,997
I'd like to thank the Mike Tyson Foundation for commissioning the next piece.,213,40,9,262,644,1409
Common time?! I only know the ole' one-two!,245,49,9,303,644,896
"And now for ""Float like a butterfly, sting like the flight of the bumble bee.""",233,41,11,285,644,1545
"And now I'd like to play the theme from""Rocky """,233,41,11,285,644,1803
"You've just heard me float like a butterfly. Now, listen as I sting like a bee.",231,45,9,285,644,5366
Next up: Mozart and Salieri's piano concerto collaboration,233,41,11,285,644,5519
if someone boos’s one more time you’re gonna get it,226,39,11,276,644,781
...and now I'd like to play a selection from the concerto for piano and boxing gloves in the key of whatever.,226,39,11,276,644,2484
I feel like my current job is boxing me in.,226,39,11,276,644,3144
And now I take the gloves off and play a mean Chopin.,212,35,11,258,644,1425
I usually have a sheet music page turner.,260,44,13,317,644,2497
"Elton, Wednesday night is NOT alright for fighting.",252,44,12,308,644,290
Piano Concert on Boxing Day.,238,40,12,290,644,2488
"Trump being an ineffective president produces a most disharmonious effect, the same as playing a piano with boxing gloves on.",240,36,14,290,644,3201
"""Ali never had to play the piano.""",236,44,10,290,644,4566
I will just punch out a few tunes  for you,226,48,7,281,644,2678
His symphonies really pack a punch.,217,50,5,272,644,211
Let's see you try to 'beat it eight to the bar' with these damn things.,214,40,9,263,644,1980
I'll punch it out!,213,42,8,263,644,2428
"And now, Concerto in C Minor by the great Rocky Marchiano.",205,42,7,254,644,2505
Ladies and Gentlemen...Let's get ready to rhumbaaaaaaaaa!!!,205,42,7,254,644,2880
At this point I can only play the Rocky theme.,239,47,9,295,644,1879
"What I said was, I could outplay you with one hand tied behind my back...!",230,49,7,286,644,3982
"And now, a largo in fall flat.",234,41,11,286,644,5276
"Somewhat shatters the illusion, don't you think?",227,39,11,277,644,2225
"And now, another of Box cantatas...",230,33,14,277,644,3356
My next selection is Rope-a-Dope in C Major.,219,39,10,268,644,188
"And for my encore this evening, I give you ""Fight of the Bumblebee"".",211,39,9,259,644,82
"For my encore,I wish to play the beloved piano solo,Chopin's ""SP'ZJMVPOIALKNCV38XSLAEADSNZKSX.""",239,40,12,291,644,5406
"So many times, it happens too fast. You trade your passion for glory.",228,46,8,282,644,356
My manager said I needed a knock-out tune.,230,42,10,282,644,520
pianissimo,229,44,9,282,644,859
"On now, next on the program: Box Well-Tempered Clavier",222,42,9,273,644,5060
88 Keys to Anger Management : “#1: instead of tickling the ivories beat them to a pulp”.,214,26,15,255,644,3935
It's called Rhapsody in Gloves,240,47,9,296,644,4527
"For the Scriabin, the gloves come off!",237,37,13,287,644,152
Rachmaninov is merciless. So am I.,234,43,10,287,644,2981
Now I Will Play My Opus Trumpus.,234,43,10,287,644,3145
Did you say forte or fortissimo?,201,36,9,246,644,3341
Do I hear another request for “Eye of the Tiger?”,237,37,13,287,644,4916
Now a surprise treat -- a little composition I wrote as a ham-fisted beginner.,231,49,7,287,644,5654
This piece is dedicated to Muhammad Ali.,262,44,13,319,644,1837
"And now, Michael Jackson's ""Beat it.""",218,43,8,269,644,5626
No. I can’t play “Flight of the Bumblebee.”,239,42,11,292,644,2411
Next I will perform for you one of the lesser known piano compositions by the legendary John Cage.,239,42,11,292,644,3431
"And now, my latest composition, 'Glissando Waltz'.",230,44,9,283,644,1166
I call it Rocky 'n' Roll.,234,36,13,283,644,2344
How about a little Duke Ellington?,231,42,10,283,644,4324
Tickle the ivories? More like pummel 'em.,229,46,8,283,644,5458
"Next, I will get out of this piano all that I can.",259,43,13,315,644,910
"Theme song from ""Rocky""? Sorry, I don't know that one. Any other requests?",222,44,8,274,644,531
This original composition will really knock you out.,220,48,6,274,644,683
"Bored silly by my insane virtuosity, I’ve taken up concert pugilism.",224,40,10,274,644,2172
"Does it start...Ba,Ba,Ba,BOOM!",215,42,8,265,644,1378
and now a litta numba I pound..it's called Lights Out...,246,37,14,297,644,2929
I thought this was a dueling pianos bar.,242,45,10,297,644,4754
And now I'd like to perform Beethoven's Pugilist's Polka in the key of ABCDEFG.,239,35,14,288,644,2818
"Oh, so you meant handle with 'Kid gloves?'",207,42,7,256,644,3686
And now I shall play the Flyweight of the Bumblebee.,237,39,12,288,644,4050
Hit 'em with the old one an' a two...,224,49,6,279,644,162
This next number is from Ali's 'The Ring Cycle'.,227,43,9,279,644,3230
Wait until you heard it.,227,43,9,279,644,4740
I  shall now play Chopin's Minute Waltz in ten seconds. It's a Knock Out!,246,46,10,302,644,3721
"Now, I will fight through Schumann’s Toccata in C Major Op. 7.",244,50,8,302,644,4197
"When I'm through with it, it'll be a mini grand piano.",221,39,10,270,644,2947
"I will now perform my masterwork:
Piano Destruction in D",217,47,6,270,644,2984
Be-Bop,236,50,7,293,644,1821
"I call my next composition,""TKO in A Minor.""",240,42,11,293,644,3651
"This next piece I am going to play for you this evening is a ""real knockout"".",235,36,13,284,644,511
I bite my nails before I play and these help me to stop.,233,40,11,284,644,3059
"For my next song, a piece played solely on black and blue keys.",231,44,9,284,644,3617
My next piece is “Punchinello” in B flat.,232,42,10,284,644,5139
"Now, this piece must be played with a one-two punch.",230,46,8,284,644,5610
My teacher said I had to fight to make it to the top!,226,38,11,275,644,5348
"And a left, and a right, and a left right left right.",240,51,7,298,644,2115
My critics say I can never hit the right key...,249,33,16,298,644,5063
"For my last number, Mozart's Sonata in D TKO.576",202,29,12,243,644,3708
Any requests or should I just F you up?,263,46,12,321,644,706
"Welcome to the premiere performance of 
the Boxing Ring Cycle.""",238,39,12,289,644,1997
"I'm sorry sir, that's not possible. I'm wearing boxing gloves.",239,37,13,289,644,3875
"And next, I'll play cxlaeirr dfee lyunme.",239,37,13,289,644,5596
Bach's...ing gloves,257,42,13,312,644,4537
"My next selection is, Beat me daddy eight to the bar.",231,37,12,280,644,109
Tonight we will be beating out Beethoven's 5th.,227,45,8,280,644,4406
I will now pound out my last tune.,249,42,12,303,644,1998
"And now, excerpts from The Ring, by Sonny Liszton.",221,41,9,271,644,771
If he doesn't C sharp he’ll B flat.,223,37,11,271,644,825
This next piece is “Beethoven’s Fists in A Minor Fight”.,262,41,14,317,644,3415
Can I start again?,213,41,8,262,644,3923
"Don't worry ladies and gentlemen, I'm just the undercard.",233,42,10,285,644,1061
"And now, without further ado, let us bid a final farewell to the jerk first violinist.",236,36,13,285,644,1757
"My parents always called it banging, so here it is!",233,42,10,285,644,1786
But I have bone spurs in my hands!,233,42,10,285,644,1891
Contrapunto on a Divorce,224,44,8,276,644,763
Know it?? I wrote it!!,224,44,8,276,644,1858
"And now, ""The Well-Tempered Clavier,"" by Johann Sebastian Box.",230,32,14,276,644,3437
This next one is a bit heavier...,245,43,11,299,644,3901
which one of my arts have you come to see?,239,39,12,290,644,436
Welcome to Full Contact Sonatas.,240,37,13,290,644,3261
"I shall now perform my rendition of LL Cool J's ""Mama Said Knock You Out""",237,43,10,290,644,4540
Was that Box or Bach ?,219,38,10,267,644,1358
"And now a piece by our esteemed conductor, Michael Tyson Thomas.",217,42,8,267,644,2817
"And now, for the main event, the ""Hammerklavier"" Sonata.",218,40,9,267,644,3711
I call it the Boxing Day Concerto.,216,44,7,267,644,5207
"And now, a little thing called ""One Note Samba.""",250,42,12,304,644,1675
I told you that I was a pianist not a pugilist!,247,48,9,304,644,3571
"Pound it once, Sam. For old times' sake.",227,47,7,281,644,319
"And now, the Marquess of Queensbury Symphony.",209,42,7,258,644,814
what?   you said we were doing rounds...,220,45,7,272,644,3313
I punched out this next piece earlier today.,228,54,4,286,644,147
"...and in this corner, we have C#.",237,36,13,286,644,5104
"I'm pounding the keyboard, like you asked.",214,41,8,263,644,696
These are perfect for BACHsing!,213,43,7,263,644,4893
"I'm happy to take requests, Madam, but Chopsticks is off the table.",227,40,10,277,644,1286
"l""My piano style is to float like a butterfly and sting like Ali.""",256,48,10,314,644,218
"And now, Rocky's Fifth Symphony in Creed major.""",208,37,9,254,644,595
This fugue is a knockout.,239,41,11,291,644,1955
I'm a bit out of practice so I'm just gonna roll with the punches.,238,43,10,291,644,4930
Good evening.  I'm Rocky Marcipiano.,220,38,10,268,644,2841
A funny thing happened on my way to the concert you all paid a lot of money for .....,218,42,8,268,644,3083
"Pyotr Pavlosky, Pugilist Pianist",248,48,9,305,644,4512
I hope no one notices that my socks don't match.,231,41,10,282,644,3155
I will now knock out 'The Theme From Rocky' for you....,232,39,11,282,644,5601
It was try this or brain surgery,256,57,6,319,644,2927
"And now, I’d like to play my new composition, the Rocky Balboa Piano Sonata #5.",240,48,8,296,644,1922
I feel as though my career is at a crossroads.,244,40,12,296,644,4523
This one is a punchy number,238,52,6,296,644,5299
"And now ""Mama Said Knock You Out"" in G minor.",256,41,13,310,644,4837
"Believe me, this is for your own good.",234,44,9,287,644,1002
Maestro - sote voce please.,231,50,6,287,644,1081
The Boxer”? Don’t know that one,235,42,10,287,644,1258
"And now, the viral ""Piano Cat"" arranged for a human",238,36,13,287,644,1701
I am also a great lover.,235,42,10,287,644,3535
I'm taking requests.,234,44,9,287,644,3863
"And for my encore I will play ""The Fight of the Bumble Bee.""",248,41,12,301,644,2019
"Now for the percussion crescendo, molto allegro",214,43,7,264,644,3121
The next movement has many sharps.,229,38,11,278,644,805
I'd rather punch a clock.,228,40,10,278,644,3470
Next I will punch out an original tune,238,45,9,292,644,282
"Lie-le-lie, Lie-le-lie-lie-lie-le-lie, Lie-le-lie, Lie-le lie-lie-lie-le-lie, Lie-le-lie-lie-lie ...""",240,41,11,292,644,5214
"Yo, Beethoven.",252,42,12,306,644,105
"Jolly good Boxing Day recital, isn't it?",247,52,7,306,644,5603
"This next one goes out to my good friend, 'Sly"" Stallone!",261,49,10,320,644,4868
"And now, a selection by Beat-hoven.",231,43,9,283,644,1330
"I always say folks, 'float like a butterfly, sting like a Flight of the Bumblebee.'",236,33,14,283,644,4570
"Float like a high C, sting like a C#",231,43,9,283,644,5057
"Mike Tyson, this one's for you.",243,44,10,297,644,52
"Pianissimo enough for you now, Maestro?",213,38,9,260,644,958
You got a problem with that?,213,38,9,260,644,1162
I get punchy before a performance.,224,41,9,274,644,1690
"I call it ""Float like a butterfly sting like flight of the bumblebee.""",235,44,9,288,644,2706
"And now, an old Simon & Garfunkel favorite ...",236,42,10,288,644,3354
"My sonatas are impetuous, my concertos are impregnable, and my etudes are just ferocious.",205,38,8,251,644,3357
I will now play for you Frédéric Chopin's Nocturne in C-Sharp Minor featuring a right uppercut-left hook combination.,218,37,10,265,644,3429
"For my next selection, ""Fight of the Bumblebee""",215,43,7,265,644,5048
Helps keep the beat.,228,42,9,279,644,363
My next piece is the theme from the 'Rocky' movies.,229,40,10,279,644,407
I only heard play Rocky not Rachmaninoff.,226,46,7,279,644,2517
I'll just roll with the punches.,238,47,8,293,644,497
I'm a little punchy.,265,43,13,321,644,1634
"If you liked the last one, you should like this one too.",188,31,9,228,644,656
"Ladies and Gentlemen, put your hands together for our latest sensation, Beat-hoven!""",198,36,8,242,644,4919
Oh SRO? I thought they said TKO.,209,39,8,256,644,505
My manager thinks I need something to fall back on.,207,43,6,256,644,3703
Sure. I'm a concert pianist; but I like to punch out a little jazz on the ivories just as much as the next guy!,218,46,6,270,644,4233
"And now, my introduction to contemporary music, 101",235,37,12,284,644,1933
"And now, something a little more lively.",232,43,9,284,644,3114
I’m sure the ad said pugilist wanted...,233,41,10,284,644,3911
"Next I will play a piece from LL Cool J: ""Mama Said Knock You Out"" in F#m",229,49,6,284,644,4631
"So far, I can only play the first eight notes of Beethoven's Fifth Symphony",244,44,10,298,644,2087
"Tonight I will  be performing ""Eye of the Tiger"" in D# Major",241,50,7,298,644,2197
Thanks... I get Billy Joel a lot!,246,40,12,298,644,3043
Bom	Bom 	Bom	Bommm!,243,46,9,298,644,3317
I’m a Bachser by trade.,265,52,9,326,644,261
You'll have to forgive me if my Bachsing is a little Rocky.,225,41,9,275,644,2221
"Any other beatboxers in the audience, tonight?",225,41,9,275,644,4299
Box Toccata and Fugue has been requested.,238,40,11,289,644,1074
"I dedicate this song to Mrs. Shirley Abercrombie, who sent me packing from this keyboard, sobbing, 'Never again Jimmy!'",236,44,9,289,644,4136
"And in the red corner, weighing in at 165 pounds, hailing from St Petersburg, Russia... Dmitri Shostakovich!""",249,43,11,303,644,5085
Liberace's Nightmare,260,46,11,317,644,3640
"Next, a smashing transcription of The Ring Cycle.",195,35,8,238,644,2790
"For my next piece, I will play 'Great Balls of Fire.'",235,55,4,294,644,2878
"Sorry, I can't perform tonight, this piano is out of tune.",228,44,8,280,644,3092
This next one is experimental but it got a lot of hits online ...,239,47,8,294,644,3156
"And now, Bach's Concerto in C # or B ♭.",228,44,8,280,644,3447
I'm now going to play Beethoven's Fist Symphony followed by a Bop cantata.,242,41,11,294,644,3767
Rocky the Musical,242,41,11,294,644,4133
"For my next selection,I will play ""The Flight of the Bumblebee"".",230,40,10,280,644,4910
"To begin,I'd like to punch out a concerto by Bach.",253,44,11,308,644,5131
His playing was a bit Rocky...,221,33,12,266,644,5577
I will now play “Bust You in the Chopsticks.”,235,39,11,285,644,397
This next piece is by Simon and Garfunkel.,234,41,10,285,644,3754
"My next piece will be ""Float Like a Butterfly, Sting Like a Bee,""",234,41,10,285,644,4620
"And now for a little number called ""Punch Drunk"".",219,46,6,271,644,3041
And now my version of Paul Simon’s “The Boxer.”,216,52,3,271,644,5034
Must be how Trump attempts to play pianissimo,214,31,12,257,644,2858
"As an encore, I pound my way through some Liszt!",263,42,13,318,644,3507
"And now, 'Mars the Bringer of War' by Gustav Holst.",250,43,11,304,644,1934
"It’s my brother’s idea. I love him. 
But don’t expect much.",238,42,10,290,644,2004
"I've heard of tickling the ivories, but punching the ebonies?",239,40,11,290,644,3550
And now I will fight the piano.,240,38,12,290,644,3928
"I told you, I'm a pugilist.",237,44,9,290,644,5126
Beethoven's Pugilistica Sonata in B-Flat!,227,39,10,276,644,4964
Symphony in flat accidentals!,241,45,9,295,644,2183
"This next piece is entitled “float like a butterfly, sting like a Beethoven”",244,39,12,295,644,3513
J.S. Box  prelude and fugue in b minor.,230,42,9,281,644,2944
"For my next selection, I would like to play ""Fight of the Bumblebee.""",220,37,10,267,644,1521
"The Pizzicato Polka, performed pugilistically.",221,35,11,267,644,1522
I'm just punching keys,216,45,6,267,644,1741
"While I'm confident this will relieve some of the violence of the Rachmaninoff, I fear something essential may be lost.",217,43,7,267,644,4535
This is Chopin’s Knockout in E minor.,208,36,9,253,644,4605
You think it's easy to play this way ?,235,41,10,286,644,3746
I’m trying to beat out a tune.,221,44,7,272,644,4012
"Next, Schumann’s Tocatta—mezzo forte.",227,32,13,272,644,4490
"Chopsticks, please....",254,37,14,305,644,2427
"Believe me, ladies and gentlemen, you will be grateful.",249,47,9,305,644,2952
Now for the Flight of the Bumblebees in Colony Collapse.,238,44,9,291,644,1309
"I shall now play float like a butterfly, sting like a bee",229,37,11,277,644,5095
In case I get booed.,226,43,8,277,644,5302
I’m sorry; all I can play is Simon & Garfunkel’s “The Bóxer.,217,36,10,263,644,1161
These ivories are extra ticklish.,254,46,10,310,644,2719
It keeps my playing punchy.,250,54,6,310,644,5130
It’s last call and I got a request for Nickelback. You kinda just have to roll with the punches.,202,41,6,249,644,5281
"I call this piece ""All the Wrong Notes"" which uncannily makes it all sound right.",240,49,7,296,644,2000
And now for something that's tough to play ...,243,43,10,296,644,5233
Nobody could hold a candle to Ol' Sugar Ray Tchaikovsky.,229,46,7,282,644,2485
"Piano? Why, no, I'd never lay a glove on it.",229,46,7,282,644,3263
The told  me I was playing a boxed set.,232,40,10,282,644,4076
I would like to welcome everyone to the Muhammad Ali Memorial Concert...,229,46,7,282,644,4100
And now the entire Rocky score through Creed 2.,230,44,8,282,644,4617
"For my next little number, the theme from Rocky.",232,40,10,282,644,5033
These are the most ticklish ivories I've ever seen.,229,46,7,282,644,5096
This next concerto is dedicated to tonight's sponsor - The School for the Deaf,227,25,16,268,644,1617
For those who are sitting ringside—the theme from 'Rocky'.',234,45,8,287,644,4291
I think this piano needs tuning.,239,35,13,287,644,4602
"And now, C minor in 12 rounds.",253,41,12,306,644,3899
"No, please. Not ""The Boxer"" again.",213,37,9,259,644,4947
I've been asked to tone it down.,240,42,10,292,644,994
Any requests APART from Flight of the Bumblebee?,241,40,11,292,644,3673
Ok....so I'm not known for my delicate arpeggios.,225,47,6,278,644,2815
Did I miss the punchline?,233,31,14,278,644,4792
"Up next, Eye of the Tiger.",253,50,8,311,644,1066
"I know — I could’ve been a contender, instead of a piano player .  .  .  which is what I am",253,50,8,311,644,5184
"It's ok, I'm the undercard.",244,43,10,297,644,1083
"Oh, the other Rachy?",244,43,10,297,644,1598
"Merry England, holiday time, Boxing Day concert.",214,44,6,264,644,5701
Tonight my concerto for the left hook.,259,47,10,316,644,4524
Now I will perform Rocky Balboa's Ringside rhapsody in g-flat minor.,231,44,8,283,644,723
"Well, this explains the tux.",233,40,10,283,644,4577
"And now, the grand finale: Chopsticks.",233,40,10,283,644,4784
"I will now play ""Gonna Fly Now"" as it was originally composed by Rocky Balboa.",248,44,10,302,644,633
"Next is a little diddy I call, ""TKO"".",219,43,7,269,644,760
"And in keeping with tonight's authentic concert series,  here's an old Simon and Garfunkel hit...""The Boxer..""",222,37,10,269,644,1877
"For this next piece, I got my inspiration from Jerry Lee Lewis.",223,35,11,269,644,3168
Time to knock them out with my Mozart,219,43,7,269,644,3581
"Float like a Satie, Sting like a Stravinsky",222,37,10,269,644,3807
"Preparing to play ""The Boxer""",261,52,8,321,644,601
Do I hear a request for “The Theme From ‘Rocky’?,238,39,11,288,644,116
Here's my fortissimo crescendo without breaking a mano.,236,43,9,288,644,2130
For my next selection: Chopstick,240,35,13,288,644,5262
My dermatologist says I need to stop scratching my eczema.,254,41,12,307,644,4215
Please wait until the end to tweet your reviews.,224,42,8,274,644,2085
And now a prelude in C minor by Rocky Balboa,269,45,12,326,644,1479
"And now, Marciano's First Sonata, traditionally performed as a round.",242,40,11,293,644,201
"And now, here to play the theme song from ""Rocky""...",241,42,10,293,644,554
I will now play “Chitty-Chitty Bang Bang”.,240,44,9,293,644,3269
"Next I shall play Mozart's Piano Concerto No. 21, K.O. 467",239,46,8,293,644,4067
And now....Anyone care to dispute my abilities in B Flat?,229,41,9,279,644,1582
"Yes, I was the star of the 1939 movie Golden Boy. And yes, I was very musical. But I always wanted to be a boxer. Any other questions?",244,45,9,298,644,4037
Really? I thought this was how Thelonious Monk got his sound.,247,39,12,298,644,4202
There would be no sequel to Concerto #1 by Rockymaninoff,243,47,8,298,644,4397
And now for some Rachmaninov.,264,39,14,317,644,2301
This next piece will knock your socks off.,217,40,8,265,644,359
Hold your applause until I get to the hook.,230,48,6,284,644,3076
The refrain is a bit punchy.,260,56,6,322,644,1527
I have always been a fierce competitor!,220,43,7,270,644,4022
"And now, ladies and gentlemen, my rendition of the theme from Rocky.",223,37,10,270,644,4557
"I am just a poor boy
Though my story's seldom told
I have squandered my resistance
For a pocket full of mumbles, such are promises
All lies and jests
Still a man hears what he wants to hear
And disregards the rest...",238,41,10,289,644,1667
I’m just all thumbs!,236,45,8,289,644,1789
"Actually, it’s a request from Mr. Steinway himself.....",240,37,12,289,644,2604
"For my next selection, Eye of the Tiger.""",234,49,6,289,644,4400
I am proud to be a contender in this year‘s Van Cliburn competition...,212,34,10,256,644,63
"Original ""Chops""",209,40,7,256,644,2334
Hello Philly! Just for you the theme from Rocky.,226,40,9,275,644,2350
Fuego means fight doesn't it?,224,44,7,275,644,4104
"Now, I would like to conclude with an original composition.  I call it ""Ode to Ali""",224,44,7,275,644,4900
What was wrong with the hook?,243,40,11,294,644,1713
"And now, my rendition of, ""The Thrilla in Manilla.""",241,44,9,294,644,2651
I'm know for subtlety and nuance.,240,46,8,294,644,3451
Turns out I’m my own worst enemy.,244,38,12,294,644,5544
I will now play Ravel’s Left Foot Concerto.,259,42,12,313,644,2233
This piece will be played in fortissimo.,210,47,4,261,644,2963
I shall now play the Marquess of Queensberry version of Debussy’s “Clair de Lune.”,212,43,6,261,644,5349
This sonata has a punchy finish.,229,43,8,280,644,1101
My next piece is dedicated to the immortal Muhammad Ali...,230,41,9,280,644,2891
"I shall now play ""Knockout!"" by the late John Cage.",233,35,12,280,644,3971
"""Yes, I can play the theme for Rocky.""",247,41,11,299,644,70
The Third Contender Sonata by R. Balboa,246,43,10,299,644,2990
"Oh, no. I'm having a nightmare.",246,43,10,299,644,4970
And now my rendition of “Hittin’ on the Keys.”,263,43,12,318,644,2444
I'm going to pound out my next selection.,248,48,8,304,644,172
"Sorry for the delay, folks - my trainer is looking for my mouthguard.",234,42,9,285,644,945
Tough Croud,232,46,7,285,644,1835
This makes it much simpler to play some of today’s new symphonies,206,30,11,247,644,4210
"Sorry, it’s not tuned...",258,37,14,309,644,3837
My therapist suggested this when i forget the notes,253,47,9,309,644,5315
And now Rockymaninoff symphony #9 TKO.,239,41,10,290,644,5254
I MUST BE DREAMING,237,45,8,290,644,5598
"For my next piece, a little number by Mr. Mike Tyson.",227,31,13,271,644,2520
"And now one of my personal favorites, Rocky Balboa's Louie Louie in C minor.",223,39,9,271,644,4776
At measure 40 it's a real knockout.,244,40,11,295,644,2590
"....and next, songs from the millennial generation.",230,34,12,276,644,1381
In a clearing stands a boxer/ And a fighter by his trade...,228,38,10,276,644,1608
"I call this one ""Back Home in Palookaville""",227,40,9,276,644,3025
I thought it said Concerto Fist Movement?,229,36,11,276,644,4186
"And now ladies and gentleman, my classical rendition of  
LL Cool J's ""Mama Said Knock You Out"".",252,33,15,300,644,1492
"And now, from Rocky IV...",245,47,8,300,644,3803
"''No, there isn't intermission.''",255,36,14,305,644,3575
Bare-knuckle piano playing is for savages.,236,40,10,286,644,333
"I started wearing them to stop sucking my thumb. Turned out I'm pretty darn good.""",234,44,8,286,644,536
How do I open this thing?,233,46,7,286,644,4396
"For my encore, I have been requested to take off my gloves and play ""The Theme from Rocky""",218,42,7,267,644,3615
And for my finale... The Flight of the Bumblebee challenge,242,37,12,291,644,3713
I don't think I can box my way out of this one.,239,43,9,291,644,5662
My next selection will be the only étude composed by the Marquess of Queensberry.,247,36,13,296,644,2652
I do big sounds.,240,50,6,296,644,5306
..if I finish and you're still clappin' i'll know for the first time in my life...that I weren't just a another bum from the conservatory.,246,47,8,301,644,932
"I could write something clever, but the New Yorker wouldn't get it.",238,29,15,282,644,2119
"My first selection will be ""Sonata for piano and bell"".",234,37,11,282,644,2822
"My dad wanted me to be a boxer and my mom wanted me to be a pianist. Please enjoy this next song, 'Gonna Fly Now'.",231,43,8,282,644,4822
Let's get ready to mambooooooooooooo!,256,36,14,306,644,4892
Then your four-year-old must be a musical prodigy.,222,27,14,263,644,2458
"As part of my international series, a new composition on the Boxer Rebellion.",218,35,10,263,644,2495
The vocalist will not be joining us for this next song in the program.,213,45,5,263,644,5671
This next piece should be a knockout in the 7th.,254,49,8,311,644,112
"Beat me, daddy, eight to the bar!",258,41,12,311,644,4247
"This is a little piece I created called ""All Thumbs"".",218,44,6,268,644,2913
"Yo Adrian, it's called Rocky V' Maninov...""",224,32,12,268,644,3224
"And now, after having finished the slow pieces of tonight's  concert we're going to really  punch up the tempo.",219,42,7,268,644,3804
Caution:  This may knock you out.,240,43,9,292,644,102
And for my next act... I will light a match with my toes.,239,45,8,292,644,1806
Can you be allergic to ivory?,239,45,8,292,644,2254
Excuse me ladies and gentlemen.  The composer has indicated the following passage be played sforzando fortissississimo.,223,43,7,273,644,4094
"Note like a butterfly, sting like a B minor.",228,33,12,273,644,5591
"This is for Mr Stallone at the bar who has requested his nightly favorite, The Rocky Theme Song....",241,50,6,297,644,627
I will now play Bim Bang Bach in C Major,244,44,9,297,644,1537
I will now attempt the Boxer Rebellion Etude. Wish me luck.,244,44,9,297,644,4474
"No, I cannot play chopsticks with these on.  Anyone else?",268,39,14,321,644,2931
It's the Punch and Judy show......But Judy didn't show.....,230,38,10,278,644,2994
It's called 'No place to Haydn'.,229,40,9,278,644,5373
"Despite claims that I'm punching above my weight,I will now attempt to knock out some Chopin.",250,41,11,302,644,916
"He's pretty good, but he always goes down during the Fifth.""",248,45,9,302,644,1744
Tonight we're going 88 rounds!,246,49,7,302,644,2957
This piece will knock your socks off.,246,49,7,302,644,3260
Up next: Box Concerto in D Minor.,232,43,8,283,644,1429
"For my encore, I will premier ""Slam, Bam, Thank You Ma'am"" by Michael Tyson in the key of ""Whatever"".",240,36,12,288,644,1560
"I call this next number, ""Fighting With My Inner Critic,"" in D minor.",238,40,10,288,644,2686
Why are the keys so tightly spaced?,257,45,10,312,644,4119
My next song is a favorite by Simon & Garfunkel.,240,36,12,288,644,5180
"This piece is called the ""Boxer Rebellion""",257,45,10,312,644,5300
And now for the staccato portion...,263,42,12,317,644,1626
"Anyone else object to ""Surrey with the Fringe on Top""",264,40,13,317,644,5520
"Bring up your instruments, I’ll take them all on",242,41,10,293,644,645
Of course it’s Rachmaninov.,240,45,8,293,644,1306
"Seeing that it’s almost closing, allow me to punch a quick  one out for you.",239,47,7,293,644,3499
I shall play for you Muhammed Ali's Piano Concerto in B-Flat.,242,41,10,293,644,5529
"Lie la lie, lie la lie la lie la lie
Lie la lie, lie la lie la lie la lie, la la lie la lie.",218,46,5,269,644,47
And now Ladies and Gentlemen Beethoven's two fisted symphony in a left and a right and a...,265,47,10,322,644,1029
"Next is 'Ode to Mohammed Ali, Opus 1'",225,41,8,274,644,1664
To consider this next song to be my biggest hit is a bit of an understatement.”,224,43,7,274,644,2700
I’m ready to duke it out with The Battle Hymn of the Republic.,247,49,7,303,644,338
I composed the next piece after hearing about beatboxing and before Googling it.,235,30,14,279,644,3579
It bit me during rehearsal...,228,44,7,279,644,4060
I will now perform John Cage’s 4’ 33”.,272,51,9,332,644,469
"I stand corrected, you really can punch the keys.",255,42,11,308,644,746
"I ain't no friend of the piano, see?",257,38,13,308,644,2383
This may only be a baby grand but it packs a powerful punch.,233,43,8,284,644,900
The New Yorkers calls me a heavyweight,235,39,10,284,644,2414
Yo Adrienne!,236,37,11,284,644,3675
My next piece is a jab-jab-cross in 3/4 time,213,40,7,260,644,4319
"My ivory tickling was going too far, apparently.",237,44,8,289,644,248
"This one is called ""I Wanna Punch Your Lights Out.""",243,32,14,289,644,2898
Wouldn't want to tickle the ivories.,239,40,10,289,644,4345
And I'd like to thank my parents who allowed me to pursue a career in boxing even though they had other ideas.,219,37,9,265,644,1472
"This is a little number I call 'float like a butterfly, sting like a bee.'",240,47,7,294,644,3583
"And now, the overture to one of my favorite contemporary operas, The Raging Bull.",222,40,8,270,644,2055
I am much better with drums,217,50,3,270,644,5447
"I give you, the Ali Conceto.",241,54,4,299,644,3148
...and this will be a real punchy number.,243,50,6,299,644,4016
In B flat.,251,43,10,304,644,2109
You should see the other guy!,233,36,11,280,644,54
This next piece was written and recorded by Muhammad Ali,230,42,8,280,644,4185
Next I shall play the flight of the bumble bee,236,30,14,280,644,4480
And now for some fancy footwork,231,40,9,280,644,4713
And then I wrote “Sonata to a Left Uppercut .”,255,44,10,309,644,496
Piano buffo?,256,42,11,309,644,1176
Asking only workman’s wages I come looking for a job . . .,238,35,12,285,644,887
"When they called him the Muhammad Ali of piano, I didn’t think it was so literal.",233,45,7,285,644,5249
"And now, Flight of the Bumble Beast.",241,38,11,290,644,115
For those who say my playing is too sensitive...,238,44,8,290,644,4601
"And now, a Sex Pistols medley.",243,43,9,295,644,4213
"And now, Prokofiev's piano concerto no. 5, written in one-two, one-two.",244,41,10,295,644,4946
"I’m classically trained, but learning jazz.",246,46,8,300,644,1563
My composition is in the key of B-flat.,253,41,11,305,644,4162
I call this one 'Punch in the F-A-C-E.,251,45,9,305,644,5669
My next song is The Boxer.,224,47,5,276,644,2801
"And now a song from the movie, Raging Bull .",226,43,7,276,644,4280
Please turn off all flash photography during the performance.,231,33,12,276,644,5326
I was always taught to punch the keys.,231,42,8,281,644,2669
"This one is for all the drunks and suckers in the house.  It goes one, two...",253,59,3,315,644,3107
I guarantee this next one will knock your socks off.,204,44,4,252,644,4915
"... next, your applause will determine whether I play Chopin’s Scherzo No. 2 or punch myself in the face.",240,33,13,286,644,2276
You didn't tell me I was going to have to perform 'Chopsticks',237,39,10,286,644,4244
And now my interpretation of baby Mozart.,240,42,9,291,644,455
And now I shall perform Etude to Discovering the Piano by a Three-Year-Old.,241,40,10,291,644,1547
I will now hum that song from Rocky.,239,44,8,291,644,5492
These ivories seem to be extra ticklish!,244,43,9,296,644,335
"It's Beethoven, not Bach.",246,39,11,296,644,1420
I don't want to spread my cold to the next contestant.,242,47,7,296,644,1862
Dueling Piano,245,41,10,296,644,2539
Marcato!,245,41,10,296,644,2729
...and in..3..2..1!,220,39,8,267,644,1391
Tonight we will have 3 rounds of knock out piano sonatas.,220,39,8,267,644,5624
"And now, something guaranteed to make you let down your guard.",243,54,4,301,644,216
For those of you who doubt that the original name of this instrument was the pianoforte...,224,40,8,272,644,1245
"Which would you prefer: Stravinsky's Pumchin' Ella Suite, or Mozart's Eine Kleine Knockout Music?",223,42,7,272,644,2985
Please dim that spotlight. I can't see my hands.,228,32,12,272,644,3858
This is how I warm up.,218,52,2,272,644,4845
"""I've got a tough one coming up.""",254,41,11,306,644,5478
"And now, my rendition of 'The Boxer'---it really packs a punch!",260,47,9,316,644,2854
This next song was written by Paul Simon.,232,42,8,282,644,1456
"And for my last piece, I will deliver a sucker punch to Schumann.",231,44,7,282,644,2757
"My opponent has been talking trash about my glissandos, but his crescendos are pathetic.",235,45,7,287,644,4974
"Beethoven's Hammerklavier sonata, cluster-chords, and glissandi: my work here is done.",237,50,5,292,644,1193
My manager told me to punch up the encore...,240,44,8,292,644,3081
...but enough silly love songs. Time for some silly glove songs!,240,44,8,292,644,4168
Adrian. Adrian. Adrian.,241,42,9,292,644,4686
This keeps me from being all thumbs.,213,37,8,258,644,2995
Mr Musicreview wrote that I needed to add more punch to my tempo. Now lets see what he has to say.,213,37,8,258,644,3676
The forte begins when the gloves come off!,245,43,9,297,644,5024
The drummer cancelled so I'll have to keep the beat myself.,215,42,6,263,644,5627
Beat-often's Fifth.,251,40,11,302,644,3455
"Wait, you mean to tell me this isn’t Canada and it’s not Boxing Day?",252,38,12,302,644,4499
This is my only way to knock out fifty songs a night.,256,39,12,307,644,5480
My next piece is Opus No. 19. by Mayweather.,225,40,8,273,644,3135
"And now, Box Prelude in F.",230,30,13,273,644,4820
"Pick any etude, I’ll nail it!",227,45,6,278,644,128
Its a tough piece to master.,227,45,6,278,644,1967
But I'm still training.,230,39,9,278,644,3611
"So, we will now perform THE PASTORAL SYMPHONY by Beethoven   I am debuting a new interpretation of the storm.",235,38,10,283,644,2161
"And now, 'Bombast'.",239,39,10,288,644,246
Play something punchy.,237,43,8,288,644,3262
I shall now perform Wagner's 'Ring'.,242,42,9,293,644,3206
"Sorry, I don't know anything by Paul Simon.",212,32,10,254,644,2277
I'm going for badass profondo.,210,36,8,254,644,4457
I had a fight with the rest of the quartet.,210,36,8,254,644,5686
Punching up the performance suddenly felt like a mistake.,217,31,11,259,644,2482
"Yes, there was actually a lot of competition for this gig,
 now that you ask. How did you know?",211,43,5,259,644,4079
"First some Beathoven, then Box Third Movement, and finishing with a TKOvsky's piece",252,40,11,303,644,279
"Tonight I'm going to play ""Tyson"" Sonata in be flat",250,44,9,303,644,2799
"Next, the Mayweather concerto in e minor.",248,48,7,303,644,4229
"For the very first time, sit back and savor the theme from ""Rocky"".",217,40,7,264,644,384
This next rhapsody is a real knockout.,220,34,10,264,644,3367
first few notes of beethoven’s fifth is my favorite.,216,42,6,264,644,3723
For my encore I will now play “Left hook in G-minor.”,254,54,5,313,644,1299
I’ve always had a mixed relationship with this next piece.,224,35,10,269,644,294
"When I told you to order any gloves with Prime shipping, I did not mean ANY gloves.",225,33,11,269,644,2230
It's for the artillery chorus in the 2012 Overture...,225,33,11,269,644,2426
My mother said they'd protect my fingers.,265,41,12,318,644,4173
Chopin is no match for me,223,46,5,274,644,2712
You've never heard a sforzando quite like this!!,230,32,12,274,644,2896
"Dat was ""Ode to George Foreman"", in E minor.",226,40,8,274,644,3188
My next number is dedicated to the Marquess of Queensbury.,225,42,7,274,644,4622
Think of it more as a performance.,224,44,6,274,644,4652
The 1812: Bells and cannons ready? Go!,230,41,8,279,644,731
I will performing TKO and Fugue in D Minor.,232,37,10,279,644,5572
"And now, friends, a little 'soft Rocky' music for your listening pleasure.",229,43,7,279,644,5641
I did hear he played with punch.,235,40,9,284,644,5291
"...but he said, dualing pianos?!",242,35,12,289,644,2064
"Eye of the Tiger? Yeah, I know that one",249,30,15,294,644,466
I'm rehearsing for a box set,246,36,12,294,644,4298
"And now, 4'33"".",246,45,8,299,644,1698
"I said, ""I don't take requests!!""",248,41,10,299,644,2607
I am now going to perform a song by Simon and Garfunkel,250,37,12,299,644,3384
I've got the beat --down.,248,41,10,299,644,3543
"And now a little thing I like to call, 'On the Waterfront.'",251,44,9,304,644,27
I am qualified to be the president's greatest Chief of Staff ever! I can do anything.. . . anything.,253,40,11,304,644,1271
"So, who wished for ""Eye of the tiger""?",250,46,8,304,644,1318
Please be sure to sing along if you recognize this tricky old tune.,250,46,8,304,644,4790
I am just the page turner.,254,38,12,304,644,5658
"No, I don't know any punchy tunes!",258,39,12,309,644,3907
"Next, THE BOXER by Simon and Garfunkel!!! You’ll G-love it!!",254,47,8,309,644,5115
"And now ""The Boxing Blues""",255,45,9,309,644,5339
My new invention makes glissando a snap .... but staccatissimo is impossible.,219,38,8,265,644,5156
"Float like a butterfly, play chords in B.",224,37,9,270,644,45
This next one is Beethoven's 9th Symphony - the Rocky Balboa version.,226,42,7,275,644,295
"So far so good. Now, with the gloves on, what is this one?",229,36,10,275,644,5223
"And now, before I take off my gloves, let me show you my Rachmaninoff.",231,41,8,280,644,854
Yes...and Richter and Monet destroyed some of their works of art. So what's your point,232,39,9,280,644,4236
"And now my favorite request, the ""Knockout"" in B Major!",235,42,8,285,644,3522
"This sonata is all about nimble finger work, and a good left hook.",239,43,8,290,644,780
The next piece was originally performed by Simon and Garfunkel,239,43,8,290,644,3729
"Well, what did you expect, madame? It was billed as a Dueling Piano show.",245,31,14,290,644,3884
"The gods had condemned Sisyphus to ceaselessly rolling a rock to the top of a mountain, whence the stone would fall back of its own weight. They had thought with some reason that there is no more dreadful punishment than futile and hopeless labor.",244,33,13,290,644,4516
"And now, the Tyson Piano Sonata in B flat major.",242,37,11,290,644,4909
"My next piece will be a concert for four hands, but Mike Tyson couldn't make it.",241,48,6,295,644,5516
Glen was feeling creatively boxed in.,248,43,9,300,644,4313
"Now, for my rendition of The Rocky Concerto",250,39,11,300,644,4470
"Now for my encore, “Sting of the Bumblebee.”",251,46,8,305,644,602
I wrote it in the Boxa Nova genre,262,42,11,315,644,4694
And now to pound out a little different beat.,217,44,5,266,644,1048
I just think Rachmaninoff's no. 2 needs a little punching up.,222,34,10,266,644,3141
This is dedicated to ‘Rocky’,217,44,5,266,644,4256
"Was aiming for a punchy staccato. Precision, not so much.",230,36,10,276,644,5331
"¨As humans, this is the closest we can get to Thelonious¨",230,36,10,276,644,5595
This next piece is called ‘Bopsticks.’,235,35,11,281,644,4598
"I shall now perform John Cage's 4'33"", to be filmed by Andy Warhol.",239,36,11,286,644,1605
"Huh, she was right. These gloves don’t go well with the suit after all.",242,39,10,291,644,1030
And in 1998 I knocked out a guy named Steinway.,240,43,8,291,644,1474
My next selection is the theme song from 'Rocky',243,37,11,291,644,4659
"Alright, I’ll stick to chords!",242,39,10,291,644,5353
My next bout is Prokofiev's Sonata #6.,247,38,11,296,644,403
You can call me Mittstro.,249,34,13,296,644,3773
"Yo, Adrian! It's me, Rocky. I don’t think I can beat this guy.",245,42,9,296,644,4640
"What do you mean by ""forte"" fortissimo?",243,55,3,301,644,336
"Oh, yeah....who's next? I'll give you a sonata right in the Steinway.",254,42,10,306,644,4815
"For my next number, Sonata a la Ali",258,43,10,311,644,4966
Chopsticks -- that's it.  You were expecting maybe Mozart?,260,39,12,311,644,5053
"Ladies and gentlemen, Beethoven’s Last Movement.",258,52,6,316,644,4497
I thought the point was to create as much dissonance as possible?,208,37,7,252,644,2364
Appears I'm a bit ham-fisted today....,210,42,5,257,644,1688
They said to play it as if I had gloves on...these were the only ones I could find.,220,40,7,267,644,1308
"Tonight,I introduce a new work ""Massacre in A"" by Klitschko.",224,41,7,272,644,2964
"I, too, don't understand this gig.",237,33,12,282,644,225
This is what happens when you tickle the wrong ivories.,237,42,8,287,644,1024
"First, a little Rocky Mananoff followed by my own Bachster medley.",237,42,8,287,644,4807
...they increase the bass response.,239,47,6,292,644,2773
It's cutting edge in Post-Modern music.,245,35,12,292,644,4082
I'm also a part time nurse.,240,45,7,292,644,5274
"Oh, a 'jaunty' tune. I thought you said 'punchy,' Madame.",248,47,7,302,644,1606
Dun Dun Dun Dun!,247,49,6,302,644,3086
This next piece is originally by Tyson.,251,41,10,302,644,4862
It’s light on notes.,258,45,9,312,644,5123
I can't play with cold hands,211,33,9,253,644,4124
"And now for my next number, the Tyson Concerto in A Minor",214,36,8,258,644,3258
And now Wagner's Der Ring des Nibelungen.,216,41,6,263,644,5082
"And now, Chopin sans arpeggios",216,41,6,263,644,5298
I  play with my boxer shorts on too!,223,36,9,268,644,4714
"♫♫ I am just a poor boy, though my story's seldom told... ♫♫",225,41,7,273,644,534
"And now, ladies and gentlemen: Rocky 3.",225,41,7,273,644,1155
"I didn't ask for these hands, sir. You're the one who bought tickets.",227,37,9,273,644,1526
"Ladies and Gentlemen, for my encore I will play a real smash hit!",227,37,9,273,644,4148
And now for my rendition of  The Boxer,225,41,7,273,644,4422
This next number's going down by the second verse.,225,41,7,273,644,4859
Are you sure Billy Joel started  this way?,233,34,11,278,644,984
Who said I'm all thumbs?,230,40,8,278,644,2147
I can punch out this symphony in 11/16ths time.,234,41,8,283,644,3610
One more low blow and Steinway is disqualified,231,47,5,283,644,4268
"That last one was by Chopin. And now, a piece by Punchin.",237,35,11,283,644,5203
It's safe to remove your ear plugs.,239,40,9,288,644,953
"In the clearing stands a boxer, and a fighter by his trade...",240,38,10,288,644,5462
"Next, I will play possum.",242,34,12,288,644,5621
"In the clearing stands a boxer, and a fighter by his trade...li la li",239,49,5,293,644,2849
This isn’t what I meant when I said we should play a music box.,248,31,14,293,644,3372
The music industry is getting competitive.,238,51,4,293,644,4312
It’s a safety thing.,244,39,10,293,644,5059
I need the score for this number!,245,46,7,298,644,1198
"Float like Jarrett, sting like Monk.",246,44,8,298,644,1653
I will now play the 'Flight of the Rumble Bee'.,247,42,9,298,644,2143
"Oh excuse me! These are real ivory, and you paid a $3 cover.",248,40,10,298,644,4650
I can promise you’ll never hear Alkan’s ‘Concerto for Solo Piano’ the same way again.,211,35,8,254,644,504
The next piece is a punchy rendition of O Holy Night.,212,33,9,254,644,5038
"It’s fortissississimo all the way, all the way!",221,33,10,264,644,3133
I’ve had a request for Music Dance Boxer.,223,38,8,269,644,318
"My uncle went to Julliard,so I'm pretty sure I know how to hit the notes.",227,39,8,274,644,1868
"Okay, I got it. Float like a
butterfly and sting like’ the 
flight of the bumblebee.’",231,40,8,279,644,3194
Box Piano Concerto No. 1,234,43,7,284,644,3810
Adrian? Adriaaaan!,234,43,7,284,644,3819
"And now I’ll be playing Rachmaninoff’s Piano Concerto No. 4, better known as the one where Rocky fights the Russian.",237,46,6,289,644,345
Rachmaninoff.,241,38,10,289,644,4303
As seen on TV: pound the keys without pain. Guaranteed or your money back.,246,37,11,294,644,1663
And now the mitt fit concerto world premiere,244,41,9,294,644,2956
And for the next song from my greatest hits CD...,246,37,11,294,644,3193
The conductor told me he  looking for musicians with fistfuls of  talent.,258,40,11,309,644,2568
"At the bell I will perform ""Ode to Adrian"", by Rocky Balboa.",258,49,7,314,644,957
Could you stop coughing? You’re ruining my concentration.,261,43,10,314,644,1305
Shall I play The Boxer?,269,45,10,324,644,2237
The odds are 2 to 1 for Bach over Mozart.,229,46,5,280,644,718
"And, after sparing  a little with my friend Mozart , it's now time to take off the gloves and duke it out with one Sergei Rachmaninoff.",253,43,9,305,644,750
I'm going to play Mozart's all thumbs sonata in E major.,233,38,9,280,644,837
I like to end with the 1-2 upper-cut cord progression,229,46,5,280,644,848
I'd now like to play Everlast Love.,245,41,9,295,644,1095
You Beat Me to the Punch by The Temptations in C major seventh.,235,43,7,285,644,1795
Do-Re-Mi-Jab-Cross-Hook,231,42,7,280,644,1959
I'm taking an eight count.,221,35,9,265,644,1978
I will  now play chopsticks,233,38,9,280,644,2107
I'll now be taking a quick break to make a momentous life decision.,252,45,8,305,644,2108
"I knew you VanCliburn guys changed the audition protocol, but this?",224,38,8,270,644,2377
"And now, for the Symphony Fight Song.",237,39,9,285,644,2655
And now for a completely new attack on the Rachmaninov No. 2!,219,39,7,265,644,3003
"To prove that I hold no grudges, the next complicated piece is in honor of the critic who recently wrote about me that, ‘He plays the piano with fingers permanently wrapped in bandages ensconced in boxing gloves.’’’",239,44,7,290,644,3022
"Please,no requests for Chopsticks.",245,41,9,295,644,3087
"No, sorry. 88 Fingers Louie couldn’t make it tonight. I’m 2 Gloves Sal.",209,41,5,255,644,3221
And now we move from Beethoven's works to Bach's.,245,32,13,290,644,3461
"And now a word from our sponsor, Everlast.",248,44,8,300,644,3894
"With the holidays coming up, I will now play, ""Boxing Day Blues.""",231,42,7,280,644,4517
And my next piece is titled Nail Biters Lament.,234,36,10,280,644,5271
"Music Therapy ""Bring to mind the image of your music teacher and proceed to pound.""",261,36,13,310,644,5563
This is a little something George Forman wrote when he was a bit woozy after a bout.,252,38,11,301,644,2720
"Hum a few bars, I think I know that one !",242,40,9,291,644,3653
And now my latest rendition of  “Baby it’s cold outside.”,239,37,10,286,644,3369
"Now, listen to this beat!",236,43,7,286,644,4756
"In this political climate, I ‘m always prepared to hit back.",231,44,6,281,644,2954
"I'm often referred to as a ""technical knockout.""",236,34,11,281,644,3566
"They think my tux looks stupid, don't they?",228,41,7,276,644,2081
And now...a little Toughaikovsky.,231,35,10,276,644,2084
This next piece is more avant-mouthguard.,228,41,7,276,644,2126
"And now we begin the ""Rocky"" Concerto No. 4 in G Major.",229,39,8,276,644,3736
Applause is highly encouraged.,227,34,10,271,644,4042
"I heard of ""all thumbs"" but this is ridiculous",220,39,7,266,644,786
"Man vs. Piano: ""Modernism?  I'll show you Modernism!""",223,33,10,266,644,960
"And now, the Punch Drunk Concerto in C Minor.",221,37,8,266,644,1532
What? A TKO? But we're only in the first rondo!,221,37,8,266,644,2791
"And now, U of M's fight song",216,38,7,261,644,415
ARE...YOU...READY...TO...RRRUMBLE?!?,203,37,6,246,644,5138
They give my pianissimos a pugilistic touch.,267,37,13,317,644,1151
"I'd like to thank my mom for this next song, titled ""Stop Itching Your Poison Ivy.""",263,45,9,317,644,4757
This next number is from my box set.,257,39,11,307,644,454
I'd like to play for you a little 12- round blues.,254,45,8,307,644,722
This next piece is in key KO sharp,255,43,9,307,644,2581
Fight me. In B minor.,248,48,6,302,644,328
"For tonight's main event, I will perform for you 'Chopsticks'""",250,35,12,297,644,353
"Oooo...the 1812 Overture, You bet I can do that....",248,39,10,297,644,2251
"And now I'm going to play my discordant Mazurka No.1 in E.
I don't know if it is sharp or flat.  I hope you like it.",246,43,8,297,644,2723
"Ladies and gentleman, my psychiatrist says I have to stop tickling the ivories.",244,47,6,297,644,5412
"without further ado, I bring you the theme from Rocky, ""I will fly now""",242,42,8,292,644,227
"What do you mean, ""tickle the ivories?""",240,46,6,292,644,344
"Next is a selection from the Ring Cycle, sung as a round.",241,44,7,292,644,2410
'This next was first performed molto vovace by my three-year-old.',239,48,5,292,644,2677
"Lean, mean, piano playing machine.",239,39,9,287,644,996
"Next, the theme song from ""Punch-Drunk Love""",236,45,6,287,644,1260
"As my first selection, I now give you ""Chopsticks.""",234,40,8,282,644,1898
"In the lobby after the show, I'll be selling my box set.",230,39,8,277,644,31
The pugilist in me will now pound out a familiar martial score.,229,41,7,277,644,120
"And now for you my new piano concerto, ""Slugfest in B Flatten"".",230,39,8,277,644,3378
"Please sing along while I knock out 15 rounds of ""Row, Row, Row your Boat"".",227,45,5,277,644,4450
"I usually get a standing O, but tonight I’ll take a standing 8!”",227,36,9,272,644,5193
"For my next number, I will pound out Gershwin's 'Rhapsody in Blue.'",222,37,8,267,644,1965
"Wait, you asked if I could play ""mitten on the keys"", right?",222,37,8,267,644,2273
"And now, 'Variations on the Theme from ""Rocky"" .'",223,35,9,267,644,4951
Sure I take requests - as long as its 'Chopsticks',220,41,6,267,644,5527
Pianissimo anyone?,216,40,6,262,644,757
Ol' Black and Blue Eyes.,200,36,6,242,644,4468
Any fans of Bach's?,269,44,10,323,644,3289
....but the music says molto softo,263,47,8,318,644,3666
This melody is going to hit you like a punch in the face.,263,47,8,318,644,4408
Any other comments on my Mozart?,254,47,7,308,644,2090
This is gonna get nuts real fast.,257,41,10,308,644,4932
I apologize for the brutality you are about to hear in three rounds.,248,50,5,303,644,67
For my next trick...,250,37,11,298,644,1361
And now a piece from The Nut Cracker,243,51,4,298,644,2170
"If the flutist can have his mouth guard, I get to keep these.",249,39,10,298,644,3112
"I didn't want to be handled with kid-gloves,but, this is ludicrous.",237,45,6,288,644,354
I swear coach told me this was the right Gymnopédie!,241,37,10,288,644,1808
"A warning to those of you expecting ""Chopsticks.""",238,43,7,288,644,2932
"I will now play Knuckles.""",240,39,9,288,644,4723
"When I do box, they call me 'Kid Baby Grand'.",237,45,6,288,644,5665
I like to lace up for Der Ring.,232,46,5,283,644,243
Smooth Jazz?,235,40,8,283,644,1044
"C, D, E, F, G, K. O...",234,42,7,283,644,2702
Now a little known piece from Boxtehude,240,30,13,283,644,3037
"I call my next piece, Could Someone Please Come Scratch My Nose",236,38,9,283,644,4028
And next I'll be playing my interpretation of 'The Boxer'.,227,47,4,278,644,510
"For my next selection, I'm going to attempt a very difficult composition that I've been fighting to learn.  It requires dexterity and expert fingering.",230,41,7,278,644,3186
"I can still do ""Chop Sticks""",231,30,12,273,644,961
"What I said was ""with one hand tied behind my back""!",223,46,4,273,644,1269
"Is it cold in here, or is it just me?",225,42,6,273,644,2745
And now for my impression of the late great Bobby Short.,229,34,10,273,644,2864
And now my gloves on rendition of the theme song from the film Rocky,229,34,10,273,644,5359
I coulda been a piano masta,220,34,9,263,644,16
Another round?  Harmony or counterpoint?,219,36,8,263,644,963
And now: Fisticuffs Etude ala’ Cage.,218,38,7,263,644,3969
Well the position said it was for a keypunch operator.,216,33,9,258,644,3892
"Now a few tunes from that indie-rock group, The Boxer Rebellion",210,36,7,253,644,5556
Vladimir Ali is shocked by his 10 stanza penalty for hitting below the keyboard.,260,46,8,314,644,4891
"On second thought, my next piece is much better suited for a cappella.",258,41,10,309,644,4382
"For the second round, I am going to take a more creative approach.",248,43,8,299,644,5684
This piano is tough to play.,245,40,9,294,644,578
E sharp is way off,251,28,15,294,644,3061
This part of the song requires you to punch things up.,242,37,10,289,644,408
"Sorry folks, but the muffle pedal isn't working.",237,38,9,284,644,1232
"And now I'd like to play a little number called, ""Punching the Ivories.""",234,35,10,279,644,4172
"Available on pay-per-view only, this Saturday.",228,38,8,274,644,427
The first rule of Fight Club is: you do not sing about Fight Club.,232,30,12,274,644,3171
I will now continue with works by Motzhurt and Beatoven.,222,41,6,269,644,2354
"I'm only playing ""The Black Keys""",214,39,6,259,644,981
The audience immediately felt the weight of this political metaphor.,215,37,7,259,644,2247
"And now my latest composition, which I call ‘Ten Rounds of Agony.’",214,39,6,259,644,5037
Now for my next piece is LL Cool J’s “Mama Said Knock You Out” .,262,44,9,315,644,2373
It's just a forte when I play,253,44,8,305,644,4742
This is going to take your breath away!,244,44,7,295,644,679
At this point in the program I get quite punchy.,247,38,10,295,644,2945
"For my next selection, I'll pound out a selection of sentimental nonsense.",244,44,7,295,644,3405
And now I will play some chin music for you.,245,42,8,295,644,3612
"And now, allegro for ten toes.",245,42,8,295,644,4161
"I know you all wanted a Rocky themed event, but this might prove challenging.",238,47,5,290,644,263
I shall now perform Brzęczyszczykiewicz's 'Concerto for Piano and Boxing Gloves.',245,33,12,290,644,734
My next selection is ‘Slopsticks.’,245,33,12,290,644,1507
As a pugilist pianist I prefer to pound the piano,241,41,8,290,644,2566
"Hit it, Maestro! I’m ready to pound those keys!",237,49,4,290,644,4118
All I can play is 'The Rocky Theme' or 'A Piano Being Beaten to Death (in C minor)'.,232,41,7,280,644,1387
"Float like a butterfly, sting like a Beethoven.",227,42,6,275,644,1838
"Well, it's really only my voice they're interested in anyway.",228,40,7,275,644,2574
This Baby has been fighting me ever since I was five years old.,229,38,8,275,644,3506
"My piano technique? I just float like a butterfly, sting like a bee, tickling these ivories",220,47,3,270,644,4590
It would be remembered as a poor performance if the cellphone had not gone off,224,39,7,270,644,5346
It's not time to take the gloves off.,265,49,7,321,644,1755
That was the theme from Rocky III.  Now here’s IV.,222,34,9,265,644,3845
This next one tugs at the eardrums.,220,38,7,265,644,5643
Are you sure this will get me a hit?,267,36,13,316,644,5513
The suit and piano are just for show.,214,41,5,260,644,2328
SRO for the TKO.,253,46,7,306,644,2072
He composed his first concerto when he was six months old.,254,35,12,301,644,2749
Boxing Day Overtures,248,47,6,301,644,5136
It's by Khachaturian.,246,42,8,296,644,1754
"Umm, are these things on?",245,44,7,296,644,1905
I’m concerned the minor fall will be misconstrued as taking a dive.,246,42,8,296,644,3641
Allow me to punch in a few of your favorite tunes,245,35,11,291,644,918
Too much bass?,245,35,11,291,644,4501
"Now my own original piece, 'Bach's Gloves'",244,37,10,291,644,5282
Rocky Balboa.  Why do you ask?,237,42,7,286,644,1833
My next number is a real knock-out song.,234,39,8,281,644,5253
It's time to get in the ring...cycle.,230,38,8,276,644,489
Too early for gloves off?,228,42,6,276,644,949
It's my new brand. The critics say I play like I'm wearing boxing gloves.,267,47,8,322,644,4991
"And now, Ludwig von Marciano's Eight Round in D Minor",228,33,10,271,644,833
I can't land the hook,226,37,8,271,644,1705
"This may look a bit bizarre ladies and gentlemen, but somehow I have misplaced my hockey stick.",229,31,11,271,644,4354
Break a LEG next time,227,35,9,271,644,4462
I'm doing my grand finale in the first round.,258,47,7,312,644,5638
"And now, ladies and gentlemen, the theme song from 'Rocky'.",220,40,6,266,644,1502
"This evening, ladies and gentlemen, I'm going to pound out Chopin's Nocturne in B Sharp Minor.",221,38,7,266,644,2629
"This fighter is a natural, Jim. His punches are sharp, despite being a bit flat-footed, and that accidental in the 5th measure was fairly minor. He should have no trouble walking out with A Major victory tonight.",219,33,9,261,644,4356
And my favorite chord; a four octave G minor 7th.,215,32,9,256,644,1053
Boxing in E flat,246,44,7,297,644,1343
-The piece ends in a fiery double octave scale run down the keyboard.,242,43,7,292,644,1224
I hope you like Bach's music.,243,41,8,292,644,4189
This us my homage to Boxing Day,235,48,4,287,644,4115
Jam ? I thought you wanted to jab,240,38,9,287,644,5377
I like to call this one the Pizzicato Palooka.,234,41,7,282,644,1279
This is a performance art piece where I pummel the keys into submission. I always win.,233,43,6,282,644,2198
And now a tribute piece I call “Sting of the Bumblebee.”,233,43,6,282,644,3556
"I thought I’d punch up this next number. See what I did there? I can be funny too ... and for Josh’s information, the word is pronounced ‘pianist.’”",231,38,8,277,644,477
If I speed thru the Rachmaninov concerto I can still make my fight,229,42,6,277,644,851
This next part I call the Mike Tyson finale.,259,47,7,313,644,2315
"Hey Shostakovitch, I know they don't want me to win, but... seriously?",228,35,9,272,644,4387
"My next medley will be Eye of the Tiger, Rock Me, and Kaboom.",257,42,9,308,644,2926
You want me to break its leg?,256,44,8,308,644,3916
"You have heard of a lead foot, now you have heavy hands.",223,36,8,267,644,46
I wear these to keep from going blind.,225,32,10,267,644,3546
And now a Simon and Garfunkel tune,222,38,7,267,644,4709
"For my next performance, I will be playing the theme from the movie Rocky.",255,37,11,303,644,4831
it's a big sound when the leathers hit the ivories,246,46,6,298,644,1000
"Now, I will play ""Boxer on a G String.""",249,40,9,298,644,4132
Lay em out again Sam.,217,30,10,257,644,1411
"Now for my new arrangement of John Cage's 4'33"",on steroids.",248,33,12,293,644,948
Now let's hear you say my music has no beat,241,47,5,293,644,5362
Now I'd like to play a tune which was a favorite of Muhammad Ali.,212,31,9,252,644,2869
Just trying to punch up my jam.,242,36,10,288,644,2872
Prepare yourselves for an eight count knockout.,237,46,5,288,644,4101
Now we present...Punch de Rhythm in C Minor,238,44,6,288,644,4221
Geoffrey could think of only one way to honor Ali.,238,44,6,288,644,5376
Did I win?,239,42,7,288,644,5703
"Float like a butterfly, sting like a bee. California can hear my fortissimo from Carnegie.",235,41,7,283,644,550
And the boxer on the bus goes Wham Bam Bam.”,240,31,12,283,644,906
And now a selection form “Rocky “,232,47,4,283,644,1075
And now for some of my more obscure hits...,239,33,11,283,644,4192
"Now, a prelude to Beethoven's Fifth!",232,38,8,278,644,3147
"Gloves, Maestro, Please ??",235,32,11,278,644,5222
"My next selection, Boxers concerto in G minor.",234,34,10,278,644,5240
I'll pound out your favorite for a small fee.,258,42,9,309,644,114
"And now, my rendition of Survivor's ""Eye Of The Tiger""",222,40,6,268,644,2805
"And now, the unfinished symphony!",253,34,12,299,644,298
I plan to finish it.,249,42,8,299,644,488
Play Rocky for me.,249,42,8,299,644,4952
Give me an A!,244,43,7,294,644,2040
"My next tune, The Boxer.",242,47,5,294,644,2775
But I don't know 'Rhapsody in Black and Blue!',239,44,6,289,644,1671
"Our first piece tonight is ""Vivaldi's K.O. in the First Round.""",240,42,7,289,644,3110
No...I’m not a showoff! As a kid I just loved Rocky movies and Rachmaninoff.,238,46,5,289,644,4749
"I was booked for ""The Battle of the Dueling Pianos""",242,38,9,289,644,4864
The conductor won’t fight me on the next piece. He’s Haydn,244,34,11,289,644,5303
And now from Simon & Garfunkel,216,25,12,253,644,4595
"And now, the theme from ""Jaws"".",236,41,7,284,644,428
"Alright, who took my sheet music?",237,39,8,284,644,1289
Now for my piano transcription from the Ring!,240,33,11,284,644,1298
T-K-PianO,239,35,10,284,644,1733
When you apply for the wrong job and still get,239,35,10,284,644,3567
And then I threw a left hook in A-minor.,237,39,8,284,644,4508
"Knuckle Down Winsocki, Knuckle Down",230,44,5,279,644,1108
Ta rah rah BOOM de aye!!,234,36,9,279,644,2159
And now for a somber rendition of T.K.O in C major.,257,46,7,310,644,2667
A one and a two and a one two punch.,228,39,7,274,644,3414
Now we will punch up the tempo and add a bit pzazz  to this Rachmaninov piano concerto,227,41,6,274,644,4302
Does anyone out there have a spare set of chopsticks?,249,44,7,300,644,3284
This piece is now in hommage to Muhammad Ali.,250,42,8,300,644,4005
I will now play Bach’s Boxer Fugue in F Major/Minor,222,42,5,269,644,1872
Applaud or I'll punch you in the nose.,220,46,3,269,644,4479
"This next piece is called ""Boxing Sonata #2.""",243,47,5,295,644,1329
This is dedicated to the memory of “The Boxer Rebellion.,248,37,10,295,644,2575
What 's the punchline?,245,43,7,295,644,2991
And now my rendition of LL Cool J’s “Mama Said Knock You Out”,219,39,6,264,644,5592
"Next, Iron Buttlerfly's interpretation of ""Flight of the Bumblebee.""",241,42,7,290,644,2454
Now I will perform the TKO.,240,44,6,290,644,2524
"And for my encore, ‘Variations on Louie Louie!’",243,38,9,290,644,4025
".... and how the theme from ""Rocky"" ...",212,35,7,254,644,3629
I will now pound out my latest opus.,254,45,7,306,644,2544
Piansubmissimo?,274,43,10,327,644,4670
It's okay. I'm a keyboard genius.,226,36,8,270,644,1028
This may sound a little off-key.  I just got back from the gym.,227,34,9,270,644,1416
"Next, my version of Nancy Pelosi's budget blues.",246,43,7,296,644,3424
"And now, 'Coup de Lune' by Cassius Claude Debussy.",253,29,14,296,644,4204
Is someone recording this?,223,33,9,265,644,5189
Sam played only fortissimo.,222,35,8,265,644,5347
Imma nockturne you out.,243,40,8,291,644,3420
"Can you, Sir, find a better way to bring Pollock to the piano?",237,43,6,286,644,2239
This tender number is about to become more tender.,240,37,9,286,644,5219
"This next selection is entitled ""The Terrible Twos.""",255,45,7,307,644,1292
I am not a real pianist; I just play one on TV.,255,45,7,307,644,2847
"And now, the Goldberg variations.",236,36,9,281,644,592
Which round are we up to my good sir?,234,40,7,281,644,1115
I’m actually a featherweight according to this scale.,236,36,9,281,644,1398
This is the first performance of Rach 3 with gloves on.,236,36,9,281,644,4976
My Sforzando tends to be too forceful.,211,39,5,255,644,406
And now my rendition of Kitty Cat Sonata,232,35,9,276,644,603
Let’s get ready to rrrumble!,250,37,10,297,644,1344
This will be a real bash.,248,41,8,297,644,3620
"This way, I can play more notes at once.",247,43,7,297,644,4142
"And now..."" Mama Said Knock You Out"" in E flat.",224,42,5,271,644,5619
"And now, The Pugilism Concerto",242,44,6,292,644,1583
And now for my interpretation of Ravel's concerto for the left hook.,240,48,4,292,644,4044
I couldn't make it as a concert pianist so now I’m a performance artist.,242,44,6,292,644,4318
"In my next round, I will be playing....",244,31,12,287,644,4342
This is the only way to make “Chopsticks” impressive.,219,34,8,261,644,508
"Every tenth concert I play for the folks in the back seats. For those of you with better tickets, I quote On The Waterfront: 'This ain't your night'",218,36,7,261,644,2127
Concerto No 5 in Knoch'em flat by Ludwig van Beatonthem,219,34,8,261,644,4769
"For my final match, I will be taking on Liszt's ""La Campanella.""",255,47,6,308,644,2380
"Now, ""Ebony and Ivory""",256,45,7,308,644,4800
"I'd like to dedicate this next number - ""Eye of the Tiger"" - to my good friend Mr. T",279,37,13,329,644,1520
I am not all thumbs and I'm here to prove it!,236,38,8,282,644,2437
KILL THOSE LIGHTS  - I'm hand syncing !!,239,32,11,282,644,4832
"Plus, I could dance like a butterfly and sing like a bee.""",235,40,7,282,644,5559
"Next, Sonata for Losers in D flat-on-your-back minor.",252,44,7,303,644,2684
"...and for all you dancers, I'll  take a mandatory 8 count for this  round.",215,33,8,256,644,772
Why is my first request song  always: 'Tenderly' ?,218,27,11,256,644,1680
Shall I pound out Tea for Two?,218,27,11,256,644,4821
I'll show you what 'punching keys' really means!,230,41,6,277,644,247
I float like a butterfly and tickle the keys,251,37,10,298,644,452
"Okay,so I lost the bet. But,for God's sake,I'm a piano player!",250,39,9,298,644,693
Better this than brain surgery.,251,37,10,298,644,838
"Now, by a split decision, I will play 'Mozart's Tenth Piano Concerto'.""",246,47,5,298,644,5016
"Hey, I'll play anything I want!",229,34,9,272,644,288
This next one will be played in KO.,240,50,3,293,644,1921
"Now, who'd like to hear some Simon and Garfunkel?",224,35,8,267,644,3943
which key should I punch again?,240,41,7,288,644,1036
Max Schmeling's Symphony No. 1 in E flat major combination.,241,39,8,288,644,1829
"Thank you, thank you. Now for an encore, I will play Autumn Leaves with my wrists handcuffed behind my back.",240,41,7,288,644,4664
My next piece will be the opening score from Jaws,241,39,8,288,644,4708
"Is my ‘time out’ for playing too loud, over?",242,37,9,288,644,5290
"Thank you, ladies and gentlemen. Next, in our tribute to Hollywood, I'm going to knock out 'Gonna Fly Now', the rousing theme song of the 'Rocky' movies.",202,32,7,241,644,4879
"And now for that great jazz classic, “It don’t mean a thing (If it Ain’t Got That Swing”).",215,44,3,262,644,3242
I will now play Liszt's Campanella in boxing gloves to prove how crazy good I am!,214,46,2,262,644,3702
Now I shall play Cage Fight in 4 33’,239,34,10,283,644,905
Do you mind if it's just the Minute Waltz?,235,42,6,283,644,4607
I will now play the famous tune called Drumsticks.,235,33,10,278,644,3949
"My biggest inspiration? Bach, sir.",255,31,13,299,644,2634
"And now I give you “Für Alise,” by Stings-Like-A-Beethoven.",265,49,6,320,644,5287
They told me to punch out a song.,247,38,9,294,644,794
I'm terrible with chopsticks.,245,42,7,294,644,1216
"The next piece in our holiday program is ""Anvils We Have Heard on High"", originally composed by James Slamwick, Bishop of HexHamfist",247,38,9,294,644,2265
"Charles, I thought you said these gloves would make my hands ""float like a butterfly""",247,38,9,294,644,2970
I wish my brother Ali were here...,246,40,8,294,644,3830
This is the part where we all sing together,264,42,9,315,644,5112
I've been fighting with that diminuendo for weeks.,244,44,6,294,644,5154
iTunes has the whole boxed set.,243,46,5,294,644,5452
"I call thith nextht number ""Down Goeth Frathier.""",258,45,7,310,644,265
"Ok, you can play until you see the towel thrown on stage.",245,33,11,289,644,278
"Since my accompanist has fled the building, there will be no dueling pianos tonight.",243,37,9,289,644,732
The odds are 50 to one that I can't knock this baby out.,238,47,4,289,644,1163
I'll be playing Tchaikovsky's 1812 Overture,225,35,8,268,644,160
And now my own composition. I call it “Boxsticks”,225,35,8,268,644,3569
Let me know if you think it's a knockout.,203,41,3,247,644,80
This next song is called Crescendo of  Cacophony,249,54,2,305,644,725
"As a follow-up to my successful rendition of  'Chopsticks',  I'm going all in on 'Flight of the Bumblebee'.",260,32,13,305,644,1282
A knockout performance or should I say a Bach-out,263,46,7,316,644,3314
"But, I don't need these to play Wagner . .",229,38,7,274,644,2512
Who'd like to hear the opening notes of Beethoven's Fifth again?,232,32,10,274,644,2810
My newest piece is titled Middleweight Bout in Vegas.,227,42,5,274,644,3382
"This piece of music was written by the late,great Muhammad Ali",210,38,5,253,644,3019
My next number will be a Palooka  composition.,237,51,2,290,644,842
"I'm gonna knock out a little tune for you right now. It's called ""Float Like  Butterfly. Bang on the Keys Like a Five Year Old.""",244,37,9,290,644,2912
"And now, Boxer Concerto No. IV, in G minor.",243,39,8,290,644,3122
I can’t find middle c.,242,41,7,290,644,3625
The Pugilist Pianist prefers the percussive-style keyboard approach.,227,33,9,269,644,521
"The  Copacabana presents,
 “An Evening with Mike Tyson”",227,33,9,269,644,4630
"What do you mean ""Outside the box""?",241,34,10,285,644,3277
"No, this is a composition by Beathoven",238,40,7,285,644,5164
And now for the Flight of the Stinging Bumblebees,249,47,5,301,644,1483
"And now, Chopin's Polonaise in G flat diminished (doubtful), ""The Boxer""",233,41,6,280,644,2015
"And now, the Maxie Rosenbloom Variations!",235,37,8,280,644,2286
"And now, ladies and gentlemen, here is our last contestant  battling it out for most original song .",235,37,8,280,644,3202
I call this 'Chopsticks'.,251,34,11,296,644,4404
I call this: Flight of The Boxer,244,48,4,296,644,4902
Rocky XII - The Dueling Piano,260,45,7,312,644,1666
"This next one's entitled: ""A Major knockout""",263,39,10,312,644,1683
Am I supposed to float like a butterfly or sting like a bee?,262,41,9,312,644,4270
What key is this in?,245,37,9,291,644,2395
The drummer couldn't make it tonight.,248,31,12,291,644,3371
"Finished with the sharps , you can take them off now",241,45,5,291,644,4633
My next piece is an homage to Keyboard Cat.,225,39,6,270,644,3047
"And now, Boxing Rhapsody",224,41,5,270,644,3199
I usually like soft music but this guy's a real lightweight.,225,39,6,270,644,3733
Next person talking shit about my piano playing is getting they ass beat.,243,32,11,286,644,146
And now the Mike Tyson concerto,240,38,8,286,644,4184
you'll never be a pianist Schumannn....try composing,238,42,6,286,644,4376
"Lesser pianists can play Chopin Etudes with fingers unfettered, but listen to me  . . . says Trump",211,29,9,249,644,1569
Nobody would ask Bobby Short to do this.,211,29,9,249,644,5212
Easy on the piano,252,43,7,302,644,895
"And now, a piece I call Rocky-maninov II.",253,41,8,302,644,4218
Sotto? I thought you said Lamotta....,246,46,5,297,644,947
I will now play Tyson's Pugilist Sonata in B-flat,246,46,5,297,644,3734
The following is `Rhapsody on a Theme of Muhammed Ali',231,38,7,276,644,2039
Are we sure a Rocky and the Piano crossover movie is going to work?,231,38,7,276,644,2630
And now for some beatboxing...,229,42,5,276,644,4734
Let's get ready to risolutooooooooooooooo!,248,33,11,292,644,369
Aaron Copland's 'Knockdown'.,273,41,10,324,644,1539
"I'm all thumbs, which works for Eye of the Tiger.",238,44,5,287,644,2710
"Next I'll play the punk rock version of ""Flight of the Bumblebee"".",249,51,3,303,644,5465
I never thought my job as a keypunch operator would ever lead to this...,224,34,8,266,644,398
"{""This has a high degree of difficulty.""",220,42,4,266,644,4668
"And now, Hungarian Rhapsody No. 2, played backwards!",236,39,7,282,644,1332
Ahma gonna sock it to ya tonight!,234,43,5,282,644,2672
"Float like a butterfly, fly like a bumblebee.",237,37,8,282,644,2936
"Okay, Beethoven, bring it on!",236,39,7,282,644,2979
"Next I'm going to play a little number I call ""The Mike Tyson Etude.""",252,36,10,298,644,324
"And for my next selection I'd like to play  that old favorite, 'Put Up Your Dukes.'",250,40,8,298,644,1774
I will now play the Muhammad Ali boxing overture with gloves.,252,36,10,298,644,1851
"For this next one, I shall punch up the jam.",261,47,6,314,644,1573
I used to play outside the box.,219,35,7,261,644,100
Here’s my rendition of “Heart and Soul.”,219,35,7,261,644,305
My next piece is in the key of Z.,231,40,6,277,644,3434
You bet I know the ‘Notre Dame Fight Song’!,245,41,7,293,644,457
"I will now play the Overture to ""The Boxer's Tale.""",248,35,10,293,644,2845
"And now I will play, what I call, ""The Two Note Handy"".",269,42,9,320,644,410
"The tuner..., where is the tuner? This piano needs to be tuned, right away",242,38,8,288,644,766
Its called the 10 second sonata,261,29,14,304,644,1038
Piano Club,240,42,6,288,644,1365
I call this next piece Pugilistic Percussion...,242,38,8,288,644,3559
And now I shall fight thru Listz’s Campanella,255,41,8,304,644,5208
I will now play a Branding Burger by Bach-Sing-Gloves,242,38,8,288,644,5679
political correctness my ass. This piece can’t be handled with kid’s gloves,252,38,9,299,644,4731
For my first piece I would like to play “Contender” in the key of G flat.”,236,41,6,283,644,2656
"And now,""Bang Bang"",arranged by Jessie J,Ariana Grande,and Nicki Minaj.",236,41,6,283,644,3222
"Imagine Van Cliburn, the early years.",223,38,6,267,644,2440
Feel free to join in with the hook.,225,34,8,267,644,5275
I’m gonna knock this one out of the park!,235,34,9,278,644,611
This next interlude will sting like a Bumblebee,235,34,9,278,644,1422
"Folks, welcome to Raging Bulls. Let’s start off tonight with a rousing chorus of I could have been a contender.”",232,40,6,278,644,3014
did i get the schedule wrong?,233,38,7,278,644,3900
My next selection is Ravel's Bolero.,232,40,6,278,644,5389
"OK Table 4, let's see you request Freebird now!",219,37,6,262,644,3257
Backstage I'm light as a feather but when the lights come on I'm a bit heavy handed.,255,43,7,305,644,2480
I like a good challenge,240,44,5,289,644,2374
"To conclude our selection of Simon & Garfunkel Classics, I present ""The Boxer.""",243,38,8,289,644,2870
Any requests for Chopsticks?,229,37,7,273,644,43
This next original tune is featured on my CD box set.,253,38,9,300,644,495
No worries. I spar with a viola.,251,42,7,300,644,2252
"No, No, No!  I said, ""We need to punch up the LYRICS a bit!...NOT the MELODY!!!",252,40,8,300,644,2303
Does anyone here know how to play 'The Boxer'?,238,39,7,284,644,923
I want you to really belt it out on this one!,235,45,4,284,644,2207
"Well, I can hardly be expected to sumo wrestle in this outfit, now can I?",238,39,7,284,644,2245
"My next number is a variation of Flight of the Bumblebee;
it's called Float of the Butterfly, Sting of the Bumblebee.""",265,34,12,311,644,219
I will now play Boxing with Beethoven,261,42,8,311,644,2146
spouf menhf skgb.,261,42,8,311,644,3958
"The owners of this establishment have asked me to wear these during ""Candle in the Wind"" because I can't help touching myself.",253,29,13,295,644,3343
"Now, I will really bang out the notes!",231,44,4,279,644,4722
Should I start with the hook?,221,35,7,263,644,1270
"The composer was also briefly the bantamweight champion of the world, 1936.",224,29,10,263,644,1689
if we count to 10 maybe he'll leave,248,30,12,290,644,2442
"Just hit the keys lightly, don't knock them out!",242,42,6,290,644,4070
"Now to punch out ""Take the A Train"" by the Duke",230,37,7,274,644,0
Tonight's set is scheduled for 12 songs.,231,35,8,274,644,2422
Float like a butterfly,230,37,7,274,644,3264
My next tune is a knockout you ladies will enjoy.,229,39,6,274,644,5585
"When I was learning to play the piano, I also bit my nails as a kid.......mom made me wear gloves.",267,41,9,317,644,4235
sonata #10 for Boxers in TKO flat,269,37,11,317,644,5568
"I will now perform Beethoven’s 5th round, a piece widely regarded as his boldest.",247,52,2,301,644,1084
"And now, Beethoven's 'Boxing Day Concerto No. 4.'",239,39,7,285,644,2641
"I am not yet prepared to ""take the gloves off"".",237,43,5,285,644,2959
They said my Beethoven last night was everything but passionate.,238,41,6,285,644,5403
I'll knock out the other finalists !,265,36,11,312,644,2275
Ding ding ding,260,46,6,312,644,4809
I can only do the one note Samba,226,36,7,269,644,752
"The secret is ""mind over matter"".",224,40,5,269,644,1354
I am certain that I heard NIGHT club.,227,34,8,269,644,4702
I’m not particularly good with chopsticks.,250,37,9,296,644,800
Are you not entertained?!,247,43,6,296,644,3427
This one has too many sharps,248,41,7,296,644,3842
I will now play Beethoven's 3rd Symphony in the key of TKO,248,41,7,296,644,5439
"All right, you've made your point, no need to be cruel.",238,32,10,280,644,418
I can play other songs than the theme to Rocky you know!,237,34,9,280,644,516
And now I will play a selection from ‘Ready to Rumble for Chopsticks.’,234,40,6,280,644,1251
Up next is the Pugilist's Overature in D minor,237,34,9,280,644,1369
How else do you expect me to play “Eye of the Tiger?”,233,42,5,280,644,3159
Coach said I needed to decompress a little.,256,45,6,307,644,2397
And now for Schubert's Undefeated!,260,37,10,307,644,3163
"Float like a butterfly, sting like a Beethoven sonata!",240,48,3,291,644,3161
"Though best known for his boxing skills, Jack Dempsey could pound out a darn fine tune on the piano - or so claimed his beloved mother.",229,41,5,275,644,1847
Everything about this next piece reflects my mid career change jitters...,231,37,7,275,644,4010
"And now,I will play the theme from ""ROCKY""",254,40,8,302,644,1495
Tonight’s Cage Match! Thelonius versus The Grand! Let’s get ready to Rumba!,242,35,9,286,644,320
"Up next, my biggest hit. It’s a knockout!",263,42,8,313,644,1930
"I’ll be doing The Boxer , originally done bySimon and Garfunkel .
My version is much better , because I have props .",260,48,5,313,644,4420
"Sorry, I only think inside the box.",251,37,9,297,644,2312
I'm having a little trouble expressing the nuances of the tonality on this pieces.,251,37,9,297,644,2674
We are only on the cusp of what reality TV will be,226,38,6,270,644,3215
"if you don't like it, leave",250,39,8,297,644,3864
"My next piece is Rocky's Rachmaninoff""s Piano Concerto .2",230,30,10,270,644,4237
"And now, Rocky Concerto #3 in D Minor.",247,45,5,297,644,4327
'To the tables down at Mory's'? Oh. I thought you wanted the fight song.,258,43,7,308,644,3422
Cliburn's mama said knock you out . . .,239,32,10,281,644,927
I'm gonna beat this music into submission.,237,36,8,281,644,1263
"I don’t tickle anything,I float like a butterfly and sting like a Muthafucka!",238,34,9,281,644,1505
"And now:
Chopin Prelude in #@%? minor.",247,36,9,292,644,1412
"And now, Chopin Nocturnes, punched up.",245,40,7,292,644,4111
"Shall we begin, Maestro Tyson?",226,29,10,265,644,2578
I’ve been known to bang out those oldies but goodies!,218,45,2,265,644,4224
"What? I'm just preparing for the end 
of Tchaikovsky's 1812 overture.",254,42,7,303,644,3407
This next piece has a nice right hook.,233,35,8,276,644,2188
I’m going to play the next song with alternating body parts,235,31,10,276,644,2784
Now I would like to play my rendition of the 'Rope-a-Dope' overture,239,43,5,287,644,1008
Victor had always wanted to be a two sport competitor,242,37,8,287,644,5680
I did not lie on my C.V.,250,41,7,298,644,965
"I said ""A box for the recital.""",225,42,4,271,644,3480
Use the hook!,259,43,7,309,644,4357
"Mama wanted me to be a pianist, but my doggie wanted me to be a boxer.",257,47,5,309,644,5593
"Next, I'll be pounding out Helter Skelter.",238,36,8,282,644,259
"...and now, the Concerto Pugilisto in C# Major by Muhammad Ali...",236,40,6,282,644,2063
"My next number is ""Bust Your Chopsticks""",239,34,9,282,644,2379
I can’t fight this feeling anymore. I’ve forgotten what I started fighting for...,238,36,8,282,644,3132
"Softly may I punch the keys with the theme from ""Rocky"" fortissimo.",214,35,6,255,644,4543
"Pay per view on PBS—
Rocky vs Rachmaninoff",247,38,8,293,644,1240
"I call this next one ""Flight of the Bumble.""",246,40,7,293,644,3777
"Next, I'll pound the ivory for you in my version of--ahem--Rocky's Concerto in D Minor.",246,40,7,293,644,4075
"All of the greats are dead, so I'm not taking any chances.",245,42,6,293,644,5393
A little more Stockhausen?,247,38,8,293,644,5518
"Especially for fight fans, Chopin's Three Minute waltz.",224,35,7,266,644,4637
I never should’ve agreed to this Boxing Day Special…,233,37,7,277,644,2367
It’s modern music !,233,37,7,277,644,2679
Are you kidding me? These aree not the kid gloves I had in mind!,244,35,9,288,644,4095
I will now play the Bang Bang Bang Concerto,241,41,6,288,644,4096
But it's my version of the 'Rocky' theme!,252,39,8,299,644,1320
Here’s one for all you glove birds out there tonight.,254,35,10,299,644,5692
...and now a new composition intended for tweeting.,262,39,9,310,644,956
What happens after the glissando?,229,36,7,272,644,2236
You can Tune a Piano but you can't Tuna fish,274,35,12,321,644,2725
"In synthesis of my interests, I will be playing the theme from 'Rocky'",237,40,6,283,644,1423
"And for myy next selection,""Punch Drunk Love""",237,40,6,283,644,1469
"Cut me, Maestro.",239,36,8,283,644,2608
It was another knockout performance by Philip!,248,38,8,294,644,824
I'm multitasking.,245,44,5,294,644,1385
We will start the evening with a little Rachmaninoff up in here.,248,38,8,294,644,2270
I present Invention no. 3 the way it was meant to be played:   Bach-xing style.,246,42,6,294,644,2906
You actually thought this might sound good?,248,38,8,294,644,4583
I’m ready to do battle with this Beethoven piano concerto!,254,46,5,305,644,1576
I am playing “The Boxer.”,226,33,8,267,644,4608
My piano career started out rocky but I'm getting strong now.,233,39,6,278,644,26
"And now, a little paino...",233,39,6,278,644,2563
This next concerto was inspired by incompetent eight-year-old and my lack of empathy.,234,37,7,278,644,3770
I don't see how I can hit the high notes,236,33,9,278,644,5288
One mustn't perform this next piece with kid gloves.,242,41,6,289,644,2168
"...if you must know, I am a welterweight",243,39,7,289,644,2811
I've Got Blisters on My Fingers,245,35,9,289,644,3315
"And now, in a salute to Bill Conti, I’ll perform “Gonna Fly Now” from Rocky..",251,43,6,300,644,3205
I have a day job as a key punch operator.,264,37,10,311,644,434
I’m practicing my Boxing Day medley.,219,38,5,262,644,3288
For my next piece I’ll play ‘Piano Is Very Manly Dad’ in A-minor,223,30,9,262,644,5534
"After several failed attempts to entertain his audience, Manuel stumbled upon the key to his knockout set.",226,44,3,273,644,3983
"For my next number I'd like to play an extract from the soundtrack for ""Rocky"" called ""One More Round"".",238,40,6,284,644,563
Sometimes the C13#5b9 fights back.,242,32,10,284,644,3881
"And now, Johanna Sebastian Box’s  One and Only Sonata in B-flat",240,36,8,284,644,4460
I'm training for a John Cage-fight.,254,28,13,295,644,2549
And now for my final piece.. I will be playing boxsticks.,251,34,10,295,644,4206
Chopsticks anyone?,246,44,5,295,644,4853
Welcome to the half price tribute to Elton John,257,42,7,306,644,5174
Chopsticks was easy.,266,44,7,317,644,283
And now I would like to do a little thing I wrote called bopsticks,214,39,4,257,644,426
"And now my own original composition, “Piano Concerto No. 1 in Box Major.”",215,37,5,257,644,1742
I am trying to punch out two chords at a time.,221,45,2,268,644,1499
My hands get cold!,226,35,7,268,644,2483
Box me Amadeus,237,33,9,279,644,2012
Want to sing a few rounds with me as I play?,229,49,1,279,644,2530
"Whateya mean, 'go to my corner?'What round are we in?",242,43,5,290,644,292
He dreams of the days when audiences just wanted their money back...,246,35,9,290,644,1717
"It's really hard for me to play the piano because my hands are
in boxing gloves.",248,31,11,290,644,3835
"And now,Box Piano Concerto in D Minor.",246,35,9,290,644,5017
I’m sorry. I can’t. My hands are tied!,246,35,9,290,644,5215
"By popular request -- the Butterfly and Bee Sonata in A sharp major""",254,39,8,301,644,2600
"And now for my own exuberant interpretation of ""Eye of the Tiger""",223,32,8,263,644,1691
My wife never wanted me to wake the kids.,218,42,3,263,644,4078
Liberboxy.,232,34,8,274,644,1972
Jabs aren't as effective on the piano.,230,38,6,274,644,3390
Can I call Sarah Sanders or Sean Spicer for advice?,242,34,9,285,644,836
If you don't stay quiet I'll take my gloves off!,238,42,5,285,644,3255
I call this one The Flight of the Dirigible.,240,38,7,285,644,5026
Let’s get ready to Tinkle!,252,34,10,296,644,125
I will now play 'Chopsticks' with using only my thumbs.,248,42,6,296,644,3466
"Maestro, I understand this is a Rocky-themed concert, but...",250,38,8,296,644,3529
"Well if you didn't like that, you're going to hate the undercard.",216,37,5,258,644,17
"And now what I call ""Mozart's Mohammad Ali Sonata.""",237,35,8,280,644,747
"My next piece is called, ""Kapow!""",243,43,5,291,644,40
Would someone in the audience lend me a hand or two?,241,47,3,291,644,4441
I am NOT playing chopsticks tonight!,254,41,7,302,644,3601
My last gig was the Punch n Judy Show!,253,43,6,302,644,3793
"And now for my encore, “The Float of the Bumblebee”",267,35,11,313,644,543
I will now play a selection of works by Hans Zimmer.,236,28,11,275,644,579
Join in while I play a Bach-Sing Along.,211,38,4,253,644,665
Could someone please stick their head in the Green Room and wake me up?,226,28,10,264,644,1902
I'm only the undercard.,237,46,3,286,644,2089
I call this one 'imagination'.,249,42,6,297,644,2158
My teacher said the audience would go wild!,271,38,10,319,644,2317
"That's half of it, they stuck my legs in cement",241,38,7,286,644,2369
"Did I hear a request for ""Flight of the Bumblebee?""",249,42,6,297,644,2782
"And now, some Stockhausen.",243,34,9,286,644,3017
"I,ll knock one out to you",254,32,11,297,644,5344
"At Master Class, he said I was pounding the keyboard. I just want to play the triangle.",253,34,10,297,644,5388
Now for the Opus One-Two--bang! Right in the kisser.,246,39,7,292,644,420
my hands are really delicate,248,35,9,292,644,1093
"It’s a strong metaphor, but the next piece I wrote really has nothing to do with boxing.",247,37,8,292,644,2212
This next piece requires more than a little punching up.,242,47,3,292,644,3377
"I don't hate Beethoven, but I pity the fool!",247,37,8,292,644,4493
"And now, my rendition of Rock'em Sock'em Staccato",244,43,5,292,644,4986
"And next: my variation on an etude by John Cage.
...In D-minor.",241,29,11,281,644,3605
"And now, the Box Sonata in d minor",240,31,10,281,644,3717
Where are the nose flutes?,224,43,3,270,644,2259
"Liebestraum No. 3, by Franz Liszt. What's it to ya.",228,35,7,270,644,3682
It's called free jazz.,221,29,9,259,644,3934
I just don't want Lang Lang to see my fingerings!,242,38,7,287,644,4062
Round 1: Classical Beats,238,26,12,276,644,817
I thought you wanted me to do interval training.,234,34,8,276,644,1402
"So she says I can do it, then doesn't show up",233,36,7,276,644,5392
I guess they don't like Shostakovich.,223,36,6,265,644,2942
Maybe no one will notice,252,49,3,304,644,1665
But the keys are sticky!,257,39,8,304,644,1818
This next piece is 'Ode to Mom',251,31,11,293,644,1555
Baby it’s cold outside.,237,39,6,282,644,1246
"Ladies and Gentlemen, Rocky Beethoven.",239,35,8,282,644,1670
Tonight I thought I’d give beatboxing a try.,237,39,6,282,644,1693
Anyone have a sippy-cup?,239,35,8,282,644,2993
I will now play “Theme from Rocky.”,240,33,9,282,644,3516
Boxeo:  A Concerto In Two Fists,238,37,7,282,644,4365
And now I suppose you're going to request Liszt's Campanella?,232,29,10,271,644,1373
"This evening,I'll be punching out my new hit.",227,39,5,271,644,4405
"I'm going to punch my way through this tune, no pun intended.",202,29,7,238,644,3646
"This next one is called 'Song for My Mother, but also My Father'.",254,36,9,299,644,2349
"I shall now play ""The Flight of the Bumblebee""",235,34,8,277,644,1400
"I'm sorry, say that again ?",232,40,5,277,644,3992
Simon did this song the easy way.,222,40,4,266,644,2802
"For my encore, Thumbsticks.",246,43,5,294,644,3169
"And now, a ci·né·ma-vé·ri·té reimagining of the theme to “Rocky” — as played by the protagonist.",251,33,10,294,644,4287
He was a Double Major.,236,43,4,283,644,4024
"And now, variations on a theme of Pacquiao.",238,39,6,283,644,4208
I believe I've found the lost chord.,281,44,8,333,644,4705
This isn’t the Steinway vs. Sons match?,223,49,0,272,644,2071
"I need these to play Prokofief's variations on Chopsticks,",230,35,7,272,644,5229
Now for some Beathoven...,264,38,9,311,644,1593
Concerto for the dexterity impaired.,251,44,5,300,644,4855
They said I ought to have a knockout on the piano during the performance,244,38,7,289,644,3883
"They say the Rach 7, is very tough",246,34,9,289,644,4488
"And now, the 1812 Overture....",235,36,7,278,644,1820
What if I need to use the little boys room...?,234,38,6,278,644,1894
This one is called 'Midnight Cat'...,237,32,9,278,644,2493
"Volti subito, or else.",221,44,2,267,644,404
And for my next bout: First performed by the legendary Queen..,251,35,9,295,644,604
"Oh shit, I left the light on at home.",251,35,9,295,644,1276
"Last night, my anxiety dreams reached crescendo level.",249,39,7,295,644,2403
This next piece will be a box waltz.,240,37,7,284,644,423
And now Piano Concerto for the Old One Two.,240,37,7,284,644,4430
"I call this ""Adrian""",229,39,5,273,644,5525
"And now, Mama Said Knock You Out No. 12",236,25,12,273,644,5541
It galvanizes my bass.,227,23,12,262,644,4514
This next one’s a punch up of an old classic.,242,44,4,290,644,144
They were out of hams.,251,26,13,290,644,3628
My next piece is dedicated to those who failed to achieve their boyhood dream despite a very inspiring '70s movie.,236,36,7,279,644,467
It keeps going out of tune.,234,40,5,279,644,3007
"In honor of Victor Borge I shall strike up the band, by hand.",235,38,6,279,644,4538
Badda Bee Badda Boom,258,43,6,307,644,2256
"It's ok, I'm just the undercard.",223,42,3,268,644,1097
"Seriously, I'm trying my best,",223,42,3,268,644,2193
We are definitely “going out with a bang” tonight!,219,30,8,257,644,652
"Lie la lie, lie la la la lie lie
Lie la lie, lie la la la la lie la la lie",241,37,7,285,644,959
"And then I wrote the theme song for the movie ""Rocky"".",246,27,12,285,644,1992
"I know, I know it's disappointing. Yet here in this golden Trump Hotel DC I feel strangely moved to present my own version of A Boxer's Rebellion.",239,41,5,285,644,2922
"Oh, it's Rocbalboa's piano concerto in A flat.",236,47,2,285,644,4532
"Tonight I will be performing the classic melodic death metal album 
""Hot Yoga Farts""  by ""MetalMurderSexMachine."" I thank you for your support of the fine arts.",244,31,10,285,644,5699
I feel as if I'm punching the keys.,265,40,8,313,644,727
My next number will be a medley from Punch Drunk Love.,234,31,9,274,644,1656
"I just said I'd be Bach.  See sharp, not be flat.  
Mistake to hire agent instead of trainer.",260,30,12,302,644,44
I'm going to treat this next composition with kid gloves.,261,28,13,302,644,182
My final selection is a tribute to Glenn Gould: Box 'Goldberg Variations'.,256,38,8,302,644,4473
This one calls for a lots of Fs.,223,33,7,263,644,3300
I will now play 'Pugilism in D minor'.,221,37,5,263,644,5145
"And now, I will play “Flight of the Ostrich.”",245,40,6,291,644,3822
I will now knockout a concerto by Boxmaninoff,246,38,7,291,644,3952
My first number will be Bach's Concerto to Mike Tyson,264,33,11,308,644,301
Could I get my cut man up here for this next piece?,264,33,11,308,644,3667
"Ladies and fentlemen, for my next number my rendition of Punch Drunk Love.",258,45,5,308,644,5550
"And now, I'll knock out ""It Don't Mean A Thing.""",236,38,6,280,644,5707
I  won't be taking any more requests ladies and gentlemen,251,39,7,297,644,2289
"I said ""piano"" not ""Marciano.""",226,38,5,269,644,914
"And now, the American premiere of Chopin’s early Black-Eye Etude.",240,41,5,286,644,2033
Think outside the box...ing gloves?,241,39,6,286,644,4446
Any guesses on my first career?,256,40,7,303,644,1830
"Tonight, ladies & gentlemen
Punch for Punch in B Minor",258,36,9,303,644,2370
We said the audition was for covering Marvin Hamlisch not Marvin Hagler.,231,39,5,275,644,4812
If you wear these you can hit the K and O notes,273,37,10,320,644,5137
I play as a butterfly and sting like a bee!,247,38,7,292,644,1035
I've been told this next piece is a real gut punch.,247,38,7,292,644,3124
"I will now play 'Braggadocio,' an etude of my own composition.'",246,40,6,292,644,5562
"Well, I find it easier than the string bass.",246,40,6,292,644,5612
"I'm gonna knock Mr. Steinway out, then I'm gonna knock him back in again.",260,43,6,309,644,858
One man show. One man audience.,266,31,12,309,644,3448
"And now, Bach’s most famous counterpunch!",238,36,7,281,644,3187
This is a new piece I call pianissimo,253,37,8,298,644,2875
"The ""Rocky Theme"" may be more challenging than anticipated...",251,41,6,298,644,5361
Bach's fourth fugue?  I thought you suggested box for the few--,231,30,9,270,644,793
"Now playing the ""Clean Up the Government"" sonata.",230,32,8,270,644,1878
Pugilist Waltz in C...,230,32,8,270,644,2199
"Hang on, folks, I need to tune him up.",228,36,6,270,644,4573
I'm going to belt out the latest showstopper.....,225,42,3,270,644,5150
"the piano is a broad spectrum instrument whose range is rarely exploited in full...I invite you to listen carefully as I play my 
concerto no1 ""for our times""",245,33,9,287,644,2441
"Round four will be a short John Cage piece, and then I have a request for the dance mix of Swing, Swing, Swing.",243,37,7,287,644,3739
The theme to Rocky 12,219,34,6,259,644,2907
I will now play 'Chopsticks' in the key of D sharp minor.,233,37,6,276,644,2519
"Yes, my rendition of the Creed theme song was a little rocky.",238,27,11,276,644,2769
Requiem for a large harmonica.,249,36,8,293,644,2823
...And now I'll show you how I gave him good Haydn.,225,33,7,265,644,4706
"Next, I will belt out ‘Clair de Lune.’",224,35,6,265,644,5533
This next piece is the Apollo’s Creed.,228,38,5,271,644,4023
"And now, my version of ""Eye of the Tiger.""",244,37,7,288,644,2163
We'll knock 'em out with Beethoven,241,43,4,288,644,4026
its the beat,273,41,8,322,644,658
I’m Boxing Jim - subbing in for One-Eye-Closed Ron. Hope you like it.,250,36,8,294,644,1977
The Cadenza!,249,38,7,294,644,4498
"Then . . with his next Indictment Rhapsody . . it was time to take off the gloves. Notice the developed motifs . . the supporting intricacies . . .No more sparring, as it were  . .",223,39,4,266,644,653
"I'm playing my, "" Float Like A Butterfly, Sting Like A Bee,""  song.",227,31,8,266,644,1405
I attack ferociously every piece I play.,227,31,8,266,644,2091
"I shall now play my ""Uppercut Sonata"" until the sound of the bell.",224,37,5,266,644,3957
And now a selection from the Simon and Garfunkel songbook.,241,34,8,283,644,5538
"Half-step, bob and weave.  Float like a butterfly, pound the keys like Liberace.",252,43,5,300,644,522
Hey!  YOU requested a soft glove song...,252,43,5,300,644,2998
I'm afraid this piece requires one to pound the keys.,214,37,4,255,644,143
This adds emphasis to my allargando.,247,33,9,289,644,210
This next one has a knockout one-two-punch! one-two-punch! hook.,202,30,6,238,644,447
"Uh, what fresh hell is this?!",231,34,7,272,644,2031
"According to known aerodynamic principles, bumblebee flight is not possible.",242,43,4,289,644,2529
"No, really --- ""Man, what are you doing here ?!""",232,32,8,272,644,4289
What? My fingers are cold!,247,33,9,289,644,4584
"This is a number I like to call, TKO.",257,44,5,306,644,4721
When you have to perform Mozart at 8 but fight in the ring at 9.,281,38,10,329,644,849
*I forgot my pants*,253,32,10,295,644,3379
'Toccata and fugue in g minor' by J.S. Box.,250,38,7,295,644,4586
"Ladies and gentlemen, please pardon the gloves. They're a temporary solution to my chronic masturbation.",241,25,12,278,644,1842
"Next I shall play ""Music Dance Boxer"".",241,25,12,278,644,3232
"This one's called ""Revolution 9.""",236,35,7,278,644,5486
"I call this one, 'Jabba, Jabba, Jabba'.",253,43,5,301,644,5407
Now for my favorite Boxthoven Sonata.,237,44,3,284,644,273
"Oh, it saves my fingers for the performance.",236,46,2,284,644,3210
How long is Fur Elise again?,243,32,9,284,644,4624
Now for a rendition of that Simon and Garfunkle classic 'The Boxer',226,35,6,267,644,280
"For my next number: ""Flight of the Bumblebees""",228,31,8,267,644,3303
Every body has a plan until they are told to play.,243,43,4,290,644,1295
And now I'd like to play for you the opening bars of Beethoven's Fifth Symphony.,248,33,9,290,644,3626
Watch as I play a mean “Three blind mice.”,250,29,11,290,644,5445
"And now, my tribute to Liberace.",234,30,9,273,644,3052
"Please don't yell at me Coach! I know the fight is tomorrow, and I should be skipping rope and running up the stairs and stuff like that, but, may I tell you something? Music means more to me.",228,42,3,273,644,5394
I stay in shape by playing a few clusters before taking off the gloves.,204,28,7,239,644,5511
my insurance agent will be here soon to release my hands,252,36,8,296,644,3408
My next song will be in the key of OH.,250,40,6,296,644,3636
"And now, Toccata, no Fugue.",236,37,6,279,644,421
Mama Said Knock You Out in E Flat Major...,236,37,6,279,644,1293
I'm composing a theme song for a film called Rocky.,237,35,7,279,644,2110
He never expected his performance would be such a hit.,238,33,8,279,644,4231
The staccato notes have been omitted.,235,39,5,279,644,5058
Music AND sports? 'Wild Thing' says yes.,224,30,8,262,644,1554
"So Mr. Tyson, who do you think has a tin ear now?",254,43,5,302,644,990
Its suposed to Sound like that,257,37,8,302,644,1191
"For this next tune, I recommend dancing the box-step.",255,41,6,302,644,1621
"In this corner, three time concerto soloist, the Piano Man, the KO Kid.",256,39,7,302,644,2106
Will you ring da bell?,239,42,4,285,644,2266
How much did you bet?,239,42,4,285,644,3766
I would like to pound out my latest political satirical piece.,241,38,6,285,644,3964
I tried to explain to the people in wardrobe that the fight isn't till tomorrow night!,241,38,6,285,644,4657
He Was shooting for a knockout performance after all,245,41,5,291,644,3501
Just getting ready to pound out some New Wave.,234,32,8,274,644,41
"And now, for the fifth time, the Theme From Rocky.",231,38,5,274,644,480
"And now a piece from Ali-Frazier ""Thrilla in Manila.""",232,36,6,274,644,4339
This is not a piano. It is a music box.,232,36,6,274,644,4412
Now I shall play “Float Like A Butterfly and Flight of the Bumblebee”.,234,32,8,274,644,4518
"I do take requests, as long as they are ""Chopsticks.""",222,25,10,257,644,4530
"It's called ""12 Rounds"" . People find it punchy.",251,40,6,297,644,596
"Ahh, Happy to oblige! Chop sticks it is!",253,36,8,297,644,2128
This next tune appears on the boxed-set anthology of my greatest hits.,254,34,9,297,644,5080
"Man, they've really run out of ideas for new Rocky movies",238,35,7,280,644,1565
"For all of you who think I'm all thumbs I present the ''Everlast
Serenade.'",237,37,6,280,644,2192
"Thou shalt see these thumbs play all 88 keys, then I'll float like a butterfly, sting like a bee.",240,31,9,280,644,3149
This next composition is an opera prelude by my Nebelung cat.,259,35,9,303,644,2910
"Looking out on the crowd, I think I may have hit the wrong note.",220,40,3,263,644,213
"I've been so anxious lately...I think my stage ""fight"" is getting worse.",223,34,6,263,644,3769
My next piece will be Box Piano Sonata.,242,38,6,286,644,620
"Theme song from ""Rocky"" anyone?",243,36,7,286,644,815
"My next piece is titled, 'Float of the Butterfly!'",246,30,10,286,644,3254
I can do anything.,262,40,7,309,644,2074
"And now the 'Rocky' sonata in E minor.""",263,38,8,309,644,2969
LET’s Let’s let’s GET Get get READY Ready ready TO To to BACH Bach bach.,270,35,10,315,644,2786
"Sorry, my trainer just quit.",231,40,4,275,644,2420
"Thelonious Monk today, tomorrow, forever!",236,30,9,275,644,2644
I just don't hit the keys... I hit them like a pro.,253,38,7,298,644,3994
This is one of my recordings featured in my latest box set of piano pieces.,236,41,4,281,644,2806
I’d say I have a softer touch than Oscar Peterson.,238,37,6,281,644,3585
Box piano concerto no.1 packed quite a wallop in last night’s concert.,259,37,8,304,644,1731
What is going on? They didn't tell you I am blind!,226,30,8,264,644,4877
"And now, Beethoven's Mmmm%$oonli88ght So?#natta2222222222...",246,32,9,287,644,2643
"If Liberace could do it, so can I,",243,38,6,287,644,3924
"Now for my next bout, how about mostly Mozart?",264,38,8,310,644,5311
"Now that the jab is established, I'll work the body a bit.",235,34,7,276,644,364
"And now a knock-off of ""Baby, It's Cold Outside.""",233,38,5,276,644,1995
#RockyManEnough,233,38,5,276,644,2585
How about a little Beethoven?,213,36,4,253,644,3689
Next I shall play 'Boonlight Bonata.',256,34,9,299,644,3981
Take the gloves off!,234,36,6,276,644,4588
"And now C Flat in, you guessed it, C flat.",257,43,5,305,644,768
Waltzing Matilda? I heard Boxing Matilda?,240,35,7,282,644,782
I can't feel my hands!,244,27,11,282,644,4191
"Oh...I thought we were doing Ravel's 'Bolero"".",241,33,8,282,644,4509
"Sorry, my German is pretty bad, I thought they told me to get ready for Beat Often.",222,29,8,259,644,3005
"And now, my own special version of ""Mama Said Knock You Out""",222,29,8,259,644,3233
Pugalistic Punching Music by Steve Reich,266,36,9,311,644,791
"This next number will be a ""mash-up"" of   Mozart vs Eminem",246,34,8,288,644,21
"Drink up, everyone! The next 15 rounds are on me.""


LockaBlocka2018@gmail.co",250,26,12,288,644,2311
I will now perform ADRIENNE !   by Rocky.,244,38,6,288,644,2961
"And then , at the peak of the crescendo , you take the gloves off and proceed with a gentler finale for ten fingers...",223,38,4,265,644,75
For my encore Rondo #10,225,34,6,265,644,3033
"And now, Liszt in a clinch.",228,39,4,271,644,3939
"Please enjoy the next piece in our Mixed Martial Music Series called ""Find The Tune"".",278,34,11,323,644,3312
Unanimous? Another ballad it is.,254,40,6,300,644,1315
I'm saving them for my hand model gig.,252,44,4,300,644,2051
Ready for some big block chords?,257,34,9,300,644,3031
Box seats at the matinee.,255,38,7,300,644,3697
I will now play Box Piano Concerto in F Minor,233,40,4,277,644,2021
I didn’t know a standing ovation was even possible at a music therapy recital!,233,40,4,277,644,3223
"And for my next number, Sonata For Boxing Day",237,32,8,277,644,4720
I took off my white gloves for the encore: 'Tribute to Liberace,257,45,4,306,644,2333
I'm hoping this next number will appeal to the Millennials.,243,31,9,283,644,617
"YOU ASKED FOR 12 TONE SERIES IN FORTISSIMO ,
VOILA   ......!!!",245,27,11,283,644,1721
Thank you. Thank you. This last piece is for mother who has always observed that my playing leaves her feeling most short-changed in the note-differentiation department.,240,37,6,283,644,5011
"And for those who may be offended by any of my songs, I've taken matters into my own hands.",221,33,6,260,644,76
I will now play a composition by Charles Ives.,222,31,7,260,644,1807
Get ready to ruuummmble!,247,34,8,289,644,2962
"And now, the butterfly and bee concerto.....",226,34,6,266,644,1152
"Ladies and gentlemen, there's no need to worry, these are only kid gloves.""",224,38,4,266,644,1594
I need to protect my assets!,227,32,7,266,644,3951
"To get the desired softened effect,boxing gloves may be used instead of the pedal.",226,34,6,266,644,5599
You disgust me.,232,33,7,272,644,574
"And now, Boom Chuck Chuck in D minor.",232,33,7,272,644,3962
A concert pianist's bad dream after eating spicy tuna rolls after 9pm,261,28,12,301,644,1840
Contemporary music these days...,257,36,8,301,644,4985
"For my encore, I will play a two finger polka.",237,34,7,278,644,3623
You may remember me from the orchestra for “Rocky” on Broadway.,237,34,7,278,644,4767
"And now, I will take on Bach’s Canon.",216,34,5,255,644,809
"I thought they said grand championship, not grand piano.",239,41,4,284,644,2587
Concerto “Antifortisimo”,242,35,7,284,644,3453
Hitting the keys has a whole new meaning with these gloves on.,239,41,4,284,644,3592
You try playing with these things on.,224,29,8,261,644,1546
Can you punch me in?,249,32,9,290,644,2066
"So this little number’s called, ‘Race for the White House.’",278,38,9,325,644,5384
"Damn it! Not this again,"" huffed his unimpressed, exasperated subconscious at his mediocre nightmares.",250,41,5,296,644,2387
He’s really taking the battle of the bands serious this year,227,34,6,267,644,3882
"This next piece is the TV sportscast theme from ""The Rumble in the Jungle.""",228,32,7,267,644,3887
"For my next number, Chopsticks.",255,42,5,302,644,5437
"No, I didn't forget anything!",230,39,4,273,644,1775
"Excuse me, but it's NOT  called ham-fisted!",231,37,5,273,644,4083
I was told it was impolite to tickle the ivories without their permission.,238,34,7,279,644,1481
This week I'm trying out boom-boxing.,237,36,6,279,644,4834
"If you have any requests, please raise your glove",237,36,6,279,644,5258
In the next round I'm going to play one of the all-time hardest hits of Rodgers and Pummelstein.,236,38,5,279,644,5597
All my unfinished symphony needs is for me to complete the punch list.,239,32,8,279,644,5631
Tell me when I get to a 10-count.,266,42,6,314,644,130
"Keep playing or start fighting, that's the question",266,42,6,314,644,1370
"What! I was  to train Bach's way, not box way?",240,41,4,285,644,4833
And now for some post-Charles Ives.,217,34,5,256,644,1067
Let's see you demand 'Free Bird' now.,245,42,4,291,644,1453
"Tonight, I’ll be playing 4’33”.",250,32,9,291,644,4033
Welcome to the new Two Note Piano!!,248,36,7,291,644,4308
"Ah, the light! It was prerecorded, yes, but I wrote every word.",222,35,5,262,644,3622
My agent asked me to perform something more inside the box.,253,37,7,297,644,2082
"Pound-for-pound, Frank is one of the best, but tonight he just couldn’t beat the refrain.",249,45,3,297,644,4667
"Sure, I'll play you a song. But first, I need to take off my gloves!",229,32,7,268,644,1824
Does the key of A major have three sharps?,256,42,5,303,644,2269
"One more thing, I majored in Sociology.",260,34,9,303,644,4739
Of course it looks silly - but you try playing pianissimo on a Hammerklavier,232,37,5,274,644,3340
"Wow, that concerto really packed a punch.",240,32,8,280,644,3035
The next piece was originally composed by Rocky Marciano.,237,38,5,280,644,4491
"I was told ""the gloves won't come off""

Chris Krusa",245,44,3,292,644,2658
"Maestro, cut me please.",246,42,4,292,644,5354
And now for a song by Everlast.,285,39,9,333,644,4942
And you all sound like you're sawing wood.,255,35,8,298,644,4401
"I shall now perform Rachmaninoff's Concerto No. 3, followed by a piece of my own composition, Lionel's one-two.",222,37,4,263,644,5197
This next one is called 'The Fight for Art.',261,34,9,304,644,3346
And now Eye of the Tiger in C minor,227,38,4,269,644,107
This next dance will be the box step.,228,36,5,269,644,624
"I'll just be pounding out a few jabs for you, until the main event tonight.",227,38,4,269,644,4053
I shall perform a round by the Marquess of Queensberry.,234,35,6,275,644,3753
I said with my hands tied behind my back,234,35,6,275,644,5632
"Float like a butterfly, sting like Ali.",240,34,7,281,644,812
"Theme to 'Rocky'.""",246,33,8,287,644,229
If it calls for cords I can.,247,42,4,293,644,4690
I knocked that song out of the ring.,213,35,4,252,644,1267
This next one goes out to The Enemy of the People.,258,31,10,299,644,2675
"I shall now proceed with "" The Lost  Chords""",254,39,6,299,644,3363
Ah! I beg your pardon. Bach’s what?,255,37,7,299,644,5689
"I don’t care if Streisand loves The Main Event, I’m never playing it agaiin.",220,32,6,258,644,4520
Oh! I prepared for the wrong event!,261,36,8,305,644,2593
So which joker requested The Minute Waltz?,229,36,5,270,644,223
No need to go to this extreme.  I promise: no more chopsticks!,273,34,10,317,644,5360
This is one of Tchaikovsky's greatest hits. I hope you'll enjoy it.,232,41,3,276,644,2292
On the scales at 300lbs...,242,32,8,282,644,5102
Oops! Wrong Job.,246,35,7,288,644,2142
"No requests for “Freebird,” lest thee desire a proper pummeling.",246,35,7,288,644,2499
Are you sure this is how to play Diminuendo?,249,40,5,294,644,4533
And this next piece is just brutal on my fingers.,249,40,5,294,644,4746
Standing in for Paul Simon tonight....George Foreman!,253,32,9,294,644,4920
... and my next piece is entitled 'Banging on Keys with Boxing Gloves'... in D minor,254,41,5,300,644,1413
Now I'll play Chopin with my left foot while eating an ear of corn.,261,38,7,306,644,66
It's my way of fighting the good fight.,257,46,3,306,644,924
Sorry folks can't play tonight; this stage fight got the best of me.,262,47,3,312,644,2181
Now for the knock out blow!,226,33,6,265,644,2690
"That was the Moonlight Sonata.  Oh, no, wait--it was Frosty the Snowman.",225,35,5,265,644,2975
I will now demonstrate how to properly beat an antique piano.,224,37,4,265,644,4230
I'm the first boxer to perform in Carnegie Hall.,238,31,8,277,644,5183
Now let’s just lay back with the smooth ‘n’ easy sound of Chuck Wepner.,243,32,8,283,644,1493
I don’t want anyone stealing my fingerings.,242,34,7,283,644,3449
"For my next piece, I will play 
Bacchanale by John Cage",255,30,10,295,644,4998
I just hate playing with cold hands.,268,37,8,313,644,1401
My next set has a pirate theme....pass me my hook please.,266,41,6,313,644,2179
"And now, a selection of pieces from Ludwig Von Beathovan, Wolfgang Ama-No Mas Mozart, Johann Sebashing Bach and Giacomo Punchini.",274,36,9,319,644,1669
Way easier than my last job. There we had to know how to count all the way up to 10...,221,34,5,260,644,1278
I will now go Bach to basics.,231,36,5,272,644,360
"Now, for my next act, I will make this piano disappear!",232,34,6,272,644,2744
"And now, a short tone poem by Floyd Mayweather...",230,38,4,272,644,5284
"This next piece is called: ""Alex Jones in C Minor"".",242,25,11,278,644,4029
And now for box prelude in C Major.,245,30,9,284,644,1788
"And the last piece tonight is Ali's ""Piano Sonata in A minor"".",242,36,6,284,644,2526
"Und now vee geev you
 Bach’s ‘Erhöhtes Fleisch und Blut’",240,40,4,284,644,4972
Are you sure Beethoven started this way?,247,37,6,290,644,2032
"I'm thrilled to debut my most recent composition. 
'The 2018 Overture in G Major'",249,44,3,296,644,51
"Hey look, Mohammed Ali was a poet. I’m a pianist.",258,26,12,296,644,3873
And now for the Bach-sing along!,253,36,7,296,644,4730
There are those who find Rachmaninoff bombastic.,220,27,8,255,644,764
What have you been smocking? Gloves have nothing to do with it. Really bad piano tuner!,224,30,7,261,644,1759
"I’m a lover, not a fighter!",230,29,8,267,644,2306
I call this one 'Bopsticks'.,239,33,7,279,644,1828
"Now, I wrote this piano concerto in honor of ""Rocky 4.""",235,41,3,279,644,3710
"So, you think this would go better with a necktie?",247,28,10,285,644,4764
His Carnegie Hall dreams knocked out in a single piece.,245,43,3,291,644,2438
Could you please tune this piano?,247,39,5,291,644,2464
"Viggo, this isn't working!",249,35,7,291,644,2595
I will now perform a real knockout of a tune!,255,34,8,297,644,2381
Play to win!,266,34,9,309,644,2911
"For my next act, I will be playing ""under pressure"".",217,35,4,256,644,4198
Round 13,237,28,9,274,644,1734
Who requested a glove song?,239,35,6,280,644,4688
"Yes, Frère Jacques IS a round in tonight's Ring cycle.",246,32,8,286,644,2764
"The next few songs are a touch more mellow, softer....",243,38,5,286,644,4036
Is there a Corner Man in the House?,249,37,6,292,644,197
"For my next number, I'm going to play Moe Zart's ""Rondo alla Trump""",251,33,8,292,644,4090
"I'm pretty sure this next one's called, ""You Go to My Head.""",259,39,6,304,644,178
"Oh no, where's the men's room?",260,37,7,304,644,221
"Without your hands and wrists you have no career, so I always keep them safe!",263,42,5,310,644,3008
"We conclude our ""Cinema from the 70's"" program with this classic rendition of ""Eye of the Tiger.""",267,34,9,310,644,3988
Is this not what it meant when it said the music was hard hitting?,269,41,6,316,644,3799
Play to win what?,269,41,6,316,644,4675
This next piece was written by a boxer.,231,31,7,269,644,449
"And now, 'Everlasting Love'.",236,32,7,275,644,86
"As a gentleman, I refuse to take my gloves off.",235,34,6,275,644,180
If I could get someone to cut me I'll begin.,236,32,7,275,644,1635
"I will be performing several songs this evening, including the soundtrack from all the ""Rocky"" movies, and my especial favorite, ""You Broke My Heart, So I Busted Your Jaw.""",237,30,8,275,644,3440
I'm just making sure I'm ready for J.K. Simmons when I can't keep tempo.,248,30,9,287,644,163
"I know you like immersive experiences, but isn't this a bit much for playing the Rocky theme song?",244,38,5,287,644,2616
"For my next number I’ll play ‘Buddy, Can You Spar a Dime’",252,33,8,293,644,3196
"Take my piano, please",251,35,7,293,644,3765
"I tried to beat the notes, but they kept ringing true.",253,31,9,293,644,4228
"""In my younger years, I could blend the fourth movement with the fourth round.""",249,39,5,293,644,4611
"I'll be playing 'Rite of Spring' tonight, I just thought I'd come prepared.",256,36,7,299,644,2591
I always told my parents I wanted to fight,260,39,6,305,644,3027
"slam,bam,ali-kazan!",259,41,5,305,644,5561
I will now play Fur Elise as Byron Janis,267,36,8,311,644,3492
Punch and  Judy Garland,229,37,4,270,644,149
Stop pounding on the keys!,253,33,8,294,644,230
"And now, the bar crawl sonata",265,31,10,306,644,655
Who wants to hear Simon and Garfunkel's The Boxer ?,238,30,8,276,644,1140
"The Pianist everyone called ""Al Thumbs""",223,38,3,264,644,1334
"And now, from my ""Pugilist's Promenade,"" . . .",258,34,8,300,644,1711
And you attack a new piece.,242,33,7,282,644,2095
When you play Rocky,241,35,6,282,644,2178
I've been getting really into Henry Cowell and John Cage lately.,239,39,4,282,644,2264
"The Eye of the Tiger"", of course",258,34,8,300,644,2789
I want my manicure to last until I give the performance.,259,43,4,306,644,3098
"Sorry folks, I'm all thumbs tonight.",237,32,7,276,644,3580
"Who wants to hear a rousing rendition of  ""On Wisconsin?""",251,37,6,294,644,3898
I will now box the boogaloo in D minor.,217,28,7,252,644,4362
I play all the right notes,220,33,5,258,644,4445
"And now I will play ""On Wisconsin,"" the Badger's fight song.",231,33,6,270,644,4806
That sonata is included in my remastered box set.,252,37,6,295,644,315
Do I use a left hook or a right cross?,250,41,4,295,644,482
"My signature composition, 'Hand in Glove, Knock Wood.'
Enjoy!",253,35,7,295,644,640
"And now, “Fight for Your Right”",252,37,6,295,644,2715
I don’t think the level playing field is all it’s cracked up to be.,253,35,7,295,644,3446
"'Hard to tickle the ivories with these puppies.""",248,34,7,289,644,686
"Tonight I will be giving new meaning to ""pounding the 88s.""",249,32,8,289,644,1523
You want me to play Chopsticks? I can't even hold them!,249,32,8,289,644,3508
I'll be presenting a program of Bach's music.,244,42,3,289,644,3681
It's not really about boxing.,243,44,2,289,644,4433
"This next piece, I call, Rocky Marciano",249,32,8,289,644,4881
I call this piece Glissando.,244,42,3,289,644,5256
"At this keyboard sits a boxer
With a fighter in the wings
And he’s wearing the reminders...",244,31,8,283,644,850
How about a duet?,241,37,5,283,644,2668
A pugilists worst nightmare,243,33,7,283,644,3657
In the clearing stands a boxer...,237,34,6,277,644,4465
"I am so sorry, darling, but maybe you can finally begin to understand this crippling commitment phobia",263,39,6,308,644,2234
Please vocalize loudly on my behalf while I bang this out.,263,39,6,308,644,3553
"And now, “The Double Knuckle Concerto”",262,41,5,308,644,5122
"And in just a moment, Ladies and Gentleman, the Keys Lorraine will be ready to come out",258,38,6,302,644,4635
"If you don't want to hear something awful, somebody better wake me up.",254,35,7,296,644,321
"And now, the Saved by the Bell Sonata in D, by Ludwig ""Kid Zucker"" Schteinmetz",247,38,5,290,644,3920
"At audience's  request,  Uppercut Sonata in A Minor.",248,36,6,290,644,3997
Free Bird? Coming right up!,249,34,7,290,644,4546
"How to fix jammed piano keys 
~wikiHow",242,37,5,284,644,456
"And now for your listening plesaure, I will play the theme from ""Rocky",242,37,5,284,644,2077
"And now, 'chop-sticks', by Henry's realative, Ray (Boom-Boom) Mancini!""",243,35,6,284,644,2399
"And now, as a demonstration of my virtuosity, listen to this!",241,39,4,284,644,3136
I play in broad strokes,244,33,7,284,644,4495
"And for the main event, I'll be performing Concerto no. 3.",236,38,4,278,644,2103
The key to this fight is...,234,31,7,272,644,1884
My hands are fine but I should have worn protective headgear.,231,37,4,272,644,3393
"Well you're all in the mood for a melee, 
and I've got you feeling alright.",227,34,5,266,644,386
"Folks, does this strike the right note of middle aged whimsy?",227,34,5,266,644,4226
BAM BAM BOOM,227,34,5,266,644,4325
I float like a butterfly and sting like a bee.,225,38,3,266,644,4716
"Look, if I can do contacts, I can do anything with them.",266,35,8,309,644,5371
I call it 'Sonata Your Day' in the key of Ouch.,260,36,7,303,644,1265
This is how I provided thunderous applause at his rally.,253,39,5,297,644,1737
"Like this, you always hit the right chords",248,38,5,291,644,1303
I call this one Raging Bull in the Eye of the Tiger.,248,38,5,291,644,3298
"And now, ""Toddler on the Ivories"".",248,38,5,291,644,3326
They said I was too heavy a hitter,247,40,4,291,644,4975
My first selection is by Bouthoven,245,33,7,285,644,214
Try me...try one more time calling me a pianist.,243,37,5,285,644,2173
"We are the champions, my friends
And we'll keep on fighting till the end"".",242,39,4,285,644,3541
Soft and smooth gentle with whites and blacks.,243,37,5,285,644,4526
Please excuse the absence of a B flat-on-my-back chord.,244,35,6,285,644,4778
"I jab with the left and hook with the right, correct?",248,27,10,285,644,5301
"And now for a song by an artist known as ""Limp Bizkit.""",243,37,5,285,644,5490
"Now, my homage to 'Eye of the Tiger'.",240,32,7,279,644,97
Gonna play now,234,33,6,273,644,1103
"My next piece, is a self-composition, which I call 'Political Bipartisanship.'",229,32,6,267,644,502
I can't do both at the same time. You gotta problem with that?,227,36,4,267,644,3134
"For my critics, we'll settle if it improves the playing?",225,29,7,261,644,241
"Floating on Lunesta, ""Fight of the Bumblebee""",224,31,6,261,644,5557
"Ladies and Gentleman, now for B-Flat.",258,42,4,304,644,606
"Will somebody please  turn up the thermostat, so I can take these off?

Michael Rogness, St. Paul MN",259,40,5,304,644,2866
"And now, 'The Lucky Hand' by Shoenberg.",255,37,6,298,644,340
Perhaps a musical boxing variety show isn’t such a clever idea.,256,35,7,298,644,1895
And now from the Adam Sandler movie Punch Drunk Love,245,35,6,286,644,2002
"For round one, I will play a rhapsody in jab",247,31,8,286,644,2506
"While difficult, it’s easier than being a defensive back...",238,38,4,280,644,966
Good thing this is a talent show.,241,32,7,280,644,1219
"I call this one the ""pugilistic pianist.""",240,34,6,280,644,2627
"Rocky"", eight coun",235,33,6,274,644,548
"Listen up, kids. Never be afraid of expressing yourself.",232,39,3,274,644,1804
Uhh...would it be alright if I just played chopsticks tonight?,236,31,7,274,644,3342
At least I have clothes on,230,32,6,268,644,898
"And now, Box Two Part Inventions.",226,29,7,262,644,1836
I think these are very effective in subduing the percussion expression of Mozart's compositions for harpsichord.,224,33,5,262,644,5185
Fighter introduces Gleft.,212,35,3,250,644,1355
Ignazio vs. John Cage,264,32,9,305,644,5604
"Ladies and gentlemen, my next piece will be the premier of the Ring Cycle as interpreted by Gio Palooka.",258,33,8,299,644,2425
"No, I'm not cancelled.",255,39,5,299,644,3598
I’ve been feeling a bit punchy lately,256,37,6,299,644,3658
These new Rocky installments keep getting stranger and stranger...,256,37,6,299,644,3758
"I know I’m all thumbs, but I can really knock out a great tune!",251,36,6,293,644,2447
'Chopsticks' is not on tonight's set list.,251,25,11,287,644,3088
I wrote this one after being clocked by Mike Tyson in the ring.  It's called 'Huh?',245,37,5,287,644,4750
Why is Mike Tyson the conductor?,248,31,8,287,644,5161
I will now play 'Chopsticks' blindfolded and without sheet music.,240,36,5,281,644,1345
"And now, so as not to offend anyone......",239,38,4,281,644,1434
My next piece will be Piano Fighter  by Warren Zevon.,240,36,5,281,644,3057
I might be nervous for the concert. I had this terrible dream last night...,236,33,6,275,644,4609
The late pianist was known for his punchy style on the keys.,234,37,4,275,644,4696
I have to treat my psoriasis during practice.,238,29,8,275,644,5464
The composer told me this was a knockout...,227,40,2,269,644,872
Anyone remember the last works of John Coltrane?,232,30,7,269,644,2058
I thought I'd play a little Bach's,229,36,4,269,644,2717
"Gonna giv'm the ole 1, 2, 3, 4",224,35,4,263,644,890
"When I sing my Alma mater fight song, I don’t want to ,”tickle the ivories.”",262,38,6,306,644,4314
Somebody doesn’t like the way I play.,265,32,9,306,644,4963
This piece was composed in July 1919 and dedicated to Jack Dempsey after von Krawlitz won a bundle on the Dempsey/Willard fight.,259,33,8,300,644,1229
The only issue is that it is untuned.,255,30,9,294,644,507
"And now, a rendition of my favorite Skrillex song",250,29,9,288,644,1170
"Letssss Get Ready To ANIMATO!""",248,33,7,288,644,3296
"My next selection will consist of a couple of arpeggio-flourishes, and a combination jab-cross-left hook. The title of this piece is, ""The Great Butterfly Dance of Ali in C-Major"" by Angelo Dundee.",241,36,5,282,644,5404
Think Henny Youngman had great punch lines? You're in for a real treat!,231,34,5,270,644,3176
"That was my interpretation of the theme from 'Rocky III.' Next, 'Rocky IV.'",225,35,4,264,644,3694
But I'll bite my fingernails if I take them off!,224,26,8,258,644,1566
"Betethoven's Symphony No. 5 in C Minor, Op. 67: I. Allegro con brio? SURE!",223,28,7,258,644,1574
"For tonight's encore, I will play for you the ""Theme Song from Rocky"" by composer Bill Conti.",221,32,5,258,644,3591
"Just remember your training: jab, jab, jab.",258,37,6,301,644,4177
"And now, the Michigan Fight song.",258,37,6,301,644,4772
"Albert realized that his post-bout recital lacked finesse, somehow.",254,34,7,295,644,4195
This next selection should make you feel a little punchy.,247,37,5,289,644,4264
"I'm a classical pianist, yes, but also the next heavyweight champ.",246,39,4,289,644,5147
I shall now play this next composition in the pugilist key.,237,35,5,277,644,1049
"And now, the Multitask prelude composed during the Boxer Rebellion.",236,37,4,277,644,1623
"And now, I will be playing ""Gonna Fly Now"" in C Major",236,37,4,277,644,1897
"Sir! In the front, you — the Belgian-looking guy. Listen up, because I'm only gonna say this once. I will NOT be playing ""White Iverson"" again tonight, so you can stop fucking asking, OK?",244,21,12,277,644,2753
What’s wrong? I like to punch the keys.,240,29,8,277,644,4880
One more request for 'Melancholy Baby' and I'll put my dukes up.,235,39,3,277,644,5409
"Baby, don't get hooked on me!",253,38,5,296,644,15
It  made a fool of me once too often!,251,42,3,296,644,3761
"And now, a little something I call, 'Rap City in Two'.",225,26,8,259,644,3991
"And now my newest composition: ""Crawl of the Sloth""",243,36,5,284,644,2598
'Melancholy Baby' a la Charles Ives? No problem.,243,36,5,284,644,4211
I'd like to dedicate this next song to Freddie Mercury.,241,29,8,278,644,3358
"Hope you enjoy my latest composition. I call it 'Noise'.""__%",235,30,7,272,644,1022
"My next number is a real ""knockout""!
Jeff Manly
Toronto, On.",264,29,10,303,644,3690
It's a living!,254,38,5,297,644,357
"You can,t beat this song",253,40,4,297,644,3655
I can give you Hits or a can give you punches,221,36,3,260,644,671
"Oh, come on! This is how the original piece was written!",224,30,6,260,644,3330
"So, music speaks to me.  Last night, it said, killing me softly with this next song.  I'll do my best.",253,29,9,291,644,3018
You forgot to take the gloves off..,269,32,9,310,644,1682
"The add said something about swing, I assumed I'd need punch too.",265,29,10,304,644,5408
The una corda pedal is malfunctioning.,235,32,6,273,644,2445
I’ve got a hand modeling gig tomorrow morning!,250,37,5,292,644,5143
Playing Country Music for Your Pleasure,249,28,9,286,644,4773
I like the way it sounds when I play with my boxing gloves on; kinda like I'm crappin' thunder!,269,34,8,311,644,405
Pounding the keys is the only way to play Boxx,269,34,8,311,644,2116
Let's Get Ready to... Percussion?,242,31,7,280,644,3846
Is anyone going to unlace them for me?,241,33,6,280,644,4534
"Sir,  the  song  you  are  performing is
requiem for  a   fighter; not  The
Boxer!",239,37,4,280,644,5555
I think I'm punching above my weight.,232,40,2,274,644,1302
"The piano was prepared, but Mike wasn't.",239,26,9,274,644,4665
"Did I hear a request for ""Mama Said Knock You Out?""",256,38,5,299,644,1765
Gives me that soft touch.,252,35,6,293,644,268
My major in Composition and minor in Method Acting give 'Gonna Fly Now' a real one-two punch.,253,33,7,293,644,1764
"Once I built a tower, now it's done. Brother, can you spar a dime?",251,37,5,293,644,2046
And now I will bang your out a few of my favorite tunes for you,251,37,5,293,644,2348
"And now, Eye of the Tiger!",224,34,4,262,644,199
Mmmfm fmmmf mffmm fmmfm!,247,34,6,287,644,2018
"And now for my own composition, ""The Ballad of the Boxer:  A blow by blow account""",218,35,3,256,644,337
A Heavyweight Music Box,240,37,4,281,644,3172
"baby, its cold inside",243,31,7,281,644,5171
Now I'm going to punch the keys to Eye of the Tiger,237,32,6,275,644,184
Old habits die hard!,255,42,3,300,644,1393
"From his earliest days Luigi had promised, ‘Rachmaninov and Marciano!, Rachmaninov and Marciano!’.",235,36,4,275,644,2982
Nobody knows the trouble I've seen...!,230,35,4,269,644,2353
You think so? I'm gonna knock 'em dead.,231,33,5,269,644,3125
"Float like a butterfly, tickle the keys, no one tried harder than self-proclaimed Mozart Ali.",234,27,8,269,644,4393
We be ham fisting. Yeah!,231,33,5,269,644,4644
Just plunking out an idea for a Rocky 9 theme.,269,38,6,313,644,1752
There had once been a time when Albert did not feel quite so defensive about his affinity for playing Russian pop music.,244,31,7,282,644,4525
The critics say I punch out the melodic line.,222,29,6,257,644,5642
"And now, Chris Brown’s cover of Rihanna",240,28,8,276,644,37
"And now for the debut of my latest composition, 'Glissando Serenade, in F♯ Major'",241,26,9,276,644,3921
"Do not try this at home.
                                         


""Do not try this at home.""",239,30,7,276,644,5172
How about something by Choppin'?,238,32,6,276,644,5363
It  practically plays itself,253,37,5,295,644,20
"You're gonna love this guy, Zoe!  He's a real knockout!",250,43,2,295,644,675
"And now for my next selection, ""Mama Said Knock You Out"" by LL Cool J.",225,36,3,264,644,148
I'm not sure that concert pianists NEED a handicap system.,225,36,3,264,644,375
"For my next piece, I shall play a ten roundelay.",230,26,8,264,644,2761
Cowell or Bartok?,266,35,7,308,644,5493
"My next selection, The FIGHT of the Bumblebee.",205,30,4,239,644,5600
Sorry. I can't play with myself.,259,38,5,302,644,1284
And I can play this piece with one hand tied behind my back!,239,32,6,277,644,1811
DUM DUM DUM   DUM...,239,32,6,277,644,5232
"I shook up the world! I shook up the world, by playing Shostakovich!",258,29,9,296,644,5235
It's a Balwin,253,28,9,290,644,929
He is a germaphobe - won't touch anything without gloves,248,38,4,290,644,998
We're going to need you to play with more punch.,247,40,3,290,644,4239
And now... Beethoven’s Moonlight Sonata in D-flat Major,210,33,3,246,644,90
Imposter syndrome? Never heard of it!,228,32,5,265,644,5289
This latest workout fad is not what I signed up for.,244,35,5,284,644,1534
Thank you. My next song has a real sweet beat.,243,37,4,284,644,2284
I can't even do Chopsticks,248,27,9,284,644,4007
I was hoping for a dissonant  sound.,245,33,6,284,644,4993
"I was going to take my gloves off and let you know how I really felt, but this is Carnegie Hall, isn't it?",262,34,7,303,644,2835
Now for the Cantus firmus.,258,31,8,297,644,1194
Everyone  needs a second job these days!!,259,29,9,297,644,2798
"Written by Fisto Pugilist, this is simply entitled...BALBOA.""",235,31,6,272,644,222
This seems a bit extreme for a single hangnail.,233,35,4,272,644,1231
I'm an outside the boxer thinker,250,36,5,291,644,2572
And now my rendition of  'Flight of the Bumble Bee...',250,25,10,285,644,871
"Buxtehude? I thought you said Boxed a Hoodie.""",261,38,5,304,644,1045
'Excuse me while I lay down some phat beats...',247,31,7,285,644,1963
A boxer's dream,229,32,5,266,644,3309
"I'd love to play the concerto but 

I feel all tied up and boxed in.",276,43,4,323,644,3648
"Ladies and gentlemen—I present to you, the -only- way to play Eye of The Tiger…",230,30,6,266,644,4285
Wanna hear me play Chopstick ?,278,28,11,317,644,4169
"And now, Round 3 of Tyson versus Holyfield.",258,33,7,298,644,1903
"Next, “The Flight of the Bumblebee.”",256,37,5,298,644,3119
my next number is entitled: discordance is just frame of mind,238,38,3,279,644,215
We here at he Music Box have added something new!,241,32,6,279,644,2899
This captures their attention from the get-go,251,36,5,292,644,845
Still not as bad as the time I entered that high-heel race.,250,38,4,292,644,4810
His recital was every bit as staged as a WWE match,234,35,4,273,644,1096
I just wanted the kids to talk about me.,237,29,7,273,644,2201
"What do you mean, you never saw the movie ""Jaws""",237,29,7,273,644,2304
This is that old chestnut: Belt It Out and Punch It Home,238,27,8,273,644,3154
"Now, the Detroit tocatto in the style of Thomas the hitman Hearns.",216,36,2,254,644,3974
This is the welterweight performance of the Right Hook Overture,263,36,6,305,644,1770
It says to play it ff af,232,28,7,267,644,4426
I will now attempt the Minute Waltz,225,31,5,261,644,2022
"I said to book The Black Eyed Peas, not Keys.",255,30,8,293,644,1857
"Good evening, Ladies and Gentlemen. I’m expecting a standing ovation....",249,42,2,293,644,2332
Be-Bop-A-Lula!,252,36,5,293,644,4031
I'd like to play chopsticks. Again.,235,35,4,274,644,2685
"What!?
It’s strong conceptual music!",237,31,6,274,644,3740
"If you don't like it, come on up here and fight me.",246,37,4,287,644,523
I'm trying to play Spar Spangled Banner,246,37,4,287,644,632
"Welcome to the third concert in our series, Beethoven’s Great Beat-Downs!
Bill Hunter,
Plymouth, MA",245,39,3,287,644,2631
Wrong scenario impresario!!,244,41,2,287,644,5705
I need a tuning.,228,38,2,268,644,1465
"Before I begin, I’d like to thank my parents for showing me the value of compromise, as applied to my choices for after-school activities...and now, the MMA concerto.",230,34,4,268,644,1893
The gloves are on...,242,34,5,281,644,3941
"I can't play a chord progression, but I can play you a few chords.",243,32,6,281,644,5605
I wrote this next song for all of the Pianist-Pugilists out there.  It'll knock your socks off!,224,35,3,262,644,1887
If the very attractive redhead in the first row would take a seat - I'll proceed with 'Concerto with no Hands.',251,40,3,294,644,1636
I need a volunteer from the audience to hold open the piano while I work the inside.,236,35,4,275,644,2503
Still better than boxing in a top hat.,235,37,3,275,644,4266
Saturday Nite’s alright for fighting,237,33,5,275,644,5040
"I thought they said, “you are to play-box piano concertos.”",236,35,4,275,644,5312
Mom says it sounds like I'm playing the bagpipes...,266,34,7,307,644,11
"Yes, it appears that Round One goes to the piano, but for my next number, I'd like to try a little Tchaikovsky.",268,30,9,307,644,5432
"And now, the ""Concerto Grosso Mosso"" by Spinks.",274,42,4,320,644,1538
"I heard he was all thumbs, but this is ridiculous!",249,33,6,288,644,2453
And now for my Chopin.,260,35,6,301,644,566
This way I can have that heavy Horowitz touch.,229,38,2,269,644,985
I always wear gloves when playing a percussion sport.,232,32,5,269,644,3699
Life's not a about how hard of a hit you can give... It's about how many keys you hit before the security notices.,270,39,5,314,644,3660
"You think this is ridiculous, ....",245,30,7,282,644,1684
Who would like to hear Knock-out?,243,34,5,282,644,2160
These gloves came as a boxed set!,242,36,4,282,644,2570
I am playing piano while wearing boxing gloves.,217,27,6,250,644,253
"Impetigo,mates.",257,30,8,295,644,141
The conductor was afraid I would play off beat,226,33,4,263,644,5178
...and now for my truly smashing rendition of the Diabelli Variations,240,29,7,276,644,3867
"See,I  can’t play jingle bells one more time.",249,35,5,289,644,1374
"And now ladies and gentlemen, Bach’s Concerto in C major for Two Pianos!",247,39,3,289,644,3226
Yes I can see how piano and boxing can sound the same.,223,28,6,257,644,5198
"You may have heard this next one ... ""Float like a Butterfly, Play like a Cat.""",265,27,10,302,644,3896
"Everyone get up and dance to Simon and Garfunkel's ""The Boxer.""",230,38,2,270,644,1238
"Yes, but I can play it with a handicap.",235,28,7,270,644,3977
"I thought that you said ""Chop On,"" not Chopin!",258,30,8,296,644,2892
I have a severe Gershwin allergy.,258,30,8,296,644,5072
It's better than my last job I had with these; picking flea shit out of black pepper.,269,32,8,309,644,628
Are there any chopsticks in the house?,279,36,7,322,644,4565
This next one is Rocky Manoff’s Prelude in C Minor.,241,29,7,277,644,5055
"Before I formally begin the work, I should like to execute a little soundcheck for those of us in the balconies.",224,28,6,258,644,3843
And now for my version of Rachy II......,223,30,5,258,644,4252
I gotta right to sing the blues...,248,28,8,284,644,1396
This is Beethoven's Concerto 1-2 (Jab-Right Cross),243,38,3,284,644,3661
Don't bring boxing gloves to a piano fight.,257,34,6,297,644,1556
ffuck. Everyone happy with ffortissimo?,257,34,6,297,644,5401
"I plan to take off the gloves, if the completion gives any indication that it might  be a challenge.",254,40,3,297,644,5548
This guy's SWINGING.,279,38,6,323,644,5086
my next number is Rocky Rolling  with the Punches,218,29,5,252,644,2361
"Ladies and gentlemen, the official scoring is a draw.  No blows were landed during the 4'33''.",227,35,3,265,644,3895
It is the sweet art.,240,33,5,278,644,113
"Next, I'll play the Moonlight, er Moonfight Sonata",237,39,2,278,644,1259
for my next  selection after  the flight and attack of the bumblebees,240,33,5,278,644,3327
"Uh, ""Flight of the Bumblebee,"" in B Flat Minor.",240,33,5,278,644,4099
"And now, the Battlt Hymn of the Boxer Rebellion!",251,35,5,291,644,3067
This shouldn’t hurt spectator’s ears!,260,41,3,304,644,801
It's heavy metal night.,238,26,8,272,644,3879
"My next number is what I call The Butterfly and the Bee. Flying and Stinging are my favorite parts. Enjoy!""",251,24,10,285,644,3029
I bring you now Box Concerto Number  in D Minor.,230,31,5,266,644,733
Who said play it again Rocky,257,25,10,292,644,1042
"And now a selection of Brahms, in the eye of the tiger.",251,37,4,292,644,1760
My percussion teacher recommends an eclectic approach to piano playing.,255,42,2,299,644,1188
This next piece was composed by Harrison Bergeron.,246,36,4,286,644,1849
Pugilistic pucussion Opis. 3,240,24,9,273,644,2516
Is this someone's sick idea of a joke?,236,32,5,273,644,2567
Hello?,250,28,8,286,644,3539
"Let me move you with a few ""tone clusters"".",247,34,5,286,644,4147
This piece will be played in fourths.,251,26,9,286,644,4234
I suppose you want me to play “Eye of the Tiger?”,236,32,5,273,644,5270
I need these to play all soft like.,235,34,4,273,644,5574
Don’t give up your day job,262,41,3,306,644,3208
This isn’t exactly what I had in mind by the piano needing a tune up!,252,37,4,293,644,2537
"I just can't fight this feeling anymore...
now somebody cut these thing off of me!",252,37,4,293,644,3292
I thought I was invited to a pugilist contest not a pianist concert!,242,33,5,280,644,373
Taking a test for the right to vote—I need to play Dixie.,242,33,5,280,644,3056
I'm protecting my hands before tomorrow's title fight.,230,33,4,267,644,892
I feel bad for things with paws.,238,30,6,274,644,5578
It isn't what it looks like!,254,35,5,294,644,876
..and now I'll play Chopin.,252,39,3,294,644,3525
"And now, Chopin’s Nocturne in B-flat minor, as interpreted by Keyboard Kat.",245,29,7,281,644,5117
The proclivities of my Father have nothing to do with this!,231,33,4,268,644,1407
"I was classically trained in the ""think system"".",232,31,5,268,644,1854
Next: The Boxer. Just me. Simon and Garfunkel have the day off.,260,36,5,301,644,3578
"I don't care what you think,it's comfortable!",235,38,2,275,644,2013
I thought this was a keypunch machine.,236,36,3,275,644,3627
"He gloats like a baritone, but sings like a chickadee.",240,28,7,275,644,5634
"I'm all for tickling the ivories, but this is Chopin's Black Key Étude.",227,30,5,262,644,5594
I thought they said thunderdome not metronome,264,41,3,308,644,3474
Jackson Pollack Rhapsody No. 4 in C Sharp Minor.,258,29,8,295,644,2343
Adrian!!  Adrian!!,246,29,7,282,644,934
I'm here for the keypunch operator position.,246,29,7,282,644,2746
"And now, Liberocky playing “Hey Adrian”.",243,35,4,282,644,3064
I guarantee this will be the best rendition of Boulez's Second Piano Sonata you will hear.,246,29,7,282,644,4086
This is the next book of Gene Luen Yang: Boxers & Pianists.,230,37,2,269,644,2594
Be prepared.  I'm coming out with a swing.,260,38,4,302,644,4338
This one goes out to all the hangry people in the house.,248,38,3,289,644,1283
I will now play Chopin's sonata for boxing gloves.,250,34,5,289,644,3876
And now I shall play the final masterpiece by Trumpelstiltskin.,252,30,7,289,644,5296
I should have just majored in Engineering.,280,35,7,322,644,233
Do I look like Tom Hanks?,238,34,4,276,644,863
Sing us a song Cinderella man! Sing us a song tonight,239,32,5,276,644,2938
I’m playing it “pianissimo”.,247,29,7,283,644,2262
Ah-oneeeeee....ah-twooooo....ah-threeeee....ah fou,244,35,4,283,644,3386
Which keys should I rubeato?,235,29,6,270,644,464
"I dunno, my agent said something about 'twinkle toes', boxing, a piano, an audition and I just... Tried to be prepared for anything,",251,34,5,290,644,4793
And now let us proceed to Bach's piano solo.,239,34,4,277,644,2626
...and in this corner...,269,35,6,310,644,1192
They want something new and different.,271,31,8,310,644,3890
"I hope you weren't expecting ""Chopsticks"" with these things.",226,36,2,264,644,1261
"Affection for this next little number was the only other thing in common betwixt Rocky Marciano, Rocky Balboa, and Rocky the Flying Squirrel.”",230,28,6,264,644,1451
A blind pianist? Wait until you see this next guy.,244,37,3,284,644,1600
Haven’t you ever seen Elton John play with his feet?,248,29,7,284,644,3275
"Ladies and Gentlemen, I present to you... ""Gonna Fly Now"" from Rocky's 1st symphony.",249,27,8,284,644,4885
"I call it a ""boxerto""!",264,34,6,304,644,689
Perfect to start off Tchaikovsky's first Piano Concerto!,239,23,9,271,644,4921
"I told you, I play hand in gloves...",249,40,2,291,644,4698
This one goes out to Harrison Bergeron.,225,27,6,258,644,1719
I 'm just here for free drinks. My twin is the musical one.,224,29,5,258,644,3323
Nobody knows the troubles I've seen. Nobody knows but Jesus.,226,25,7,258,644,4953
"Apologies. I was under the impression I was to be playing Beatoven, not Beethoven, tonight.",259,33,6,298,644,1846
"Do you think we could make an exception to the ""all employees must wear boxing gloves at Mike Tyson events"" ?",259,33,6,298,644,3841
"I’m toe tarry I’m not feeling very well tonight, I’m fighting a bad chord.",247,33,5,285,644,2469
Beethoven wrote the next sonata in seven #s.,237,29,6,272,644,2049
"I AM the Greatest, but ""Freebird?""  Really??",239,25,8,272,644,3929
"Last song he was sharp, but now he just sounds flat.",268,41,3,312,644,1618
I'll be playing the Boxing Ring Cycle.,245,26,8,279,644,5444
And now... a slam dance tune!,259,35,5,299,644,1549
What I burnt my hands.,262,29,8,299,644,5269
"And now from ""The Suite
Science...""",264,38,4,306,644,3577
take the gloves off and let me kill it,238,29,6,273,644,1695
The gloves help when I play Rachmaninoff— especially when I’m ‘Russian’ it (ha ha).,252,38,3,293,644,5685
And now for an interpretation of Hurricane.,277,38,5,320,644,593
Has anyone seen my cut man ? This Concerto is killing me.,261,33,6,300,644,3267
". . . Gonna Fly Now. Next the theme from Raging Bull, Cavalleria Rusticana Intermezzo.",248,35,4,287,644,2534
Your only limit is you,249,33,5,287,644,3109
I could not decide if I wanted to be an athlete or a musician!,232,30,5,267,644,84
Sting like the Flight of the Bumblebee.,253,38,3,294,644,5554
Come out swinging?,241,25,8,274,644,1911
"For my next number, I will be punching above my weight",237,33,4,274,644,3282
Do you have a shorter bench?  I can’t reach the pedals.,261,35,5,301,644,4304
"My next selection will be ""Thinking 'bout you"" by Frank Ocean",264,29,8,301,644,4398
"Risin' up, back on the keys",244,32,5,281,644,1462
Did someone request BeatHoven?,246,28,7,281,644,3443
"Seriously, I'm a lover not a fighter.",242,36,3,281,644,3905
How dare you say I'm all thumbs!,230,23,8,261,644,3146
And now for my impression of Jake LaMotta - after he retired.,225,33,3,261,644,5230
And now for Box Well-tempered Clavier,270,30,8,308,644,2992
"This is my ode to Mike Tyson's brilliant Broadway production, his undisputed truth and all the Tysons who went before him.",250,33,5,288,644,2760
"And now, for your listening enjoyment, my new pie.ce, which I call ""Etude:  for Boxing Day""",250,33,5,288,644,4981
"With finesse and endurance, the 88s always defeat the challenger",231,34,3,268,644,2565
"Oh no I knew I forgot something when I got up this morning... i forgot my hat, my hair will be ruined in this rain!",234,28,6,268,644,4149
Flight of the bumblebee?,237,22,9,268,644,5069
"Mr Houdini, are you in the audience?",273,37,5,315,644,2368
"Today, I defy Benjamin Franklin's advice to please my critics.",255,36,4,295,644,145
This is a heavyweight piano. I told you I only play Bantam.,255,36,4,295,644,1113
And now for a little Simon & Garfunkel ...,240,29,6,275,644,4284
It’s easier than chopsticks.,244,34,4,282,644,1622
"I’m feeling boxed in, at this stage.",244,34,4,282,644,4817
"When life?
Expects more!
And you?
Disappoint everyone.
Mr. President.",228,29,5,262,644,1633
"And now, I'm going to box your ears!",234,30,5,269,644,3706
"Okay, that's better.",235,28,6,269,644,4317
"Could you kill the lights? you aren't gonna want to hear or see this.""",232,29,6,269,644,5395
"And now, this, from Joe Frazier and the Knockouts... You'll TOTALLY get the piano part...",262,37,4,303,644,255
"I may be punching above my weight, but I’d really like to perform this next piece for you.",251,35,4,290,644,471
"And now, Beethoven's fifth...",276,35,6,317,644,401
Wait... is this some sort of  twisted metaphor? I thought it was an étude!,257,36,4,297,644,1341
I hate playing ham handed songs and music.,234,32,4,270,644,4711
I am trying to avoid the flight of the bumblebee,266,31,7,304,644,3716
"What do you mean, 'this isn't the glove compartment'?",266,31,7,304,644,5310
When I dreamed of being a key punch operator I never dreamed there would be an audience.,240,33,4,277,644,4758
"Sorry, my last sparring partner only knew Heart and Soul.",271,34,6,311,644,389
"The meat locker was too cold, so I do this instead.",263,26,9,298,644,12
Can we play it in C major and D major?,235,32,4,271,644,5484
I will now play Bill Conti's 'Gonna Fly Now',273,32,7,312,644,1831
I punch the keys for a crisp sound effect.,221,23,7,251,644,4286
"Unfortunately, the lessons omitted certain key fundamentals.",225,28,5,258,644,4429
The next song is 'she's crafty' by the beastie boys,257,27,8,292,644,4980
"And now, Sonata in A minor by my wittew itty kitty cat, Colonel Chubby Von Meowington...",254,33,5,292,644,5218
"Okay, guys, I promise I won’t play Chopsticks again.",234,23,8,265,644,3152
Can we turn the heat up? These are treble clefs,261,32,6,299,644,1055
"Flight of the Bumblebee? Come on, someone request a real challenge.",260,34,5,299,644,2324
Or would you rather be watching the maestro now replacing me in the ring against the heavyweight world champion?,260,34,5,299,644,4979
"I'm allergic to bees so I like to wear these when I play Rimsky-Korsakov,",238,28,6,272,644,1874
My hero was Harry Houdini..,239,26,7,272,644,5446
"Next I will play Tchaikovsky's symphony number 1, 2 and left hook",258,40,2,300,644,1223
TKO!!!  (Tickle the keys!),230,33,3,266,644,1122
"For my next selection,Chopin's 5 Minute Waltz.",274,34,6,314,644,3613
Beethoven was a bit if a pugilist,245,29,6,280,644,2016
"This grand ol' box I'm boxing
'til the whole damn place is rocking
I'm the PianoBoxer Man",252,28,7,287,644,3978
"This next piece is called, 'The Three-Hundred Pound Kitten's Run'.",251,30,6,287,644,4918
"Fiddlesticks? Why, sure!",255,35,4,294,644,999
"That’s it, I’ve warned you before, get that light off me or I’ll....",255,35,4,294,644,3182
How does that Rocky tune sound again?,262,34,5,301,644,4485
"I used to be a real ""hands on"" type of guy.",225,32,3,260,644,3751
This next one is a Split-Decision.,268,35,5,308,644,5372
My parents never loved me.,234,27,6,267,644,3931
The key to success is to knock on wood before every performance.,237,34,3,274,644,556
"For some reason, Haydn is Hidin'",238,32,4,274,644,2853
I can’t believe I forgot to take these boxing gloves off. Too late to do it now! Just have to play the piano with boxing gloves. I should have taken them off earlier.,247,27,7,281,644,396
1st note is a K.O.!,259,29,7,295,644,3391
"And now for the calming music of 
Galina Ustvolskaya.",254,39,2,295,644,4281
AND STILL CHAMPEON,257,33,5,295,644,5155
"As they say, ""Float like a butterfly, ring like a key""",228,28,5,261,644,4343
Enrique “The Spanish Pianist” Carrasco plays the music of Lady Gaga.,232,33,3,268,644,1473
I still need to crack my knuckles.,230,37,1,268,644,3024
Let's Make the Tune Great Again,241,28,6,275,644,1706
"And then I wrote my next big hit,",247,29,6,282,644,796
"Places, please.",244,35,3,282,644,1460
"I’ve got a touch of the flu, but I’m fighting through it.",246,31,5,282,644,4013
Real champions are always ready for a knockout performance whether in the ring or at the player piano.,253,30,6,289,644,4471
I will now attempt to beat the Für Elise land-speed record set by Sir Chuck Norris.,261,27,8,296,644,1496
"Like Pop always said... ""Dance like a dragon flies, and string it all to B.""",266,30,7,303,644,3862
I play to fight off the blues!,265,32,6,303,644,5702
"The sound is sharp, but the piano is flat.",234,31,4,269,644,1215
"I probably can't play Beethoven, but I can play ""Row, Row, Row You're Boat"".",236,27,6,269,644,1226
This is how you play those Chris Nolan trailer noises.,235,29,5,269,644,3476
This is the greatest piano concerto ever!... and I’ll slug anyone who says otherwise!,232,35,2,269,644,4464
...and for my next challanging piece,251,36,3,290,644,1510
“This next tune is likely to punch out your Likes.”,250,38,2,290,644,4035
I only prepared for Hot Cross Buns!,260,31,6,297,644,1542
"This piece was written for my newly formed, ""Heavy Leather band.""",258,35,4,297,644,4144
"I would now like to play for you my latest composition , The rope-a-dope.",257,37,3,297,644,4973
"Hey Yo Adrian, one more time, I swear just one more time",227,34,2,263,644,3349
The gig economy has been very confusing to him,239,36,2,277,644,1686
And the beat (box) goes on...,252,23,9,284,644,106
"I play the songs, not the melody
I'll sing you a song tonight
I'm the piano man
and I'll make you feel alright",244,39,1,284,644,1558
Do you think that this is worse than two left feet?,248,31,5,284,644,3671
"i call this Tango, Uppercut!",252,36,3,291,644,4613
"And next, Rocky's theme in knocked flat.",263,27,8,298,644,2070
Procrastination wasn’t working.,262,29,7,298,644,4799
Just tryin' to punch-up Shcumann's Piano Concerto Op. 54,259,35,4,298,644,5606
"My next number will be Dwayne Johnson - ""The Rock"" III",266,34,5,305,644,2948
I auditioned for the kettledrum.,278,36,5,319,644,1367
"Begging your consent, an interpretation of the movement: Pound Me Too.",219,26,5,250,644,5167
I call it the 'Stump of a Crash of Rhinos'.,224,29,4,257,644,2288
this really is the ONLY way to play Beethoven,232,26,6,264,644,23
Is there an Ali in the House?,233,24,7,264,644,2471
"What my playing lacks in clarity, my un-bitten fingernails display in acuity.",230,30,4,264,644,2889
I'm just playing it how LaMotta would have played it if he had altered Bach's version.,235,33,3,271,644,309
"Tommasini said one hand dominated too much, but I forgot which  one.",235,33,3,271,644,738
I guess we know what happened to Rocky after the fight,246,24,8,278,644,499
"Please excuse my playing, but I've recently been declawed.",244,28,6,278,644,1782
I will now play the theme song from the movie - Rocky.,245,26,7,278,644,5190
Down for the count!,249,31,5,285,644,1531
"Der Ring des Nibelungen"" by Wagne",254,34,4,292,644,4779
This piano just came out of a box.,260,35,4,299,644,2682
He's really known for his voice. The piano is just a prop.,260,35,4,299,644,5160
Tonight I will differentiate beat from beat,266,36,4,306,644,195
It's suppose to sound better with the new rap music.,266,36,4,306,644,3272
"I signed up for tuxedo boxing, does this piano have anything to do with it?",267,34,5,306,644,3370
"I need these, I'm playing the ""Rocky""  theme song!",267,34,5,306,644,4715
The texture is actually quite nice.,232,28,5,265,644,967
My next piece was written by Bach when he was training for the Golden Gloves.,238,29,5,272,644,2112
He plays the most amazing glove songs!,245,28,6,279,644,4447
I'm the typecast for 'Rocky' not 'Liberace'.,250,31,5,286,644,2136
I think it's safe to assume I've been knocked out.,248,35,3,286,644,2532
"LIGHTS, please!",250,31,5,286,644,4395
I call this composition 'Sweet Chin Music volume  IV',256,32,5,293,644,4660
"I bet Saul Bellow could never do this.""",259,26,8,293,644,4907
I can do it by instinct,253,38,2,293,644,5285
I will now play my own composition called 'Rocky Roll.',258,41,1,300,644,3558
Pound them keys is what I say.,225,31,3,259,644,302
"This song goes out to my piano teacher, Miss Lydia Prunkett, who taught me that I can play the piano, even with boxing gloves on.",250,33,4,287,644,570
Uhhh...You don’t need boxing gloves to perform the Mephisto Waltz!,255,36,3,294,644,678
This sonata 1-2-3b-2's movement is a knockout,272,41,2,315,644,1253
I should like to play my randition of The WilliamTell  Overture,239,29,5,273,644,1718
He’s a man of many talents.  Beating up pianos is just one of them.,251,31,5,287,644,3174
"I know it looks odd, but just wait for the sound!",226,29,4,259,644,3853
"This next little number, ‘A Bloody Pulp,’ I wrote bare knuckle.",246,28,6,280,644,4528
"Swinging tune, Mac. Ease up on the keys.",235,24,7,266,644,4561
C'mon people! Let's pump it up!,243,34,3,280,644,4578
Chopsticks? Afraid not. A knife and fork please,274,37,4,315,644,4897
"Hey, it’s Rachmaninov!",226,29,4,259,644,5001
"When George heard ""break a leg,"" he took matters into his own hands.",251,31,5,287,644,5370
A-major fight ends in defeat.,217,34,1,252,644,5704
"Ready for the soundtrack for ""Boxing Helena.""",287,39,4,330,644,2318
"Yo, Simon, it ain't over till it's over.",269,36,4,309,644,3972
I'm just going to assume I'm not hosting the boxing championship.,257,34,4,295,644,4492
Desperate one hit wonder tries again....,256,36,3,295,644,4575
"I can't even do ""Chopsticks"" like this.",255,38,2,295,644,5225
"Ruckus, please.",251,33,4,288,644,615
I apologize in advance. Blame my poison ivy.,243,36,2,281,644,4550
And now my talent offering in this year's WBA welterweight competition,248,26,7,281,644,5454
"He is incomparable at recognizing its percussive potential.
Hilary A. Kaplan
Silver Spring, Maryland",238,33,3,274,644,795
I'm not supposed to punch the keys BUT I CAN'T HELP IT I'M A BOXER >:(,278,33,6,317,644,2489
"And now, Ladies and Gentlemen, may I present to you, ""The Eye of the Tiger.""",269,38,3,310,644,1644
This next piece is Marcatissimo Maximus.,260,30,6,296,644,5428
"I  just  punch, the  lid  falls  BINGO  !  CANON SHOT",254,29,6,289,644,1984
There's poop in here!,252,20,10,282,644,1173
I used to be able to tickle the ivories real nice.,241,29,5,275,644,1290
Next I’ll play my fight song. I call it my take back my life song.,244,23,8,275,644,3811
I will now play “Kidney Chopsticks.”,260,32,5,297,644,1212
The key to being a musician is to glove your work.,253,33,4,290,644,4155
But it’s not wearing a mouth guard.,241,31,4,276,644,2401
It is the only way I can play The Polooka Polka!,243,27,6,276,644,4385
"So you want to hear ""Flight of the Bumblebee?""",235,30,4,269,644,672
"I call this piece, Giving My Fingers a Rest, and I hope you all will enjoy this.",234,32,3,269,644,3395
"---AND FOR MY NEXT PIECE  ""THE THUNDERER------""",217,27,4,248,644,1949
I play only chopsticks and you will like it,268,31,6,305,644,1021
Good evening. My name is Robert Schumanny Pacquiao.,259,36,3,298,644,5148
I was not prepared for this kind of duel.,254,33,4,291,644,32
This ISN’T for the Punch and Judy reboot?,253,35,3,291,644,2730
The next piece is by Dave Brubeck.,255,31,5,291,644,4238
Dooby-dooby-doo...,242,31,4,277,644,400
Dueling Pianos Competition,223,30,3,256,644,3368
Now for the newly discovered Rach 5!,222,32,2,256,644,4677
"""Well, it worked for the Keyboard Cat.",226,24,6,256,644,5400
Let's get ready to huuuummble.,274,34,5,313,644,1630
"Believe it or not, I can still play 'Twinkle, Twinkle Little Star!",260,36,3,299,644,2918
"And now, my rendition of the new uncomplicated classical beat",249,32,4,285,644,1077
And now for my next bout -- I mean Beethoven Sonata.,247,36,2,285,644,1328
My next piece will be a tribute to Erroll Garner,236,32,3,271,644,3790
"Some of you might not know that as of last midnight the tenets of Vonnegut's ""Harrison Bergerson"" became law. Therefore, in place of Beethoven's sonata number thirty I present ""Chopsticks.""",232,27,5,264,644,1797
And they said I didn't stand a puncher's chance of playing Carnegie Hall.,260,38,2,300,644,729
the title is Cached Fingering,263,32,5,300,644,3287
I've never heard 'Eye of the Tiger' performed with such grace before!,254,37,2,293,644,485
"Um, I don't think this is how you play ""chin music""!",258,29,6,293,644,3311
I'm the accompanist for the Punch Brothers.,259,27,7,293,644,3616
"It's a knockout.
If looks could kill, they probably will",251,30,5,286,644,2166
"Hey, put your Vernon Dukes up!",248,36,2,286,644,3722
You mean starring in ROCKY wasn't enough???,246,27,6,279,644,1892
"I don't know how to sting like a bee, but I do know Flight of the Bumblebee.",244,31,4,279,644,3970
"Bobby Short was never asked to play with these, was he?",265,30,6,301,644,2834
For my first trick...,255,37,2,294,644,4654
"Round 6, Round 6!",256,35,3,294,644,5503
This is going to be a real page turner.,222,23,6,251,644,3745
This is just my hobby. I made my name by getting in the ring without gloves.,250,34,3,287,644,529
These heated keyboards make simple ditties quite challenging.,249,36,2,287,644,1512
Boxing Beethoven! You all ready for this?,246,29,5,280,644,1204
"My next piece is entitled ""Ode to Cross-Training""",244,33,3,280,644,4771
These are fighting musical notes,239,30,4,273,644,1085
Lullaby of Broadway requires me to play with kid gloves,241,26,6,273,644,3435
Classic keyboard  boxer,241,26,6,273,644,4089
"No hands!
Pitch Perfect!",233,29,4,266,644,576
"Hell no, man.",234,27,5,266,644,3444
This movement’s nickname is The Knockout,263,36,3,302,644,5113
"Jim specialises in all sorts of movements - 5th movements, head movements etc...",264,34,4,302,644,5517
"Duel talents?""But,I sing with this one""",257,35,3,295,644,5251
they said be unique ya think this is easy?,250,36,2,288,644,4802
"We don’t have Boxing Day in America, but I’m sure I can find the right beat.",247,29,5,281,644,3524
"And now we’d like to play Mike Tyson’s piano concerto in E#, also known as “Fingers? Who needs fingers?”",246,31,4,281,644,5166
Heavy-handed? No punch?,243,37,1,281,644,5498
"And, now, Tyson's Etude Op.10 No. 3 - B-Flat Major.",272,33,5,310,644,682
And now. The Levine variations by Cardi B.,239,32,3,274,644,2714
"I channel Ali: float like a butterfly, sting like a bee.",266,32,5,303,644,2737
How exactly is this supposed to help me win coach?,267,30,6,303,644,4867
"Recently “chopped” on the food network, he moved on to his next artistic endeavor.",267,30,6,303,644,5560
"For mohammed Ali,Sting like a bee and float like a butterfly",235,27,5,267,644,5565
Hey Joan can we wrap up the show I got noses and keys to break,258,35,3,296,644,2976
Play Punch Rock!,260,31,5,296,644,4895
"I call this next piece, 'Me Versus Pianola Roll.'",252,34,3,289,644,202
What the! This is NOT what I wished for! I asked to be a key member of the board!,258,22,9,289,644,1944
"And now, ""The Minute Atonal Crash-Bang.""",255,28,6,289,644,1982
Sure it fits me like a glove but the uppercut technique is not working for D#.,280,32,6,318,644,4876
"boxing glove: ""unhand me, you fool! """,215,28,3,246,644,1134
"In honor of the tenth anniversary of the Piano Fight Club, I shall play the theme from Rocky in the Italian classical tradition.",240,32,3,275,644,2551
"Well, ham isn't kosher.",242,28,5,275,644,2657
Simon and Garfunkel require this if you cover the song...,263,40,1,304,644,417
"Boxing Day? Heck, I say boxing play.",235,29,4,268,644,5468
"The pitch might sound a bit rocky, as I play wearing these gloves.",256,28,6,290,644,439
"I heard Mike Tyson was coming to watch his nephew perform at the piano recital, so I had to impress.",227,32,2,261,644,2586
What people don't realize is that the gloves have made it more likely that pianists get injured.,253,34,3,290,644,5325
This tune is in gratitude to the bouncer who is so great with his hands.,249,29,5,283,644,864
I'ts a tune up fight.,267,34,4,305,644,1660
Perhaps I should use my head instead.,267,34,4,305,644,4558
Doctors orders I'm afraid.  Bad case of Onychophagia.,245,24,7,276,644,1379
"Ladies and gentleman, please put your hands together for Mr. Piano Man!",244,26,6,276,644,1958
I knew I should have stuck with trombone.,239,23,7,269,644,3457
Can’t I just use the electronic keyboard to mute the sound?,231,26,5,262,644,181
I just finished my warm up,250,29,5,284,644,437
"In keeping with the spirit of the times, I will now play Bach the way Mafia Don governs.",250,29,5,284,644,5010
They asked me to tinkle the ivories,267,36,3,306,644,5088
"In fact, sir, I trained at Fleety Floyd's Gym.",254,36,2,292,644,4591
I only play Bach's pieces,228,34,1,263,644,1732
I call this next piece 'Going HAM.',232,26,5,263,644,4122
"I'd like to play for you, but I just washed my hands.",232,26,5,263,644,5396
Chopsticks? Are we eating Chinese?,269,34,4,307,644,822
"And now, for the latest by John Cage. It's not a """"Cheap ""Imitation"".",245,28,5,278,644,976
"And, now,  I'd like to play for you the Intermezzo from Cavalleria Rusticana , by Pietro Mascagni.",246,26,6,278,644,4882
"Flight"" of the bumblebee?

Nevermin",245,28,5,278,644,5266
"I shall now play, ‘Duke it Out’!",258,30,5,293,644,394
Hey Dad this is my dream!,251,31,4,286,644,1239
"Before tonight, Peter had only played  Symphony No. 5 in bars and small rock clubs.",232,28,4,264,644,2205
"The classic piano music box at your service, sir?",265,31,5,301,644,1780
We aren't fighting the conchords after the show?,248,24,7,279,644,316
"I'm a classical fighter, not a lover.",246,28,5,279,644,399
"Gloves off for this dueling piano fight, please.",245,30,4,279,644,2253
"I'm from Julliard, doing my practicum on Heckler Control.",247,26,6,279,644,3938
I shall now type a letter to Terpsichore.,239,29,4,272,644,440
This song is called “Puncher.”,239,29,4,272,644,739
"And now ladies and gentlemen, Sugar Ray Stravinky's ""Knocked Coal Digger,"" in A Flat Miner.",240,27,5,272,644,926
"...and now, winner by unanimous decision, I will play your request.",237,33,2,272,644,4181
Bah! To think they criticized my last concerto for lacking that signature punch - preposterous.,250,35,2,287,644,185
‘Occhio di Tigre’ by Sopravvissuto.,252,31,4,287,644,3268
"This isn't right, Mr. Jordan.",245,32,3,280,644,834
What is everyone’s appetite for a black and blue concerto?,243,36,1,280,644,2056
Just Refined Enough,247,28,5,280,644,2298
Boxer on the keys,241,27,5,273,644,1544
And if I hear any snorin' out there I'll play chopsticks with your head.,275,28,7,310,644,2609
"Everyone, if you would kindly look under your seats, I've seemed to have misplaced my hands.",253,31,4,288,644,3639
"Oh my!!!!
Where do I begin. From right to my left or left to my right.",252,33,3,288,644,3714
"Liszt was out of the question, but, ohhh, Christmas Chopsticks!",267,31,5,303,644,1207
"It ain't never gonna stop 'cause
You can't fight the feeling",266,33,4,303,644,1316
"Tea, a drink with jam and bread...
That will bring us back to Boom-Boom, Pow-Pow",249,26,6,281,644,3166
And to those critics who said I couldn't beat the Rach 2-- watch.,279,35,4,318,644,5569
And now..”Eye of the Tiger Symphony No. 12” by Beat-hoven,250,26,6,282,644,1948
It's so declasse to do this with naked hands!,261,32,4,297,644,4648
"For my next number, I'll be playing ""Brontosaurus On the Keys"".",242,29,4,275,644,3276
And now for a Bach Suite,256,29,5,290,644,4114
"Dear, my fingers don't hurt any more!",272,25,8,305,644,1571
They appear to have shrunken in the washer.,268,33,4,305,644,3004
"I wish my brother George Foreman was here.""",251,26,6,283,644,166
"And now for the grand finale,
Boxing Boogie Woogie.",263,30,5,298,644,4925
"I'll play 'row, row your boat once', as my trainer warned I might be KO'd after the first round.",228,31,2,261,644,5006
I don't need these to play my College Fight Song.,244,27,5,276,644,767
I have a boxing match at 6:00 but a recital at 5:30.,251,28,5,284,644,5653
You said play with your left hand? I thought you said play with your left hook!,232,25,5,262,644,2191
This boxing-piono match really shows off both of my talents!,246,25,6,277,644,3213
Keep your hands up!,257,31,4,292,644,740
You shall know me as Hasim Rachmaninoff,257,31,4,292,644,1157
Chopin and I will not be pleased if maestro's tempo is too slow this evening.,254,37,1,292,644,3307
"And now, my impression of Lang Lang.",247,25,6,278,644,1322
It's an eh tu Brute in punch-drunk manner.,244,31,3,278,644,3757
"Please don't laugh, this is the only way to play  lil Xan on piano.",233,25,5,263,644,3467
Beathoven piano concerto no 5,264,34,3,301,644,39
"I,m just wearing these to keep my hands warm.

Elizabeth Shaw
San Francisco, Calif.",263,36,2,301,644,2258
This is where John Garfield and I diverge.,250,34,2,286,644,4582
They call me the rope-a-dope ivory tickler.,259,31,4,294,644,1054
"I think you're punching above your weight, Steve.",246,29,4,279,644,50
The guy at the store said these go loves would knock you out!,247,27,5,279,644,4874
Could somebody please turn down the air conditioning?,267,30,5,302,644,3854
"now, i understand how ridiculous this may look! however, this piano is - against all odds - the heavyweight champion of the world, and i have had to enact both a cinematic heist and a personal revelation in order to find myself on this stage today!",254,28,5,287,644,1503
umm..k...then...o,254,28,5,287,644,5523
"Ladies and gentlemen, Let’s hear it for the boxin love chords!",240,28,4,272,644,4105
"Ladies and gentlemen please welcome George! George is an excellent multitasker —  effortlessly defending his title in the ring, he also tickles the ivory AND simultaneously accomplishes advanced pivot tables in Microsoft Excel. Give it up for George!",246,31,3,280,644,528
The Reprise Fighter,267,32,4,303,644,4336
Try fisticuffs on chopsticks.,254,30,4,288,644,4019
"I'm not a fan of, Chopsticks.",239,32,2,273,644,4103
What about the pianissimo parts?,247,31,3,281,644,157
"My next piece is titled ""Politically Incorrect""",250,25,6,281,644,3189
Another day at the office...,233,31,2,266,644,1486
"Next, I will play Beethoven - 'Moonlight' Sonata in a new C Stick and Move.""",267,34,3,304,644,1515
"Do I have to do your job, too?",270,28,6,304,644,5687
"hmmmm,",244,24,6,274,644,2416
Mind if I play with my mitts on?,264,27,6,297,644,3805
A.J. Liebling taught me everything I know.,248,31,3,282,644,684
Breaking  News— Rocky Balboa attempts the piano!!!”,248,31,3,282,644,2356
"For your holiday enjoyment, we'll be singing 'Jingle Bells",248,31,3,282,644,2893
Tonight I'm going to play Chopin.,249,29,4,282,644,3528
Sergio is obsessed with Victor Borge.,248,31,3,282,644,3700
"Good, but your playing needs a different attack.",251,25,6,282,644,4065
Stella. Estella?,222,27,3,252,644,4647
Fly like a bumblebee,243,28,4,275,644,4091
The last time I attempted Franz Liszt's Campanella I injured my hands therefore my Dr. insists I wear these.,262,33,3,298,644,3281
Ali's Flur de Punch in A minor.,250,29,4,283,644,571
I was afraid there'd be a boxing kangaroo in the audience tonight.,258,28,5,291,644,450
Aren’t there already too many YouTube videos with this gimmick?!,255,34,2,291,644,3523
Now we shall box the piano.,256,32,3,291,644,3874
Punch punch punch puuuunch.,227,19,7,253,644,2408
And now I play for you... ‘An ode to boxing.’,264,31,4,299,644,5022
I call this 'The Sweet Science Sonata.',251,29,4,284,644,1031
Aren't we playing the first movement from the Pugulist Concerto in Bb?,251,29,4,284,644,2547
"This movement is titled ""Scontro non troppo.""",257,32,3,292,644,3127
This next piece helps me touch some tender feelings...,258,30,4,292,644,5440
I am boxing it up,266,29,5,300,644,1749
Now they tell me that the only words I could make out in their garbled voicemail were actually 'Bach sing loves.',268,25,7,300,644,5673
"As an encore, I""m going to play my Boxing Concerto.",245,28,4,277,644,889
I tried tying strings around my fingers to remember the punch lines.,246,26,5,277,644,2618
"I call it ""The Upright Uppercut""",243,32,2,277,644,3913
Concerto for boxing bouts,243,32,2,277,644,4661
"My next tunes for my Mommy, for letting me borrow her gloves",252,29,4,285,644,1975
No encore tonight.,259,30,4,293,644,2076
"In the next piano duo, I will be performing the Kangaroo Hop with the bloke from Down Under.",262,24,7,293,644,3891
He packs a punch on the b-minor chord!,240,25,5,270,644,2514
You lied to me!,238,29,3,270,644,3481
And now for the Israeli national anthem...,267,29,5,301,644,1595
Where's the Ring Girl?,267,29,5,301,644,2214
"I call this ""What's Black and White and Red all Over.",272,34,3,309,644,3602
Muhammad Off-key,251,33,2,286,644,314
"I’m going to play this way, believe it or not.",254,27,5,286,644,2180
"And now, thumping keys by my boy Elroy. If you don’t like it please cross that line on the stage.",254,27,5,286,644,2812
Did Golden Boy survive?,258,34,2,294,644,4905
"And next, ""Flight of the Albatross""",268,29,5,302,644,2879
And Muhammad Off-Key is on the piano.,248,26,5,279,644,2771
"A standing 8 count please! A standing 8 count!! A one, a two, a onetwothreefourfivesixseveneight: Boom! Yeeeeah!!",273,34,3,310,644,3747
"You better be prepared for a fight,  if you play Christmas music!",247,28,4,279,644,5411
For my final ringside number I would like to play one of Bach's Sonatas.,260,32,3,295,644,3488
"Yes, I’m exercising!",263,26,6,295,644,3728
"ladies and gentlemen, without further ado, i regret to inform you that the men’s bathroom is closed.",241,27,4,272,644,131
I'm the best.  I just haven't played yet.,252,35,1,288,644,3105
"The next selection is ""The Hypochondriac's Concerto""",227,27,3,257,644,636
"I just had a manicure.So, bear with me, or I'll punch you out.",242,27,4,273,644,411
"My closing piece: ""Unanimous Ten""",242,27,4,273,644,5489
"You didn't say 'delicate hands for a delicate task'?"" - David Steenburg, Washington, D",248,30,3,281,644,1925
This punch line is a trifle too black and white for my liking.,214,25,3,242,644,2663
"Hamfisted ?
Hell no!  -- These are my Piano-training Gloves!",264,28,5,297,644,774
When you said “ punish the counter” ...?,269,33,3,305,644,3530
And now Hayden’s symphony 12. The Boxing Symphony,237,24,5,266,644,3732
"And now, Mozart's Opus No. 1, The Enfant Concerto",249,30,3,282,644,1845
"If Keith Emmerson could stab his Hammond organ with a knife, why can't I ...",250,28,4,282,644,2768
"ooh, maybe you better turn up the heat instead.",257,29,4,290,644,2097
You wanna fight me on this piano bro!?,265,28,5,298,644,1643
And now from my new rap concherto,266,26,6,298,644,5426
"and now Cauliflower Ears', JuNgLe In ThE rUmBlE",271,31,4,306,644,4249
Now please enjoy several selections from my new album.,238,24,5,267,644,583
Beethoven again?,238,24,5,267,644,4164
"Eb-o-ny and i-vo-ry,
From Stallone.
For his herd's men-ta-li-ty...",259,27,5,291,644,1436
I don't remember seeing this in Whiplash!,259,27,5,291,644,4347
"Please forgive any inelegance, the repertoire always suffers a bit on December 26th",268,24,7,299,644,4481
He punches below his weight.,267,26,6,299,644,5509
"And now a new original work for our time, 'Pizza Chord.'",279,32,4,315,644,2092
"And now for my final selection: 
Rollin, Rolling, Rolling!",236,30,2,268,644,939
They told me to break a leg!,237,28,3,268,644,2501
One Note!@,244,29,3,276,644,3048
Once I Ko'ed Ali .,252,28,4,284,644,1790
"And now, Mozart's Piano Concerto N. 23 in A.",254,24,6,284,644,1871
"Sir, kindly take your mitts off me.",252,28,4,284,644,4744
"Boxing the keys, Bobby Shorter style:",251,30,3,284,644,4995
Pinching hazard.,259,29,4,292,644,1019
Do you prefer my rendition of Mozart with a left hook or right cross?,261,25,6,292,644,3336
m now going to play a Chopin mazurka,258,31,3,292,644,3482
Gimme that old soft shoe.,256,35,1,292,644,5165
My next selection is called ‘Gonna Fly Now’ by the great Bill Conti.,263,36,1,300,644,501
"My next opus is entitled ""CT in E minor""",272,33,3,308,644,2393
"They protect me from the threats I have received--sinister forces plan to close the keylid on my precious fingers.  Now, enjoy my outstanding play.",288,31,5,324,644,2439
Excuse the gloves. I’ve had a falling out with my Fairy Godmother.,239,26,4,269,644,2294
"I’ve got a bad neck rash that I need to scratch. With a collar cone I couldn’t see the keys,
but at least with these gloves I can.",248,23,6,277,644,756
My next piece comes right out of the box.,244,31,2,277,644,2881
Savate Concerto,258,33,2,293,644,4774
"Yes, I've taken some tough knocks, but maybe I can hit the world stage this way.",258,33,2,293,644,5041
"When I pound the black and whites, the harmony is incredible.",267,30,4,301,644,1164
"In lieu of the Squeeze Box, I will now play the Piano Box.",264,36,1,301,644,5134
"My next # is ""Waltz around the Ring"" composed solely to be played with boxing gloves.",271,37,1,309,644,1491
"I call it Pieces of Eight, of course.",238,30,2,270,644,4043
I'd like to add you to my LinkedIn network,246,29,3,278,644,835
"my record is 0 and 111 losses, however my nest opponent J.S. Bach only has a simple tocata and fugue in d minor played lively with ppp dynamics",252,32,2,286,644,3820
"As a former Boy Scout, I am compelled to be a prepared pianist.",253,30,3,286,644,5417
So it's playing piano first and then the boxing.,220,23,4,247,644,1441
Now I will play Bachoxing piano concerto No. 3,243,22,6,271,644,4413
They told me to learn some monophonic pieces.,247,29,3,279,644,387
"for my next number i shall play ""punch""",254,30,3,287,644,2028
"Next I put the top down, take my gloves off, tie my dance shoes on and dance my favorite song.",256,26,5,287,644,3560
"We'd like to welcome Rocky, here in the front row.",267,34,2,303,644,4194
They told Johnny he was a one hit wonder . Look at him now !,241,28,3,272,644,2347
"And now, here’s Wonderwall.",242,26,4,272,644,3060
Rachmaninoff?  I don't Think so.,257,26,5,288,644,4248
This is the Winner By Knockout sonata for piano four hands.,235,25,4,264,644,4903
You promised me I'd have a corner man and a trainer.,269,32,3,304,644,5093
klsfjsd,269,19,9,297,644,1999
Has anyone seen my shadow?,254,34,1,289,644,4563
I'm committed to the lower register.,251,25,5,281,644,2456
How about some K.O. Key?,241,30,2,273,644,4355
Hope it's not Prokofiev's 1st or 3rd?,243,26,4,273,644,5475
This is no pianola.,269,36,1,306,644,4000
"I will now play ""Fanfare for a Triamphant Presidential  Knockout of a Democratic Congress.",247,20,7,274,644,3084
"Next number is ""Boxer's delight""",242,30,2,274,644,5177
And now here’s “Revolution #9.”,275,26,6,307,644,2935
He catches a glimpse in a mirror as he prepares to perform a Leonard Bernstein piece that requires special instrumentation.,265,31,3,299,644,5120
Is there a sports doctor in the house?,262,22,7,291,644,5588
"Just another key puncher, in the slog of life...",252,27,4,283,644,608
"And for my next piece, I like to place a tune by Simon & Garfunkel",253,25,5,283,644,1767
No one expected the spelling bee's elimination round to be like this.,281,31,4,316,644,4653
Best technique to compose a fine lullaby.,262,24,6,292,644,1350
"And now as my Al Jolson tribute continues, I'd like to play AlaBAMy Bound.",252,29,3,284,644,1082
A singer is not going to be a good boxer without knowing piano.,255,23,6,284,644,2583
"You should see Cody, the other guy.",252,29,3,284,644,5582
"Yo Mick, can I go back to chasing the chicken?",245,28,3,276,644,119
"Clearly, I am the most superb.",246,26,4,276,644,549
I wear these to beat my meat.,247,24,5,276,644,2882
My next selection is by a well known 21st century composer.,238,27,3,268,644,2701
There's a rhythm in the ring of the keyboard...,224,25,3,252,644,1277
"If you loved ""Mrs. Robinson"", Art tells me this song from our latest album ""Bridge Over Troubled Water"" will knock you out.",252,31,2,285,644,3707
"I'd like to take this opportunity to remind all of the fine people gathered here tonight, that there's plenty of folks out there who still say that no black man could ever play Liszt.",247,26,4,277,644,2195
"Maestro, I'm ready. Bring on the concerto!",267,33,2,302,644,5391
But this piano goes below the belt.,239,29,2,270,644,38
I once thought there were no second acts in American lives.,255,29,3,287,644,4182
I shall now attempt Mozart's Sonata No.16 in C major.,251,22,6,279,644,1384
"Chopin's etude Butterfly, plink a minor key.",250,24,5,279,644,3417
Don't break a leg!,249,26,4,279,644,3568
My town.  Round ten?,263,30,3,296,644,2309
I like to feel the beat through the piano.,291,36,2,329,644,2473
"Float like a butterfly, sing like a Beatle.",228,23,4,255,644,4143
Can you play ‘Love Is A Battlefield ‘??!!,248,30,2,280,644,2888
My next song is “Gonna Fly Now”.,273,27,5,305,644,2829
let me box to this beat,267,24,6,297,644,3557
Gonna pound these keys like I pound my dick!,240,16,8,264,644,4949
"And now for your musical enjoyment..Boxer Rapsody





Susan Elwood Monterey Calicornia",263,32,2,297,644,5246
Do I look sharp with these gloves?,266,26,5,297,644,5571
This is one of the greatest works of Bach's.,257,29,3,289,644,55
"Nah, Anything but chopsticks!",258,27,4,289,644,1160
I thought we were playing the Notre Dame fight song next,228,25,3,256,644,4032
Piano concerto in b minor. Boom Boom Bang Bang.,264,32,2,298,644,2925
"Time out, foul, breaking rhythm, loss of one point.",229,25,3,257,644,1793
And now for the opening notes of “Night and Day” by Cole Porter.,251,28,3,282,644,1185
Playing the piano on 'hard' mode,254,22,6,282,644,2047
"No, I'm hardly a kitten on the keys!",243,29,2,274,644,3400
I call this one 'The Sweet Music of the Sweet Science.',266,30,3,299,644,3607
You listining to D magore engery,290,29,5,324,644,3831
My drums was stolen,260,27,4,291,644,200
Rejoice-- I was able to get this concert on Pay TV.,259,29,3,291,644,515
"This is Princeton, right?",260,27,4,291,644,2494
"Next, I’ll be playing Bach’s “In G Minor”",259,29,3,291,644,5351
We are not the UFC - we have class!,229,27,2,258,644,5448
"We will,  we wi[[ box you""

Deda Jacobse",256,20,7,283,644,3940
"And, now, the Cannibal Corpse trio sonata.",277,25,6,308,644,1244
This piano has been shading me,268,28,4,300,644,1281
Everything started when I received a music box at Christmas,285,26,6,317,644,670
"And now a little composition of my own called 
""Etude for Washington, No. 535"".",254,26,4,284,644,257
"And now, a Paul Simon rhapsody.",267,32,2,301,644,758
"Sorry, but the piano has chickenpox.",270,26,5,301,644,1307
Gwyneth said no porcelain.,240,24,4,268,644,3926
"And now, the Box Well-Tampered Clavier",235,19,6,260,644,698
That's supposed to be Bach's prelude in C!!,223,28,1,252,644,2886
"They call to the Jersey bounce, it’s the rythem that really counts!",243,20,6,269,644,4258
This is not the Thrilla in Manila,240,26,3,269,644,4551
I'm auditioning for the Punch Brothers' Christmas concert.,255,28,3,286,644,862
How do you expect me to do two things at once?,248,27,3,278,644,1612
And to conclude tonight's performance: Beethoven's bowel movement.,257,26,4,287,644,5688
You never know when you may be attacked,250,25,4,279,644,2153
They had asked me to box-in the keys.,270,34,1,305,644,2355
My sinphony for appassionato.,287,32,3,322,644,1694
That was a real knockout!  This next one will be a TKO...,251,25,4,280,644,778
You think these gloves can stop me from playing my brilliance,266,27,4,297,644,2500
When,260,24,5,289,644,2833
But I thought he said I played as if...?,271,34,1,306,644,3464
"I was told there would be a boxing match, but now I see that I am to play the piano. Random!",272,34,1,307,644,3009
Niles pretending to pound out a tune when the CD skipped.,267,31,2,300,644,1139
"The ex-boxer had moved from the ring to the classical music stage. Although still limited in his piano playing, he has become highly regarded in the nearly lost art of round singing. Here he is shown preparing his audience to go the full 10.",267,31,2,300,644,4597
Good boxing is a piece of art,268,29,3,300,644,5552
"I mastered this advanced technique by watching the Ali vs. Frazier 3 fight""",254,25,4,283,644,2507
,241,19,6,266,644,1363
You hate my playing this much!??,262,26,4,292,644,1900
'Am I loud enough to go through your hearing aid?',247,24,4,275,644,1528
And now I give you Rondo No. 15 by my boxer.,245,28,2,275,644,4735
"For my next piece, ""Canon in CTE.""",268,31,2,301,644,613
I totally expect you to account for every song that vaguely fits.,234,18,6,258,644,1106
"A famous rap artist told me to ""knock it out the box"", maestro!",238,27,2,267,644,5228
I shall now play Total Concerto for Radness and Coolness by Strong Bad.,248,24,4,276,644,2111
Looks like I accidentally wore my boxing gloves instead of my piano gloves,246,28,2,276,644,3197
I'm going to hit a grand slam with my grand piano.,254,29,2,285,644,5635
It's a new style. We call it Beethoven.,265,26,4,295,644,3229
I'm feeling boxed in and want greater freedom to develop my music.,240,27,2,269,644,3360
Its the challenge of playing Bela Bartko,250,24,4,278,644,638
"Aww crud, was I sleep walking again?",249,26,3,278,644,1094
"That’s if one is falling on you. But up close and personal, take the gloves off.",248,28,2,278,644,2088
'Welcome to Chris Brown in the lounge.',258,25,4,287,644,544
"Ali, was always my dream to play the Ivory keys..",264,30,2,296,644,3236
"OK, you guys go ""dah-dah-dah, dah-dah-dah""
and then I windmill and do some jabs
we'll all feel hugely uplifted",261,21,6,288,644,5414
Chief of Staff?  I'm not dressed for the occasion,235,24,3,262,644,4725
"You might say “This looks like a sack race” and then you might say... 
“Yes, you can run a sack race, but why run a freakin’ sack race?”  
And I tell you “It’s all thumbs.”",245,21,5,271,644,2307
Well it wasn't the first  piano performance to put me to sleep,250,28,2,280,644,954
Shut up! Fifty years ago we'd have you upside down with a fucking fork up your ass...,256,16,8,280,644,1827
Three little kitten lost their mittens...,252,24,4,280,644,2803
"Oh, I'm so sorry. I just came from boxing practice.",252,24,4,280,644,5586
"No, Penn & Teller, not a piano roll",258,29,2,289,644,2772
Watch out for the hammer move!,257,31,1,289,644,4112
"Fight, or Floght if the Bumblebee?",259,27,3,289,644,5530
I'm moving up in classical music.,236,24,3,263,644,1564
I'll start with twinkle twinkle little toes in the key of c,243,27,2,272,644,431
Something about using the gloves to masturbate I dunno figure out your own caption.,246,21,5,272,644,2314
OK.. the odd's are even.. I can play Chopin VS Trump knew nothing...,267,30,2,299,644,5319
"Three blind mice, three blind mice...",245,25,3,273,644,2384
This one was penned by Bundini Brown.,270,26,4,300,644,136
"For my last number, I need to play only a few keys and I need to protect myself from my OCD.",270,26,4,300,644,3271
And now I will play Islamey alla Bellicoso.,231,21,4,256,644,2917
It seems my manager's text message auto-corrected from 'plink those black keys' to 'punch those black eyes.' Apologies.,283,34,1,318,644,58
"Please welcome our next performance, ""The Boxer's Treble""",254,26,3,283,644,1065
"Chopped, not chops",253,28,2,283,644,2244
"Trust me!
  This is neither an easy-to-set nor effective large rodent trap.",254,26,3,283,644,2814
"AS A BOXER ,I AM TOTALLY UNSUITED FOR MUSIC",262,27,3,292,644,3947
"Chop kicks, not chopsticks!",230,25,2,257,644,3365
"Damn, caught red handed...",244,31,0,275,644,3493
Where do I punch,255,26,3,284,644,2739
"This is my fight song
No hands no feet song
Just mouthing words song",248,25,3,276,644,669
I will now play one of Dwane's great pieces.,256,26,3,285,644,2721
I'm so pleased  to a part of this Day after Christmas Concert at Massey Hall.,265,25,4,294,644,2533
easy enough,254,32,0,286,644,2006
Liberace can really pound out some mean tunes!!,256,28,2,286,644,2571
I'm taking giant steps.,267,25,4,296,644,419
you want me to shell the peanuts right now?,274,28,3,305,644,4783
"I will now play, ""D.E.A.D"".",268,25,4,297,644,10
"Bam bam, ey, what a bam bam.",251,25,3,279,644,2463
I feel like such a dick,252,23,4,279,644,2752
"You better like this, or else I will knock you out.",275,30,2,307,644,1928
I find it difficult to float like a butterfly and sting like a bee just now.,262,22,5,289,644,818
"This sonata has 12 movements. It's called ""By Unanimous Decision""
Javier Pescador, Ann Arbor, MI",258,30,1,289,644,1599
Oscar Bait,245,22,4,271,644,3108
"By executive order,
I present you a piano concerto in Me Mayor.",237,21,4,262,644,2619
"His salary known work, this piece was composed by Handel at 6 months.",246,22,4,272,644,1935
And then I fought ...,246,22,4,272,644,4483
"So if I think Beethoven's Minuet in G, I can play.",228,24,2,254,644,1778
"And now for ""The Flight of the Boom Boom Beegone""!",260,30,1,291,644,5005
"I,m now going to play gloves get in the way",252,29,1,282,644,4487
Big decision: Pizza or chicken for dinner?,272,25,4,301,644,3297
"It fifights me.
I have no chouxe.",265,22,5,292,644,2036
I wasn’t sure what was scheduled tonight at MSG,280,28,3,311,644,3954
"And now, I play Beethoven’s Moonlight Sonata",272,27,3,302,644,1904
Our next act is MMA sousaphone.,249,22,4,275,644,2646
Come out flat and get played like a fiddle,248,24,3,275,644,2698
"Sorry, I just finished the boxing match.",233,20,4,257,644,2592
"Oh, Henry Mancini!"" (Please underline the word Henry.",256,27,2,285,644,2673
"Joe could always set a beat down. Tonight, he was going to set a beat-down.",248,26,2,276,644,1552
"This one is called ""Rudolph the smash-nosed Reindeer.""",241,23,3,267,644,3551
Psst! Hey! Wanna score some gluten?,274,27,3,304,644,61
"And now, a little something by John",259,23,4,286,644,4556
"You've seen Golden Boy?  Well, I just can't decide!",240,27,1,268,644,1860
There are many reasons why I am confused right now. Chiefly amount which is the question of where my seeing-eye bat is?,243,21,4,268,644,4798
Cluster time!,276,25,4,305,644,310
Ushio Shinohara pivots into a musical career.,243,23,3,269,644,311
the last number really did a number on me!,267,28,2,297,644,4175
The piano is my ring and the sheet music is my mouth guard.,258,29,1,288,644,2135
"My next number is ""A Rollin' and a Tumblin""",251,26,2,279,644,1146
I didn't mean to actually break a leg!,245,21,4,270,644,1979
Mum can I take the gloves off now so I can play piano?,245,21,4,270,644,3588
No this isn't a piano. I have a scale in here.,261,25,3,289,644,5630
I 'm the poster boy for Trump's new rhythmic safe sex and birth control plans.,254,22,4,280,644,5553
I will now perform my swinging ‘Larkin’ suite.,279,27,3,309,644,4645
"My next number is Bill Conti's ""Gonna Fly Now.""",253,26,2,281,644,165
War and music ? Lets keep Smileing,271,26,3,300,644,4937
I don't want to hear another word about your fat thumbs.,246,23,3,272,644,5323
"The next piece is my own composition entitled, 'Fight Club.' And no, I haven't been drinking, but am a bit punch drunk from my previous profession.",280,27,3,310,644,3308
I think I lost by a TKO ...,254,26,2,282,644,1715
Is this how Scott Joplin learned?,255,24,3,282,644,2648
Turn off that spotlight!  I don't want the audience to see why I play so delicately.,263,27,2,292,644,4643
"Risin' up, back on the street",256,24,3,283,644,5078
It's closer to 'punch' music.,258,20,5,283,644,5690
"We are now going to sing a round: Row, Row, Row Your Boat.",273,26,3,302,644,891
My week beats your year,248,23,3,274,644,506
"Hello, Pianist Temps, send someone over quickly. One of the pianists in the duet suddenly came down with a splitting headache.",249,23,3,275,644,2386
"You know, I HAVE  the chicken pox!",250,21,4,275,644,3893
Marshmallow gets into hard rock,267,23,4,294,644,430
"A boxing we will go,
A boxing we will go,
High-ho the dairy oh,

A boxing we will go!",283,27,3,313,644,4300
"Next,the boxing champion Ali will perform.",276,24,4,304,644,2588
This is how Doraemon plays the piano.,256,28,1,285,644,2934
They just told me I needed to know ten key punch.,248,27,1,276,644,5116
They call me the Gloved Geek.,291,32,1,324,644,3000
"And now playing “The Cinderella Man” in Cross, Hook, Uppercut.”",266,29,1,296,644,773
"Thirty years, and he still can't get ""Hot Cross Buns"", folks.",251,23,3,277,644,4955
For my next piece I'll literally be tinkling the ivories.,260,24,3,287,644,5693
'Time to duck & cover bitches while I fulfill the request for 'The Theme from Rocky'.,272,19,6,297,644,4656
Now for a medley from the World War II era,253,21,4,278,644,1841
"(Afternoon of requests) ""Tchaik 1st?   OK.  Ready!""",250,27,1,278,644,3756
I swear this is the right way to play the piano!,251,25,2,278,644,4163
Just to show you that I'm not at war with myself...,253,21,4,278,644,5427
"‘Ay, it’s me, Brooklyn Maitre-D! I got a nice pipin’ hot piano pie, straight from da oven! Just kidding, I’m Piano Hater! I beat ‘em up! Stop me when one of these is good enough for my MadTV audition tape.",244,22,3,269,644,1647
… And now: “Battling Joe”,242,26,1,269,644,2281
Enough with the snotty critique. I do.,263,24,3,290,644,4011
"Yo Adrian. Yo Adrian, you have become part of my plan.
Yo Adrian. Yo Adrian, here's the one thing.
I'll step out of the boxing ring and give you another kind of RING!
(excerpt from Rocky: The Stage Performance)",245,24,2,271,644,4178
"At recital, all the way up the scale, my hands told me I was a non-pianist.",264,24,3,291,644,5170
This next piece is for prepared piano.,272,27,2,301,644,4444
"If someone will hit me with a touch of smelling salts, I'll close with Ode to the Renaissance man.",259,19,5,283,644,5494
"And that's how I learned to play ""Concert Toes"".",276,23,4,303,644,1128
This next number is really hot.,238,25,1,264,644,3128
"I didn't want to, it sounds awful.",274,29,1,304,644,2478
"This isn’t a boxing match for crying out loud! You are meant to play the piano and those gloves are completely inappropriate. Don’t look at me like that, you know exactly what to do, so get them gloves off and use your fingers like you’re supposed t!",242,19,4,265,644,2873
"""Every time I  try to play 1 key I play 6 other keys""",302,30,2,334,644,3705
Perhaps I should switch to hand drumming instead.,280,21,5,306,644,2971
I was told not to juggle boxing and piano but I didn't know that it was to avoid something like this!,244,19,4,267,644,5067
"Wait, this is not the bathroom... Too late I guess.",255,18,5,278,644,1609
"What's that? You'd like me to play with boxing gloves on? Well, it's highly unorthodox. I won't be able to use my fingers to strike individual keys. Might as well give it a try, I suppose.",237,18,4,259,644,5042
Chord Master,244,23,2,269,644,1372
"And as I face the final curtain, Boss, I honor you.",256,20,4,280,644,599
This is not what I meant by “break a leg”!,236,22,2,260,644,3250
The performance will continue as soon as I dispose of this anthropomorphic mouse!,236,22,2,260,644,3404
I just have to punch the keys on the piano to bring 'em back to tune,255,22,3,280,644,3953
`We now take you to a very controlled contest!!,267,19,5,291,644,1596
With all due respect to Simon et al  - this is not going to work.,254,26,1,281,644,4459
I will now attempt Beethoven's Moonlight Sonata on super duper hard mode.,257,22,3,282,644,1800
Thank you thank you I will be autograph signing healthcare bills after the show. Thank you!,267,25,2,294,644,169
Get used to this.,242,20,3,265,644,2774
Chopin handicaps himself just to flex on his peers and assert domincance.,262,22,3,287,644,1118
I'll be playing the piano sonata by Wolfgang Amadeus K.O.zart,252,23,2,277,644,1794
Meet me in the ring after this piece. Five O'Clock. Don't be late.,254,21,3,278,644,1941
Safety first of all: I prefer to skip a note that the piano top makes me jump my fingers.,254,21,3,278,644,4651
"I am David, Front of House at the Wigmore Hall.",257,17,5,279,644,4039
"I said Moonlight ""Sonata'""- not Moonlight ""South Paw""!",274,23,3,300,644,284
"OK, I've got a nail biting problem, nut couldn't I wear a cone instead?",277,19,5,301,644,741
And now I shall perform Chopin's Prelude in G for pianist's penis.,266,22,3,291,644,65
"A Beethoven Classic, right up.",245,26,0,271,644,541
"""The key to solving any problem is to just finger it out.""",270,20,4,294,644,3209
I wish I had knuckles instead of these crab hands.,248,24,1,273,644,4992
"Ladies and Gentlemen, get ready for some action on the old 88!",250,22,2,274,644,2048
"Its tough to survive in this business.""

Mel Vigman, Summit, N",241,21,2,264,644,3632
"I am fighting a cold tonight. I play not Tchaikovsky, but Chopsticks.",245,17,4,266,644,4157
'This next piece is called 'Boxing Clever'',272,26,1,299,644,1875
"You know the old saying?
Yes...I am a professional Pugilist Pianist.",243,23,1,267,644,1613
Nauseating discordance is the soundtrack to my career but they’ll never understand :(,274,24,2,300,644,1291
OH GOD IM GONNA CUM,268,17,5,290,644,1815
"You thought I said my favorite things were pianos and violins, did you?",265,25,1,291,644,475
I will now attempt my encore in C#m,275,26,1,302,644,5313
Required paraphernalia to perform the latest new music and to fight back.,256,24,1,281,644,4914
"Oh, Mr. Mayweather, I'm going to tune you up!",276,26,1,303,644,1458
"Guess who said, ""I punched my music teacher because I didn't think he knew anything about music and I almost got expelled.""",249,19,3,271,644,716
It’s the new fashion,246,25,0,271,644,2169
I will now perform Rocky's concerto no. 1 for pianist's penis.,231,17,3,251,644,1726
"My firsta requesta eez ""Box Em RoundO",250,23,1,274,644,5255
What is Stevie Wonder up to now?,262,20,3,285,644,4074
How'd you like to pull my gloves?,242,22,1,265,644,553
A punchers chance my a#%!,295,23,3,321,644,3038
i was afraid there'd be a boxing kangaroo in the audience,264,22,2,288,644,460
I don't think they'll even notice I sent a sub for this gig.,264,22,2,288,644,3177
Hey ! Wanna learn my boxing style ?,254,23,1,278,644,2279
Rocky still has a punchers chance of knocking out Liszt's Campanella,297,25,2,324,644,3198
I never knew that a set of punches could sound like a set of keys.,266,24,1,291,644,2589
Sorry  I promised my wife to stay off Facebook for a week  But i can box my way through.,257,21,2,280,644,1431
Remember: 9/11 was an inside job,288,26,1,315,644,4600
Just the kind of gloves I need for a piano.,249,18,3,270,644,4936
"I can't Bogy 

gus zaso, concord nh",249,20,2,271,644,3425
What a Louis Lortie Nightmare looks like,271,20,3,294,644,2327
"Since I can play only chords, my concert  repertoire is limited...but we'll see what happens.",249,22,1,272,644,1909
And now for your request...punch in time...sing alone folks...,241,17,3,261,644,808
"Bach-sing! Cantatas. By Bach. Me singing. Dammit, they were right! The only sight gags that work with you people are pianist jokes. Somebody get these off me. The gloves, madam!",252,20,2,274,644,4138
Oh! Oh no! This must be how you hit “the brown note.”,274,22,2,298,644,2758
"The Scouts new ""Trump Advisor"" badge.",268,13,6,287,644,5416
An uninpired riff off of my Baa Baa Blacksheep entry made the finals.,278,20,3,301,644,29
"''I heard Chuck Norris plays the violin with a piano between his teeth, this will be easy in comparison...what do you mean internet memes aren't true?''",246,19,2,267,644,3491
How will I flip the notes?,248,23,0,271,644,1697
"Hmmmm, Insurance Company says I am not covered if I am not covered""",241,18,2,261,644,1482
I Call this number....,263,22,1,286,644,3039
"Its the fermata tiger, its the trill of Wainwright",255,19,2,276,644,416
It's not gay. It's big dick energy.,238,17,2,257,644,1692
Oh request those great 1-2 beat tunes.,275,20,2,297,644,4120
On piano making right noise.,257,18,2,277,644,2235
"I'd gladly spar but I'm ill-prepared in today's reign of hip hop, rap, house and Brittney/Bieber clones.",260,16,3,279,644,1296
"My bad, I have pummeling walls and newspapers as my primary job, and this as my second.",264,16,3,283,644,5648
First they took away the boxing ring...now I don't know how to play this piano...unless they have really really wide keys...,256,14,3,273,644,5623
Here’s an old standardyiu May. It recognise,244,15,2,261,644,1127
Casio Clay got more than e asked for when presented with a Baby Grand,252,15,2,269,644,3175
Never made a better performance,250,19,0,269,644,5369
"Man, taking 25 lsd tablets wants my best choice",264,15,2,281,644,1154
"R is for the way you drove me crazy,O is for the way you drove me nuts,Cis for the way you drove me insane,put them all together they spell fricking psyco..",249,17,0,266,644,662
How do I piano tune with my claws?,290,15,2,307,644,577
sorry guys just came back from a game and i sweat alot and my gloves are stuck   sorry we are still doing the show but i will have twin brother do it instead you won't tell the difference well be dose play boxing,242,12,1,255,644,907
