caption,unfunny,somewhat_funny,funny,count,contest,target_id
"If we time it right, I can get you in this house today.",65,48,27,140,645,672
"Sure, location is important, but timing is everything.",65,38,26,129,645,7229
"Location is important,
but here,
timing is everything",78,39,32,149,645,2661
"The previous owners were a sweet elderly couple, but a tad slow on their feet.",69,39,23,131,645,234
If you want to get into this property you will have to move fast.,77,45,25,147,645,6401
I'm afraid this IS the only retirement community you can afford that is on a golf course.,65,37,21,123,645,1756
Perhaps I misunderstood you when you said you don't want a long drive.,69,38,22,129,645,1149
Getting into a house like this is all about timing.,66,30,22,118,645,3325
"On the count of three, whaddya say we take a look inside?",63,24,22,109,645,4445
I'm afraid your offer didn't go through.,64,32,20,116,645,5872
"If we time this right, I can get you folks in here today.",76,41,22,139,645,3893
Can I show you something in a shoe?,75,46,20,141,645,3475
"Shall we go in and have a look... 
on the count of three.",74,47,19,140,645,5899
And it has five security speeds - off for kids to high for unwanted relatives.,74,36,22,132,645,7430
"Trust me, as your broker, this one is all about timing.",67,38,18,123,645,5713
It’s not your typical run of the mill house.,88,41,26,155,645,7009
"It's pricier than the clown's mouth, but you save on energy costs.",63,37,16,116,645,1675
"On the other hand, it really cuts down on door-to-door salesmen.",79,43,21,143,645,5426
The previous owner died of a stroke.,74,28,23,125,645,567
she's selling because she lost her husband in a terrible accident,82,36,24,142,645,211
Forget location. Timing is everything.,76,41,20,137,645,778
"Three words: rotation, rotation, rotation.",65,28,19,112,645,6339
You're going to want to move quickly on this one.,70,28,21,119,645,6033
"With this house, timing is everything.",93,39,27,159,645,3149
"Great, let’s go sign the papers now...no...now! Wait, ok now...",76,45,18,139,645,571
Timing is everything if you want to get into this unique property.,84,39,23,146,645,3486
"On my count of three, we can begin our walkthrough.",75,36,20,131,645,1081
This came on the market suddenly. The owner just peeked out  the door for the morning paper.,66,37,16,119,645,4190
"Geez, you've said no to the igloo, the lighthouse, the old woman's shoe and now this.  What ARE you looking for?",62,38,14,114,645,2007
I’ve got 17 others that I think you’ll love,76,37,20,133,645,4317
"Listen, we only have a short time to get our foot in the door on this one.",71,40,17,128,645,6065
"By far, the most important feature: Rotation. Rotation. Rotation.",65,35,16,116,645,5485
Act fast -- this kind of opening only presents itself every eight seconds.,69,37,17,123,645,6949
"Well, given your budget, this is what 'living on a golf course' looks like.",77,27,23,127,645,248
"I don’t show this to most people, but you look like a fun couple",71,39,17,127,645,4821
"You did say energy efficient, two story property on the golf course.",82,40,21,143,645,2485
"If you'll wait just a moment, we can have a look inside.",78,43,18,139,645,3457
You don’t want to get the newspaper until after you’ve had at least one cup of coffee.,67,38,15,120,645,4358
The only other listing I have in this price range is a shoe.,88,32,25,145,645,6782
"If you aren’t ready to decide, we can let that other couple play through.",70,37,16,123,645,7284
"It's a four bed, two bath, par three house.",76,44,16,136,645,5618
"Usually it's about location, location, location, but in this case, it's all about timing, timing, timing.",71,37,16,124,645,1401
Not a huge fan?,74,24,21,119,645,3636
Just remember timing is everything.,77,27,21,125,645,6485
The seller's are disclosing that the floor breaks a little left to right,72,37,16,125,645,6583
"This one's is a little different - location, location, timing!",69,30,17,116,645,4647
"I’ll level with you, sir. You need balls to live here.",79,26,22,127,645,6769
"Remember, location, location, location. Also, timing, timing, timing.",78,28,21,127,645,7544
What obstacles do we need to overcome to put you in this house?,86,44,19,149,645,2613
"Location, location, timing.",66,32,15,113,645,105
"Forget location,location,location.  Here it's all about timing,timing,timing.",77,29,20,126,645,4831
It’s all about timing in this market.,67,36,14,117,645,3643
"You understand of course, timing is everything.",79,37,18,134,645,560
Timing is everything on this deal.,79,37,18,134,645,6185
I finally found a house on a golf course that is in your price range.,73,33,17,123,645,6897
It's perfect if you want to putter around the house.,65,33,14,112,645,748
You'll have to get in quickly on this one.,72,38,15,125,645,4324
"In this real estate market, if you want to get in the front door, your timing has to be just right.",72,22,20,114,645,747
It comes with a revolving mortgage.,78,38,17,133,645,5257
"Once you get the timing down, the doors are a breeze.",85,43,18,146,645,6303
It’s perfect for someone who likes to putter around.,76,38,16,130,645,950
"Okay, follow me inside, one at a time.",62,31,13,106,645,4599
"It hits all three: location, location, timing.",64,30,14,108,645,2125
"So, this is your first time doing AirB&B?",74,35,16,125,645,5649
You did say “golf course” and “affordable.”,87,39,19,145,645,2155
"It’s a two bed, one bath, three par.",85,30,21,136,645,1087
It's a new listing – the last owner died unexpectedly of a stroke.,72,31,16,119,645,3697
Of course you could go solar.,73,38,14,125,645,3240
Timing is everything with this one.,77,33,17,127,645,1302
You'll want to move quick on this one.,81,28,20,129,645,1069
Once you get the timing down it’s a piece of cake.,76,38,15,129,645,5916
"If you have a small pencil and a score card, I can get you signed today.",79,35,17,131,645,98
If you want to get in on the ground floor timing is everything.,87,31,21,139,645,834
The only other thing in your price range is the clown mouth,81,43,15,139,645,6581
It's the only thing on a golf course within your price range.,76,25,19,120,645,2877
"As with most real estate, timing is everything.",85,38,18,141,645,2188
It's Quixotic in a nice way.,86,36,19,141,645,4341
"On your budget, this is all we could find in a golf community.",76,28,18,122,645,4087
What whirring sound?,91,32,22,145,645,6728
"My real estate colleagues say, “location, location, location,” but I say, “timing, timing, timing!”",77,41,14,132,645,5739
It’s all about timing folks.,86,32,20,138,645,6086
I have one more place to show you.  It is owned by a little old lady who has a of lot kids.,66,41,10,117,645,6177
"Of course in this market, timing is everything.",73,30,16,119,645,1325
"Now with this listing, timing is everything.",73,36,14,123,645,103
"Trust me, this is the right time to get you into this house.  No wait!  Okay, now this is the right time...",77,31,17,125,645,1653
"It has an open, closed, and open again floor plan.",77,37,15,129,645,433
This is the only golf course community in your price range.,86,25,22,133,645,7481
Sorry the pirate ship is over your budget.,77,46,12,135,645,2663
Great! I'll contact the owner with your offer and get ball rolling.,86,34,19,139,645,2050
It fell into foreclosure after the previous owner suffered from multiple strokes,92,37,20,149,645,5653
It sounds like we need to refine what you meant by wanting to live on a golf course.,76,32,16,124,645,3437
This is a two bedroom two bath par 3.,77,33,16,126,645,718
"This property is available, but you'll have to move quickly.",82,29,19,130,645,7206
Of course this is a Trump property.  Didn’t you see the huge clown with the round mouth on the 18th hole!,85,26,21,132,645,4023
"Location, location, location? No, it's timing, timing, timing.",85,35,18,138,645,5413
This is the only option next to a golf course in your price range.,87,34,19,140,645,71
"Rotation, rotation, rotation.",84,46,14,144,645,44
"If your timing is right, I can get you into this home.",76,31,16,123,645,5462
Here we just call it “golf.”,74,38,13,125,645,6914
"""Yes, this is the open house, but we'll have to be quick.",78,36,15,129,645,6707
"This is a Dutch-style, three-bedroom, two-bath, par-3.",84,36,17,137,645,6164
"It's not your average, run-of-the-mill property.",88,40,17,145,645,270
It's very energy efficient and its location is above par.,71,28,15,114,645,1673
It’s all a matter of timing.,67,36,11,114,645,3101
"I really think you should put in an offer now, you already lost the alligator and the castle is out of your price range.",72,26,16,114,645,5048
It's a nice place to putter around in.,73,30,15,118,645,7290
"Just one thing. If It's windy,use the back door.",80,25,19,124,645,4510
"Of course, you would have to let people play through.",80,28,18,126,645,2899
"With this purchase, timing is everything.",76,36,14,126,645,6768
I'll be honest. You need balls to live here.,87,23,22,132,645,334
"Yes,the listing did say ""Small Dutch Traditional on a golf course.""",80,37,15,132,645,5550
Timing is everything in this market.,83,37,16,136,645,963
You wanted to live on a golf course and this is in your price range.,94,21,25,140,645,1901
"I can probably get you in here, but it's going to take good timing.""",94,30,22,146,645,4891
I think we'd like to putt in an offer!,93,35,20,148,645,1631
"As promised, a home on a golf course.",67,35,11,113,645,3550
This is the only Dutch Colonial at your price point.,72,34,13,119,645,5458
"With this model, it’s not so much “location, location, location” as “timing, timing, timing.”",75,31,15,121,645,7349
"Let me explain the ""intermittent egress"" clause.",87,31,19,137,645,542
How quickly do you think you can move in?,90,37,18,145,645,5770
"Let's hop on the next blade to see the view from
the top.",75,36,13,124,645,115
It is just a matter of timing.,73,40,11,124,645,862
"It's the only 4-blade, 1-bath you'll find at this price.",78,45,11,134,645,1243
"‘You know what they say – rotation, rotation, rotation’",77,35,14,126,645,1320
"Everyone talks about location, but timing is everything.",85,31,18,134,645,2333
Golf is big around here.,87,39,16,142,645,2678
"Why yes, it was a fore closure.",77,35,14,126,645,2788
It's priced to move.,85,37,16,138,645,2847
What did you think “Easy access to Holland tunnel” meant?,74,29,15,118,645,2910
"I know you said solar, but it was just outside your budget.",87,33,18,138,645,4200
"If you like this, I have 17 others to show you.",66,27,13,106,645,4902
Timing is important.,84,33,17,134,645,5067
The previous owners?  Never got the timing down.,90,38,17,145,645,2772
Timing is everything on this one !,88,42,15,145,645,6989
"If you love it I think we can get you in, but you'll have to move fast.",91,33,19,143,645,1145
"Yes, it is only a par-3.  All the par-4 properties have already been sold.",82,39,14,135,645,2271
"Remember, with real estate it's all in the timing.",81,38,14,133,645,3674
"And the best part is, it keeps the Jehovah's Witnesses away.",81,32,16,129,645,369
It's everything you wanted in your dream house:  a Dutch Colonial on a golf course with a lawn you can putter around on!,80,34,15,129,645,5917
The current owners are retiring to a green dinosaur in Florida.,81,29,17,127,645,4307
And there are only 17 other homes on this development.,72,38,11,121,645,3267
My advice is to move quickly.,74,28,15,117,645,6952
"If you want in, you'll have to move fast.""",72,29,14,115,645,5444
Yes they do always say location location location but with this property I think you’ll see what I mean when I say that timing is everything.,95,30,21,146,645,1265
"With your income, this is the only way you can own a house on a golf course.",92,30,20,142,645,888
This really cuts down on the trick or treaters.,88,35,17,140,645,4536
The price is on par with others in the neighborhood.,82,41,13,136,645,4926
You must be the Mulligans.,82,35,15,132,645,609
You should act fast before someone else putts in an offer.,80,36,14,130,645,1032
You're getting in at just the right time.,79,35,14,128,645,6261
"I have 17 other models to show you, so let's get started.",76,38,12,126,645,2469
"A place like this, you need to move fast.",76,38,12,126,645,6308
"Think of it more as an ""intermittently gated community.""",77,36,13,126,645,6456
"We said we'd like to find something ""under a 'mil"", not live in one",76,32,14,122,645,1227
The Quixotes are motivated to sell.,74,36,12,122,645,5835
"It's move-in ready... now. Wait, now! Ok go now!",69,37,10,116,645,4562
"In this market, timing is everything.",71,30,13,114,645,27
It was slightly misleading to say that it was “near” a golf course.,63,31,10,104,645,106
"Okay then, we can look at the one with the water hazard again.",92,38,17,147,645,6641
"Now, you'll need to time your entries and exits, but otherwise, it's the perfect house",88,31,18,137,645,4236
"If you're not sure, we have seventeen other locations we can look at.",86,29,18,133,645,3640
"Believe me, you'll never find another home on a golf course that's this affordable.",81,39,13,133,645,5098
"Not only do you qualify for the wind energy tax credit, but we also waive your greens fee.",85,28,18,131,645,3163
"If you want this place, the timing is...now",81,33,15,129,645,171
"Yes, it's true what they say about location. 
But timing's important, too.",74,38,11,123,645,1093
"It hits every item on your wish-list, large front yard, natural lighting, and you're on a golf course.",80,26,17,123,645,1148
... and an old woman lives in a shoe just down the block.,71,41,9,121,645,455
"Like so much in life,timing is everything.",75,30,14,119,645,3464
"Don't worry, almost no one gets the ball through the living room.",76,25,16,117,645,6922
"As you know, timing is everything.",88,36,16,140,645,2174
"This is a 2 bed, 2 bath, par 3.",84,44,12,140,645,5957
This is the closest you’re going to get to a golf course at your price range.,84,41,13,138,645,5666
"Location may be important, but here, timing is everything",82,39,13,134,645,907
"You said, ""Find us a house on a golf course.""",104,42,19,165,645,3648
I just sold an old woman a shoe who would kill for this kind of light...,79,39,12,130,645,1005
"It'll cut your energy costs by 80 percent and eliminate, and I mean eliminate, solicitors.",76,42,10,128,645,6653
You’ll find this an ideal mother-in-law apartment.,80,31,15,126,645,374
I wouldn't worry too much. Most people miss.,78,35,13,126,645,3165
"Like I said,"" in this market timing is everything""",80,31,15,126,645,5572
"If you'd like to make an offer, I'll get the ball rolling right away.",80,31,15,126,645,6238
It also has a 3 par garage.,82,24,18,124,645,2328
"Yes, the blade speed is adjustable.",76,36,12,124,645,6584
"Would you like to try and go through the house again?""",78,32,14,124,645,7045
Of course timing is everything!,79,24,17,120,645,776
"Location, location, location... and timing. Timing is critical.",73,33,12,118,645,5541
You may call it a Quixotic investment.,73,30,13,116,645,5217
'You did say you wanted to go Dutch...',86,42,13,141,645,1630
There is a 'play through' clause in the deed.,88,38,15,141,645,6660
"Eventually, you don't even notice them.",67,36,9,112,645,3521
If you don’t like this .. I have 17 others to choose from,88,32,17,137,645,6779
"It's a two bedroom, two bathroom, par 3.",64,36,8,108,645,491
"Work with me, Mr. Sterling.  You said you wanted a place on a golf course...",83,39,13,135,645,559
"In real estate, timing is everything.",90,25,20,135,645,1168
"It checks all your boxes: off-the-grid wind power, plenty of play opportunities for the kids, and it’s golf course adjacent!",84,34,15,133,645,1720
"Like I told you, timing is everything on this house.",85,26,18,129,645,1831
Now this little Dutch-influenced charmer affords you sweeping fairway views while putting you right in the middle of the action.,81,34,14,129,645,3623
3 bedrooms. 2 baths. Par 3.,79,32,14,125,645,7297
Here is the only golf course option I could find you within your budget.,79,29,15,123,645,5740
We also have the same unit in gingerbread.,78,28,15,121,645,6731
I just wanted you to see the kind of houses that are available in your budget.,93,30,19,142,645,5851
This just came on the market—the previous tenant walked outside while texting.,72,34,11,117,645,4747
Once you get the timing down it's a very welcoming space.,88,37,15,140,645,7278
"If this isn't your style, I also have a clown's mouth available.",71,33,11,115,645,451
"Where else are you going to find an energy efficient house, in a gated community with only 18 homes?",87,36,15,138,645,5707
"We've got a very motivated seller, he moved to a lighthouse.",80,41,11,132,645,1994
"Like I said on the phone, it's an authentic Dutch Revival right next to the ninth hole.",84,33,15,132,645,2920
"They've rejected a lot of offers, but we time it right, I think we can get you into this house.",85,31,16,132,645,6464
"I'm not going to lie, you're going to need balls to move here.",80,35,13,128,645,3599
And everything is just a short drive away.,94,36,17,147,645,3794
The price is par for the course.,64,32,9,105,645,5014
"It's a 2 bed, 1 bath, Par 3.",93,35,17,145,645,7209
"I am willing to waive the greens fees, but I have a very motivated couple on the 15th hole.",76,37,11,124,645,611
I should probably tell you about the easement.,90,38,15,143,645,2503
"Manicured lawn, right on the green, powered by renewable wind energy, this listing won't last long!",90,35,16,141,645,3990
"No, no, no... your entrance would be around back. This is what we in the business refer to as the Mother-in-law Door.",90,35,16,141,645,4408
"With interest rates rising, you won't see a par three at this price again.",76,31,13,120,645,5923
It's perfect for the couple that wants to putter around the house.,74,32,12,118,645,1242
I am happy to show you a par 4 if you would like a little more space,85,36,14,135,645,3218
A lowball offer might get through if you time it right.,86,34,15,135,645,4078
The prior owners were recently separated.,91,21,21,133,645,5224
But it's your choice. Clockwise. Or counterclockwise.,82,36,13,131,645,5802
"I suggest that if you want to get into  this house now, timing is everything.",85,27,17,129,645,4268
"You know what we say in real estate,  rotation, rotation, rotation.",80,37,12,129,645,4369
"This neighborhood checks all your boxes -- a volcano, a waterfall, and a giant clown head.",78,38,11,127,645,3919
"Each of the 18 properties is unique while still sharing our signature feature of ""the large round hole in the yard.""",77,40,10,127,645,6705
How's your timing?,79,33,13,125,645,6005
"Well, as with buying any new home, it's all about timing.",89,39,14,142,645,62
"It’s a fast moving market, but if you time the entrance right this could be a hole in one.",83,22,18,123,645,5470
Any questions?,77,34,12,123,645,5948
"Three words: timing, timing, timing.",80,28,15,123,645,7506
You did ask for a Dutch Colonial on a golf course.,79,27,15,121,645,4679
"It's a one bedroom, one bath, par five.",91,29,18,138,645,2528
You asked to see a house on a golf course.,74,34,11,119,645,387
"...and it is indeed on a golf course, as you requested.",85,38,13,136,645,711
A par 3 seemed to be more within your budget.,84,40,12,136,645,6592
This is Trump golf. He hates the word 'miniature.',90,25,19,134,645,391
Now this is not your run-of-the-mill house!,88,29,17,134,645,5927
"“You’re in luck, this dude from La Mancha is anxious to sell”",66,21,13,100,645,4540
"I'm sorry, for the budget that you gave me, this is the only listing available with old world charm, in a gated community, on a course!",93,36,16,145,645,119
Did I mention it's the only par 3 left in the neighborhood?,90,42,13,145,645,2487
"Of course, on windy days, we suggest using the back door.",83,30,15,128,645,6853
"The good news is, it’s $300k less than the Clown’s Mouth.",69,32,10,111,645,4770
Of course the neighbors will want to play through,88,37,14,139,645,2966
We also have hole 8 available with a waterfall view.,87,39,13,139,645,3958
I can also show you something in a par 3.,78,31,13,122,645,5515
I think you may have misunderstood the golf membership,88,34,15,137,645,2499
"It's hit or miss, really.",98,31,19,148,645,7043
It's not your run-of-the-mill house.,87,30,16,133,645,28
It's a 3 bedroom 2 bath par 3,94,36,16,146,645,450
It gets great light...then not so great...then great again...then not so great...,82,37,12,131,645,1970
I'll draft the offer and get the ball rolling but timing is everything.,93,35,16,144,645,5981
Timing is everything.,82,34,13,129,645,1023
Three things. Rotation. Rotation. Rotation.,91,33,16,140,645,160
And then there's the 2 par garage...,87,41,12,140,645,4114
What you need is a house that says ‘We’re the Johnsons! We’re fun...We’re whimsical...We’re a little bit dangerous...’”,71,30,11,112,645,4246
I think the 7th hole is more in your price range.,91,30,17,138,645,4976
"This is a charming 2-bedroom, 2-bath, par 4.",75,39,9,123,645,1380
"Oh, once you get the timing right, you'll never even notice...",76,37,10,123,645,1878
There's a castle on the next green if you want something more upscale.,79,31,13,123,645,1922
Would you like to take a look at the lighthouse before making up your mind ?,99,31,19,149,645,1564
"Well, you said you wanted a house on a golf course...",78,27,14,119,645,319
"After this, we'll go visit a wonderful 3 bed, 2 bath shoe.",87,29,16,132,645,4303
Location isn’ t everything..it’s timing.,93,37,15,145,645,2072
"Yes, the clown's mouth is cheaper, but it lacks curb appeal.",93,34,16,143,645,2440
It’s not your run-of-the-mill rental.,85,30,15,130,645,3912
"You have to admit, it is not your run of the mill type place",84,32,14,130,645,6482
"Of course, like life, timing is everthing",94,29,18,141,645,682
"Location certainly matters, but so does timing!",83,31,14,128,645,5478
"Not to worry, it's actually a very tricky shot.",74,29,12,115,645,1810
"Well, just a quick warning, with this place timing is everything!",75,27,13,115,645,4148
"Now, timing is critical for this open house.",92,30,17,139,645,1740
You said you wanted something reasonably priced on a golf course....,90,34,15,139,645,3670
Timing is the key.,81,32,13,126,645,2334
And it has excellent ventilation.,77,37,10,124,645,2370
"Sure, let's talk about the elephant in the corner.",88,32,15,135,645,6631
"It's a two bed, two bath, par three...",75,38,9,122,645,3042
We think it might be gophers.,74,40,8,122,645,6029
"Well you did say you always wanted to live on a golf course, Harold.",80,28,14,122,645,7109
"Tiny house, green energy source, located next to the fairway... I think you'll find this listing checks all the boxes!",74,37,9,120,645,1957
"If you like the property, I think the timing is perfect to get in now.",80,25,15,120,645,4814
"Well of course you've heard the three most important words 
in real estate-rotation, rotation, rotation.",86,30,15,131,645,4485
Sustainable power and a golf course - seems to check all your boxes,69,27,11,107,645,1617
"When we said we wanted to live on a golf course, I don’t think this is quite what we had in mind.",93,33,16,142,645,7200
"And, as you can see, it truly is right on the golf course.",73,36,9,118,645,4943
"If you have one of those small pencils, I'll write up the contract now.",81,20,17,118,645,6818
The previous owner died in a freak accident.,91,34,15,140,645,1154
"On windy days, I suggest working at home...",75,29,12,116,645,3658
This Dutch charmer overlooks the seventh hole.,82,32,13,127,645,74
"Unfortunately, the house by the waterfall is out of your price range.",79,38,10,127,645,281
Follow me in on the count of three.,83,30,14,127,645,435
I know the tiny house craze is over but the mini-golf house market is just heating up.,79,38,10,127,645,3576
"It's a charming three-bedroom, three-bath par-three.",80,36,11,127,645,5197
An opportunity like this only comes around every so often.,79,35,11,125,645,2850
Make sure you look both ways before you walk out of the door.,81,31,13,125,645,6845
Salesmen and missionaries think twice before ringing your doorbell.,81,31,13,125,645,6946
So. . .would you like to putt in an offer?,95,37,15,147,645,1593
"And the best part is, that hole leads straight to the parking garage.",82,26,15,123,645,426
I would argue it’s EXACTLY  what the listing said: “Green energy home with European feel. On the course.”,79,32,12,123,645,1496
"As I was saying, timing is everything.",83,24,16,123,645,7001
"I'd act fast, the foot traffic on this property has been unbelievable.",85,37,12,134,645,1492
And the location is great. I just sold the shoe next door to a little old woman.,86,35,13,134,645,4807
"If you don’t like this floor plan, we have 17 more to choose from.",88,31,15,134,645,5483
"As we say in the real estate business, it's all about ""timing, timing, timing.""",95,34,16,145,645,3603
"Two bed, one bath, par 4",87,30,15,132,645,624
"Before we get to the showing, remember that timing is key.",73,24,13,110,645,1778
"Your mortgage statements will be written with a stubby pencil on a little card, and will probably not be accurate.",92,37,14,143,645,3622
"It tends to get a bit noisy in the summer months, but that's par for the course around here.",92,34,15,141,645,547
If you are a drinking man we should look elsewhere,90,38,13,141,645,5951
"You hated the clown on hole 6, and you hate the windmill. Do you want to live on a golf course or not?",67,30,9,106,645,163
"What we're offering is a lifestyle that's high on whimsy and low on maintenance.""",66,32,8,106,645,3769
"On a windy day, use the back door.",94,41,13,148,645,4183
"It’s a three bedroom, two bath, par three.",100,29,19,148,645,6077
90% of the balls never make it this far. It's safer than a bocce ball court.,81,33,12,126,645,3478
This is the only golf retirement community you can afford.,75,28,12,115,645,2124
"If you want in, we gotta act fast. In this neighborhood, timing is everything.",74,30,11,115,645,6622
"And the best part is, you can charge your Tesla for free.",77,24,14,115,645,7014
"It's a 2 bath, 3 bed, 4 par.",87,35,13,135,645,453
Ready to get swept off your feet?,86,37,12,135,645,4287
You could putter around the yard to your heart's content.,79,34,11,124,645,1532
"If you're interested in this house, know that timing is everything.",79,34,11,124,645,4946
It looked different on Zillow ?,73,29,11,113,645,3187
I’ll see what I can do but no one gets this property on their first shot.,89,28,16,133,645,2825
You said you wanted a house on a golf course.,81,27,14,122,645,3607
"Yes, indeed. Timing is everything.",80,29,13,122,645,7089
"Location? No, no, no.  In real estate, it's timing, timing, timing.",87,29,15,131,645,2599
This one's gonna sell fast.  It's the only par-3 in the neighborhood.,89,39,12,140,645,2223
To get you into this one timing's everything.,76,34,10,120,645,3023
"Oh, there are a couple of easements that I should probably mention.",89,39,12,140,645,5059
"I can get you into this house, but timing is everything",84,32,13,129,645,2376
"In this business, timing is everything.",81,38,10,129,645,6481
"On the bright side, very few people can make this shot.",92,30,16,138,645,6667
We can't keep going round and round on the price. There's a foursome waiting.,94,40,13,147,645,1964
Your timing will be crucial for this property.,86,25,16,127,645,1270
...and the Hubbards are just two streets over in the shoe,86,25,16,127,645,3132
Just some parting words of advice - don’t text and walk.,83,31,13,127,645,6396
Once you get the timing down I think you’ll really like it here.,89,33,14,136,645,3013
"Well yes, there is no driveway, but that's kind of the point.",92,27,17,136,645,4766
"It's on a golf course, it's close to church, and it's eco-friendly. What else could you want?",90,31,15,136,645,6279
Mexico will pay for the windmill.,97,31,17,145,645,6530
"It's 2 bedrooms, 1 1/2 baths and a par 3.",82,30,13,125,645,1072
And of course any late rent payments will result in a two stroke penalty.,81,32,12,125,645,3876
This house perfectly fits your criteria - a traditional design near a golf course.,88,32,14,134,645,133
"This offer should go through easily, but we’ll have to time it just right.",87,34,13,134,645,2057
"In this case, it’s “timing, timing, timing.”",91,26,17,134,645,3956
"Now I have to warn you,the front door is a little tricky.",67,29,9,105,645,1876
"As with all real estate, timing is crucial.",94,34,15,143,645,2202
"Good news, Mr. and Mrs. Quixote!  Your dream home is no longer impossible!",103,30,19,152,645,2567
"Trust me folks, around here below par is a good thing.",73,31,10,114,645,6048
...And you never have to worry about door-to-door salesmen.,79,33,11,123,645,3126
"Listen, real estate is all about timing.",82,27,14,123,645,3208
Did I mention proximity to recreational activities?,76,39,8,123,645,7516
You said you were looking for a Dutch colonial?,91,37,13,141,645,6982
The pirate ship is taken. This is the best we have,78,32,11,121,645,2593
I also have something on the back-nine with a water feature.,96,38,14,148,645,2460
Let’s get the ball rolling if you think the timing’s right.,104,36,17,157,645,7459
This is the only Dutch colonial I could find in your price range.,79,27,13,119,645,6118
"It's a great deal, quite a bit less than you usually pay for a place on a golf course.",83,33,12,128,645,2776
It’s perfect.  You’ll be downsizing... and living on a golf course.,81,37,10,128,645,6713
It depends on how much you putt down.,94,25,18,137,645,4650
"On a windy day, it generates its own power AND keeps away Jehovah's Witnesses.",92,29,16,137,645,5171
"It's the original air bnb.""",88,34,13,135,645,516
Gotta move fast on this one. shall we get the ball rolling?,91,28,16,135,645,1372
"This particular tiny house is exotic, quixotic, and a step up from your current shoe.",83,30,13,126,645,4310
It wasn’t easy finding something in your price range that was in a family friendly neighborhood and on a golf course.,90,30,15,135,645,5346
"Compared to other houses in the neighborhood, it's above par.""",96,32,16,144,645,6783
The seller is very motivated.,93,38,13,144,645,6849
I was told they were very happy here before the accident.,92,37,13,142,645,5661
"When you're thinking of getting into a home, timing is everything.",81,31,12,124,645,3471
The owner recently relocated the hole to the front yard to cut down on through traffic.,97,38,14,149,645,87
...I'm telling you ...in this neighborhood timing is everything,88,42,10,140,645,2855
The timing was off for the last couple who were interested in this property.,88,42,10,140,645,4082
Amazon delivery is hit or miss.,86,32,13,131,645,585
It's no ordinary run-of-a-mill home.,84,36,11,131,645,1068
"Just remember the three R's--Rotation, rotation, rotation.",84,22,16,122,645,7050
"In your price range, this is the closest you'll come to golf course living.",73,30,10,113,645,505
"I usually tell my clients that it's all about ""location, location, location."" In this case, the timing is key.",72,32,9,113,645,1784
"Yes, didn't I say it was on a golf course?",89,37,12,138,645,417
"I understand. The timing has to be right.""",82,23,15,120,645,985
"The rent is reasonable, and the electric bill is practically nil",75,37,8,120,645,7356
"It's small, but it's right on the golf course.",92,42,11,145,645,2011
"I mean, you said you were in the market for a Dutch colonial...",95,36,14,145,645,6686
"It's a par 4, but I think I can get them down to 3.",85,42,9,136,645,3402
"It's in great shape. The seller is a little old lady 
who downsized to a shoe.",84,30,13,127,645,1191
I think we preferred the 7th hole - better schools...,86,26,15,127,645,2308
This isn't just your run of the mill home....,84,30,13,127,645,5609
"I admit, ‘central air’ may have been a little misleading.",75,34,9,118,645,1051
"No, that's old news.  The neighborhood association has taken care of Mr. Quixote.",89,31,14,134,645,136
"I understand your skepticism, but I sense the developer is serious about limiting this subdivision to just the 18 units.",82,31,12,125,645,349
Timing will be everything.,83,29,13,125,645,2089
... and don't forget to have your key ready.,82,31,12,125,645,5785
"At the end of the day, there's risk involved in any home purchase.",95,30,16,141,645,1645
"If you wanna get in on the ground floor, timing is everything.",78,25,13,116,645,5080
This is no run-of-the-mill property.,78,36,9,123,645,4994
"Please understand Mr. and Mrs. Quixote, the entire neighborhood has a vivid imagination.",80,32,11,123,645,7280
"Of course, the property values are on par with the neighbors'.",73,32,9,114,645,3515
There are only 17 other homes in this neighborhood.,74,30,10,114,645,6804
A windmill at this price is par for the course.,85,33,12,130,645,1790
I'll show you the inside when the wind dies down.,72,31,9,112,645,112
The seller is willing to throw in a lifetime supply of tiny pencils.,76,23,13,112,645,257
The previous owner had 4 strokes before he finally moved on.,84,32,12,128,645,1579
Timing is critical.,85,30,13,128,645,4767
It’s only dangerous to leave the house in windy days,91,43,10,144,645,4963
"If you don’t like this one, there’s a gorgeous clown’s mouth in foreclosure just across from the waterfall.",93,25,17,135,645,1860
You said an original home on a golf course,90,31,14,135,645,4778
"Remember: It's all about rotation, rotation, rotation.",91,29,15,135,645,6509
Really don't know what happened to the former owner but I heard that it had something to do with bad timing.,81,24,14,119,645,2530
"Well, if you decide to purchase the place, just remember-Timing is everything.",81,24,14,119,645,4323
"I assure you, this is no run-of-the-mill house.",95,32,15,142,645,475
The only downside is that your neighbor is kind of a clown.,94,34,14,142,645,6162
We call this model the “Home-in-one!”,84,29,13,126,645,55
"I know it's at the upper end of your price range, but it is a Par 4.",81,35,10,126,645,3403
This unit is on par with other houses in the market.,79,39,8,126,645,4107
Don’t worry.  They usually miss.,81,35,10,126,645,5584
It's the latest thing in mixed-use development.,77,18,15,110,645,858
If you want to get in this place we have to act right now.,88,32,13,133,645,481
"In Real Estate timing is everything, especially with this house.",87,34,12,133,645,1247
"It became available when the last owner, and his horse, moved to Spain",92,24,17,133,645,6104
I’d recommend moving quickly — timing is critical.,89,30,14,133,645,7487
"It’s energy efficient, Dutch inspired, and has a path to a lovely water feature.",79,25,13,117,645,1056
I can only think of one drawback.,77,29,11,117,645,2351
First question I always ask: How are your reflexes?,89,41,10,140,645,407
You just have to time it.,91,37,12,140,645,5405
"Some say location, location, location. But this place is all about timing, timing, timing.",92,35,13,140,645,5730
Do you like to putter around the house?,97,36,14,147,645,1167
"Oh, and one more thing. Please, PLEASE remember to answer the doorbell within 27 seconds.",95,40,12,147,645,1863
Not ON the 18th hole. It IS the 18th hole.,98,34,15,147,645,2949
I also have a charming 3 bedroom inside a clown's mouth.,101,28,18,147,645,5591
I also have a very nice castle with a moat and draw bridge.,73,23,12,108,645,6111
Maybe the merry-go-round is closer to your price range.,85,35,11,131,645,3081
It's a time share. You can enter at 10 second intervals.,86,33,12,131,645,3781
"Of course price is always important, but with this property timing is everything.",83,39,9,131,645,4882
It's a gated community...but only in 3-second intervals.,86,33,12,131,645,5599
"On the bright side, it could be a shoe.",89,38,11,138,645,2868
I can even give you a sub-par loan.,99,29,17,145,645,1958
It’s really only an issue when it’s windy.,98,31,16,145,645,6678
Think of it as Dutch Revival meets Maralago.,82,27,13,122,645,235
This is about as close as you can get to the 9th green in your price range.,79,33,10,122,645,683
The Quixotes are very motivated sellers.,77,37,8,122,645,1521
There is one easement in the deed that I think you should read.,77,37,8,122,645,3516
You've got to move fast.,89,35,12,136,645,1852
I have another property I'd like to show you. An old lady is moving our of her shoe.,88,37,11,136,645,2574
"We'll,there's this lovely old shoe we could look at.",78,21,14,113,645,1392
"It’s downsizing and on the golf course.
Best of both worlds!",93,38,12,143,645,7223
"You’ll hear ‘location, location, location,’ a lot, but with this one it’s all about timing.",79,30,11,120,645,1123
Getting through the door will be easy once you get the timing down.,84,31,12,127,645,3662
"Golf course view, miniature price.",83,33,11,127,645,5181
The window of opportunity is closing fast.,84,42,8,134,645,170
"In real estate, everything is timing.",90,30,14,134,645,912
This is not your run-of-the-mill place.,96,29,16,141,645,347
Its definitely above par for this neighborhood.,87,33,12,132,645,4539
"It's not just a game, it's a lifestyle",87,33,12,132,645,4587
"Actually no, it's coal powered.",91,25,16,132,645,7423
Don't let the door hit you on your way in.,94,30,15,139,645,5650
Why not just putt in an offer and see where it goes?,103,34,16,153,645,6808
"An open concept, energy efficient and steps to a golf course; this is everything you’re looking for.",75,21,13,109,645,7269
I'd also recommend hazard insurance.,74,34,8,116,645,503
"As far as rentals go, this one is par for the course.",82,29,12,123,645,1771
We'll view the interior once the wind dies down.,79,35,9,123,645,4576
We made Holland pay for it,90,24,16,130,645,1285
Right on the golf course as you requested.,84,36,10,130,645,6692
It's crazy but timing is everything if you want to get into a place like this...,94,27,16,137,645,6122
Built in renewable energy. Built in pet door.  Small in ground pool.  This won't be on the market long.,100,26,18,144,645,2929
And the yard is great for just puttering around!,74,31,9,114,645,6030
"For a par three, this is an absolute steal.",83,35,10,128,645,226
"On the plus side, the ball rarely lands in your living room.",87,38,10,135,645,4144
This is a very exclusive development with only 17 other neighbors.,88,36,11,135,645,6023
"It comes with a fenced-in yard, but that's par for the course in this neighborhood",83,32,11,126,645,279
The last owners died suddenly.,89,31,13,133,645,316
"We could probably low ball them, but we'll need to time it perfectly.",101,29,17,147,645,1435
"The seller, Mr. Gulliver, will still maintain play through privileges.",82,34,10,126,645,2597
It does require balls to live here.,95,30,15,140,645,4839
Not exactly what I had in mind when I said I wanted a house with a white picket fence.,77,33,9,119,645,5031
And the value is well above par for the neighborhood.,83,43,7,133,645,5505
"In this market, timing is key.",96,36,13,145,645,7208
You're in luck - this gem is definitely not your run-of-the-mill property...,86,34,11,131,645,64
I can show you the inside but we're gonna have to make a run for it.,85,36,10,131,645,2152
I think I can get you into this complex if we time it right.,83,40,8,131,645,7161
"With your budget, this is the best place I can find you on a golf course.",85,25,14,124,645,2802
With this model you have no unsightly solar panels and you naturally repel solicitors.,83,29,12,124,645,3470
"Yes, we can install Dutch Doors.",84,27,13,124,645,3529
"And at a par-3, it's right in your range!",83,29,12,124,645,4763
"It's a 3 bedroom, 2 bathroom, par 4.",89,36,11,136,645,2053
I can promise you this: All your Prius-driving friends are going to be insanely jealous.,92,30,14,136,645,5333
"Nearby you have a Covered Bridge, a Paddle Wheel, and there's a Loop de Loop just down the street.",85,33,11,129,645,4275
You might want to use the back entrance during tee times.,84,24,14,122,645,1219
"Before we go in, I have to ask if you have good reflexes.",77,38,7,122,645,1605
You asked for Dutch doors.,79,34,9,122,645,7122
"I know you were looking for a par 3, but this just came on the market and it is loaded with Old World charm"".",87,37,10,134,645,186
"The property is fully carpeted, but that's par for the course.",87,37,10,134,645,2408
It's not your typical 'run of the mill' type establishment.,89,33,12,134,645,4822
And it is more reasonably priced than the Gingerbread House.,80,29,11,120,645,6134
"As promised, an affordable home on a golf course...",79,31,10,120,645,6493
"For your price range, this is a real hole-in-one.",75,28,10,113,645,5689
"Noisy, sure. But way less creepy than the Clown's Head walk up we saw earlier.",96,38,12,146,645,607
I'm sensing you're concerned with more than just the size of the property.,92,35,12,139,645,6576
"Yes, life on a golf course has its challenges. 
But in this case they are miniature.",96,27,16,139,645,7275
"Well, you said you wanted to go dutch!",85,38,9,132,645,804
Solar panels just seemed too obtrusive.,88,32,12,132,645,2146
The only negative is trying to get into the house on a windy day.,83,31,11,125,645,2300
It's a great place to putter around.,79,39,7,125,645,4583
"Don't worry, hardly anybody makes that shot. But just be careful how you arrange your furniture.",101,36,14,151,645,5491
"Yes, but do you really want to deal with the draw bridge on hole 3 everyday?",80,26,12,118,645,1839
"If you want something a bit nicer, there's a par four right on the water.",81,24,13,118,645,4855
It’s a green home. And on a golf course. What more could you want?,94,39,11,144,645,1238
"Any house can have a little white fence, but this one will be earning you a massive carbon credit.",86,33,11,130,645,1690
As a home it’s pretty run of the mill,89,27,14,130,645,3021
And the view of the clown's mouth from the master bedroom is amazing.,100,35,14,149,645,4700
I'm pleased to meet you on behalf of Quixote Realty.,118,29,21,168,645,2167
You did say you wanted something near a golf course.,94,36,12,142,645,3807
"To get into this house, timing is everything.",76,31,9,116,645,2419
Of course in real estate...timing is everything,83,36,9,128,645,6270
"Look, in your price range, this the the best retirement home on a golf course you’re gonna find.”",99,34,14,147,645,3059
"Oh, yes, timing IS everything.",99,34,14,147,645,4043
It's a great fixer-upper if you're on the ball and like to putter around the house.,100,32,15,147,645,4499
"Frankly, this is the only place within your handicap.",78,35,8,121,645,1757
It's vintage Dutch colonial.,96,29,15,140,645,5327
What's makes this property unique is the timed entrance.,95,31,14,140,645,6269
"Yes Maam, but, in my professional opinion, timing is everything.",100,40,12,152,645,1229
Waterfront? Let me show you something on the back nine.,78,24,12,114,645,3118
"The former owner?  Sadly, just a freak accident that could have been prevented by good timing.",90,30,13,133,645,3877
I'm legally obligated to tell you the old owner was killed by a golf ball.,94,41,10,145,645,3942
"Well, we call that the mother-in-law hole",84,31,11,126,645,1110
It's on par with the rest of the homes in this neighborhood.,84,31,11,126,645,1592
with your budget this is the closest you’ll get to your dream of living on a golf course,73,23,11,107,645,5294
I think you'll find everything's up to par.,103,42,12,157,645,575
"It is a great house, but you will have to get the timing right.",88,42,8,138,645,232
I’ve been studying the cycle and now is the perfect opportunity to move in.,92,34,12,138,645,1649
You said you would be open to real estate alternatives so long as there was a golf course nearby…,90,38,10,138,645,6207
"If you want this house, timing is everything",86,46,6,138,645,6277
"No? Then let's look at #18, the one with the water view.",79,30,10,119,645,3490
"On your budget I could not get you that 'tiny house' on the golf course, but I may have a compromise....",82,24,13,119,645,4300
"In light of your budget, this is the best home we could find on a golf course.",80,28,11,119,645,5565
You're not going to find anything else on the course at this price.,79,30,10,119,645,6567
"It really is all about rotation, rotation, rotation.",104,29,17,150,645,2182
Yeah. it's off the grid.,90,27,14,131,645,1344
The previous owner stayed remarkably nimble and was never bothered by solicitations.,88,31,12,131,645,2794
Timing is everything with this particular property.,98,30,15,143,645,6129
"You said “show me something affordable on a golf course,” so here we are.",82,32,10,124,645,2874
"With this new home, timing is everything.",85,26,13,124,645,5433
"And your mortgage rate is obviously variable, depending on the winds...",95,25,16,136,645,2941
The key to getting into the right house is timing.,91,33,12,136,645,4214
"Well, you asked for a home on a golf course",79,27,11,117,645,421
"The insurance policy covers fire, water damage and group events like middle school birthday parties.",79,27,11,117,645,602
"If you'd prefer a beachfront property, I can show you Hole 9.",75,35,7,117,645,2014
The other houses only have solar.,79,27,11,117,645,5082
What will it take to putt you into this baby?,74,26,10,110,645,599
This looks like a wind-wind situation for everybody.,72,30,8,110,645,4031
I’m really afraid if you don’t time this right you’ll lose out.,81,31,10,122,645,2059
The asking price is about par for the course in this neighborhood.,81,31,10,122,645,3939
The yard is too big? Then I’ll show you a Par 2.,95,41,10,146,645,4712
It’s just a run of the mill house.,101,29,16,146,645,6049
My hand to God.  The moment I laid eyes on you folks I said to myself.....Windmill.,80,22,13,115,645,6412
"Run of the mill? Yes, I have heard that one.",85,31,11,127,645,2511
Basement access is tricky.,86,29,12,127,645,2842
"Now, when you say this one is below par, is that a good or bad thing?",89,23,15,127,645,6173
You might qualify for a revolving mortgage.,92,36,11,139,645,5063
"While I understand you're concerned, keep in mind that the paint color can be changed.",92,44,8,144,645,39
We'll have access in four seconds.,92,44,8,144,645,428
This is just what you wanted--something directly on the golf course with lovely breezes all year.,87,35,10,132,645,728
Its just a short drive to the office,97,34,13,144,645,2562
"Dutch Colonial, off the grid, lovely breezes.",91,27,14,132,645,2637
I like that it's right on a golf course but the guy next door seems like a clown with a big mouth,81,28,11,120,645,3281
The previous owner forgot the importance of timing his exit out the door,103,30,16,149,645,3070
"Sure its small, but it feels like a par 5 inside.",99,38,12,149,645,4711
It could be worse. You could be living in a shoe!,96,44,9,149,645,5383
Your timing must be impeccable to get into this one.,97,42,10,149,645,6113
"Coming and going is dicey, but the energy savings are fantastic!",97,42,10,149,645,7361
We'll just have to time your closing carefully.,90,37,10,137,645,2879
I can also show you one with a moat.,83,32,10,125,645,117
Getting through the front door requires a little timing!,84,30,11,125,645,1597
It's on a par with other houses in the neighborhood.,87,24,14,125,645,2889
"The description ""on a miniature gulf"" might have a typo.",105,34,15,154,645,1906
I like to think of it as a quixotic little place.,96,33,13,142,645,3374
Good timing helps,94,37,11,142,645,5926
There's just a couple things to watch out for...,89,28,13,130,645,5496
"Well, you did say  'energy-efficient' and 'green' .""",72,24,10,106,645,4211
"Yes, it is a rather unusual take on mixed-use development...",83,29,11,123,645,1976
Scoring on a place like this is all about the timing.,79,37,7,123,645,6445
"Let's just duck in and see the inside, shall we?",79,37,7,123,645,6699
"I'm not gonna fight you on the price, Mr. Quixote",94,34,12,140,645,3889
This next house will knock you out!,95,32,13,140,645,4111
"You see, they say it’s all about location but with places like these... it’s all about timing.",98,26,16,140,645,4673
"No running water, but hole 17 has a huge wishing well.",94,34,12,140,645,7038
"Free electric, and door-to-door salesmen are never a problem.",83,37,8,128,645,23
It’s all in the timing.,84,35,9,128,645,1407
"And best of all, green fees are included.",86,31,11,128,645,3665
Decapitation insurance included the first year,78,28,10,116,645,1487
"Yes, it is on the expensive side, but you know what they say: Rotation, rotation, rotation.",91,29,13,133,645,3829
Perfect for the man who likes to putter around.,89,33,11,133,645,4571
I was pretty clear that this was an open house.,89,33,11,133,645,5419
"At his behest, everything is exaggerated at the Trump Miniature Golf Course.",93,25,15,133,645,7068
And you thought a Dutch Colonial on a golf course was impossible!,84,24,13,121,645,2411
"If you’re ready to sign, shall we get the ball rolling?",81,30,10,121,645,3356
"With 10% down, we can get the ball rolling immediately.",91,37,10,138,645,6955
"Just a moment before we start the open house, we have to time our entrance just right.",75,23,11,109,645,1497
"We can check out the interior, but we have to be quick.""",81,38,7,126,645,7521
"As you can see, it's centrally located: Pirate Ship-adjacent and steps from the Castle Moat, the Dinosaur, and the Krazy Klown.",75,31,8,114,645,179
It just needs someone with a little imagination. And quick reflexes.,74,33,7,114,645,372
On a windy day....you have to be quick.,76,29,9,114,645,549
So when do you want to get the ball rolling?,81,19,14,114,645,3183
We'll need to act fast on this one.,75,31,8,114,645,4306
We're big fans of renewable energy housing.,76,29,9,114,645,7381
This is not what we had in mind when we said we were looking for a Dutch Colonial style home,88,32,11,131,645,1464
"Trust me, it's not a trap.",91,26,14,131,645,2744
Why yes . . . Don Quixote did once live in this neighborhood.,86,36,9,131,645,4159
And after 9pm you have the course to yourself!,86,36,9,131,645,7006
"Sure, but it's a miniature mortgage too.",91,34,11,136,645,336
"For this property, timing is everything.",80,29,10,119,645,3227
"If you like the neighborhood, I have 17 other unique homes to show you--all with front door views of the fairway.",90,36,10,136,645,4815
"Not sure if we can afford this, it’s a big step up from the clown’s mouth.",89,38,9,136,645,6638
When we said we were into Dutch Colonial...,93,30,13,136,645,6741
If price is your prime concern I can get you a great deal on a shoe that's about to go into foreclosure.,86,33,10,129,645,1903
"And if you sink this putt, your first month's rent is free.",75,28,9,112,645,1832
The good news is that we have a shot.,90,33,11,134,645,6418
This is the only property on a golf course I could find in your budget.,80,26,11,117,645,137
"It’s priced to move quickly, so timing is key",81,24,12,117,645,2343
"Security system? You try getting in.""",95,31,13,139,645,329
I realize that but imagine the feeling of acomplishment you would have every time you left the house.,94,33,12,139,645,4513
"Yes, access to the golf course in included.",82,30,10,122,645,2768
"If it gets really windy, you may want to stay inside.",85,32,10,127,645,84
"To be honest with you,  this is not what I  meant when I said"" an environmentally friendly house on a golf course. """,88,26,13,127,645,5677
"...and it offers luxurious views of the Eiffel Tower, the Taj Mahal, and the hot dog stand.",88,26,13,127,645,6645
"With only 17 other units, it's a very exclusive development.",101,43,10,154,645,2354
Think Don Quixote meets suburbia.,75,25,10,110,645,3160
This one's perfect for people who like to putter around in the yard.,87,36,9,132,645,3173
That big hole in the ground is just par for the course.,75,25,10,110,645,6241
For another 50 thousand I could put you in a nice two-bedroom replica of the Eiffel Tower.,79,25,11,115,645,3154
"And now, we're going to see a house in a golf course community which fits your budget.",100,26,16,142,645,338
The timing on this is most important,98,30,14,142,645,6160
"And if this Dutch Farmhouse isn't your style, there are 17 other homes in the development, including one with a front entry shaped like a clown's mouth.",80,31,9,120,645,2322
Look at it this way: you WILL know what hit you.,82,27,11,120,645,5912
...and the drive couldn't be shorter!,101,32,14,147,645,3416
"You don't have to be crazy to live here, but it helps.",87,25,13,125,645,40
"And it's only a five minute walk to the miniature railway.""",84,31,10,125,645,187
"On the bright side, the grass is green year-round",81,37,7,125,645,6011
This one's all about timing,86,35,9,130,645,1382
The green carpeting is standard.,90,35,10,135,645,379
Location and timing are equally important here.,92,31,12,135,645,4086
This is about par for the neighborhood.,89,37,9,135,645,4350
You'll be the envy of the Old Woman who lives in a shoe.,93,29,13,135,645,4526
"When I say run, you run. The last buyer dodged the mill but was taken out by the ball.",98,35,12,145,645,814
"Yes, the front door's a little tricky, but you're just across from the church and there's no mowing.",77,34,7,118,645,2368
"In this market, it's all about location... and timing.",81,26,11,118,645,6276
"There are two beautiful yards, but there is a hole in one.",79,30,9,118,645,7096
What will it take for me to putt you into this home today?,101,37,12,150,645,1287
This one may be a little out of your range.,101,37,12,150,645,4204
This home is one of the 18 properties in this golf community.,83,30,10,123,645,6550
"No,we didn't mislead you. We said we have a beautiful,low maintenance community with year-round golfing.",87,30,11,128,645,2142
"Best of all, it's right on the golf course!",87,30,11,128,645,3001
It won’t last long at this price...I already have a foursome asking to play through.,92,28,13,133,645,2093
"Well, you're paying for that fairway view.",92,28,13,133,645,3954
It’s either this one or the giant clowns mouth,91,30,12,133,645,5448
What can I do to get the ball rolling?,89,34,10,133,645,6231
"In this market, it's all about the timing.",96,28,14,138,645,6871
Think of it as your impossible dream.,94,32,12,138,645,6961
I understand your concern about the constant breeze.  Can I take you to 14 to see the Brontosaurus?,69,31,6,106,645,4879
"Or, I can put you in a clown face tri-level on the 13th hole.",100,28,15,143,645,1760
"Of course, there is occasional through traffic.",103,30,15,148,645,3125
It's a good fit if you like to putter around the house.,102,32,14,148,645,6716
"The key to prime real estate in this neighborhood is, ‘Rotation, rotation, rotation.’",80,25,11,116,645,5885
"It's available immediately, the previous tenants had to duck and run.",79,35,7,121,645,4081
"Well, it never floods and your utility bills would be miniature.",84,25,12,121,645,7547
"I guarantee that most of the time, you'll have a ball in your new house.",87,27,12,126,645,5674
Think of it as the perfect house with the white picket fence--some of the time.,82,37,7,126,645,5832
The owner assures me that only one out of ten balls makes it into the house.,93,23,15,131,645,2706
"In that unlikely event, your homeowner's insurance should cover it.""",85,39,7,131,645,5834
"This is a younger area, lots of families with kids. And it’s much safer than the driving range.",95,27,14,136,645,26
"And on a deal like this, timing is everything.",94,29,13,136,645,265
You said you wanted a house right on the golf course.,90,37,9,136,645,2006
And who doesn't want to stay home on a windy day?,87,43,6,136,645,3263
"On the plus side, you do get the renewable energy tax credit.",96,33,12,141,645,1558
We're tilting toward this one.,94,37,10,141,645,3914
"If you’re ready to make an offer, let’s get the ball rolling.",95,35,11,141,645,7543
You gotta have balls to live here.,110,29,17,156,645,6265
Well yes but is a matter of timing.,75,24,10,109,645,709
The previous owners are still inside...,80,22,12,114,645,6090
It's presently a par 2 but you could change that once you buy it.,80,30,9,119,645,97
Utilities are included.,79,32,8,119,645,576
I can also show you the solar model.,85,20,14,119,645,5297
"The seller won't budge on the price, but they are willing to throw in two free games and all the miniature pencils you can use.",80,30,9,119,645,5810
We just think the condo over the bowling alley is a better fit.,87,24,13,124,645,1598
"It’s practical, sure, but there’s a shoe down the block that I think you’ll absolutely love.",85,28,11,124,645,2325
Most timeshares put you in a house by the fairway.  Our dutch colonial model puts you right on the green!,86,26,12,124,645,3798
"In real estate it's ""Rotation, rotation, rotation.""",88,30,11,129,645,207
I can let you have it for a mill.,88,30,11,129,645,1774
"Unfortunately, a few buyers have already putt in an offer.",87,32,10,129,645,7142
"Of course, you'll need to time your entrances and exits precisely.",95,24,15,134,645,3383
"Picket fence going around the house"" is what you asked for - isn't it",94,26,14,134,645,4534
Wait till you see the ballroom.,91,32,11,134,645,5645
Trust me. Solar is dead.,89,36,9,134,645,6523
"Perfect for you, if your timing is right.",96,30,13,139,645,2444
If you don't like this place I've got 17 other unique condos too look at.,95,32,12,139,645,5248
There is an easement; the neighbours are allowed to play through.,107,40,12,159,645,7324
"""In the interest of full disclosure, the previous owner was decapitated.""",78,31,8,117,645,1469
"Folks, getting into the right real estate is all about timing.",80,27,10,117,645,4392
There's one covenant with your home purchase I forgot to mention -- the front and back doors must remain open at all times.,82,23,12,117,645,7542
"Yes, this is well within budget, but I see you're pre-qualified for a Par 5",80,35,7,122,645,712
"'Round these parts, 'subpar' is a good thing.",83,29,10,122,645,3141
"Okay, so you are a sleepwalker.  Is that a problem?",80,35,7,122,645,7156
Feel free to putter around.,89,25,13,127,645,411
It doesn't take long to figure out when not to open the front door.,86,31,10,127,645,5501
And if you feel like privacy you can simply turn it on high.,89,25,13,127,645,6176
"Plus, the front door opens automatically every 5 seconds!",82,39,6,127,645,6757
"On the bright side, very few golf balls will make it into the house.",86,31,10,127,645,6865
"Forget solar, wind is the way to go!",86,39,7,132,645,3732
"If you get inside, you're gonna love it!",87,37,8,132,645,4075
"This is the perfect place for you, if you like to putter around the house.",89,33,10,132,645,4473
Solar? That’s so last week.,94,23,15,132,645,7374
"Oxymoronically, the “Miniature” refers to you and not the course.",94,31,12,137,645,5178
The view is fantastic every other second.,92,35,10,137,645,7496
I suggest we use the back door.,94,39,9,142,645,978
"I think you'll like this one, Mr. Quixote.",98,31,13,142,645,6451
Mm..yes we do have a clown’s mouth.  But that’s in D.C.,113,25,19,157,645,2819
"...and it overlooks a castle, a bridge, and a glow-in-the-dark clown.",84,32,9,125,645,181
but you said you wanted to be on the golf course,78,28,9,115,645,1349
"To enter, timing is of the essence.",83,26,11,120,645,1635
"This one's more about timing, timing, timing.",92,24,14,130,645,1726
The previous occupants moved up to a pitch-and-putt,93,30,12,135,645,2605
You asked for something right on the golf course.,77,22,11,110,645,3647
I'm pretty sure they will accept a low-ball offer,78,28,9,115,645,4038
It’s the most affordable place you’ll find at Pebble Beach.,81,22,12,115,645,5281
We call it the Kitsch and Sink.,99,34,12,145,645,5682
Timing in this market is everything.,85,22,13,120,645,5685
I realize it may not be run of the mill,87,34,9,130,645,5994
You just need to get the timing down.,84,24,12,120,645,6012
"I'm legally required to inform you that yes, this IS the infamous Dutch Windmill Putt-Putt Mini-Golf Funland Murder House...",77,30,8,115,645,6070
The timing is key.,91,34,10,135,645,6337
"“...but you said you wanted to downsize, to a low maintenance property, near a golf course.“",99,26,15,140,645,6484
The energy efficiency is above par.,90,36,9,135,645,7182
You said you wanted to downsize and watch a lot of golf.,100,32,13,145,645,7394
"Yes, I'd say this home is on par with others in the area.",100,37,11,148,645,205
It's a fun neighborhood!,101,35,12,148,645,6689
It was the only Dutch Colonial in your price range.,99,31,13,143,645,410
I can get it for you for well under par,96,37,10,143,645,6055
I must warn you....there's a weird right-of-way associated with the property.,93,35,10,138,645,1373
would you like to see something in a single blade?,94,33,11,138,645,3508
"It's not Mar a Lago, but you said golf property on a budget.",92,37,9,138,645,5746
You did say you like to putter around the house.,95,31,12,138,645,6643
As homeowners you’ll enjoy being lulled to sleep by the gentle humming of blades—and you’ll quickly learn to time your entrances and exits.,88,37,8,133,645,6929
You also get a carbon credit.,83,31,9,123,645,3061
"Remember, If you want to get into this one,
in this market, timing is everything.",87,23,13,123,645,4705
"Location, schmocation . . . it's all about timing!",82,33,8,123,645,5415
Your next door neighbor is the woman who lives in a shoe with her family,82,25,11,118,645,2535
Shall we putt in a bid?,84,21,13,118,645,5150
"Before you make this decision, I should mention the size of the gopher.",82,25,11,118,645,6057
"It's a great location, but the security features are kind of on and off.",75,31,7,113,645,3761
Detached or semi-detached? Depends how quick you are.,77,27,9,113,645,5262
Just remember: Never hesitate at the doorway and you'll be fine.,76,29,8,113,645,6434
"Unfortunately, your scorecard is too high to qualify for a loan.",109,32,15,156,645,7397
"It needs a bit of work, but that's par for the course.",104,34,13,151,645,5454
"No, you don't get many trick or treaters around here",96,34,11,141,645,5232
The original owner liked to putter around the house.,94,30,12,136,645,488
The prior owners?  They died in a freak accident while leaving the house.,94,30,12,136,645,6039
I’ll be frank...You’ll need some balls to buy this place.,90,30,11,131,645,566
"Yes, but electricity savings are phenomenal.",86,38,7,131,645,4240
"With this type of house ,timing is everything .",88,34,9,131,645,7331
Real estate is all about perfect timing.,90,30,11,131,645,7386
"In this real estate market, your timing has to be perfect.",86,30,10,126,645,5545
"In the real-estate timing is everything""",84,27,11,121,645,384
"Well, you said you wanted golf course property...",87,20,14,121,645,3017
The Open House is four times per minute.,81,32,8,121,645,3272
It's a great home if you like puttering around the house.,85,24,12,121,645,7121
"No air conditioning, but wait til you see the Dutch oven!",75,28,8,111,645,4338
Getting in and out is just a matter of timing.,75,20,11,106,645,3691
It keeps the house cool in the summer and the front door cleared of snow in the winter!,97,45,7,149,645,1201
It's perfect for people who like to putter around the house.,98,35,11,144,645,867
"I've also got a lovely little par 3 to show you, if that's more within your handicap.",97,37,10,144,645,1658
"Plus, any balls that make it inside are yours to keep!",95,41,8,144,645,6254
"Some say it's a miniature golf course, others say it's classical dutch architecture. You know what I call this property? A god damn hole-in-one!",96,23,15,134,645,3389
Real estate is all about timing your entry.,93,29,12,134,645,3780
There’s always some downside to living with renewable energy.,89,37,8,134,645,3944
You said that you wanted something overlooking a golf course.,90,35,9,134,645,5526
This one's right on the green and completely off the grid.,88,31,10,129,645,563
"Great location, too. Within walking distance is a schoolhouse, a church, and a giant clown head.",88,31,10,129,645,1418
"When I said, ""On the golf course,"" I meant on the golf course.",92,23,14,129,645,4633
Ready to get the ball rolling?,85,37,7,129,645,5158
"When the timing is right, we'll take a look inside.",82,35,7,124,645,73
"Well, I'm not going to lie to you. It's not the safest neighborhood.",85,29,10,124,645,202
"If you sink the putt into the dragon's mouth, we'll waive the HOA fees for a year.",86,27,11,124,645,359
It's energy efficient and keeps those Jehovah Witnesses from coming by.,89,21,14,124,645,1085
"It's not the golf that's miniature, it's us.",87,25,12,124,645,5211
"Best of all, it’s nowhere near the clown head.",81,29,9,119,645,5443
The price is on par with the rest of the neighborhood.,83,25,11,119,645,5756
It’s a rather unique home security system and alternative power source all in one.,75,33,6,114,645,2159
"The good news,you will save on electrical bills ,the bad news do not come home drunk on a windy night!!",78,27,9,114,645,2901
"If you're serious about buying, you have to move quickly.",98,32,12,142,645,3802
"We can close escrow later this week, if we time it right.",98,32,12,142,645,4608
"Well, you asked to see a place on a golf course.",91,30,11,132,645,3198
"Dear, this is not what I meant when I said I wanted to live on a golf course.",93,26,13,132,645,3397
"Yes, but this one has a REAL Dutch door...",91,30,11,132,645,6421
Timing is everything with this property.,92,28,12,132,645,6607
Is privacy important to you?,87,30,10,127,645,3483
"I think you'll like this one, Mr. & Mrs. Quixote.",106,37,12,155,645,2721
"Yes, you can go Dutch on the mortgage.",84,28,10,122,645,1974
What an awesome opportunity. The seller just told me he will accept Monopoly money as a down payment.,84,20,13,117,645,2217
"Well, you know the market. You’ve got to hit it at the right time.",84,20,13,117,645,3604
"In your price range, this is the only house with wind power and a picket fence.",99,35,11,145,645,5187
Decide soon.  Timing is everything to get into one of these.,99,35,11,145,645,6045
"I know they all have something wrong with them, but this is the 18th one we've seen today and I'm running out of patience.",96,33,11,140,645,6390
You enter by the rhythm method.,94,29,12,135,645,5364
We'll just have to wait for the family on 7 to come through before we can take a look inside.,73,26,8,107,645,4964
"Energy costs are low, but healthcare can be a little high.",72,28,7,107,645,5506
Is this on par with the other properties you’ve looked at?,105,44,9,158,645,5678
It's not as quixotic as you think.,91,27,12,130,645,213
"There are three things that matter in buying property: 
rotation, rotation, rotation....",89,23,13,125,645,752
"500 years ago it was just a windmill.  Now it’s considered a state of the art, sustainable, zero-energy eco-house.",87,27,11,125,645,931
"It's nice,but we were really looking for something with a water hazard view.",85,31,9,125,645,1847
And you're eligible for a sub-par loan!,83,35,7,125,645,3079
"Yes, she’s such a sweet old lady.  As a matter of fact, that shoe was my first listing.",89,23,13,125,645,5621
As requested... On a Fairway and under budget.,86,29,10,125,645,7339
Then there's the cachet of being on the golf course.,84,25,11,120,645,2446
"Real estate is all about timing. The markets, the rates, the front door..",84,25,11,120,645,2833
And it comes with a lifetime supply of stubby little pencils.,83,27,10,120,645,5978
"I like it, but I feel like the clown's mouth had a bigger green for the kids.",84,25,11,120,645,6959
You won't find golf course real estate at a lower price.,100,30,13,143,645,6796
What's it gonna take to putt you into this house?,102,26,15,143,645,7127
The yard is perfect for puttering around.,98,26,14,138,645,496
"People say the key to real estate is location, location, location, but in truth, it's timing, timing, timing, and this property proves it.",95,32,11,138,645,1665
"Well you do love to putter around the house, Bill.",79,27,9,115,645,6618
This is a great retirement community if you love golf.,94,34,10,138,645,7319
"If you don’t like this one, there is a White House that may be coming on the market soon.",107,37,12,156,645,4755
"Yes, golf course membership is included with the lease",95,24,14,133,645,2063
"Despite the obstacles, the neighbors say they love green living.",92,30,11,133,645,4662
Our security system stops thieves 30% of the time.,92,30,11,133,645,5642
"And after a while, you won't even hear the trains going by either.",88,30,10,128,645,2372
"It has central air, and a one ball garage.",86,26,11,123,645,6132
It's hard to find another property on a par with this one.,111,34,14,159,645,7076
"I'd describe this unique home by two words, timing and opportunity.",79,32,7,118,645,1925
And the school system is actually above par.,79,32,7,118,645,4843
You can't beat this price for a home on the golf course.,81,28,9,118,645,5778
"Once you get the timing right, it's lovely inside.",83,24,11,118,645,7191
"If this doesn't interest you, we have a house of cards that's going for practically nothing while it's standing.",95,29,12,136,645,4723
Now I have to ask.  Does loud cursing offend you?,91,37,8,136,645,6433
"The previous owner mistimed exiting the front door, but fortunately landed on top of the miniature hospital on Hole #7.""",78,26,9,113,645,1796
"Our listing said, ""located on a beautiful 18-hole golf course."" How's that fraud?",80,22,11,113,645,2388
Central air...? In a way.,78,26,9,113,645,3170
"True, there is an easement issue.",76,30,7,113,645,6554
"I'm sorry, but 'a home for a mil, near a golf course' is what I heard you say!",90,31,10,131,645,1141
And there is an upstairs room where you can let down your hair,94,23,14,131,645,7466
"It just came back on the market, now with a permanent restraining order against Mr. Quixote!",87,29,10,126,645,1045
This whole community is green.,84,35,7,126,645,1103
"Up next is a par 3 with 2 bedrooms, 1 bathroom, and ample parking.",86,31,9,126,645,3518
"This neighborhood has a fantastic school, and it’s only three holes away",88,27,11,126,645,3539
You're Miniature People...what did you expect?,98,36,10,144,645,3762
"In this market, timing is critical.",101,30,13,144,645,6488
"Yes, the neighborhood is a little busy; but that's par for the course...",95,34,10,139,645,2315
It’s what we like to call a semi-gated community.,86,23,12,121,645,1033
The trick is to start running for the doorway while the blade is covering it.,83,29,9,121,645,5892
Green fees are included.,104,37,11,152,645,486
"It's got two bathrooms; three, if you're not too picky.",93,30,11,134,645,2233
This energy efficient Dutch colonial will pay for itself.,79,29,8,116,645,522
It’s a great place to putter around in.,78,31,7,116,645,1075
It is the latest in green housing.,82,23,11,116,645,5791
"This one has everything you want: a wonderful view of the water, easy access to the golf course...but timing is critical.",89,30,10,129,645,237
"Good price, great neighborhood you just have to time your entrance.",90,28,11,129,645,7301
"I  have two words for you, ""feng shui.""",77,25,9,111,645,3098
It's a steal. The previous owner got out at the wrong time.,88,24,12,124,645,1371
And it's within walking distance of the Snack Bar.,93,35,9,137,645,3202
"Highly motivated seller, he's in the hospital.",94,33,10,137,645,6311
You'd enjoy golf course living without the high green fees.,91,39,7,137,645,6736
This is a very exclusive new development. There are only 18 custom-built homes.,74,23,9,106,645,919
We're calling it the home-in-one.,103,36,11,150,645,3943
"Turns out, the HOA had no rules against it",85,22,12,119,645,210
"In this hot market, timing is everything, when to buy, when to get in and out of the front door.",91,31,10,132,645,1633
"'You're very observant madam, they do look like giant waffle fries.",92,29,11,132,645,2955
"I agree, you shouldn’t move in on a windy day.",99,36,10,145,645,582
Kids just love this place,88,29,10,127,645,201
The Windmill Par 4 has more space than the Clown Face Par 3 and none of the screaming children.,97,32,11,140,645,1569
So how recently did you folks move to Lilliputtputt?,100,26,14,140,645,2933
There is some 'through' traffic.,99,28,13,140,645,5000
It's only a problem when it's windy!,108,31,14,153,645,2439
"Well yes, people have questioned the access issue before, but you're the first to mention the sinkhole and the elephant.",82,33,7,122,645,353
If you don’t get in now you’ll have to wait a full cycle,86,25,11,122,645,1953
Do you have a sense of rhythm?,84,29,9,122,645,3191
"Believe me,Mr. and Mrs. Quixote,it's real.",84,29,9,122,645,3308
The listing clearly states the house is situated on a golf course.,85,27,10,122,645,4157
"I can assure you, if you time your leaving, you won't have any trouble.",84,29,9,122,645,5070
"Just between us, the seller is very motivated.",88,21,13,122,645,7195
"You wanted something on a golf course, and this is definitely not your run of the mill house!",93,32,10,135,645,1979
Two words...carbon offsets,91,36,8,135,645,4053
"Now, let's address the elephant in the neighborhood.",101,16,18,135,645,7071
"You’ll have a ball. Lots of them, actually.",100,39,9,148,645,65
"I shouldn't tell you this, but the owner is anxious to sell.",93,24,13,130,645,1591
"As with all real estate here location, timing, location..",92,26,12,130,645,1864
"Listen, a property like this only comes around once a round.",103,25,15,143,645,2514
Timing is a bit of an issue with this seller. I say we make an offer when the blade is in front of the door.,81,27,9,117,645,2668
Surely you joust,93,24,13,130,645,3279
It's a par 3 but I think we can get you in.,81,27,9,117,645,4206
"I could show you a shoe, or I have 3 little pigs interested in selling",91,28,11,130,645,6517
Just think of what you could get on Airbnb,102,27,14,143,645,6529
You may want to stay home on windy days!,80,29,8,117,645,7134
"Within the neighborhood, this place is about par for the course.",102,40,9,151,645,478
As advertised… overlooking the 3rd hole of a popular golfing destination.,105,34,12,151,645,2423
On the plus side - zero solicitors,94,35,9,138,645,3651
The owner’s relocating to Disneyland,84,34,7,125,645,2030
This one is totally off the grid.,87,28,10,125,645,3052
Add solar panels to the arms and you pretty much are the grid.,113,31,15,159,645,285
It is perfect if you like to putter around the house.,104,28,14,146,645,695
"Yes indeed, buying a house on a golf course can be a great investment, but there are some risks.",103,30,13,146,645,1719
The house comes with a beautiful view of the 9th hole.,90,35,8,133,645,4239
"Of course, your in-laws will need a good sense of timing.",92,31,10,133,645,4447
"Timing is very important, if you want to buy this place.",84,26,10,120,645,2099
Most people don't even make it this far.,83,28,9,120,645,3026
Trust me. 3.2 seconds is plenty of time to clear the doorway.,97,34,10,141,645,3629
"It's offered at a variable rate, depending on how the wind is blowing.",99,30,12,141,645,3931
"Trust me, if you like to putter around the house, you'll love living here",92,23,13,128,645,449
It's on par with other properties in the area and you've got great neighbors who are just a short drive from here.,87,33,8,128,645,3758
Prepare to get blown away.,89,29,10,128,645,3955
"Yes, you may enter, but timing is critical.",89,29,10,128,645,6636
The previous owner moved on after having several strokes.,82,22,11,115,645,289
"Now,you've heard that timing is everything in real estate?",103,35,11,149,645,5356
You said something on a golf course.,96,28,12,136,645,1909
This is not exactly what we had in mind when we said we wanted to live on a golf course,92,36,8,136,645,4108
We felt this house was subpar,98,24,14,136,645,6228
"To get into a deal like this, your timing has to be perfect.",96,28,12,136,645,6679
It comes with a crazy old man on horseback,88,23,12,123,645,2044
"It's more affordable than the castle, without the worry of upkeep on the moat.",82,35,6,123,645,2346
"True, you could be decapitated by the windmill or disappear in a sinkhole, but the public schools are great!",84,31,8,123,645,3128
"Well, sure, but if you time it right, this could be the home of your dreams.",84,31,8,123,645,3192
I hear you like to putter around the house?,83,33,7,123,645,3246
"And if the ball doesn’t go in the hole, you’ll want to be upstairs.",87,25,11,123,645,3417
"The homes you saw at Pebble Beach and Augusta National are out of your price range, but I think we can get you into this energy efficient bungalow if we act now.",89,21,13,123,645,3582
This very affordable charmer is perfect for an agile young couple.,97,39,8,144,645,269
"When buying real estate,timing is everything.",103,27,14,144,645,3406
Besides the down payment you'll have to pass an agility test.,75,28,7,110,645,5019
"And there's plenty of room in the front yard, for puttering around.",88,36,7,131,645,1
Real estate. It’s all about timing.,90,32,9,131,645,1065
So can I putt-putt you down as a maybe?,91,30,10,131,645,2105
"Actually, the LOWER your credit score the better.",93,26,12,131,645,2610
It’s nothing to worry about once you get the timing down.,91,30,10,131,645,6404
"Look, only one in a dozen shots or so actually go through. But maybe keep your valuables on the second floor.",91,30,10,131,645,6833
"It's not actually a golf course community, but this is what's in your price range.",90,32,9,131,645,7504
"We had something a little different in mind when we said we wanted a wind powered home_Claudia Dezwick, Venetia,Pa",84,23,11,118,645,1374
The best part is how it cuts down on door-to door salesmen!,82,27,9,118,645,6002
You'll definitely want to go with the hazard insurance!,79,33,6,118,645,7465
"How many bedrooms?""

""FORE!",96,33,10,139,645,1565
As long as you can count to four no problem in getting getting in and out,98,29,12,139,645,5410
Well technically the ad didn’t lie... the house is next to a golf course.,93,39,7,139,645,5681
People like putting around this house.,95,35,9,139,645,6514
Don't worry about the golf balls. Nobody ever gets through the windmill.,88,28,10,126,645,3400
It's from Frank Lloyd Wright's early miniature golf period.,90,37,7,134,645,2080
This home is sure to increase your reaction time and agility.,90,37,7,134,645,2459
You'll like the open door plan.,96,25,13,134,645,3418
"The electricity is free, but there is a whooshing sound you have to get used to.",91,35,8,134,645,4158
Don't worry about it. Nobody gets the ball through.,82,19,12,113,645,2078
There's nothing like a crosswind on a warm night.,80,23,10,113,645,5312
Did I mention it's in walking distance of a golf course?,77,29,7,113,645,7012
"When you get an opening like this, you take it.",84,28,9,121,645,1806
"Now remember folks, timing is everything!",85,26,10,121,645,3104
It's a classic par 3 bedroom.,99,45,6,150,645,1995
Timing is everything when entering the market and this house.,90,29,10,129,645,145
The only downside is you won’t be able to leave the house when it’s windy.,90,29,10,129,645,2622
Of course green fees are included.,88,33,8,129,645,5395
It’s a timed share: you can only move in every 5 minutes.,88,33,8,129,645,6136
This is great honey.  All you do is putter around the house.,109,38,11,158,645,1788
Will you be going dutch on the sale?,97,28,12,137,645,2179
You said you wanted a house with a picket fence that goes all around it.,94,34,9,137,645,4041
"It's a fixer upper, but it's nice if you like to putter around the house.",95,32,10,137,645,5492
"Of course, you do get golf privileges.",82,24,10,116,645,2777
"With the budget you provided, this is the only home we could find with a golf course.",104,27,14,145,645,6209
"Look, this is what it takes to live in the city on 40 grand a year.",77,34,5,116,645,6559
"As they say in real estate, “timing is everything”",110,28,15,153,645,1427
"On the plus side, the power bill is really low.",107,34,12,153,645,3588
The front door has somewhat intermittent access,106,36,11,153,645,4203
How fast are you?,100,48,5,153,645,6820
Are you golfers?,87,27,10,124,645,1101
"Well, I'll be honest...the turnover's pretty high.",82,37,5,124,645,3351
It works really well on insistent salesmen and Jehovah's Witnesses.,89,23,12,124,645,4498
Your quixotic dream of living on a golf course is fulfilled.,94,26,12,132,645,3928
Hazard insurance is a must.,94,26,12,132,645,5323
It's a great place to relax and putter around the house.,91,32,9,132,645,6009
"Yes, but think of how much you’ll save on your energy bills!",95,37,8,140,645,551
First time on acid for you folks?,97,33,10,140,645,3167
It's a great yard for puttering around!,93,41,6,140,645,6341
You said you were looking for Dutch-contemporary.,95,37,8,140,645,6862
Are you ready to putt in an offer?,79,22,10,111,645,1985
"If you move fast and your timing is right, I think you can get in on the ground floor for under a mill. And though I agree with you that the front yard pool is a bit small, it's par for the course in this neighborhood.",108,24,16,148,645,6913
"If you time it right, I think you'll be in.",114,38,12,164,645,154
Sign on the dotted line with this really small pencil.”,90,26,11,127,645,337
"If you like it, we need to get in fast; it's all about timing for this house.",91,24,12,127,645,656
The home offers close access to recreational facilities.,86,34,7,127,645,991
It's an Escher.,85,36,6,127,645,1486
This next property is a much more affordable par 2,91,24,12,127,645,5469
It’s really not that bad if you time it right.,87,32,8,127,645,5508
But everyone dreams of living on a golf course.,91,24,12,127,645,5818
The housing market is really all about timing.,84,38,5,127,645,6846
The owner is a little old lady who's selling so she can downsize to a Shoe.,99,34,10,143,645,3638
"With this one, you pay a little more to be right on the green.",99,34,10,143,645,5929
I suggest you try to always use the side door.,98,36,9,143,645,6795
The hole in the front yard takes to directly to the pool in the back!,108,29,14,151,645,2526
No problem!  There’ s an  app for your smart phone that tells you when you can go in and out the door.,70,32,4,106,645,4253
I can assure you that this one is above par,115,28,16,159,645,7021
It's a fourclosure.,83,19,12,114,645,630
You’re in luck. Finding a Dutch Colonial in this neighbourhood is a hole in one.,81,23,10,114,645,3361
We can add a water hazard for an additional 10K.,80,25,9,114,645,4591
Your grandchildren will love it!,83,32,7,122,645,3611
And it comes with a garden to putter around in.,88,35,7,130,645,1752
"Aside from the occasional giant golf ball, this neighborhood is ideal.",93,25,12,130,645,2915
It's all about the timing.,89,33,8,130,645,4947
The secret is to anticipate,88,35,7,130,645,5474
"Really, it's a great house; only a few balls make it through each day.",90,31,9,130,645,5555
The only thing is ... we don’t recommend that you ever come home drunk.,102,33,11,146,645,1240
"To be honest, the Home Owners' Association is a little idiosyncratic.",72,20,9,101,645,5285
It's a great place to wind down,85,33,7,125,645,2594
It comes with a fantastic view of the first hole,83,37,5,125,645,3172
"OK, it's not actually off the grid, but it beats the hell out of that waterfall on 18.",90,23,12,125,645,3598
...not to mention the view of the lighthouse!,88,27,10,125,645,3920
"I know it's a bit more than you wanted to spend, but that's because it's so close to a golf course.",85,33,7,125,645,4194
A bathroom fan? The owners didn't think that was necessary.,89,25,11,125,645,4578
"I know, but around here, it's par for the course.",85,33,7,125,645,4841
It's a terrific starter hole.,84,35,6,125,645,7215
Yes it's a fixer-upper. Hope you like to putter around.,93,30,10,133,645,1619
"No, it's definitely not your run-of-the-mill entrance...",91,34,8,133,645,2554
. . . And did I mention this one is on the golf course.,94,28,11,133,645,3718
"Folks, I'll need you to keep an open mind on this one.",94,28,11,133,645,6107
I think you'll find that sub par is a postitive description when discussing properties in this neighborhood,102,25,14,141,645,457
"Again, I apologize for not noticing the 20 x 1 scale notation on the blueprints...",97,35,9,141,645,3275
"Honey, I know you said that after you retired your dream was live in a house by a golf course, but this isn't quite what I had imagined.",96,37,8,141,645,4910
What can I do to get you into this house?,98,33,10,141,645,6349
This neighborhoods above par.,100,29,12,141,645,6625
"Actually, we were thinking something in a Mid Century Clown's Mouth.",115,25,17,157,645,6299
"You did tell me you wanted to putter around in the yard, correct....?",103,28,13,144,645,476
Just wait until you see the water feature.,105,37,10,152,645,1071
"Well, yes, it can be a bit of a challenge to get in and out on windy days.",105,24,15,144,645,2067
I’ve got something a little less ostentatious over on 18 if you’d like...,98,25,13,136,645,2285
Much less maintenance than gingerbread.,81,20,11,112,645,2733
"We don't recommend flipping these properties, but yes, they do rotate.",88,19,13,120,645,2931
"Actually, missing a payment is a two-stroke penalty.",83,29,8,120,645,3602
"Real estate 101 - Rotation, rotation, rotation.",96,29,11,136,645,3836
"Zillow rates it at Par 3, but down the road when you go to sell,  trust me, it'll be no less than a 4.",89,30,9,128,645,4681
And the church is on the very next hole.,75,32,5,112,645,4975
You can come and go every 2-5 seconds,95,31,10,136,645,5260
"In this hot market, timing is everything.",80,22,10,112,645,5390
It’s the Mar-a-Lago of tiny homes!,93,22,13,128,645,5922
"If we want to get you into this house, timing will be the most important thing.",87,21,12,120,645,6274
The plusses include wind energy and a low criminal break-in rate.,84,27,9,120,645,6427
We're not your typical retirement community on a golf course.,101,37,9,147,645,3575
"Can't beat the location, and-, 5-4-3-2-1, ok, let's go inside.",103,33,11,147,645,4175
It's a great place to unwind.,89,35,7,131,645,2881
"As they say, “timing is everything”!",92,29,10,131,645,2909
I’ll show you the inside as soon as the next group plays through,92,29,10,131,645,4677
"Well, if you love golf, you're going to love this place.  We'll just go in one at at time ok?",95,23,13,131,645,6430
It's a great house for someone that likes to putter around.,87,26,10,123,645,1021
"The house may not have air conditioning, but check out the fan.",84,32,7,123,645,2923
No electric bill and no Jehovah's Witnesses.,90,20,13,123,645,3075
"It’s a two bed, two bath, with a fore car garage",91,18,14,123,645,6975
"Now, tell me how can I putt you into this home?",83,21,11,115,645,7288
"If our neo-Dutch Revivalist isn’t to your liking, we also have a giant clown head on 18.",77,20,10,107,645,469
"...and best of all, it's just a short put from all the good schools in the area!",75,24,8,107,645,6706
I've got another in this neighborhood we can look at. How do you feel about clowns?,101,29,12,142,645,275
Air BNB  advises to just count to 5 and run in between the blades,103,25,14,142,645,3752
The next one will sweep you off your feet.,100,31,11,142,645,4280
Rare chance to really live right on the golf course!,98,35,9,142,645,4331
The weather is great except for the occasional golf-ball-size hail.,100,31,11,142,645,4463
Unfortunately the previous owner is deceased . He lost his sense of timing,95,28,11,134,645,2534
The last occupant died of a mini-stroke.,95,28,11,134,645,3155
"It's new. If our timing is right, I can get you in on the ground floor.",96,26,12,134,645,4648
"Think of your bragging rights , this is the toughest hole on the course.",88,29,9,126,645,2951
It's a great starter hole for a couple with your budget.,87,31,8,126,645,2985
"I know you are looking for a house with solar, but keep an open mind, this one has wind and geothermal.",88,29,9,126,645,3372
"You said you wanted to downsize, go carbon-free, and host the grand kids, right?",90,25,11,126,645,3467
It comes completely furnished and includes green fees.,87,31,8,126,645,4415
One highlight is the novel front door security system!,87,31,8,126,645,7059
You have two more wishes.,85,22,11,118,645,993
"We said Cape Cod, not Dutch colonial.",84,24,10,118,645,1531
Now I know you asked for something near a golf course...,83,26,9,118,645,4813
The little old lady who lives in a shoe is your neighbor.,77,25,8,110,645,494
We also have a lighthouse and a loop-de-loop I could show you.,97,29,11,137,645,1273
It's a golfing community with 18 available units.,96,31,10,137,645,3228
This place is not as easy as it looks.,91,41,5,137,645,4220
"As you can see, the home sits beautifully overlooking the 16th hole.",101,21,15,137,645,4701
"Actually, hazards are par for the course in this neighborhood.",96,31,10,137,645,5143
Just stand on the dot and sprint to the doorway as soon as one blade clears.,99,25,13,137,645,6024
"The Quixote family has owned it for generations,
which means there's no wear and tear.",89,32,8,129,645,223
"Yes, his departure WAS rather sudden.  Let's just say the previous owner couldn't figure out which way the wind was blowing!  Gabeesh?!",91,28,10,129,645,441
"Green carpets, green energy, and no greens fees!",90,30,9,129,645,964
Resale value? Just walk out the door and you’re on the golf course!,94,22,13,129,645,2173
"Now, let's talk about the elephant in the yard.",88,34,7,129,645,3601
And the yard is great to putter around in.,87,36,6,129,645,6681
"As owners, you'd get to keep all the balls.",88,21,12,121,645,1412
"By law, I must inform you of the children’s parties",86,25,10,121,645,4656
"Sure, leaving the house requires lightning reflexes and exquisite timing, but on the plus side, it IS right on the golf course...",79,26,8,113,645,3932
The past tenant paid his mortgage by selling balls back to the course.,102,37,9,148,645,4015
"It may not be what you had in mind, but it's definitely above par for the neighborhood.",91,33,8,132,645,239
I think you'll find it well priced considering it's on a golf course.,92,31,9,132,645,4046
Of course in this market your timing has to be just right.,97,21,14,132,645,6548
"It's Dutch Colonial, of course, and the electric bills are practically nothing!",90,35,7,132,645,7559
"And yes, it is carbon neutral.",106,34,11,151,645,2743
The timing is right to get into this one.,93,34,8,135,645,1725
Good news. Hardly anyone has been through so far.,94,32,9,135,645,2725
It’s equipped with a wind powered security system,95,30,10,135,645,3653
"In your price range, I'm afraid this is the closest we can come to your living on a fareway.",96,28,11,135,645,3970
It’s a nice little extra...you can grind your own wheat,90,27,10,127,645,772
"And best of all, you don't have to worry about door-to-door solicitations.",87,33,7,127,645,1713
The sellers are highly motivated to sell under par.,86,35,6,127,645,4274
"Yeah, a little pricey for a par 2, but I also have a lovely par 3 church.",87,33,7,127,645,4981
"I know you two like to putter around the house, so I think this place will be a perfect fit.",86,35,6,127,645,5223
"Wind-powered, this is for the family that wants to live green.",87,33,7,127,645,6165
You said you wanted a place that was right on the 18th hole.,91,25,11,127,645,6221
I guarantee that “Dutch Modern Sustainable” will become the new American dream house.,91,25,11,127,645,6301
Solar panels are overrated.,69,25,6,100,645,5056
So.. what's the price without the windmill?,103,32,11,146,645,2289
"I’m not gonna lie to ya: it gets drafty in the winter, spring, summer, and fall.",103,32,11,146,645,3689
"I’m sure I can find a small pencil somewhere around here, just sign on the dotted line and it’s all yours.",104,30,12,146,645,4393
"You mentioned Dutch architecture and giant golf course. Two birdie's with one stone, eh?""",88,18,13,119,645,1853
"It marries the tiny house concept with golf course amenities, and even features green energy as a bonus!",85,24,10,119,645,3840
Weren’t you the folks that wanted to be on a golf course?,84,26,9,119,645,4575
"On the plus side, it's completely energy efficient.",84,26,9,119,645,5200
The neighborhood is very kid friendly.,92,41,5,138,645,2565
The house is perfect for people that like to putter around.,99,27,12,138,645,4215
"There’s no points on the mortgage, but there will be a one stroke penalty if your monthly payment is late.",98,29,11,138,645,6492
Did you find the place alright?,94,37,7,138,645,6507
...and the best feature is it fronts on a golf course.,81,19,11,111,645,4271
"So, would you like to take it for a spin?",91,30,9,130,645,178
"It's a great location, and hardly anyone makes that putt.",104,35,10,149,645,1867
The window is closing fast,88,23,11,122,645,397
Our whale's mouth model is another great option.,88,23,11,122,645,2688
I must disclose the strong wind advisory,84,31,7,122,645,4201
"It needs some improvements, but that's par for the course.",97,36,8,141,645,677
Think of it as a house to putter around in.,97,36,8,141,645,2996
I should tell you the last occupant died in a water hazard.,100,30,11,141,645,6483
"I love the big windows and natural light, but I think the lighthouse is more in our budget.",94,29,10,133,645,1522
I suggest you take it for a spin.,93,31,9,133,645,3375
You have to wait for it! wait for it! wait for it! . And then run like hell !  You’ll get use to it !,95,27,11,133,645,3966
"Don’t worry, the golf ball hardly ever makes it through.",93,31,9,133,645,5500
Now there are some reciprocal easements you should know about....,94,29,10,133,645,5601
And this one is right on the green.,93,31,9,133,645,6758
Picture yourself puttering around this place.,100,35,9,144,645,4112
"I've spoken to the owners, and they're willing to throw in the clubs, too.",89,26,10,125,645,477
I think you'll find the neighborhood above par,90,24,11,125,645,2608
Maintenance is a breeze.,108,37,10,155,645,4056
I also have 17 more different models for you to choose from.,100,22,14,136,645,480
Not to worry. The golf ball only gets through every twenty strokes.,82,27,8,117,645,2273
I do have one Clown's Mouth model available.,84,23,10,117,645,4733
Could I interest you in a lighthouse?,88,33,7,128,645,217
"With a market like this, it's all about timing.",89,31,8,128,645,370
"So, I know a door was on your list, but I think I can get them to lower the price.",89,31,8,128,645,4829
I guarantee you'll have a ball living here.,91,27,10,128,645,6168
Don't ever leave the house in a rush.,97,33,9,139,645,2980
A great place to live! Timing is everything!,95,37,7,139,645,4328
"""We'd recommend the back door for slower guests, especially when the fall breezes kick up""",100,27,12,139,645,4735
"And there's a school nearby, just through the alligator's mouth.",109,27,14,150,645,689
It's just like miniature golf but the stakes are higher.,87,22,11,120,645,6866
It's listed as a par 3 but the comps run closer to 4.,113,37,11,161,645,4697
It's all about timing.,95,24,12,131,645,3721
"If you're willing to stretch, we can look at some par-4s.",92,30,9,131,645,5047
I guarantee you'll have a ball in this  house.,96,22,13,131,645,6046
"The asking price, Mr and Mrs Jones, is well below par"".",94,26,11,131,645,6321
"Golf course view, low maintenance, fun neighborhood- I really think this property checks all the boxes!",98,36,8,142,645,2386
"It's priced to move and, trust me, you'll have a ball in this house!",78,27,7,112,645,3298
It's the perfect location to putter around the house.,91,19,13,123,645,783
"No utility bill, it's a wind-wind deal",87,27,9,123,645,3120
I thought you said you wanted to live on golf course.,86,29,8,123,645,3511
"How about your kids, do they love running as well?",88,25,10,123,645,3759
"It grinds your coffee and provides 50% of your electricity
we got a deal?",94,31,9,134,645,5741
The sellers are downsizing to the clown's mouth,101,35,9,145,645,321
I forgot to ask -- do you play golf?,110,35,11,156,645,4436
I know it’s a little out of your driving range...,79,30,6,115,645,4527
"So, should I get the ball rolling on this?",88,30,8,126,645,1404
...and this place is perfect for puttering around the house.,90,26,10,126,645,2826
At this price where else are you going to find three bedrooms with a view all in a gated community right on the course?,89,28,9,126,645,3237
A hole-in-one gets you free electricity for a year.,88,30,8,126,645,4825
It's actually harder leaving than entering.,91,24,11,126,645,5471
"Yes, in this price range, thats par for the course.",97,30,10,137,645,2481
According to Zillow this place is a rating of Par 4,96,32,9,137,645,6647
It's literally right on the course.,105,32,11,148,645,7473
"It’s our premium property.  A putting green in the front yard, and absolutely no need for central air.",79,35,4,118,645,5955
Very reasonably priced and it’ll do wonders for your sense of timing.,84,25,9,118,645,6062
"Yes, the place is wheelchair accessible, as long as you have it synchronized.",83,27,8,118,645,6255
"I'm telling you, after a couple weeks you won't even notice",85,23,10,118,645,7255
"Timing is everything in real estate, and I want to bring you into this home at just the right moment.",94,23,12,129,645,282
Welcome to Lilliputt.,89,33,7,129,645,1627
"Actually, no-one discusses the elephant in the neighborhood.",90,31,8,129,645,3731
I told you it was located right on a golf course.,91,29,9,129,645,4311
"Solar panels are so yesterday.
Wind power is the future",98,33,9,140,645,1309
"It's a steal at that price, but there are two hazards if either of you is a sleepwalker.",100,29,11,140,645,3193
Timing is everything folks.,100,29,11,140,645,5400
I also have a castle I can show you.,106,35,10,151,645,6726
It’s early Dutch.,91,34,7,132,645,30
How's your sense of timing?,86,26,9,121,645,91
This house will sweep you right off your feet!,103,28,12,143,645,214
"Of course, novelty architecture is tricky to get into.",100,34,9,143,645,2162
"And not just energy savings, you'll never have to mow the lawn again.",93,30,9,132,645,3884
The last couple to live here didn’t quite get the timing right.,89,38,5,132,645,4385
"The best part, it slices, dices, and filets your solicitors",95,26,11,132,645,4909
If this is not working for you I can show you a lovely clown head that just came on the market.,102,30,11,143,645,4922
Have I mentioned the unique selling point?,86,26,9,121,645,5522
"It’s got European charm, country quiet, and none of the problems of Pirate Cove.",94,28,10,132,645,7116
It's a semi-gated community with just a few water hazards.,92,32,8,132,645,7318
And there are strict association rules,98,20,14,132,645,7467
"I know you like the Castle, but the Windmill's fun factor is so much greater.",100,39,7,146,645,4876
It’ s great for someone who likes to putter around the house!,106,27,13,146,645,6811
Maybe you’d like The Gingerbread House better?,93,35,7,135,645,730
"There are three things I keep my eye out for: location, location, location, mostly of balls.",93,35,7,135,645,1440
You get a front door a quarter of the time.,96,29,10,135,645,1975
"Look, you said you wanted a house on a golf course...""",91,39,5,135,645,2492
"The incessant ‘whoosh, whoosh’ is actually quite soothing. Just be vigilant when entering and exiting.",96,29,10,135,645,3777
I promise you the price of this one is on par with the rest of the neighborhood.,97,27,11,135,645,6662
"Sure, I have other properties but none as challenging.",93,35,7,135,645,7205
Make sure the area between the front and back doors is kept clear.,85,33,6,124,645,3499
My client would like to play through.,88,27,9,124,645,3579
You seem like a couple of people with really good timing...,89,25,10,124,645,5306
"It’s super-charming, and you simply cannot get closer to the golf course",89,25,10,124,645,7070
Do either of you golf?,105,34,10,149,645,741
Or would you prefer the more traditional clown’s mouth entrance?,97,32,9,138,645,1758
"Fairway views in your price range don't come without a few trade-offs.""",95,36,7,138,645,2479
Just use the back door and you'll be fine.,95,36,7,138,645,5055
It's golf course frontage on a Lilliputian budget.,90,28,9,127,645,827
"With this one, it's all about the timing.",91,26,10,127,645,1061
You’ll find this home very energy efficient,87,34,6,127,645,1077
Your cats will love it.,94,20,13,127,645,1488
Do you golf?,91,26,10,127,645,3661
I would advise timing your exits. The previous tenant landed in Sweden.,82,26,8,116,645,724
"I suggest you get flood, fire, and golf ball insurance.",100,31,10,141,645,2722
The asking price is ten million tickets.,103,25,13,141,645,5210
"You’ll love the open floor plan, but you’ve gotta be fast in and out!",91,31,8,130,645,1709
It will turn quickly.,92,29,9,130,645,3189
It makes as much sense as anything else these days.,93,27,10,130,645,3842
you'll save a bundle on your electric bill in the summer.,80,35,4,119,645,4935
The asking price is on Par with similar places in this neighborhood.,84,27,8,119,645,5968
"Open floor plan, maintenance-free fenced-in yard, and the commuters are, at worst, heavy foot traffic.",83,29,7,119,645,6564
We're lucky to have found something this size on your budget.,81,33,5,119,645,7245
This house is really cool.,105,26,13,144,645,794
"Are you kidding, if you got to keep the balls I would have bought the place.",103,30,11,144,645,3108
But in real estate timing is everything.,93,32,8,133,645,2828
Have I mentioned the easement?,95,28,10,133,645,3412
Our last tenent walked in his sleep.,98,22,13,133,645,4468
Most folks who buy this model tend to be fairly agile.,91,36,6,133,645,6145
"If not to your taste, I also have a giant clown's mouth up the street.",95,28,10,133,645,6466
"And don't forget, there's a great school on the fifth hole.",84,32,6,122,645,156
"You mentioned solar panels before, and well, I think you’re gonna love this.",84,32,6,122,645,1315
This is the only par 5 on the market,87,26,9,122,645,1944
"1t has 144 square ft. on the main floor, it's on a golf course, and, oh, watch your head.",85,30,7,122,645,7017
Thrill seekers can set it for FIFTY revolutions per minute!,106,29,12,147,645,2506
"There is that, but on the other hand your electric bill will be very low and you will have lots of fresh flour.",80,22,9,111,645,1182
You do need to schedule your exits a bit,78,26,7,111,645,2309
I've also got some lovely properties on the front 9.,81,20,10,111,645,6150
"It's 2 bedroom, 2 bath, and 2 par",94,35,7,136,645,99
"And best of all, the school district is ranked sub-par.",98,27,11,136,645,2974
"The neighbors are generally nice, but the guy at the end of the block is a real clown.",101,21,14,136,645,3207
"Don’t worry, they are used to low ball offers.",86,33,6,125,645,545
We call it the heads up house,88,29,8,125,645,2493
"As you can imagine, there are pros and cons to golf course living.",73,18,9,100,645,6596
What will it take to putt putt you in this house?,92,21,12,125,645,7271
It's a fine example of pre-industrial air conditioning.,80,27,7,114,645,4950
Your offer is about on par.,90,30,8,128,645,1750
It's a unique opportunity to live within the golf course instead of just nearby,91,28,9,128,645,3559
Noise?  What noise?,91,28,9,128,645,3881
"Good news its discounted , bad news, when you hear the swish 
sound you have 3 seconds to enter or exit.",99,35,8,142,645,4446
You have to make up you mind now - there is another interested party about to tee off.,100,33,9,142,645,5725
"Before we go inside, I’ll need you to sign this liability waiver using a tiny, unsharpened pencil.",86,20,11,117,645,636
So it’s a choice between this one or the clown’s mouth colonial?,84,24,9,117,645,1328
"You wanted a dream home on a golf course, what do you think?",85,22,10,117,645,3938
This is the perfect home for a family of fore.,85,22,10,117,645,5054
The good news is you don't have intruders on a windy day.,83,26,8,117,645,6836
Entering the front door is all in the timing.,79,34,4,117,645,7518
"In golf as in real-estate, timing is everything.”",84,24,9,117,645,7520
"It's a buyer's market. 
If you time it right you won't end up in the hole.""",93,29,9,131,645,212
You are the first people to notice the hole in the back yard.,90,35,6,131,645,2658
"Mr and Mrs Quixote, your dream home awaits.",91,33,7,131,645,4799
"All the lawns are AstroTurf, that's par for the course these days.",113,35,11,159,645,67
"Everything seems to be in order, now how's your sense of timing.",89,19,12,120,645,2579
"With this house you do have to deal with the occasional odd ball coming in, but that is just life these days.",86,25,9,120,645,3086
"Okay, you're probably asking why is the hole in FRONT of the windmill...",83,31,6,120,645,5074
"The elephant is not in the room, sir. He is in the backyard.",87,23,10,120,645,6687
"With four revolving white picket fences, this beauty won't be on the market for very long.",98,24,12,134,645,1755
"Yes, this is especially known as a 'kid-friendly neighborhood'",94,32,8,134,645,2480
"In this market, your timing has to be juuust right.",98,24,12,134,645,4060
You'll love the in-home renewable energy and free golf balls.,95,30,9,134,645,4616
Minor problem; timing your exits,96,28,10,134,645,6747
"Sure it's risky, but renewable energy is the future.",95,30,9,134,645,7178
The closest grocery store is three holes over.,103,37,8,148,645,557
"Of course, the hole location is negotiable.",104,35,9,148,645,7185
Welcome to the most unique Airbnb in the city!,86,30,7,123,645,872
Me. Quixote will see you now.,90,22,11,123,645,1124
"Energy self-sufficiency, low-maintenance lawn, and a surprisingly fun neighborhood.",86,30,7,123,645,1748
"The good news is that your electricity won't go out during a windstorm. The bad news is that you won't,either",92,18,13,123,645,5751
The home security system is a bit unusual but effective.,92,41,4,137,645,673
"It has a faster speed, for religious solicitors!",104,17,16,137,645,1865
"In this market, it’s all about timing.",98,29,10,137,645,2101
A light breeze will recharge your Tesla.,97,31,9,137,645,3033
It's a huge kid friendly neighborhood.,98,29,10,137,645,4772
The clown next door never shuts his mouth.,99,27,11,137,645,6990
Built-in 24/7 security--and fresh-ground flour. What's not to like?,106,36,9,151,645,1417
And it's only a short drive to the water!,92,23,11,126,645,596
"And, you will love your electric bill!",89,29,8,126,645,1150
But on the plus side: no lawn care.,99,32,9,140,645,1715
"Trust me, it’s a home in one",96,38,6,140,645,3503
"Well, I could show you seventeen more properties, but honestly they're holes too.",83,18,11,112,645,3748
"The previous tenant moved on, after six strokes.",103,24,13,140,645,4261
It's a nice little place where you can putter around.,103,24,13,140,645,4537
We should make an offer before the next foresome plays through.,99,32,9,140,645,5201
I think you're timing's gonna be just right to get into this little starter.,88,31,7,126,645,6986
"This one here is more eco-friendly, but the clowns mouth has a much nicer kitchen.",81,22,9,112,645,7458
"So, it's a little tricky getting into the house, but you get as many chances as you need.",97,41,5,143,645,1541
Perfect for someone who wants to putter around the house.,101,33,9,143,645,1600
"Well,at least it's on a golf course",100,35,8,143,645,2313
"I hate to say I told you so, but the name on the wall did say Putt-Putt Acres.",102,31,10,143,645,2687
But you said you were looking for a house on a golf course.,99,37,7,143,645,2727
It's the quietest street in the neighborhood. Hardly anyone ever makes it.,98,39,6,143,645,4444
There's a lot of room to putz around,92,28,9,129,645,2418
I think the Gingerbread House might fit your tastes better.,91,30,8,129,645,7373
"Keep in mind, it is a seller’s market.",79,31,5,115,645,4277
Best to stay indoors on windy days,108,24,14,146,645,550
And its the only property on the course with an alternative energy system.,102,36,8,146,645,1082
You just have to time your entrance,106,28,12,146,645,1981
"Well, no, there's no DOOR. But it does stop roughly two-thirds of golf balls that attempt to enter.",90,37,5,132,645,1744
Now let’s address the elephant in the room,97,23,12,132,645,5765
If you don't like your caller....take your time answering the door,95,27,10,132,645,6502
"Sure solar is hot these days, but this is time tested technology.",84,26,8,118,645,2363
"It has great cross-ventilation, and waterfall views from every room.",82,30,6,118,645,5091
And you'll find that the asking price is par for the course.,96,30,9,135,645,325
Manicured lawn.Pool out the front door.Continuous  air flow throughout the House. What's not to like?,92,38,5,135,645,725
It's a lovely par 3 with a European flair and a fantastic view of the lighthouse.,99,24,12,135,645,1144
Good news! The owners are tilting towards your offer.,94,34,7,135,645,4356
"The Holland features keyless entry, utilizing a state-of-the-art timing pattern.",98,26,11,135,645,4894
Forget solar. RetroWind Estates is the way to go!,98,26,11,135,645,5049
This model features an open floor plan and central air conditioning.,96,30,9,135,645,5123
So... your husband was telling me your mother is in a wheelchair.,99,24,12,135,645,7203
You're in easy putting distance to great local schools and houses of worship.,84,31,6,121,645,1120
What do you say we get the ball rolling on this one?,87,25,9,121,645,1724
"It’s great exercise, and folks usually miss the door.",86,27,8,121,645,2064
This house just came onto the market. Your timing is impeccable. As it must be with this property.,89,21,11,121,645,2292
'You know that golf course property always appreciates in value.',99,29,10,138,645,1759
"``Step this way,and you'll be able to inspect the rooftop momentarily.''",99,29,10,138,645,4720
Tulips included.,102,23,13,138,645,6927
"Before 10 am, you can putter around the yard as much as you like.",97,33,8,138,645,7441
The real estate market is all about timing.,102,23,13,138,645,7450
"You stipulated off-the-grid, close to church and near the zoo. 
Looks like a no-brainer to me.",89,26,9,124,645,66
Only one of us can enter at a time,86,32,6,124,645,1322
The seller is motivated and willing to throw in some wooden shoes...,100,32,9,141,645,114
Sure you could go with solar panels but these babies work day AND night.,100,32,9,141,645,855
"Look, you weren’t excited about the bounce house; didn’t even want to enter the escape room... Frankly, I’m beginning to think you two aren’t as into entertaining as you originally led me to believe.",99,34,8,141,645,7362
You said you were looking for a place to putter around.,88,33,6,127,645,31
"And every 3 seconds, it keeps intruders from entering.",92,25,10,127,645,357
It’s got great cross ventilation!,92,25,10,127,645,958
solar panels are so last year,92,25,10,127,645,1360
The ad said golf course with wind turbines,88,33,6,127,645,5117
"It's all about ''Timing, Timing, Timing.'",89,31,7,127,645,5141
"Yes, old world charm meets wind energy efficient...but do take care entering the front door...",88,33,6,127,645,5633
"Dont worry, almost no one makes it in.",90,29,8,127,645,5759
When we said located on a golf course we really meant it.,100,37,7,144,645,6021
This was his first miniature golf course. That's why the windmill is so bigly.,81,24,8,113,645,1185
I wouldn't worry about it. The golf balls rarely make it in the door.,81,24,8,113,645,1779
"To the left is a beautiful sandy park, behind you is a water feature and here we have a Dutch revival inspired home perfect for puttering around in your retirement.",83,20,10,113,645,3096
This would serve nicely for a family of 'fore'.,97,20,13,130,645,880
Timing is everything in today's housing market.,95,24,11,130,645,1333
"Look the time to buy is now, before they put in the Hole Foods.",93,28,9,130,645,1430
This new listing is above par.,92,30,8,130,645,2846
"When I said Dutch Colonial, this isn't what I wanted",90,34,6,130,645,5170
"Perhaps, you could show us something with solar panels?",92,30,8,130,645,6923
"In no time at all, you'll be hearing the putter-patter of little feet.",93,28,9,130,645,7093
The property value will skyrocket once they finish the castle down the street.,92,30,8,130,645,7334
"It's a one bedroom, two par hole in the wall.",103,36,8,147,645,7291
No electric bill for the next couple of centuries,81,29,6,116,645,6234
The listing did say it was a green community.,91,37,5,133,645,1248
"Admittedly, it's not quite on par with the others""..",93,33,7,133,645,2058
This is a rare opportunity to get into this neighborhood.  Timing is everything!,95,29,9,133,645,5378
It was cheaper to install than solar panels.,97,25,11,133,645,6163
"Listen, we all know that timing is everything in real estate!",94,31,8,133,645,6752
"Yea, you're gonna want to spend most of your time upstairs.",104,39,7,150,645,3294
This property is right on par with your budget.,109,29,12,150,645,5585
I’m gonna be honest with you; I don’t know what’s down there.,85,26,8,119,645,14
...and don't you worry about that giant gaping hole. That's just where Billy lives.,86,24,9,119,645,434
I think you'll find this is much better than the clown's mouth neighborhood.,89,18,12,119,645,2409
"Now, I know you wanted something that felt a little more 'authentic'...",95,34,7,136,645,2800
It's like a revolving door. You just have to be careful when you enter and exit.,95,34,7,136,645,4431
The entryway is a little tricky.,95,34,7,136,645,4786
You can get in most of the time.,71,26,5,102,645,5463
"The other buzzword in real estate is “Timing timing, timing!”",85,26,8,119,645,6397
... and wait until you see the clubhouse.,102,25,12,139,645,6085
"Yes, it has Central Air.",89,23,10,122,645,4104
"This is the best property I found, with a golf course view, that is within your price range",87,27,8,122,645,5762
"yes, the front door is a little tricky",102,30,10,142,645,2797
"It’s perfect, for those that like to putter around the house.",98,38,6,142,645,5133
The savings on your electric bill will make up for the inconvenience,88,30,7,125,645,1414
"Negative electric bill, grind your own flour, and zero solicitors.",88,30,7,125,645,2591
"On the plus side, you'll never have to cut the grass.",90,26,9,125,645,3302
Let's face it. All real estate is timing.,88,30,7,125,645,4503
"Mulberry, the elephant, anxiously waits while his parents learn if exotic pets are allowed.",90,26,9,125,645,5036
Other than the ingress and egress issue the house is very nice!,87,32,6,125,645,5040
"It’s resort living, without all the pretense.",88,30,7,125,645,6489
And you'll be right on the golf course!,78,22,8,108,645,2110
"If you like to putter around, look no further.",103,33,9,145,645,1703
I hope you don’t mind temporarily obstructed views.,103,33,9,145,645,3433
"It is a bit unconventional, but the energy savings are outstanding!",90,31,7,128,645,2815
"It's a bit over your budget, however it has everything on your checklist - vaulted ceiling, open concept living-dining room, granite counter tops and intermittent river views.",94,23,11,128,645,4177
"Yes, the previous owners... split up, shall we say",90,31,7,128,645,4419
This is the only Dutch Revival you'll find in such a family-friendly neighborhood.,92,27,9,128,645,4493
We can take a look inside if you feel ready.,92,27,9,128,645,4709
What it lacks in privacy it makes up for in schadenfreude.,91,29,8,128,645,6171
You wanted a 'green' home close to the golf course?  Mission accomplished.,106,32,10,148,645,2425
Occasionally a golf ball will roll through the front door,81,21,9,111,645,3455
"There's a birdie nesting on the roof, and a hole in one of the  floorboards but that's par for the course.",101,42,5,148,645,5473
It's a par 4 at a par 2 price.,95,26,10,131,645,3150
"It's not really the blades, it's the giant golf balls that make it hard to sell.",93,30,8,131,645,3797
The last couple I showed this to were bowled over once they got inside.,89,38,4,131,645,4340
I'd highly recommend you stay upstairs.,108,33,10,151,645,4016
Now this little baby is a golfer’s dream!,107,35,9,151,645,4169
"Now, the only drawback is that you will have to time your exits and entrances carefully!""",84,20,10,114,645,2781
"And to top it off, it has a very low carbon footprint.",81,26,7,114,645,3084
Could be worse. We could be in a Whac-A-Mole game.,78,32,4,114,645,4962
"But on the other hand, you get a huge energy tax credit.",94,33,7,134,645,1165
This one comes with its own security system,97,27,10,134,645,2543
"Ever since Old Man Quixote moved, the neighborhood's been pretty quiet.",94,33,7,134,645,4816
It's the perfect Starter Hole.,84,25,8,117,645,104
It's more efficient than solar.,85,23,9,117,645,1526
Fore!Closure!,84,25,8,117,645,3757
This is the last one left. I already sold the other seventeen.,82,29,6,117,645,7140
This one offers a view of the Eiffel Tower AND the Sphinx.,85,23,9,117,645,7237
Let me show you a sweet castle on #18.,97,32,8,137,645,1173
And here's your new backyard: perfect for just puttering around.,98,30,9,137,645,1875
Yes...but it also makes break-ins difficult.,98,30,9,137,645,2667
And you save a ton on your electric bill.,101,24,12,137,645,5050
I also have something easier in this neighborhood,97,32,8,137,645,5701
"Yes there’s a minor easement, but utilities are included!",99,28,10,137,645,6506
Real estate rule #2: Timing is everything,98,30,9,137,645,6743
"As with every goal, timing is everything.",113,33,11,157,645,1874
Your timing couldn't be better.,112,35,10,157,645,4611
"If you don't like this, I can show you something on the 15th hole.",86,26,8,120,645,3
Let's not make this more difficult than it already is.,87,24,9,120,645,144
I was finally able to find something in the neighborhood in your price range.,99,33,8,140,645,1506
"Before he was President, he combined his love of real estate with his passion for golf.",87,24,9,120,645,2468
"And now for the elephant in the room . . .""",100,31,9,140,645,3031
"Yes, the door does swing inward._",113,38,9,160,645,3185
Do you want to hear the short or long winded version?,96,39,5,140,645,5938
Financing is a breeze,98,35,7,140,645,6824
Don Quixote has a vacation home here.,91,16,13,120,645,7490
If this one doesn't appeal I have a bridge I could sell you on the 8th hole,101,34,8,143,645,7196
Surviving the home-buying process is all about timing.,87,29,7,123,645,1535
You'll have a ball in this house.,91,21,11,123,645,3358
"The upside is that if someone gets a hole-in-one, your rent is paid for the month!",87,29,7,123,645,5267
"Classic European architecture, adjoining a golf course--I feel I've hit a home run finding this property for you.",89,25,9,123,645,5536
"I've reviewed your case, and I'm afraid you will not be able to take a mulligan.",89,25,9,123,645,6183
"It's a bit of a fixer-upper, but in this neighborhood - - that's par for the course.",88,27,8,123,645,6688
Now this is something less run-of-the-mill.,90,28,8,126,645,524
"Of course, you will need to be a bit careful when coming in or going out.",90,28,8,126,645,568
Of course it's a little dicey on windy days but that's why you're getting such a great price.,90,28,8,126,645,1375
It gives true meaning to putter-ing  around the house.,92,24,10,126,645,3130
It’s got a great view of the 18th hole.,92,24,10,126,645,3933
"In our business, timing matters.",94,20,12,126,645,4103
I recommend taking the hole-in-one insurance.,92,24,10,126,645,4545
The lot is perfect for a tear-down and rebuild: were you thinking volcano or clown's mouth?,91,26,9,126,645,4585
When I count to three; run through the door.,93,22,11,126,645,4869
Look at it this way....your kids won't want to be living with you after college.,90,28,8,126,645,5607
"Regarding your homeowner's policy, I should point out that a large, white ball coming through your door is considered an ""act-of-God...""",91,26,9,126,645,7364
I'm going to be honest with you. The groundhogs around here are the size of Vespas.,105,36,8,149,645,1295
The good news is the windmill is solar-powered.,106,34,9,149,645,5102
"Once you get around the hazards, this place is a real hole-in-one.",91,31,7,129,645,439
Not only does this offer sustainable living; if you exit the house without getting hit by the windmill and jump in the hole you are delivered right to the street.,94,25,10,129,645,1027
It's zoned as a drive-through,94,25,10,129,645,1508
"Easements? Yeah, a couple.",90,33,6,129,645,1528
"The deal on this one is incredible, but you'll have to move fast.",94,25,10,129,645,3423
With good timing and a little hustle you’ll make it inside unscathed every time.,93,27,9,129,645,3446
And there's easy access to the beach over the bridge obstacle.,88,37,4,129,645,4247
So that’s what you meant by revolving doors.,95,23,11,129,645,5118
"The last owners told us that slow, turning creaking sound helped them sleep like babies.",78,24,7,109,645,1326
"Yes, but you'll be fine---it's a really tough shot.",95,28,9,132,645,790
"I'd show you the interior, but I hear the guy up next is pretty good.",98,22,12,132,645,3392
Here we have a motivated seller.  You can get this for 20% less than the Gingerbread House we looked at yesterday,94,30,8,132,645,3946
No unfortunately the windmill doesn't actually create electricity for the house thanks to the new EPA regulations the whole thing has to be run on coal,98,22,12,132,645,4077
I did promise you a view of the 18th hole,92,34,6,132,645,5004
Would you be interested in something off the grid?,94,30,8,132,645,5913
What goes around comes around.,79,27,6,112,645,2109
What on earth makes you think this is a white elephant property?,93,37,5,135,645,1511
This house is par for the course.,96,31,8,135,645,2381
It's cheaper than a solar panel.,97,29,9,135,645,4048
"This dream, totally green house can be yours. Keep in mind, timing is everything.",100,23,12,135,645,4119
"In real estate time is of the essence, in this case it's par for the course too.",95,33,7,135,645,5828
Best not to lock the door when you leave.,101,26,11,138,645,896
And you live off the grid.,101,26,11,138,645,903
"A taste of Holland, with stunning views of the ninth hole. Tell me, are you golfers?",101,26,11,138,645,1257
"Best of all,  green fees are included in your rent",81,28,6,115,645,1357
I’m also going to recommend you get hazard insurance for the golf-ball sized hail they get here,84,22,9,115,645,2666
"Of course, on windy days, you're in or you're out. Period.",96,36,6,138,645,3322
It's a great deal just don't come out the front door without looking.,98,32,8,138,645,3343
"I think it’s just perfect for you, Mr and Mrs. Quixote, and it sits right on the fairway overlooking the 9th hole...",102,29,10,141,645,4973
"Don't worry, this is an extremely safe neighbourhood. The most dangerous things you'll come across are teens on their first date.",102,29,10,141,645,5033
Is this place a dream or what?,101,31,9,141,645,6194
"Before deciding, you need to know about Don...",103,27,11,141,645,6609
Just let them play through.,86,23,9,118,645,192
You'll never buy another golf ball as long as you live.,85,25,8,118,645,754
This is par for the course in this neighborhood,81,33,4,118,645,1843
"I don't understand. You wanted ""charming"" and ""on a golf course.""",83,29,6,118,645,4342
This home offers plenty of space to putter around in.,86,23,9,118,645,5850
"You’ll need to maintain the lawn, but that’s par for the course.",83,29,6,118,645,6114
"If you don't like this, I've got a castle with a draw bridge one block over...",87,26,8,121,645,1648
"It's not just a house, it's a hole.",88,24,9,121,645,2074
Great privacy except for the occasional miniature golfer.,84,32,5,121,645,3839
This property is ideal if you like to putter around in the garden.,88,24,9,121,645,4315
Sign the contract with a very short pencil and call it home.,92,26,9,127,645,68
They say this is where little Donald first learned to cheat.,94,22,11,127,645,775
"Why yes, the neighbourhood is very kid friendly",93,24,10,127,645,1616
"I've been doing this for a while, it's all about timing",90,30,7,127,645,2371
"You're a golfing man, aren't you Bob?",93,24,10,127,645,2538
"Before we continue, can I get either one you a tee?",91,28,8,127,645,2987
"Lastly, let's discuss the easement.",87,36,4,127,645,6928
"“Yeah, it’s a little pricey, but it’s par for the course.”",90,30,7,127,645,7219
"Perhaps, instead, I could show you something in a cozy 3-bedroom plastic dinosaur?",91,33,6,130,645,544
This is right on par with your price point.,93,29,8,130,645,832
The homeowners association does require that you keep the center aisle free of obstruction so that giant balls can occasionally roll through.,92,31,7,130,645,1515
And you can charge your Tesla for free...,95,25,10,130,645,2561
And you get to keep any balls that land in your yard.,96,23,11,130,645,2759
Windmill?  Pshaw. It’a a zero carbon footprint home.,93,29,8,130,645,3672
"On the plus side, the grass is much greener than the last house.",94,27,9,130,645,4448
and we can keep the golf balls?,92,31,7,130,645,4664
"850 is a fine credit score, but this neighborhood requires a 3-handicap or less.",95,25,10,130,645,6117
"It's nice, but we'd still like to see the one shaped like a clown's mouth.",94,27,9,130,645,6457
It's all in the disclosures.,92,31,7,130,645,7187
"I know you said modern, but
how do you feel about Dutch Colonial?",94,32,7,133,645,373
I'd add a water hazard plus a loop-de-loop and flip it.,97,26,10,133,645,1448
"Think of the positives. There’s fresh air, constant guests and endless entertainment.",96,28,9,133,645,2680
I'm afraid high casualty insurance is par for the course when you buy in this neigbborhood.,93,34,6,133,645,5010
"Folks, the time to buy is now!...Aaanddd, now!",98,24,11,133,645,7224
"Sure, on a windy day, you have  to time your exit",94,32,7,133,645,7279
One negative: you need good timing to get in or out.,98,29,9,136,645,1160
"The downside is that if you miss the putt three times in a row, you will automatically be locked out of the house for 5 minutes.",98,29,9,136,645,3091
Financing will be a breeze.,96,33,7,136,645,4381
We said we wanted to live on a golf course NOT in a golf course.,99,27,10,136,645,5617
"Don't worry, wind is very rare in this neighborhood.""",96,33,7,136,645,5710
I recommend keeping your good furniture away from the front door.,98,29,9,136,645,6675
Its the only gated community in your price range.,80,22,8,110,645,3995
"There are solar panels on the roof, too!""",101,28,10,139,645,2251
You said you wanted a home with an alternative energy source.,98,34,7,139,645,3434
It has that Old Dutch charm and right on the golf course.,84,19,10,113,645,2231
So you're planning to go Dutch?,84,19,10,113,645,4461
"This house is not just a steal, it's a hole in one!",82,23,8,113,645,6103
The ad was not misleading. This is an airy house in a gated community.,104,27,11,142,645,3039
"True, it is a bit airy, but wait until you get wind of the price.",103,29,10,142,645,5159
You'll get used to the golf balls coming through your living room in no time.,82,28,6,116,645,4817
Its a 3 bedroom 2 bath par 3 and priced to sell quickly.,101,38,6,145,645,5777
Rent is on par with the rest of the neighborhood,85,27,7,119,645,378
The market's really tight these days.  It's this or the clown's face.,88,26,8,122,645,1340
Make it through and it's all yours!,89,24,9,122,645,2699
It was a typo.  I meant it to say Movin'  Condition.,85,32,5,122,645,2928
"But on the other hand, you never have to mow the lawn.",86,30,6,122,645,4116
.... and in the summer there’s a nice breeze.,112,31,11,154,645,2856
"The good news is, the course shuts down at night.",89,29,7,125,645,7404
This neighborhood has features you won't find anywhere else.,91,30,7,128,645,518
"With every hole in one, there’s a 10% reduction in your closing costs.",94,24,10,128,645,529
"But on the upside, it runs on renewable energy.",90,32,6,128,645,1672
"Sorry, I should have added ""postmodern"" when I said the house had the classic white picket fence.",93,26,9,128,645,2033
It's energy efficient.,92,28,8,128,645,2557
"It's generally regarded as a very safe neighborhood, but the proof is in the putting.",94,24,10,128,645,3347
"...and I agree but on the plus side, with even a slight breeze, you’ll get incredible water pressure.",92,28,8,128,645,3472
And it's great for puttering around!,90,32,6,128,645,4618
What’s better than living on a golf course?  Living in a golf course!,94,24,10,128,645,6127
You'll also have access to the community waterfall,94,29,8,131,645,561
"By law, I’m obligated to tell you the previous owners were crushed by a golf ball.",95,27,9,131,645,1438
Electricity is free but the front lawn can be busy during playing hours.,95,27,9,131,645,1609
This model supports off grid living and built-in rotating security.,93,31,7,131,645,1618
"Now this model is not your classic white-picket-fence situation.""",96,25,10,131,645,2010
It really is a miniature golfer’s paradise.,95,27,9,131,645,4199
"Between 10 p.m. and 10 a.m., you'll have full use of every room in the house.",91,35,5,131,645,5870
"And with this house, Mr. Quixote, you will also get your exercise.",98,21,12,131,645,7247
"In this neighborhood, a property like this is par for the course",96,25,10,131,645,7410
Timing is of the essence when you consider both making an offer or touring the interior.,97,28,9,134,645,1873
In Manhattan you take what you can get.,96,30,8,134,645,2256
"Leslie, you wanted a tiny house; John, you were looking for something with style and adventure, amiright? I think I’ve found you the perfect property",93,36,5,134,645,2852
The last owner was a sleepwalker and things didn't work out.,98,26,10,134,645,4141
The wind is free but hazard insurance will cost an arm and a leg.,97,28,9,134,645,7472
"No problem, the front entrance is free every 30 seconds.",100,27,10,137,645,2278
You said you wanted to be off the grid.,98,31,8,137,645,4002
"You'd think the wind mill blades are the biggest thing; but, there is one other issue.",122,41,9,172,645,3289
We can offer you a great mortgage rate. It's just par for the course.,102,28,10,140,645,1002
"The thing is, most players miss.",79,16,10,105,645,1927
"Your timing is excellent — which in this case is a very good thing, indeed.",100,32,8,140,645,3600
"Unlike the clown's mouth, it's chic and energy efficient.",75,24,6,105,645,7510
There's just one thing before we go inside.,105,27,11,143,645,1177
"With some quick, agile action, this home could be yours.",80,19,9,108,645,1458
Think about it...no solicitors!,107,28,11,146,645,1926
But think of what you’ll save on electricity.,102,38,6,146,645,6257
"It may seem like a lot at first, but the energy savings will make it very affordable in the long run.",78,28,5,111,645,984
You have to move quickly to keep from getting injured but the electric bill is very low.,106,35,8,149,645,1952
"You know, life can be quixotic...",85,19,10,114,645,1984
"The seller is really motivated....he's discovered tennis.""",82,25,7,114,645,4405
"No, there aren't any ceiling fans.",83,23,8,114,645,4458
"You are going to have to be quick, but I have a good feeling about getting you into this house.",113,26,13,152,645,6184
It is very well ventilated.,107,38,7,152,645,6342
We heard you were going Dutch.,82,30,5,117,645,699
"As you can see, this house has a great front yard for just putting around in.",87,20,10,117,645,3616
"Ted, I realize it's a bit out of your price range. Maybe you and Debra could go Dutch.",85,24,8,117,645,4696
"Remember, timing is of the essence when entering”",86,22,9,117,645,5099
"Welcome to Lilli Putt Estates, the biggest name in miniature, golf course living!",86,22,9,117,645,5578
I assure you the foundation is up to par.,87,25,8,120,645,474
"There's no bathroom, kitchen, or front door, but it has great curb appeal.",87,25,8,120,645,2389
"You get it all, quaint bucolic village, loft, neat garden wall, arched windows, free grain grinding, elephant trap...",84,31,5,120,645,2751
I think we should make a low-ball offer.,89,21,10,120,645,3112
"Apart from the energy efficiency, it’s got a fabulous front lawn, which you can stroll at your leisure, as long as you exit the front door at five second intervals.",86,27,7,120,645,4388
Once you’re in you’ll stay putt,89,26,8,123,645,60
Forget ADT - check out THIS security system!,89,26,8,123,645,3315
"On the upside, it's totally off the grid!",88,28,7,123,645,7181
"Lots of places claim fairway views, but how many are actually on the fairway?",90,29,7,126,645,1662
"I'm telling you, wind power is SO much better than solar.",91,27,8,126,645,1991
Don't drink and arrive.,94,21,11,126,645,4948
On the other hand it discourages home invaders.,90,34,5,129,645,1475
"The clown's face was the first to sell, but this hole is still available.",94,26,9,129,645,2160
Yes it's expensive. It's the only house right on the course.,95,24,10,129,645,2618
"It’s in a great neighborhood, and just down the street from the loop the loop and the fake pond",91,32,6,129,645,4167
"As you consider this for your new home, timing is everything.",94,26,9,129,645,5517
"It also shreds, chops and dices.",95,24,10,129,645,5634
Going Dutch?,98,23,11,132,645,678
"Open floor plan, built-in theft deterrent system, zero lawn maintenance.",91,37,4,132,645,1524
It's solar powered.,95,29,8,132,645,1982
"Trust me, the ball never makes it in.",94,31,7,132,645,2132
If you two go Dutch it'll be cheaper,96,27,9,132,645,2552
"Yes, the electricity is free!",95,29,8,132,645,2851
A single stroke and it’s all yours.,99,26,10,135,645,1083
Could you show us something a little more 'Clowns Mouth'-y?,94,36,5,135,645,4435
"On the other hand, it's a steady source of income.",96,32,7,135,645,5659
...and did I tell you how energy efficient it is?,97,30,8,135,645,7552
"When that happens, I strongly recommend you let them play through.",101,27,10,138,645,86
"Yes, this neighbourood is quite above par.",103,23,12,138,645,3868
This is the best house on Quixote Court.,103,23,12,138,645,4225
It's a very walkable neighborhood,99,31,8,138,645,4773
The plus on this house is free electricity and the negative it can get very tricky getting in and out of the front door.,102,25,11,138,645,5662
That’s true but the rent is miniature as well.,101,32,8,141,645,4968
"You said you wanted the grandkids to visit, right?",102,30,9,141,645,5166
"Technically, it qualifies for the wind energy tax rebate",99,36,6,141,645,5737
The covenant requires you to keep you the grass cut and the back door open,102,35,7,144,645,4930
I'm sorry but the  homeowners association will  not let you fill the hole.,110,24,13,147,645,402
This one's a bit too quixotic. Is the castle still available?,103,38,6,147,645,2884
"On the plus side, it does have wind power and a semi-reliable security system.",109,31,10,150,645,2032
"You might want to make an offer, golf course properties often go quickly.""",106,37,7,150,645,2491
The previous owners upgraded to the castle.,76,24,6,106,645,717
It’s quite peaceful at night.,77,22,7,106,645,3105
HOA fees include turf maintenance and access to the waterfall on the 13th Hole,74,28,4,106,645,4372
It’s a once-in-a-lifetime opportunity Mr. and Mrs. Felps. What do you say we go inside and get the ball rolling?,78,25,6,109,645,41
"This isn't exactly what we had in mind when you said ""view of the ninth green"".",77,27,5,109,645,5700
Don’t forget to look before you leave.,82,17,10,109,645,6799
"This is our most coveted model home, the Manse of La Mancha.",81,24,7,112,645,2734
"Well honey, it's either this or the giant clown.",82,22,8,112,645,3353
"Oddly, it runs completely on solar.",84,18,10,112,645,4960
It’s all about the timing on this one.,84,23,8,115,645,3428
"An architect misplaces a decimal point and, voila, your dream home.",85,21,9,115,645,4297
"Yes, on breezy days getting in or out can be a bit dicey.",84,23,8,115,645,4333
"On the upside, the homeowners association has a strict no solar panels rule.",85,21,9,115,645,4442
What would it take to putt putt you in this house today?,86,19,10,115,645,6714
"It's actually far more efficient than solar panels, and, even better, a windy day keeps unwelcomed visitors away.",85,26,7,118,645,1960
Did I mention the recreational easement?,84,33,4,121,645,859
"Yes, in real estate timing is very important.",91,19,11,121,645,937
You've got to hurry....the little old lady who lived in a shoe put an offer on it this morning.,89,28,7,124,645,618
...and the best part is you never have to mow the grass.,90,26,8,124,645,2926
"Remember, the value of a great home is “Timing, Timing, Timing”.",88,30,6,124,645,3012
I am required to disclose that there is a volcano in the neighborhood.,89,28,7,124,645,5198
Here you are—a home on the 18th green in your price reange.,89,28,7,124,645,5831
...It's listed as a Par-Two but they're motivated so I think we can bump them to a Par-Three...,90,26,8,124,645,6144
Miniature  Golf is a religion around here.,88,30,6,124,645,6992
It's our latest project-- Maximum Golf. Miniature Golf is so last century.,91,29,7,127,645,2702
"Just remember, utilities are included.",94,23,10,127,645,6154
"And the best part, the course is only open on weekends.",91,29,7,127,645,6823
This isn’t exactly what I had in mind when I said we were looking for a sustainably powered home.,94,28,8,130,645,4546
"...and drying laundry out here is a breeze!""",91,34,5,130,645,5692
"Believe me, this house is way above par",95,26,9,130,645,6097
"And your down payment is only 5,000 tickets.",95,26,9,130,645,7095
"Not only does this property feature both wind and solar, but it has exceptional access to recreational activities.",97,27,9,133,645,2414
"If you don't answer the door immediately, an unwelcome guest will be gone.",98,25,10,133,645,4555
"If you’re interested, we can putt an offer in",98,25,10,133,645,5579
"Getting in and out is a little like Russian Roulette, but you get use to it.",95,31,7,133,645,6296
"Sure, coming and going could be tricky, but it's a great location!",97,32,7,136,645,1230
And the neighborhood tends to draw young families.,98,30,8,136,645,4938
"...and it’s a steal at 400,000 tokens",100,26,10,136,645,7379
"On windy days, you can even sell electricity back to the power company.",101,29,9,139,645,716
The Windmill has the same floorplan as the Old Lady's Shoe,99,33,7,139,645,2745
"Are you thinking what I'm thinkin? A home not 'near' the golf course, but literally ON the golf course!",99,33,7,139,645,3137
"There's a lot of foot traffic, but if you get a hole in one, your next month's rent is free.",99,33,7,139,645,4019
"Well, solar wasn’t available in this area.",99,33,7,139,645,6801
I know we talked about solar panels but wind energy really is the next big thing,100,31,8,139,645,7154
You also get access to the community moat.,106,24,12,142,645,452
Don Quixote had his eye on this place...,102,32,8,142,645,3355
What makes you ask if the previous owner was Dutch?,103,30,9,142,645,3986
"Keeps the bad guys out about 60% of the time, depending on the wind.",106,24,12,142,645,5402
You know what? I’ll throw in a couple of free rounds.. do we have a deal?,100,36,6,142,645,6306
Its got sweeping views of the 9th hole.,102,32,8,142,645,6443
"Of course, there will be no utility bills.",103,35,7,145,645,3015
You'll get used to the timing.,104,38,6,148,645,2195
The latest in Condo design. Did I mention it has a putting green?,106,34,8,148,645,7243
This is a much better location than the clown face.,112,27,12,151,645,734
It's listed at Par 4.,105,41,5,151,645,1718
"Since you're going 'Dutch', this would be perfect!",121,29,13,163,645,3715
Windmill-on-the-Ninth is an enviable address in a premier minigolf community.,81,21,8,110,645,3546
"If you like Little Italy, you're going to love Little Holland.",80,23,7,110,645,4070
And it has solar on the other side.,85,18,10,113,645,774
"Unfortunately Mr. and Mrs. Putney, there is nothing miniature about the liability premium for your homeowners insurance.",84,20,9,113,645,7199
The developers have taken mixed use zoning in an interesting direction.,82,24,7,113,645,7317
‘Beutiful European styling and right on the golf course!”,84,25,7,116,645,2891
"With this set up, you'll never pay an electric bill again.  And the old lady in the shoe lives right next door!",86,21,9,116,645,3424
And you never have to cut the grass.,82,29,5,116,645,5007
Can we please discuss the elephant outside the room?,89,20,10,119,645,5097
Well...this is the 18th. I'm afraid I don't have any more to show.,87,24,8,119,645,7190
You must admit that it isn't a run-of-the-mill home.,86,31,5,122,645,3827
You’ll absolutely love the second story view. On a clear day you see Clownmouth!,86,31,5,122,645,6216
It’s a desirable neighborhood and great house so getting in is going to be all about timing.,91,21,10,122,645,6577
Don't forget the Trump family doesn't add its name to just any property.,93,22,10,125,645,366
"Welcome to Trump Tower, Holland.",92,24,9,125,645,2139
"Year-round air conditioning, clothes drying, free water supply, and a zoo  and a church just across the street: you'll love it.",92,24,9,125,645,3204
It has wonderful cross ventilation.,91,26,8,125,645,5066
"Two bedrooms, one bath, no heat, but has a killer AC.",91,26,8,125,645,5350
"When you leave, use the remote to increase the blade speed to keep out the thieves.",87,34,4,125,645,5528
"And, as you can imagine, it's a really fun neighborhood.",87,34,4,125,645,7298
"After a few months, you'll hardly notice it anymore.",94,25,9,128,645,1237
Just carry your groceries sideways. You will get used to it. Its a small price to pay for carbon neutrality.,91,31,6,128,645,1312
"It breaks hard right-to-left, but otherwise the place is a gem.",93,27,8,128,645,1442
I suggest online newspaper delivery.,93,27,8,128,645,1601
"There are only three of the original eighteen left, this one won't last long...",91,31,6,128,645,2218
The timing is right.,94,25,9,128,645,2681
"No, that's an in-ground pool.",95,23,10,128,645,3220
"It's a one hole, one shot home. Nobody can play through.",90,33,5,128,645,6223
My only concern is that the appliances aren't stainless steel.,92,29,7,128,645,6377
"The present owners are in fore closure, I'm sure they'll accept your offer!",96,26,9,131,645,2096
It's a two story with one ball garage.,95,28,8,131,645,2170
"Not only is it on the fairway, it also qualifies for renewable energy credits!",93,32,6,131,645,2180
Timing is everything when you want to get into a new house.,93,32,6,131,645,4241
Panoramic views. Great ventilation. Central location. I think that covers it.,93,32,6,131,645,4626
It’s a fine unit. I’d say it’s at par with any other house in the neighborhood.,93,32,6,131,645,6348
Yup..Real estate is timing.,93,32,6,131,645,7177
You won't find a better deal this side of the pirate ship water hazard.,99,25,10,134,645,555
Quixotic golf course living at its finest.,99,25,10,134,645,2473
"It helps to close your eyes
when you run.",99,25,10,134,645,2576
The sellers are in the hole.,100,23,11,134,645,5603
"Yes, you can live here free. Just collect the golf balls and put them in the big bucket.",99,25,10,134,645,7201
The nice thing is it's on a cul-de sac.,98,27,9,134,645,7265
The sellers are moving back to Holland.,98,32,7,137,645,1296
Tilting is permitted daily from 4 to 7 PM.,102,24,11,137,645,1743
And all 18 of these units are free of the noise of lawnmowers.,97,34,6,137,645,2536
You'll really love the privacy on windy days!,101,26,10,137,645,5749
It's perfect for augmenting your timing and decision-making skills.,98,37,5,140,645,2035
"It's not a Trump golf course, but for many people that's a plus.",103,27,10,140,645,5002
"Okay? Now, on three!",99,35,6,140,645,7409
And the unique feature is the revolving door.,106,26,11,143,645,1209
"Other than occasional acts of Quixotism, there were never any complaints about this property.",104,30,9,143,645,2088
The former tenant forgot to use the exit tunnel. It was a windy day.,104,30,9,143,645,3460
Wait 'til you see the pool.,98,42,3,143,645,5108
Here at Trump Mini Golf Estates every  day is below par.,110,23,13,146,645,2297
Not only that. Just one hurricane and you’re good for six months.,104,35,7,146,645,6901
Time is of the essence.,106,36,7,149,645,2836
It's a great yard for just puttering around.,107,34,8,149,645,3869
"Now I know it seems like we have been tilting at windmills with those other houses in the neighborhood, but I think this house is a real hole in one.",106,36,7,149,645,4806
it's our model for those who like to putter,107,34,8,149,645,5009
A bit tricky to get in on a windy day,115,23,14,152,645,4354
"The wind power saves on electricity bills, plus it has a ballroom in the basement.",97,26,9,132,645,15
Getting in or out can be a little iffy .,93,34,5,132,645,78
The previous owner was an avid golfer and  a big fan of renewable energy.,91,23,9,123,645,152
"Sorry, we don't do sub par mortgages.",98,14,14,126,645,290
Timing is everything in getting into the housing market,84,27,6,117,645,750
"Now you do understand, the wind is not included.",96,28,8,132,645,863
This is a little more open concept than we're looking for.,106,43,4,153,645,1166
Two words: Big Balls.,89,22,9,120,645,1180
I wish I could tell you it has a miniature price.,102,31,8,141,645,1222
I say we let them play through.,108,29,10,147,645,1224
"But if you can get the car into the garage in one attempt, the local carwash will give you a free pass.",86,23,8,117,645,1350
"I SAID, IT'S ENERGY EFFICIENT, BUT YOU HAVE TO GET USED TO THE REVOLVING DOORS.",97,21,11,129,645,1420
A Quixotic Home at a Sancho Price!,96,23,10,129,645,1613
And we have walk and don't walk signs in the living room.,103,19,13,135,645,1798
This way you don’t need solar.,88,29,6,123,645,2272
"Full disclosure: There is a volcano nearby, but it is dormant.",85,20,9,114,645,2336
This place has 24/7 security provided by the gator on hole 7 and that clown on hole 18.,93,19,11,123,645,3152
"Full disclosure: It's a bit drafty, and the neighbors live in a shoe.",93,29,7,129,645,3166
The master looks right on to hole 18.,97,21,11,129,645,3284
"Well Mr. Smith, is this anything like the windmills in your mind""",100,25,10,135,645,3366
And you'll be living right on the golf course!,101,23,11,135,645,3627
"Except for the wind, it's the perfect place if you like small towns and golf.""",98,29,8,135,645,3660
You mentioned you wanted to live on a golf course.,97,26,9,132,645,3750
The owner wants to move back to Spain to pursue new adventures.,92,26,8,126,645,3803
I hope it's up to par with your standards.,74,27,4,105,645,3826
"Oh yes, this is a tremendous kids' neighborhood!",86,18,10,114,645,3894
I can let you have it for five under par,89,22,9,120,645,4250
This model has the best security system in the complex.,90,30,6,126,645,4403
"We like the Scandinavian styling, but could we see something a little more clown mouthy?",90,25,8,123,645,4429
You can generate your own power but I wouldn’t go outside when it is windy.,105,30,9,144,645,4588
"It's energy-efficient, near a church, and it backs up onto a golf course.",94,32,6,132,645,4630
It’s just a matter of practice.,85,30,5,120,645,4717
"The electric bills are quite low, but some of the rooms can be a little drafty.",88,29,6,123,645,4729
"Admittedly, access and egress can be a little dicey.",95,25,9,129,645,4740
This hybrid home keeps pesky birds away while lowering your electric bill!”,96,28,8,132,645,4776
"Yes, it is expensive, but you can always go Dutch.",94,22,10,126,645,4903
"This house is a mill, but the owners are willing to sell for half.",96,23,10,129,645,4906
"It needs a little work, but it’s a great buy if you don’t mind a little puttering around.",80,25,6,111,645,5180
"Par 4 sounds high, i know, but i think we can get them down to a par 3",99,32,7,138,645,5222
The front door security system either keeps ‘em out or it wipes ‘em out.,101,33,7,141,645,5525
It's in a walkable neighborhood.,89,32,5,126,645,5567
You can have it for a breeze.,86,23,8,117,645,5620
"Don't worry, they'll yell fore.",81,33,3,117,645,5753
The timing for entry and exit is a little tricky - especially on windy days- but the utility bills are near zero!,92,21,10,123,645,5754
The price of this home is par for the course.,110,25,12,147,645,5822
"Actually, it’s a fantastic price for a par 3.",103,34,7,144,645,5984
I have one more to show you.  It’s down three hills and around a bend.,94,27,8,129,645,6038
Neighborhood is very child-friendly.,91,28,7,126,645,6159
"Ok, so it’s not the 18th hole, but...",103,34,7,144,645,6212
"It’s usually pretty quiet, except when someone gets a hole-in-one.",92,26,8,126,645,6319
This satisfies both your requirements: Historic and Green,95,35,5,135,645,6439
It also comes with solar.,98,19,12,129,645,6462
"You did say you were looking for something right on the golf course, did you not?",86,23,8,117,645,6578
"It’s not that bad, you just have to time yourself.",92,21,10,123,645,6593
But the schools are very good.....,92,26,8,126,645,6943
It's perfect if you enjoy puttering around the house.,104,22,12,138,645,7524
Think of it more as being where the action is.,111,40,6,157,645,945
"Yes, it might be a bit drafty, but I think you'll appreciate the freshly ground flour each day.",109,34,8,151,645,5088
"This golf community is perfect for those who don't like to drive, hate to weed, and understand the importance of good timing.""",106,30,9,145,645,375
It's an Elon Musk design.  Jump in that hole and you're at work in 3 minutes.,103,36,6,145,645,3344
". . . and, if someone actually makes the putt, you get to keep the ball.",104,29,9,142,645,853
We only provide the best housing for our customers. Ever heard of the lady who lived in a shoe?,102,33,7,142,645,942
Wait 'til you see how low the monthly electric bill is!,100,37,5,142,645,2619
"The place is great, but I'd add a side entrance.",102,33,7,142,645,3180
And this back yard is a great place to putter!,105,27,10,142,645,4565
It's a matter of timing.,100,32,7,139,645,4332
"""This Dutch Modern needs minimal landscaping and it generates its own electricity.",99,34,6,139,645,6721
"As you can see, this house comes with its own security system.",96,35,5,136,645,873
This prime site on the 18th hole suddenly became available.  The previous owners had an unfortunate accident.,97,33,6,136,645,4161
Just use the back door if the wind is blowing more than 5 mph.,99,29,8,136,645,5228
"It's a great starter home, only a par 2!",96,35,5,136,645,6623
And a hole-in-one takes a full point off your interest rate!,97,28,8,133,645,482
OK when I say go we are going to run to the dot then when I say go we are going to run inside. Got that?,98,26,9,133,645,1181
I'm telling you... Putt putt is the new oceanfront.,98,26,9,133,645,3695
The former tenant forgot to look both ways before exiting!,93,36,4,133,645,5728
"Bob...as requested, your home comes with your very own private golf course!",99,24,10,133,645,6531
"It’s walking distance to a school, a loopty-loop, a T-rex and a snack bar. And no one in this neighborhood ever locks their doors!",96,30,7,133,645,6573
"Yes, it is a bit of a hole.",98,26,9,133,645,6797
The neighborhood is perfect for kids.,97,28,8,133,645,7040
Are you going Dutch?,98,26,9,133,645,7119
"Some people worry about security, but trust me, it’s much harder to get in than it looks like.",97,28,8,133,645,7431
"Well, there are 18 units in the association, and it is strongly recommended that owners do summer elsewhere.",93,31,6,130,645,1711
And it's got superb ventilation.,93,31,6,130,645,3782
And no electric bill.,96,25,9,130,645,4160
Timing. Timing. Timing.,95,27,8,130,645,4391
"Rest assured, most people miss their shots.",95,27,8,130,645,5658
"Yes, and it's right on the golf course.",97,23,10,130,645,5884
Now let's talk about the elephant in the room.,95,22,10,127,645,262
"This one has it all - 100% green energy, low maintenance yard, and a kitschy curb appeal.",90,32,5,127,645,390
"Nothing to worry about! This is Amsterdam, not La Mancha.",93,26,8,127,645,940
"On three, I say we run for it!",95,22,10,127,645,1451
It practically pays for itself.,92,28,7,127,645,2404
You don't need a gardener but you may want a caddy.,90,32,5,127,645,2778
"And as you can see, it uses the latest in wind power generation.  You just need to go in the front door quickly.",91,30,6,127,645,2814
"Naturally, going in or out, timing is essential",93,26,8,127,645,4872
Try to time your entries and exits according to prevailing winds.,94,24,9,127,645,5902
The previous owners were the Millers.,94,19,11,124,645,1306
"You have a nutty neighbor you'll have to keep an eye out for, a Mr. Quixote.",94,19,11,124,645,2652
Great natural light. Outstanding rooftop views. And a knockout foyer.,93,21,10,124,645,3502
This next house is best for a couple with a very regular schedule.,92,23,9,124,645,6525
Heating this place will be a breeze,89,24,8,121,645,1731
Just one thing before I show you the interior--we won't be able to all go in together.,88,26,7,121,645,1902
"And the electric bills, ZIP!",88,26,7,121,645,4602
"If this is out of your price range, I have a nice place next to the clown.",90,22,9,121,645,6051
"I think this is the perfect fit for you two! It's on a golf course, it's got Old World charm, and the rotating windmill keeps solicitors away.",90,22,9,121,645,6226
"The walls are structurally sound, but there's a hole in one.",90,22,9,121,645,6730
Your comings and goings must be carefully timed.,88,26,7,121,645,6995
"Not to worry, when there's no wind, there's no problem.",87,23,8,118,645,4908
This home is on par with your budget.,88,21,9,118,645,5160
"In the housing market, timing is everything.",87,23,8,118,645,6025
It's loaded with charm.  You just have to be a little careful when you step out on a windy day.,83,26,6,115,645,587
Trust me.  It really doesn’t matter.  No one plays minature golf today.,84,24,7,115,645,2215
You will just love living on the golf course and not having to mow the grass!,81,30,4,115,645,4216
"With cash up front, I can get you in the door of this place, although it might take a few tries.",116,27,12,155,645,820
I think you are going to love it here. But I also think you might want to reconsider buying that dachshund.,118,23,14,155,645,5898
"If you're alert and nimble and stick close to the walls, I'm sure you'll be very happy here.",110,34,8,152,645,1000
"Yes, it’s expensive.  But you save a lot on electricity.",103,43,3,149,645,2782
Hole 7 is the most sought after address on any course.,108,28,10,146,645,1203
The lawns are fake but that’s par for the course.,108,28,10,146,645,7514
If you like golf you're going to LOVE this next place,106,22,12,140,645,6966
Access is slightly trickier on windy days.,103,23,11,137,645,1323
It's ideal for a couple that likes to putter around the house.,101,27,9,137,645,1620
"Well, it fits your budget and has a breathtaking view of the back nine.",101,27,9,137,645,3701
I strongly advise against making a quixotic decision.,103,23,11,137,645,4998
On the fairway AND a tax credit for energy efficiency!,99,31,7,137,645,6389
You'll learn to time your entrances and exits.,98,33,6,137,645,7048
Entering into a new home like this is really all about timing.,98,28,8,134,645,892
You said you always wanted to live on a golf course....,99,26,9,134,645,3785
"Okay, here we are at house number three. Try not to get swept away by this option, folks!",96,32,6,134,645,7151
"It’s like living near the airport, you just get used to it eventually.",93,33,5,131,645,629
And you get to keep all the balls lost on your property.,92,35,4,131,645,4020
"The average savings in electricity is $3,600 a year, which you can put toward medical bills.",97,25,9,131,645,5734
It's right on the golf course.,100,19,12,131,645,6511
The Mulligans are willing to concede that.”,96,22,10,128,645,846
And it backs on to a golf course.,94,26,8,128,645,1052
The membership fees are very affordable.,94,26,8,128,645,1789
"Three bedrooms, 2 baths.  Well priced.  And it comes with a life time supply of whole wheat flour...",94,26,8,128,645,5329
"...and not a penny ever for greens fees!""",94,26,8,128,645,6022
"If you prefer solar, I'll show you the home on hole 3.",95,19,11,125,645,1365
You'll never again pay an electric bill.,93,23,9,125,645,3473
And we also offer hole-in-one insurance!,94,21,10,125,645,3590
Do you play golf?,90,29,6,125,645,4143
"First, let me explain the security system to you.",89,31,5,125,645,5552
"Three beds, two baths, par four.",91,27,7,125,645,7383
Your condo fees are already included in the green fees.,88,28,6,122,645,1871
"On the bright side, you won't be bothered by solicitors on windy days",90,24,8,122,645,1898
True. But with the hole in FRONT of the door the risk is substantially reduced.,91,22,9,122,645,3692
It's a wind generator to power your solar panels.,86,32,4,122,645,4692
"Like I said, it's a risky investment. I don't know if  you have the balls to buy it.",91,22,9,122,645,7274
The Tudor on the back nine was not in your price range.,89,26,7,122,645,7392
"Trust me, you’re far more likely to go underwater with the castle.",84,31,4,119,645,1137
I understand you folks are open to Dutch Revival ?,91,17,11,119,645,1674
Your front door security system works even better when there's a gale force wind blowing.,88,23,8,119,645,6058
Solar power is so yesterday.,86,22,8,116,645,883
"Not to put any pressure on you, but golf course views tend to sell quickly”",84,26,6,116,645,5311
This one’s got central air!,83,23,7,113,645,1249
"On the upside, you'll get free air conditioning and golf privileges.",83,23,7,113,645,2026
"Yes, there's a reason they placed the door on that side.",83,23,7,113,645,3270
"Real estate, it’s just hit or miss.",82,25,6,113,645,5983
It's a great neighborhood!  Have you ever played dodge ball?,77,25,5,107,645,4694
"To live in this house, you've got to have some pretty big balls.",81,17,9,107,645,7148
Great neighborhood and everything's close enough that you'll never have to drive.,76,22,6,104,645,383
"Look Steve, I'm going to level with you... This place is a hole.",115,26,12,153,645,5680
Named the most challenging house in Mini Golf Estates.,110,31,9,150,645,6091
"If you want to stretch the budget, we can get you into a clown’s mouth.",112,27,11,150,645,6867
"The front entrance is a little tricky, but it generates its own electricity.",107,32,8,147,645,5934
And there's a good breeze year-round.,105,31,8,144,645,25
"You're lucky it's still available.  The last couple I showed it to, put a bid in, but then tried to enter on the count of ""2"" instead of ""3"".",103,35,6,144,645,3282
The front nine already sold out so I'd make an offer fast.,103,30,8,141,645,1215
I guarantee you. There’s nothing miniature about it.,102,32,7,141,645,4595
I really think you'll like this Dutch-style charmer overlooking the 9th fairway.,104,28,9,141,645,4893
"Trust me, it's a better deal than the laughing clown house.",98,35,5,138,645,744
and you'll notice it is quite convenient to the course,100,31,7,138,645,3694
Tilting at windmills on your bucket list?,100,26,9,135,645,1079
"I'm tellin' ya, this property's a hole in one!",99,28,8,135,645,2355
And of course there's plenty of room to just mill about.,100,26,9,135,645,4808
...and you can say good-bye to uninvited guests.,97,32,6,135,645,4914
And the electricity is included.,101,24,10,135,645,5672
"It takes a little getting used to, but it's great for deterring the in-laws!",96,34,5,135,645,6007
The owner built this part of the Mar-a-Lago resort for when he was feeling inadequate.,102,22,11,135,645,6071
It's open concept and energy efficient.,93,40,2,135,645,7166
Just think of all the electricity you can sell.,98,30,7,135,645,7533
"Maxi golf, it's the next big thing.",100,21,11,132,645,2720
But you said you wanted a golf community.,95,31,6,132,645,4117
You get to keep all the stray balls AND it has a Dutch oven.,97,27,8,132,645,4290
This place is perfect if you like puttering around the house.,98,25,9,132,645,4609
"Green technology, but the security system's a little tricky.",100,21,11,132,645,4925
So if you time it right you'll have plenty of money for retirement. I suggest a combination of term and hole life.,98,20,11,129,645,797
"Sure, it's a quirky house, but it's right on the fairway.",93,30,6,129,645,2052
"Each time you get through the door, a bell rings and you get a free game.",93,30,6,129,645,3696
The Will states it's yours now. Consider it a windfall,92,32,5,129,645,4363
Par 4 quality at par 3 pricing. Wind power. And quiet — most people quit before the 18th hole.,93,30,6,129,645,5347
"You're kidding, right? Your name really isn't Don Quixote.",93,30,6,129,645,5925
Falling into the cup. Seen it. Covered it.,94,23,9,126,645,430
This place is as green as they come.,90,31,5,126,645,647
Imagine your weekends puttering around the house.,94,23,9,126,645,5172
The market here is all about timing.,92,27,7,126,645,6945
This IS mid-century modern,91,29,6,126,645,6947
Perfect place to putter around,88,30,5,123,645,2584
It's easy once you get the timing right and it's entirely green,93,20,10,123,645,2704
"Yes indeed, when it comes to buying houses, timing is everything!",87,32,4,123,645,2741
The sellers are downsizing to a pinball machine.,88,30,5,123,645,2811
Just don't go in or out when the wind's blowing.,90,26,7,123,645,5162
...... with the added benefit of discouraging Jehovah's witnesses.,91,24,8,123,645,5980
"It's quite obvious why the price was dropped, but the location is fantastic""...",84,33,3,120,645,1727
You did say you wanted a home on the 18th green.,88,25,7,120,645,2600
"The balls are bigger too, but you’ll get used to it",88,25,7,120,645,2824
Imagine how much money you can save grinding your own corn!,90,21,9,120,645,3520
I haven't told anyone else but...it also grinds corn!,89,23,8,120,645,4272
Resort living with a view of the eighteenth hole.,85,31,4,120,645,6495
Look both ways when crossing the living room.,114,35,8,157,645,6856
"It's charming, and you save a ton on your electric bill.",86,24,7,117,645,5046
"You asked for a house on a golf course, but with your budget........",85,26,6,117,645,6133
"And if you decide to buy it, I'd avoid taking Ambien.",113,32,9,154,645,4364
Each unit in our Mini Golf Retirement Village is unique. This one offers plenty of fresh air and ventilation.,83,25,6,114,645,4137
Typical summertime traffic but really quiet in the winter. And it certainly beats the clown you’re liv’n in now.,83,25,6,114,645,5551
It's a seller's market. Timing is everything.,109,30,9,148,645,850
There are no HSA fees and the golf is free,82,22,7,111,645,5207
"Yes, off the grid and with a golf course view!",107,29,9,145,645,3277
It will be great once you get into the swing of things.,104,30,8,142,645,306
The last owner got a hole in one on the first try,103,32,7,142,645,479
Tiny houses are all the rage right now and this one is a real hole-in-one.,106,26,10,142,645,6648
The wooden shoes are optional.,100,33,6,139,645,2728
It's really only a problem in the summer months.,101,31,7,139,645,4640
"It's a great neighborhood, and you only have to risk death twice a day.",100,28,8,136,645,130
You'll be off the grid.,99,30,7,136,645,856
"Yes, but think about the low energy costs.",98,32,6,136,645,1128
Upgrading from the hole to a moat would be surprisingly affordable.,96,36,4,136,645,2682
You might say that we’ve made child’s play out of home security.,99,30,7,136,645,4971
Central air?  I don't think so.,99,30,7,136,645,5844
And the decapitation insurance is quite reasonable,100,28,8,136,645,5846
"It's just the one room, but there is a lake and ferris wheel right around the corner.",98,27,8,133,645,185
Wait till you see the security system.,100,23,10,133,645,3007
Don Quixote Realtors at your service.,98,27,8,133,645,4834
The best part is you never have to cut the lawn.,95,33,5,133,645,4924
"It's perfect -- a quaint village on a golf course, where the President plays twice a week.",99,25,9,133,645,5023
"And this is our premium home, where almost no balls go through!",96,31,6,133,645,5606
"Have you decided which of you is going to pay, or are you going Dutch",71,24,4,99,645,3866
Let's wait for the wind to die down and this putt before I show you the beautiful interior?,98,22,10,130,645,721
"... and if you like the beach, you'll love to hear that it's only a two-minute walk to a sand bunker near the water hazard",95,28,7,130,645,2061
"Off the grid, what's not to like?",95,28,7,130,645,2098
It's called oscillating Feng Shui.,96,26,8,130,645,2254
"So you're looking for a home closer to the fairway.""",94,30,6,130,645,3917
The Millers? What a coincidence!,96,26,8,130,645,7264
Of course we can lubricate the windmill and fill in the hole in the front yard before we close.,92,29,6,127,645,1300
It's everything you wanted: kid-friendly; renewable-ready; fun part of town.,92,29,6,127,645,1643
"Now that we are clear on the sustainability features of the house, we can address the elephant in the room.",92,29,6,127,645,1824
Just think of how much you’ll save on your electric bill...,94,25,8,127,645,1973
This is one of the more challenging properties I am listing ....,94,25,8,127,645,7495
"True, Mrs. Van Dyke, but only on windy days....",88,32,4,124,645,176
"Out of personal experience, I suggest you watch your step.",90,28,6,124,645,461
"To get in on this deal, it's all in the timing.",92,24,8,124,645,2709
As you can see this part of Lilliput has become gentrified.,90,28,6,124,645,3419
It'd be perfect should one of you develop a handicap.,94,20,10,124,645,3716
Why yes.  It was listed as golf course living.,91,26,7,124,645,5089
"The sellers are very motivated, they're moving to hole 12.",91,26,7,124,645,5192
You'll get in on the bottom floor of the small house movement.,94,20,10,124,645,5221
This is as close to a lighthouse as it is possible to purchase in Iowa,90,28,6,124,645,5771
Make ‘em a low ball offer.,91,26,7,124,645,5962
"Yes, it's a fixer. But the energy credits are amazing!",88,27,6,121,645,1009
"Besides being energy-independent, your home is now 25% more secure!",88,27,6,121,645,3051
It comes with a par 3 garage.,91,21,9,121,645,7173
The good news is that you are surrounded by other par 3 properties.,103,44,2,149,645,6016
"The monotonous creaking will help you sleep, and you'll never have to worry about unwanted sales and church people.",86,26,6,118,645,541
Since you’re just dating you can go Dutch on it.,88,22,8,118,645,1854
"This model is called ""The Impossible Dream House"".",88,22,8,118,645,2448
The energy savings will sweep you off your feet.,87,24,7,118,645,3776
"This house has everything on your wish list--light and airy with an open floor plan, a fun-filled design for entertaining, and a distinctive and welcoming front entryway.",84,30,4,118,645,4558
...And it's perfect for someone who likes to putter around the house.,87,24,7,118,645,4864
"Sure, it's a little tricky getting in and out, but your utility bills will be practically nothing!",104,37,5,146,645,1291
"And if this isn’t what you’re after, I also have a castle with an uncontrollable drawbridge over on the 7th.",108,29,9,146,645,2410
"It's a little cozy, but the neighborhood's nice and quiet since they moved the pirate ship to hole 18.",85,23,7,115,645,2341
"In the interest of disclosure, I must tell you this house is a par four",85,23,7,115,645,4353
"So, Mr. Quixote, you mention there is a bit of family history involved here.",84,25,6,115,645,7420
"Giant golf balls do roll in every once in a while, but you get used to it",104,32,7,143,645,5987
"Lucky for you, it has the highest hole in one rating on the course.",82,24,6,112,645,4868
You want to use the back door.,80,28,4,112,645,5554
"It's a windmill, just like the President",106,23,11,140,645,5735
It’s also haunted.,108,19,13,140,645,6061
Utilities included for life.,100,35,5,140,645,7216
"Yes, you're right, but the big paddles keep most of them out.",104,27,9,140,645,7342
I know you said green was important.,99,32,6,137,645,24
Thanks for coming to this open house.,101,28,8,137,645,444
I will say the architecture here strongly favors the nimble.,100,30,7,137,645,4553
"You guys wanted a gated community with a golf course, so at seven million this is a steal in San Francisco!",103,24,10,137,645,5020
"Great buy! Master suite, two additional bedrooms, two full baths, upgraded kitchen and fully off the grid.",98,34,5,137,645,7370
"This one goes for three hundred, but if you're looking for something a little cheaper, we have the clown's mouth for two-seventy-five.",95,35,4,134,645,315
"Look, this is the only one in town!",95,35,4,134,645,409
"To be honest ,it can get a little breezy .",98,29,7,134,645,1100
We lovingly refer to this model as the 'Don Qui-Hole-in-One',99,27,8,134,645,3722
"It's quaint, charming, and you can work on your short game.",98,29,7,134,645,5044
But the ball almost never makes it in the front door.,96,33,5,134,645,7193
"Tulips, always plant tulips.",102,21,11,134,645,7557
"It’s a bit over budget, but you are on the first hole.",98,24,9,131,645,1801
"But, Don Quixote is your neighbor.",97,26,8,131,645,2775
I cannot emphasize enough how important it is to have a good exit strategy in place before you invest in this property.,97,26,8,131,645,3465
We’ve managed to reduce the possibility of home invasion robbery by 25 percent.,95,30,6,131,645,6014
I said we wanted a place ON a golf course not IN a golf course.,98,24,9,131,645,6423
"One bedroom, air conditioned...Charming old world facade and a yard to putter in...Those were your criteria, no?",96,28,7,131,645,6738
This house is a steal.  Electricity from wind power and a golf course view.,94,32,5,131,645,7078
Of course you can ‘Go Dutch’ with the payments,114,34,8,156,645,1670
"Just what you asked for, an affordable, active community.",112,38,6,156,645,3874
It’s the latest in green living.,94,27,7,128,645,2841
…And your electricity bills would be quite low…,94,27,7,128,645,4088
One pill makes you larger,96,23,9,128,645,5529
"You’ ve been looking for a sweet deal on golf course property, right? How about this cottage right on the green?",94,27,7,128,645,5848
I know this isn’t as nice as the water-hazard-front property but that was way out of your budget.,94,27,7,128,645,7110
"You DO know the windmill house is the best property on this golf course, right?",95,25,8,128,645,7186
"Believe me, it is better than solar and forces you to exercise",89,32,4,125,645,1292
"As you can see, there is nothing miniature about it.",94,22,9,125,645,2572
Did I mention it comes with a pool?,95,20,10,125,645,2986
You get the whole white picket fence thing without feeling so trapped.,91,28,6,125,645,3668
"Because it’s a World Heritage Site, you couldn’t make exterior alterations.",96,18,11,125,645,4489
How do you feel about letting 'em play through?,94,22,9,125,645,5804
It's the only wind powered unit in the Hole neighborhood.,90,25,7,122,645,2626
WHEN IT'S WINDY IT'LL BE GOOD TO STAY INDOORS.,91,23,8,122,645,4425
The housing crisis has affected every industry.,90,25,7,122,645,4756
"Neighborhood's a little under par, but it's a short drive to work.",90,25,7,122,645,5337
But you said you wanted a golf view.,89,27,6,122,645,5905
"You're in luck, because in the windy season this place will cost you and arm and a leg.",88,29,5,122,645,6429
"Or, if you prefer, I can show you a lovely ""angry gorilla"" property just around the corner.",89,27,6,122,645,6658
"And the commute is easy, except for the last part.",90,25,7,122,645,7079
"Don't worry, no one ever gets it into the windmill.",103,36,5,144,645,273
"If this isn't your thing, I've got a clown's mouth listing that's priced to move.",108,26,10,144,645,1108
People love the open floor plan.,104,34,6,144,645,2443
The ball hardly ever comes through.,107,28,9,144,645,3053
"In this neighborhood, a fixer-upper is par for the course.",108,26,10,144,645,6189
Think of it as a challenge every day.,88,24,7,119,645,1348
Think of it this way. It's like you're always on vacation.,83,34,2,119,645,1555
The current owners are motivated to sell.  Consider it a guaranteed hole in one.,85,30,4,119,645,5709
It is completely powered by sustainable energy and it has a great view of the 18th hole.,87,26,6,119,645,6788
If this isn't your style I can show you a 3 bedroom with a loop-the-loop.,104,29,8,141,645,631
"The white picket fence? The current owner, uh, repurposed it.",106,25,10,141,645,1264
This cute home is part of an exclusive miniature golf course community,102,33,6,141,645,3093
I hear you like to golf,103,31,7,141,645,3482
You'll be the first on your block with renewable energy.,101,35,5,141,645,4248
"No garage, but you won't be driving on this course.",108,21,12,141,645,4873
"Yes...it's a bit smaller but, it's right on the golf course.",102,33,6,141,645,6557
Please remember that the covenant requires that you always leave the doors open,86,23,7,116,645,2284
And wait till you see the keyless entry!,88,19,9,116,645,2890
In your price range this was the best option with a golf course view.,85,25,6,116,645,5776
The pirate's cove might be more in your price range.,100,32,6,138,645,127
And the power generation alone will provide you a guaranteed income for life.,100,32,6,138,645,676
"This is great starter home while you are young, fit, and childless.",104,24,10,138,645,1413
This is one of the newest models from Don Quixote modular homes.,99,34,5,138,645,3148
You'd never have to mow again.,98,36,4,138,645,3299
"To be honest, we're not entirely sure where it leads.",102,28,8,138,645,3578
"As I mentioned at your first visit, there may occasionally be times were you may not want to leave the house",105,22,11,138,645,5309
With the right timing you can make it right to the second floor.,104,24,10,138,645,6447
And it’s got the very latest in sustainably-sourced energy.,81,28,4,113,645,727
"For windy days, there is a backdoor",84,22,7,113,645,4737
I don't know... I'm just not a fan of those granite counter tops,104,19,12,135,645,10
It has the latest green energy features.,97,33,5,135,645,132
It's only a par 3 now but with a little TLC you'll have a par 4 before you know it.,101,25,9,135,645,1660
You're only a par from the church and a birdie from the zoo.,101,25,9,135,645,2546
Real estate is about being at the right place at the right time.,99,29,7,135,645,3739
"You know what they say, “rotation, rotation, rotation”",97,33,5,135,645,5549
The area is zoned for both residential and comical.,99,29,7,135,645,5808
The kids will love it.,97,33,5,135,645,6199
"Yes, but you get to keep all the golf balls that come through the door",99,29,7,135,645,6476
". . . however, the seller retains playing privileges.",96,35,4,135,645,6719
"If balls are a problem, and the blades aren’t cutting it, you could always add a drawbridge or a metal loop-de-loop.",97,33,5,135,645,7220
This House has all the charm of a Dutch Colonial and is on a golf course.,113,33,8,154,645,764
"See, in this neighbourhood you'd just call it regular golf",99,24,9,132,645,2176
Welcome to the open house.,113,33,8,154,645,3800
The windmill? It's par for the course.,67,14,7,88,645,4993
Security is intermittent,80,25,5,110,645,5482
Be careful with the front door. Especially on a windy day.,112,30,9,151,645,2863
What did you expect? A castle?,96,25,8,129,645,2646
And there are no green fees.,94,29,6,129,645,3291
"If parking is that important, we can show you
the Fire Station at #7.",97,23,9,129,645,3719
"When you hear ""Fore!""  you run upstairs now, okay ?",95,27,7,129,645,4292
Did I mention that any balls that make it in belong to you?,96,25,8,129,645,5408
I don't know why they call it mini golf. Everything is huge.,95,27,7,129,645,6245
...and the lease includes free insurance against blunt trauma and dismemberment.,98,21,10,129,645,7022
...and its Energy Star rating is 'off the charts!',93,31,5,129,645,7421
"Of course, nothing says you have to let them play through.",90,32,4,126,645,527
Just think of the money you’ll save on electricity,93,26,7,126,645,2120
you said we should go dutch,95,22,9,126,645,6088
Drafty? No. Why do you ask?,107,30,8,145,645,389
The right time to enter the market changes by the second.,107,30,8,145,645,2490
Fairway view!,107,30,8,145,645,2516
"Are you interested in this as a home, investment property, or guillotine?",107,30,8,145,645,4139
"It has a couple of drawbacks, but think what you'll save on electricity.",106,32,7,145,645,6759
"You asked for something ""above par"" --this is it, on your budget!",107,30,8,145,645,7378
Houses don’t get any greener than this one.,106,32,7,145,645,7513
The grandkids will love it.,90,27,6,123,645,928
"With your budget, this is the best I could do regarding listings on a golf course.",129,18,17,164,645,2129
This timeshare unit includes unlimited rounds of golf.,89,29,5,123,645,2807
"I would suggest buying both properties, in case you get a hole in one.",92,23,8,123,645,3195
"When the golf ball comes through the doorway,you stand here.",93,21,9,123,645,3910
"In this neighborhood when anyone says'""get outta' the way"", just  do it.",91,25,7,123,645,5379
It's all about the second floor.,104,31,7,142,645,2590
We can get you out of your Pirate Ship and into this “classic” within the month !!,102,35,5,142,645,3062
"And, you can apply for energy efficient financing.",104,31,7,142,645,5445
Let me show you the interior. Immediately.,104,31,7,142,645,6316
"As I said, it’s A somewhat gated community",107,25,10,142,645,6499
"Good schools, close to shopping...oh there’s one other thing you need to know.",102,35,5,142,645,6620
"Actually, it's a FOOORE!-Closure",106,27,9,142,645,6893
I know it's not on the course of your dreams but the price is right.,87,28,5,120,645,806
"With our windmill home, you save on electricity, speed up your reflexes AND discourage unwanted visitors.",90,22,8,120,645,817
It livens up around here in the summer.,99,36,4,139,645,1820
Just let me know. The timing is crucial.,106,22,11,139,645,1835
"For an extra 20 grand, I can get you on a water hazard.",107,20,12,139,645,2068
Elephant?  What elephant?,105,24,10,139,645,5594
And you'll be happy to know the mortgage rate is way under par.,101,32,6,139,645,7457
It's expensive but you could always go Dutch.,88,21,8,117,645,3656
It's not a run-of-the-mill golf course community.,86,25,6,117,645,6546
This one comes with club membership and utilities included.,86,25,6,117,645,7435
"Well, it's on a golf course, just like I promised. And I wouldn't worry too much. They almost never make it into the windmill.",100,29,7,136,645,286
"It's only a Par 3, but the view is fantastic!",101,27,8,136,645,2294
And you have a lovely view of the golf course.,97,35,4,136,645,2596
Let me hazard a guess.,98,33,5,136,645,2908
You might want to be a bit  careful when you are going in or out.,100,29,7,136,645,4054
Don't be indecisive. There are a lot of people lined up to go through this house.,100,29,7,136,645,7351
... but I can't recommend the neighborhood. Everybody seems pretty teed off.,111,34,7,152,645,43
A hole-in-one no longer qualifies for a zero down mortgage.,100,24,9,133,645,2708
If you time it just right you'll have no problem going in and out.,99,26,8,133,645,2927
Buy it today and I'll throw in free club membership.,85,22,7,114,645,3004
On Sunday afternoons you can expect a little more traffic in the neighborhood.,98,28,7,133,645,3487
"Inspired by Mr. Swift’s book, we call this subdivision “Lilliputt”",83,26,5,114,645,5247
This is truly the most exclusive golf course real estate there is! NOBODY gets Windmill. Nobody!,101,22,10,133,645,6500
I think you'll find that this property is well above par.,100,24,9,133,645,7447
OK - let me address the elephant in the room.  There is a black hole in the front yard of this property.,111,29,9,149,645,1656
There is a very small easement with the property.,95,29,6,130,645,574
Why hold out for a dream home when you could move into a family-sized fantasy?,97,25,8,130,645,1236
This little gem was once owned by the Quixote family.,96,27,7,130,645,1685
It's energy self sufficient and the old woman in the shoe next door loves kids.,96,27,7,130,645,2083
It's a starter. You can move up to the 18th later.,98,23,9,130,645,2134
"I like to think the blades add a unique level of excitement to the entryway. And you'll never need another table fan. That, folks, is what we call a wind-win.",95,29,6,130,645,2420
Are you feeling nimble today?,97,25,8,130,645,6885
Relax. It comes with a Don Quixote restraining order.,95,29,6,130,645,7507
"This coveted home has a view of the 4th, 5th, 6th, 9th, 10th and 12th greens.",111,24,11,146,645,1764
At least coming home drunk will be an adventure.,107,32,7,146,645,1777
You'll love the neighbours – Mr Quixote is quite a character.,94,26,7,127,645,1258
Could we see one with a lower par?,93,28,6,127,645,1641
"Technically, it's on the green. And it's certainly in your price range.",95,24,8,127,645,3178
Irony is always a good investment.,95,24,8,127,645,3314
You’ll only get your key deposit back when you return the balls,94,26,7,127,645,4810
"The golf balls will be an adjustment, but think of what you'll save on your electric bill.",92,30,5,127,645,6958
"And for every 'hole-in-one', you get a free month of rent""",94,26,7,127,645,7211
Is this the windmill of your mind?,80,22,6,108,645,1785
And as a bonus you will enjoy reduced electric bills,81,20,7,108,645,6229
"Well, nuclear just isn't practical.",109,23,11,143,645,592
Past tenants have increased their cardio by more than 40%!,106,29,8,143,645,5452
It's perfect for those who like to putter around the house.,92,25,7,124,645,204
"Sure, your neighbors are a giant clown head and a mechanical  alligator, but you wouldn’t be living on the back nine anymore.",89,31,4,124,645,3201
And it comes with a charming legend about an elephant who thinks he’s Don Quixote.,92,25,7,124,645,3494
You'll love it! Much more room than the Clown Face.,94,21,9,124,645,5060
"Oh, don't listen to Mr. Quixote and his nonsense. This house is perfectly safe.",92,25,7,124,645,5100
A home on a golf course always keeps its value.,88,33,3,124,645,5376
"Sure, it does get a little drafty, but the curb appeal's a hole-in-one.",93,23,8,124,645,7100
"Besides the occasional golf ball, you have to watch out for a crazy Spaniard with a lance.",104,28,8,140,645,875
The view of the Clown's Mouth is to die for.,102,32,6,140,645,1604
And it has a unique drainage system in case of floods,103,30,7,140,645,3124
My commission is par for the course.,103,30,7,140,645,5017
"And also remember, no more electric bills.",103,30,7,140,645,5539
Mr. Trump doesn't believe in miniature golf.,81,15,9,105,645,5921
"In addition to the club membership, it comes with a two-stroke handicap.",103,30,7,140,645,6879
"In a small market like this, timing is everything.",91,22,8,121,645,595
"The mortgage?  Oh, it's not bad.  APR for the course.",91,22,8,121,645,2267
Any extra power gets sold back to the grid.,90,24,7,121,645,3562
"Living on a golf course, your dream come true!",91,22,8,121,645,4245
You can speed up the windmill when say your parents visit...it's hysterical watching them try to time the entrance.,91,22,8,121,645,6161
"Listen, the other 17 homes you want us to look at...are they...similar to this one?",100,31,6,137,645,1834
It's a three story colonial with great curb appeal and a beautiful view of the tee.,99,33,5,137,645,2077
"I think we can reduce the price, it’s only a par 2.",102,27,8,137,645,5291
They tee off at 6am but that's what makes it affordable.,76,20,6,102,645,1355
"So finally, you pop out of the hole, dodge the blade, somersault through the door, and Voila, you're at your polling place. Please don't forget to present your photo ID.",91,17,10,118,645,697
"No, the previous tenants had not considered solar.",87,25,6,118,645,1363
"And like all the homes at Trump-Crest Village, it was designed by the President himself.",89,21,8,118,645,4466
"The housing market, much like the entry and exit of this home, is all about timing!",99,28,7,134,645,1893
You said you wanted to be in a neighborhood with kids.,100,26,8,134,645,7535
"All wind power, not to mention you'll have a great view of the alligator on hole #5",85,24,6,115,645,4453
"I've got just the place for you, Mr. and Mrs. Quixote",85,24,6,115,645,4802
You'll have a ball here in Lilli-putt,84,26,5,115,645,5206
"In this property, it’s not about location—it’s about timing your entrance.",84,26,5,115,645,6324
I'm concerned about a draft.,97,27,7,131,645,1849
"No one even makes it to this round, and if they do, we cover your utilities for the month. Hole-in-one if you ask me.",97,27,7,131,645,2225
"Before we get into the specifics of this place, let me ask you a question Bob and Helen- Do you like golf?",97,27,7,131,645,2967
This gorgeous Dutch Colonial Revival is only moments from the course.,101,19,11,131,645,3841
"What with the income from the milled grain and the local giants` miniature golf fees, this place will pay for itself.",96,29,6,131,645,4266
"Odd, I know, but the electric bill is low.",93,35,3,131,645,5127
"I don’t know what else you want - two bedrooms, on the golf course, close to downtown, and a hole in one wins a free game.",98,25,8,131,645,5428
"Frankly, folks, living in Putt-Putt Village takes balls.",97,27,7,131,645,7512
There may be a zoning issue.,107,29,8,144,645,578
Your neighbors have longer par and more distractions.,98,20,10,128,645,908
I wouldn’t put anything breakable in the foyer.,93,30,5,128,645,1636
"And if you get a hole in one, they will take 10% off the purchase price!",97,22,9,128,645,1828
Think of it as buying a small carbon footprint.,96,24,8,128,645,2433
"If you like this, let me also show you our signature waterfall hole.",95,26,7,128,645,4917
"True, the insurance is expensive, but the house is very ""green.""",94,28,6,128,645,6139
And the best part is you can buy it with revolving credit,103,37,4,144,645,6934
And the windmill can be voice activated with Alexa.,108,22,11,141,645,4420
It'll pay for itself in 11 years.,104,30,7,141,645,5339
It's a par four fixer-upper.,100,38,3,141,645,7371
"Yes, coming and going can be tricky... but it's rent controlled!",95,21,9,125,645,2510
"Yes, it is a little more expensive than the Dinosaur and Volcano models we saw but you’ll save a whole lot on electricity.",91,29,5,125,645,4604
Think you can swing it?,93,25,7,125,645,4678
The buyer’s have agreed to throw in a clown’s mouth at closing.,93,25,7,125,645,6843
You can adjust the blade speed to deter all kinds of intruders.,90,31,4,125,645,6951
The security system is considered on par with the best.,92,27,6,125,645,7226
And it has a great view of the golf course!,80,24,5,109,645,57
This baby won’t last... It’s all about the timing.,106,21,11,138,645,1378
"I’m sorry, this house just isn’t up to par.",103,27,8,138,645,1518
This place boasts renewable energy and proximity to a golf course!,92,22,8,122,645,1596
It’s got great airflow.,88,30,4,122,645,3028
You just have to time your mother-in- law's exit just right.,91,24,7,122,645,4589
This was early wind power ...,112,31,8,151,645,3558
"Oh. Yes, there's also a back door.",99,30,6,135,645,1170
"See?  It says so right here: ""Central Air included.""",99,30,6,135,645,2391
"The entrance is a bit hinky,but once you're inside the rest is a breeze",98,32,5,135,645,2795
The prior owner was a miniature golf enthusiast before his untimely death.,104,20,11,135,645,3589
It can be a little tricky getting in and out.,101,26,8,135,645,4716
"Homeowner's liability insurance is not required, but I strongly recommend it.",87,27,5,119,645,420
Not only does this home produce it's own clean energy but it has a great view of the 7th hole.,88,25,6,119,645,2045
"Built by Gulliver himself, Lilliput-put is a truly exclusive location!",88,25,6,119,645,2620
Don't look at me!  You should have planned better for retirement.,88,25,6,119,645,3006
"Sorry. This one is under contract. But, I've got an open house today on the loop de loop next door.",90,21,8,119,645,3680
And here's another plus - you'll be completely off the grid!,86,29,4,119,645,4163
"If you waive the inspection, I can throw in a free game.",108,34,6,148,645,2240
It is a good buy if you both have a strong short game.,111,28,9,148,645,4794
Think of it as a whole house fan.,111,28,9,148,645,6244
"Not only does it have a great view of the 18th hole, you get to keep all of the golf balls that get stuck in the living room.",98,27,7,132,645,1228
"This isn’t what you had in mind when you said, you wanted a house that was “green?”",98,27,7,132,645,1582
And you’ll save on air conditioning.,97,29,6,132,645,1682
"In addition, you'll get home exchange privileges with Chuck's Bowling Pin Estates and Harold's Splash Lagoon Condos.",97,29,6,132,645,1987
"We are the largest mini golf community on the East Coast""",101,21,10,132,645,2548
Of course all your home appliances are connected and you're finally off the grid.,99,25,8,132,645,3241
"Yes, it needs a few upgrades, but with a classic like this that’s par for the course.",98,27,7,132,645,3707
I feel freer now to mention that it’s a tiny bit drafty.,93,37,2,132,645,5093
The bedroom gets morning sun. A staccato effect of course.,110,25,10,145,645,1559
"This fine home  has a unique security system. You don't need a front door, just turn on the windmill when you leave the house.",85,26,5,116,645,1608
The owners say they'll accept below asking price if you get a hole-in-one.,90,16,10,116,645,3360
"remember,  you did ask for a surreal estate agent.",109,27,9,145,645,4346
"Yes, the windy days are why it's marked down.",85,26,5,116,645,7235
It came on the market after the last owners mysteriously disappeared.,97,24,8,129,645,653
"Yeah, no, it’s a tiny house, sure, but it’s right on the darned golf course!",96,26,7,129,645,1232
"In this market, this is the best course I can get you on.",96,26,7,129,645,1303
"My name's Bob, and I'l be your guide today. Will this be your first acid trip?",98,22,9,129,645,3994
"Well, you said you could not afford that place on the golf course",95,28,6,129,645,4683
"It's not a sink hole, it's a Par Three.",95,28,6,129,645,5354
"If you buy today, Mr. and Mrs. Quixote, I'll throw in a complementary round of golf.",97,24,8,129,645,5798
"Dont worry, it's not a real windmill.",94,30,5,129,645,6988
We do suggest avoiding outdoor activities between 10 AM and 7 PM daily.,96,26,7,129,645,7332
Now why would you need solar?,95,28,6,129,645,7531
The Wind energy credits make this place almost free !,72,25,3,100,645,4367
This run-of-the-mill home falls well within your budget.,107,26,9,142,645,7063
"If it's windy, it's one at a time",92,29,5,126,645,819
"You'll have to putt some work into this one, but it's worth it.",97,19,10,126,645,1134
This will  look great with our other yard art!,94,25,7,126,645,1260
"What's more, it qualifies your full home purchase price for renewable energy tax credit.",95,23,8,126,645,1913
"If you want to go Dutch, it's yours.",98,17,11,126,645,4213
Just set the speed to high at night.,92,29,5,126,645,5632
Mind if I play through?,97,19,10,126,645,6651
And there's a golf course.,97,19,10,126,645,7135
The 18th hole is extremely desirable.,102,31,6,139,645,2115
"As is often the case in these negotiations, timing is everything.",104,27,8,139,645,4745
...and you won't need central air conditioning.,102,31,6,139,645,5914
A certain Spanish knight expressed interest until he found the dragon on 18.,103,29,7,139,645,6213
"I hear you. But on the plus side, it’s 100% energy efficient.",103,29,7,139,645,7113
Think of it as your impossible dream house.,114,29,9,152,645,7023
And it's the only one with a hole in the front.,91,26,6,123,645,252
"Location, location, location. Am I right, folks?",90,28,5,123,645,1366
"Great views, and it's right on the golf course!",89,30,4,123,645,3147
Access is an on again off again arrangement.,91,26,6,123,645,5318
"""The previous owners loved it, but they lost a step.",93,22,8,123,645,6471
This property is going to move fast.,102,26,8,136,645,1369
The only other lot I have available is the Clown's Mouth property.,99,32,5,136,645,1637
"....and you will never need air conditioning!""",97,36,3,136,645,2060
The only downside is you cannot close the doors until 9pm.,101,28,7,136,645,2630
"True, it could drive you nuts, but your energy costs are zero!",101,28,7,136,645,3066
This place is meant for the couple who like to putter around the house on weekends.,101,28,7,136,645,4593
Just think of it as the original energy-efficient tiny house,104,22,10,136,645,5630
"Fads may come and go, but high ceilings last forever.",101,28,7,136,645,6382
Bad news. The castle on the beach is already gone.,102,26,8,136,645,6908
"I know you said the last property was a hole, but this one will be different, I promise.",102,26,8,136,645,7244
No-Cervantes never actually slept here.,109,34,6,149,645,5641
Abandoned theme park living will become the new rage.,89,25,6,120,645,2198
"Just one word of caution: watch out when you're comin' out the door.""",91,21,8,120,645,2246
We like to call it the golf resort for the little guy.,88,27,5,120,645,3210
"At par four, this is on the most desirable units in the neighborhood.",92,19,9,120,645,3950
You're gonna love the open floor plan!,89,25,6,120,645,4182
Magnificent view! Overlooks the dinosaur!,89,25,6,120,645,4559
Right on the course!,88,27,5,120,645,5420
And you are allowed to keep any golf ball that makes its way in.,89,25,6,120,645,6777
Of  course you need big balls to live here.,98,29,6,133,645,1347
"It's a steal for the price, and all you have to do is time your entries and exits.",100,25,8,133,645,2236
I’ve got another on 14 I think you’re gonna love.,100,25,8,133,645,3655
Everywhere is just a short drive away!,101,23,9,133,645,3902
Perfect for puttering around the yard.,101,23,9,133,645,4368
The only downside is that your comings and goings have to be timed.,98,29,6,133,645,4597
But its in a great school district,100,25,8,133,645,5605
"It generates its own power, but the security system is tricky.",101,23,9,133,645,6740
Tell Alexa to control the speed and which family members get in.,98,29,6,133,645,6803
Don Quixote once lived here.,110,27,9,146,645,997
You must time your entrances and exits with great precision.,103,41,2,146,645,4457
Can we see now the next hole with the little pond?,108,31,7,146,645,6036
"I'm afraid that's correct, if someone gets a hole in one they do obtain legal title to your house.",118,33,8,159,645,6263
What if they did pay you to live here?,109,24,10,143,645,274
And look at all the room to putter around in this backyard!,86,26,5,117,645,293
"The location is amazing. We are right next to a barn, a bridge, and a very unique Clown's head.",97,26,7,130,645,395
And the kitchen has granite millstone,114,36,6,156,645,603
This property is protected by an inexpensive but very effective security system.,106,30,7,143,645,669
"There's interest from other buyers, but I'm tilting towards you.",85,28,4,117,645,1447
"European elegance with the original sustainable energy. 
I advise you either get in fast or wait for the next one.",87,24,6,117,645,1499
Just stay upstairs when the course is open.,95,30,5,130,645,1692
"Just avoid poking your head out on the front of the window and you'll be fine.""",85,28,4,117,645,3377
"Way cheaper than solar, and architecturally—much more stylish.",107,28,8,143,645,3645
"Well, you did mention you loved golf.",86,26,5,117,645,3930
Not to worry!  You can control the rotation speed with our app.  And we expect to have a solution for the giant white balls any day now.,108,26,9,143,645,4061
You just have to remember to duck every 27 seconds.,107,28,8,143,645,5129
"In your price range, this is the only course side real estate you can afford",107,28,8,143,645,5219
It's the architect's vision of a mixed-use development. He's the developer's kid and he's going to be 11 in November.,99,22,9,130,645,5657
"Full discloser,this property has experienced  Quixotes.",97,26,7,130,645,7282
a house with a white picket fence around it not ON it!,105,27,8,140,645,1284
You'll get the hang of it in no time.,102,33,5,140,645,3158
"Once you get the timing right you really appreciate the green aspects.""",106,25,9,140,645,3741
"You're right, the feng shui isn't perfect but that has brought the price point in line with our budget.",103,31,6,140,645,4440
Timing is everything for the real estate market in this neighborhood.,104,29,7,140,645,5101
You have to putt the ball into the black hole from the living room to get the wind mill to stop.,93,29,5,127,645,558
Homes on golf courses always sell at a premium.,99,17,11,127,645,1490
You'll never go back to central AC again.,95,25,7,127,645,3863
It's the latest in golf course community living,94,27,6,127,645,4467
This one's within your budget and it overlooks a golf course.,92,31,4,127,645,5877
I think you'll like the home security system on this one.,94,27,6,127,645,6682
And it’s right on the golf course,87,19,8,114,645,110
"The President claims to hate windmills, but he golfs here regularly.",82,29,3,114,645,1179
"For a Par 4 property, the asking price is very reasonable.",86,21,7,114,645,3633
Our home security features harken back to a simpler time.,120,36,7,163,645,4969
The architect was inspired by Russian roulette.,113,28,9,150,645,194
You won't find everything you're looking for with your current budget.,103,26,8,137,645,260
The mortgage interest rate is only 2 points above par.,101,30,6,137,645,377
"After a while, you never notice the foot traffic.",103,26,8,137,645,679
"It is literally the only listing for ""tiny house on a golf course""",102,28,7,137,645,1477
"The market in this neighborhood is a little different.  It's timing, timing, timing.",106,20,11,137,645,1650
And it comes with solar too!,103,26,8,137,645,2257
The size of the hole is relative. You should see the golf ball.,102,28,7,137,645,4977
Why yes as a matter of fact this house does run on wind power.,101,30,6,137,645,5107
Great location listed as a par four,102,28,7,137,645,5824
And that includes the club fee.,102,28,7,137,645,6486
And this is the exact spot where the previous owners were decapitated.,93,24,7,124,645,531
Mind you the utilities are  next to nothing and it is certified Green.,92,26,6,124,645,894
This one is perfect for people who live their lives on a schedule.,92,26,6,124,645,1241
"It's only one bedroom and one bath, but it's only $5.00 for a bucket of balls.

David Ardao, New York, New York",93,24,7,124,645,4233
"With this model, I required to ask; how good are you at Dodgeball?",92,26,6,124,645,4684
"Multi-level single family home with great views, fresh air, and local church. Wouldn’t you say this is a hole-in-one?",92,26,6,124,645,5574
"Yes, you are correct, timing with this real estate is big consideration...",90,30,4,124,645,6634
This place has a beautiful view of a lighthouse and a dragon's lair.,81,26,4,111,645,2627
"Of course, the clothes dryer is included.",81,26,4,111,645,5945
"Yes, but I guarantee that you will have almost no solicitations.",107,35,5,147,645,6020
....and the upkeep will be a breeze,105,39,3,147,645,6515
"So, can we put-put pen to paper?",101,25,8,134,645,158
You see balls rolling through your living room. I see your own personal aerobics workout.,101,25,8,134,645,688
Solar panels are so yesterday.,98,31,5,134,645,5058
"I know what you're thinking. Yes,there's a sex dungeon.",99,29,6,134,645,6180
"By any chance, were you good at jump rope?",101,25,8,134,645,6717
You wanted a house on the 18th green - you got it!,99,29,6,134,645,6790
You won't ever have to mow the lawn.,98,31,5,134,645,7452
"It can get windy sometimes but, on the other hand, grinding flour can be a breeze.",89,27,5,121,645,29
This will save big-time on your electric bills!,87,31,3,121,645,254
Would you like to see the ballroom?,93,19,9,121,645,2279
You said that you wanted something in your ball park.,89,27,5,121,645,2993
I told you we only had one home available with electricity from wind power.,90,25,6,121,645,3222
"Trust me, it doesn't get greener than this",116,34,7,157,645,2040
Our windmill is just one of 18 models inspired by the designers love of miniature golf.,108,28,8,144,645,714
Just think of it as a turnstile,104,36,4,144,645,1449
This model comes with a 'whole-house' fan!,82,19,7,108,645,1479
"We need a quick offer...everybody's shooting for this deal, and timing is everything.",80,23,5,108,645,3705
"We like the idea of no utility bills, but are concerned about the recurring green fees.",107,30,7,144,645,7539
"Yes, this is suitable for tilting at.",98,26,7,131,645,1587
"With the current roll back, windmills will be trendy anytime now",98,26,7,131,645,1680
"Aside from your concerns about gigantic white balls rolling through from time-to-time, how do you like the house?",97,28,6,131,645,3382
"Of course, a discerning buyer such as yourself might consider upgrading to one of our clown head units.",98,26,7,131,645,3948
And the beauty part: all that juice without those ugly solar panels.,98,26,7,131,645,4217
Well it is a bit breezy but but you won't need an air conditioner.,96,30,5,131,645,4568
"Savings on your electric bill?"" Hell, this thing lights up half the town.",97,28,6,131,645,4570
Forget solar power!  This is the future!,100,22,9,131,645,4674
Wind power is the new solar.  You just have to be more careful leaving your house on a windy day.,97,28,6,131,645,5878
Tell me you haven't always dreamed of a picket-powered eco-house.,97,28,6,131,645,6364
"Yes, the ball would be rather large",97,28,6,131,645,6383
Why don’t you each come up with money to buy this home. You can go Dutch.,98,26,7,131,645,6437
It boasts a periodically open-concept design.,96,30,5,131,645,7065
I can also show you a lovely two bedroom condo in Clown Nose Court.,116,29,9,154,645,2821
"For another 50 grand, we’ll get you on the clown hole.",111,39,4,154,645,4965
You’ll love the open floor plan,88,24,6,118,645,1668
"Not only is it energy efficient, but the location is right on the 14th hole.",84,30,4,118,645,2025
I know what you are saying... but I think you should strongly consider hazard insurance.,87,26,5,118,645,2154
"Thing is, the neighbour is a bit of a clown.",87,26,5,118,645,3565
Just be careful going in and out.,88,24,6,118,645,3895
A bargain for the punctual family,91,18,9,118,645,5847
This is par for the course if you want to stay within your current driving range.,88,24,6,118,645,7258
"Not only does it have a great view, it's extremely fuel efficient.",104,31,6,141,645,539
It’s really a quiet neighborhood until tourist season,105,29,7,141,645,1938
"Okay, next I’ll show you a property in the village of a model train set.",107,25,9,141,645,2350
"When you run out between the blades, jump down the rabbit 
hole, it will take you directly to the front door",107,25,9,141,645,2862
Now this one is par for the course.,104,31,6,141,645,3852
It's what we call 'a Winder Upper'.,77,24,4,105,645,5286
Course membership is included with your HOA,76,26,3,105,645,5635
Well it does come with an option for club membership.,97,23,8,128,645,3819
Absolutely! Off the grid!,94,29,5,128,645,5317
"For a limited time, you can have this as a par 3.",99,19,10,128,645,5939
"It's just for show, unless the wind is really strong. It doesn't do anything then, either.",95,27,6,128,645,6288
"We'll be standing in front during the actual ceremony, so remember to say 'I do' before the next vane comes around.",115,26,10,151,645,2269
"On the other hand, it makes solicitors exit quickly.""",113,30,8,151,645,3466
"If this doesn't fit your needs, we are also offering a medieval castle with a lifting drawbridge.""",86,23,6,115,645,828
Solar panels? Er.....no.,104,26,8,138,645,1092
"It's got three bedrooms, two and a half baths, free electricity, and it's a par 3.",107,20,11,138,645,2004
There used to be a lot of Jehovah's Witnesses in the neighbourhood.,86,23,6,115,645,2517
Electricity is included in the rent.,100,34,4,138,645,3368
Comes with a lifetime supply of milled grain.,85,25,5,115,645,5028
And they pay YOU for the golfball easement.,101,32,5,138,645,5353
The property taxes are miniscule.,99,36,3,138,645,6101
depending on the wind you have up to a three second window.,104,26,8,138,645,6463
It's a great deal! Wind powered and right on the golf course.,102,30,6,138,645,6821
"Is hole number 14 the ""Giant Gorilla"" still on the market?",113,25,10,148,645,90
All homes include free outdoor carpeting.,113,25,10,148,645,382
Think of the money you'll save grinding your own coffee beans.,112,27,9,148,645,6920
It does require some dexterity,93,26,6,125,645,1934
...And you could also rent it out on AirBnB!,94,24,7,125,645,2183
Now this next place is really gonna sweep you off your feet.,94,24,7,125,645,2645
The previous owners made a killing on airBNB.,97,18,10,125,645,5423
It's a front door and a hall in one.,93,26,6,125,645,5800
"Just look at it this way, when the ball comes rolling in your front door you can pretend to be Indiana Jones.",93,26,6,125,645,6329
The security system is almost foolproof!,93,26,6,125,645,7456
The house comes with two putters and miniature golf instructions.,101,27,7,135,645,484
"And as a bonus, you'll be saving big-time on air conditioning.",101,27,7,135,645,917
"On the upside, you wouldn’t need ceiling fans.",97,35,3,135,645,1031
Ideal for the couple that likes to putter around the house.,101,27,7,135,645,1411
"You can hook it up to generate your own power, and none of those ugly solar panels on the roof!",99,31,5,135,645,2785
This is our sustainable model.,101,27,7,135,645,3474
Once you get the timing down it’s really easy to go in or out.,100,29,6,135,645,4099
"3 bedrooms, 2 bathrooms, plus it’s the only Dutch colonial on the property with a view of the first hole.",102,25,8,135,645,4592
It's a green neighborhood.,100,29,6,135,645,5723
You don’t need to be crazy about golf to live here but it helps!,100,29,6,135,645,5738
"Not only are the energy costs low, but no Jehovah's Witnesses on Sunday mornings",101,27,7,135,645,6098
"If you don't like this one, we also have a waterfront  property on hole 16.",103,23,9,135,645,6610
The neighbours? There's a giant disembodied clown head next door and across the street there's a 20ft witch that lives in the gingerbread house....but they mostly keep themselves to themselves.,103,23,9,135,645,6829
"Don’t think wind MILL ...
think wind SLATS!",102,25,8,135,645,7368
But you wanted something with a picket fence.,84,22,6,112,645,1481
Solar!  Artificial turf!  Cul-de-sac!  That cute little church next door!  What more could you want?,83,24,5,112,645,4154
Your kids will love this place!,109,28,8,145,645,2539
And you can have freshly milled oats every morning.,107,32,6,145,645,3778
"It's affordable, and you can work on your short game.",107,32,6,145,645,5005
This is the perfect house for couples who can't stand their in-laws.,92,23,7,122,645,1162
"Of course, golf club membership is included.",91,25,6,122,645,1968
"If you keep the reasonable rent in mind, the occasional golfer passing thru shouldn’t be a dealbreaker.",87,33,2,122,645,2624
"The other one in your price range is that scary, clown face with tongue thing, over on the 18th hole.",92,23,7,122,645,3307
THE LADY WHO ONCE LIVED HERE MOVED INTO A SHOE,92,23,7,122,645,4101
"Only 18 homes in the community, each with a unique hole.",91,25,6,122,645,4991
"Have you seen the film, ""Blade Runner""",92,23,7,122,645,5142
You said you wanted a green home...,89,29,4,122,645,5969
It comes with sub-par schools but a world-class trauma center.,89,29,4,122,645,6384
...and that's when it hit me--Mega Golf!,91,25,6,122,645,6725
Mr and Mrs Mulligan? I'm here to take one of you.,117,29,9,155,645,4857
Does anyone want to talk about the elephant in the room?,98,28,6,132,645,756
"It's good for the environment, it's near the church, and you get a dollar off the rent for every hole in one.",99,26,7,132,645,781
Watch those annoying salespeople just disappear!,102,20,10,132,645,897
Life is fraught with near-misses.,99,26,7,132,645,933
It's listed as a classic farmhouse cottage with two bedrooms and an option of three or four par.,98,28,6,132,645,960
You can pick your ball color after closing.,98,28,6,132,645,1734
It's got your white picket fans.,98,28,6,132,645,2150
"Don't worry, there's a par five I'd like to show you that might be a bit more in your price range!",97,30,5,132,645,2477
You can control it from your phone.,100,24,8,132,645,3214
"A beautiful house on the fairway, what could be wrong with that?",100,24,8,132,645,3530
We take mini golfing to the next level.,73,22,4,99,645,3663
"I know, I know; it's not ideal, but most of these 'tiny houses' only have the single half-bath. You just can't fit a whole in one.",99,26,7,132,645,4883
I thought my husband's golf obsession would get him OUT of the house.,100,24,8,132,645,5935
...plus utilities are free.,98,28,6,132,645,6376
"There's a lot of rumbling and, occasionally, a big ball rolls through it.",96,32,4,132,645,6405
"The price has dropped significantly. The windmill should have been on the other side.""",98,28,6,132,645,6568
And the electric bills will be almost nothing!,98,28,6,132,645,7115
You folks will only have six seconds to get inside that doorway.,100,24,8,132,645,7153
"Now this, this is downsizing!",102,37,3,142,645,63
But you said “golf-course-close.” Should we give the ocean-view property a try?,104,33,5,142,645,1246
Really it's a wonderful home. I will say that getting in and out is a little dicey. But as they say timing is everything,108,25,9,142,645,3484
"Barb, I know you’ve always been nostalgic for Danish windmills. And Dave, I know how much you love ‘Indiana Jones and the Last Crusade.’ So when I saw this listing, I knew I had to drop what I was doing and call you right away.",106,29,7,142,645,3808
The next place to see is just off the Holland Tunnel,108,25,9,142,645,5732
"Putter around if you like, but do watch your step.",105,31,6,142,645,7130
"Putt in an offer, see what happens.",83,19,7,109,645,2382
Your timing is perfect,81,23,5,109,645,3332
"As an added bonus, the electricity bill is very low.",89,24,6,119,645,769
Two words. Fore play.,92,18,9,119,645,1267
"Livingroom, dining room, kitchen, two bedrooms, and one bath...it's what we call a classic par six",89,24,6,119,645,6704
They'll throw in the fridge but won't budge on the fan.,97,25,7,129,645,3934
Perfect for minigolf and tiny home enthusiasts like yourselves.,99,21,9,129,645,4543
"Hey, you'll really save on your electric bill...",95,29,5,129,645,5057
On most days they're purely decorative.,96,27,6,129,645,5284
You have to be really fast or really slow.,100,19,10,129,645,7448
"I'm sure you'll both love it, but I would recommend keeping any breakables out of the central hallway""",110,33,6,149,645,3898
"Look, to find real estate like this is a hole-in-one",79,22,5,106,645,7101
"Don't worry, it still allows animals to follow their natural migration patterns.",87,23,6,116,645,1218
"It's fore-closed, but in this area that's par for the course.",88,21,7,116,645,1523
"Did I mention this deters porch pirates as well?""",88,21,7,116,645,1602
The neighborhood is very diverse.,87,23,6,116,645,7083
Putting down a miniature mortgage won't put you in the hole.,91,15,10,116,645,7388
The owner sort of fell into a black hole which is why it's going for peanuts.,86,25,5,116,645,7414
"Don't worry, no one ever actually hits the ball through the hole.",95,24,7,126,645,229
This unit is a bit more expensive but it's right on the course,94,26,6,126,645,536
"It's not easy getting in but once you're there, you're pretty safe.",92,30,4,126,645,1623
"They're asking Par 3, but I think I can get them to budge.",94,26,6,126,645,2625
"I assure you, this is the most advanced home security system on the market.",93,28,5,126,645,6040
You have to time your entry just right.,94,26,6,126,645,6099
It has 100% renewable energy.,93,28,5,126,645,7133
"Net zero, but be careful exiting and entering.",100,31,5,136,645,3122
It is vintage sustainable!,102,27,7,136,645,3407
Think of it - your own  wind turbine!  You'll be the envy of your friends.,101,29,6,136,645,4223
You need balls to live in a house like this.,104,23,9,136,645,6334
We don't have enough balls to buy this place.,104,23,9,136,645,7051
It's off the grid.,104,23,9,136,645,7303
"One last disclosure. . . 
There’s an interesting easement attached to this property.",103,25,8,136,645,7515
"If timing your exit is not to your liking, we're showing one with a moat and a slanted bridge",107,34,5,146,645,5
"Tell you one thing, it takes huge balls to play this game.""",113,22,11,146,645,49
Kids love it!,108,32,6,146,645,1316
"half solar, half wind, very European...",114,20,12,146,645,5252
"On the bright side, it’s energy efficient.",109,30,7,146,645,7056
HOA fees are free if you get a hole-in-one.,76,23,4,103,645,2149
I have it on inside information that this maxi golf property is being eyed for a Presidential Library.,86,20,7,113,645,995
Just be careful going in and out when it’s in green energy mode.,84,24,5,113,645,3493
"Yes, you're right. People without imagination will only see a really big miniature golf course, but for you it will always be 'my little old home on the range.'",84,24,5,113,645,5038
you're going to want to spend most of your time on the 2nd floor,85,22,6,113,645,5422
The last owners died mysteriously.,83,26,4,113,645,7485
Miniature golf...well that all depends on your perspective.,89,31,3,123,645,1200
It's an up and coming neighborhood. They just put in a Whole Foods and a giant whale.,94,21,8,123,645,3060
It's close to shopping and restaurants and when you walk out your front door you're practically on the golf course.,92,25,6,123,645,4243
Now Hole #17 has what we call ‘an open door concept’...,93,23,7,123,645,5960
Fore sale!!!,93,23,7,123,645,6148
"This model comes with the very desirable four-stroke limit, and any golf ball damage is covered by your Homeowners Association!",93,23,7,123,645,7267
"Other than the occasional giant golf ball, it's a safe neighborhood.",101,24,8,133,645,1610
Best not to hesitate,100,26,7,133,645,1836
I would suggest you use the window.,100,26,7,133,645,2445
The whole-house fan really cools things down in the hot summer weather.,98,30,5,133,645,3642
But did you see that gorgeous kitchen island?,101,24,8,133,645,7194
"Our Homeowners Insurance Policy covers damage caused by fire, windstorms, and golf balls.",99,28,6,133,645,7313
I told you this one was “hard to show”,96,34,3,133,645,7359
I can offer whatever energy source you’d like as long as there is wind.,106,31,6,143,645,6060
"Don’t listen to Mr. Quixote, this is the perfect home for you.",109,25,9,143,645,6411
"I suppose it's time to bring up the elephant in the room.""",117,26,10,153,645,142
You won't believe the utility bills!,112,36,5,153,645,5711
"As your real estate agent, I'm obliged to help you find a home, but as a friend, I must say; this is one of the dumbest purchases I've ever seen.",104,30,6,140,645,322
It's a very hot property -- recently renovated and the only par 5 in the neighborhood.,90,24,6,120,645,760
It has a commanding view of the golf course AND you can practice putting from your living room.,107,24,9,140,645,1505
What's it going to take to get you folks to tilt?,99,23,8,130,645,1553
"Every now and then you’ll get a disturbance but otherwise, I think this deal is a hole-in-one.",80,27,3,110,645,2001
"And this listing has that fun, we live on a putt putt golf course kinda feel.  Very desirable right now.",89,26,5,120,645,2119
The seller has agreed to throw in the washer and dryer and a pair of those silly wooden shoes.,112,31,7,150,645,2507
Who doesn't like a white picket fence?,102,34,4,140,645,3064
"This is one of the most prestigious housing estates in town, folks - only 18 properties.",89,26,5,120,645,3581
"After a week, you won't even notice the putting.",88,28,4,120,645,3859
"You may get bonked occasionally, but wait 'til you see the electric bill.",117,38,5,160,645,4456
"Mr. and Mrs. Miller, I think this house was made for you.",87,30,3,120,645,4762
"..and of course, membership is inclusive..",105,28,7,140,645,4987
Overall this property is sub-par.,99,23,8,130,645,5139
Think of it as your own little Mar-a-Lago.,106,26,8,140,645,5341
It’s the latest in security systems. It keeps burglars and large rodents away.,112,31,7,150,645,5495
It only gets busy on the weekends,95,31,4,130,645,6215
"Well, what do you think?  I know that you also liked the shoe the little old lady lived in.",89,26,5,120,645,6562
So you're interested in putting in solar.,90,24,6,120,645,6828
"Runs on renewable energy and in a kid-friendly neighborhood, too.",96,29,5,130,645,7189
I'm sure you'll be a big fan of the house.,112,26,9,147,645,6387
Now the security system is a little different but it will keep you nimble through-out your years here.,106,21,10,137,645,3338
"It's quaint, and it will keep your mother-in-law occupied.",105,23,9,137,645,3506
"Sure it's a fairly dangerous, but it's entirely carbon neutral.",104,25,8,137,645,4309
This is not just a run-of-the-mill windmill.,102,29,6,137,645,4652
You' ll just have to tip the pizza guy extra.,104,25,8,137,645,4708
"....and best of all, it's on the 18th hole.",104,25,8,137,645,5853
Let's just call the center hallway a shared living space...,102,29,6,137,645,6344
"'And when it comes to renewable energy, I'm a BIG FAN'",93,30,4,127,645,1436
It might be considered a rotating picket fence.,96,24,7,127,645,1813
"In this property market, timing is everything.",97,22,8,127,645,3566
You said you wanted a view of the 18th hole.  This is the best you can get on mini-budget.,93,30,4,127,645,3639
It's a fixer-putter.,97,22,8,127,645,4941
"If you buy this house, you will be helping to fight climate change.",95,26,6,127,645,5614
"Unique features include low energy costs
and really healthy flour",96,24,7,127,645,6305
It has more square footage than living in the Clown Face.,93,30,4,127,645,7159
"Solar is great too, but why not throw caution to the wind?",89,21,7,117,645,1769
Our artist didn't realize that it would hit the ground.,87,25,5,117,645,1858
"Don't worry, it's not that windy around here.",86,27,4,117,645,3918
"That's right, you can't go out at six o'clock or half past any hour.",79,24,4,107,645,889
And it’s hooked up to a coffee grinder.,83,16,8,107,645,2015
"I think you will love it here,the ball doesn't come in more than once,maybe twice a day",116,30,8,154,645,13
"Its airy, its bright and you have a major golf course on your front yard",110,25,9,144,645,801
"It's a wonderful home for a young couple. You DO need to time your exits and entrances, though.",106,33,5,144,645,996
"Oh, the balls are dangerous for sure, but what you really have to watch out for is the crazy guy in the Spanish helmet.",109,27,8,144,645,4037
We call it 'Dutch Doors',110,25,9,144,645,4791
"You can’t cover the hole, but it’s the only house in Lilli-Putt-Putt with renewable energy.",106,33,5,144,645,7385
And who doesn't love Tulips!,99,30,5,134,645,141
It's a small community and very kid-friendly.,99,30,5,134,645,330
Sorry  but the 18th hole was sold on Sunday.,99,30,5,134,645,5486
"Oh, well. Perhaps you'll prefer the back nine.",98,32,4,134,645,6540
I comes with two sets of wooden shoes and non-stop tulips.,102,24,8,134,645,7055
The interest is sub par.,102,24,8,134,645,7221
And it is entirely powered by renewable energy.,92,27,5,124,645,2220
The owners are moving down the road to some waterfront property.,92,27,5,124,645,2329
"Don’t forget, doors close quickly!",96,19,9,124,645,2948
Yes there is air conditioning but only on certain days.,92,27,5,124,645,4646
When no giants showed up he had to put the whole course on the market.,94,23,7,124,645,4811
Lots of folks love living in a golf course community.,92,27,5,124,645,5144
"Location, location, location -- am I right?",94,23,7,124,645,5157
We see the occasional giant golf ball through your front door as part of the charm.,93,25,6,124,645,6345
This is our finest par 3 home.,86,22,6,114,645,3649
"A home on a golf course, self-powered​, permanent green lawn, what more could you want?",84,26,4,114,645,5451
This hole will go fast.,79,19,6,104,645,2365
This house is totally green!,111,35,5,151,645,5277
Think of it as a wind fall.,114,29,8,151,645,6287
"Well, we got all the paperwork signed and filed- as soon as you make the hole, the place is yours.",114,29,8,151,645,6366
"Fall in love with it? 
It will sweep you off your feet",105,30,6,141,645,253
"Yeah, I guess we should talk about the elephant in the driveway.",108,24,9,141,645,5527
"On the plus side, the ventilation is superb.",72,16,6,94,645,6926
And it’s perfect for entertaining.,96,31,4,131,645,722
It meets your budget AND only a fraction of the balls actually make it through to your living room !,97,29,5,131,645,758
"Like many new couples, you may find the more difficult part is getting out.",97,29,5,131,645,1345
"Going in isn't too hard, but you'd better be careful on your way out",101,21,9,131,645,1879
The blades are equipped with solar panels just in case!,98,27,6,131,645,2009
The cost is par for others in the same neighborhood.,98,27,6,131,645,2296
And no need for those ugly solar panels.,99,25,7,131,645,3067
I'm sure you'll like it and it's significantly less expensive than the Pyramid or the Bozo face house.,99,25,7,131,645,3979
"On the minus side: giants. On the plus side: fairway views, free electric.",101,21,9,131,645,4365
The good news is that the HOA dues includes turf maintenance.,95,33,3,131,645,5001
You're a winner every time you get in the door.,104,15,12,131,645,5954
And you’ll be totally off the grid,97,29,5,131,645,6018
"At 600,000 sacks of whole wheat flour, it’s a steal.",98,27,6,131,645,6210
Given you're both crazy golf fanatics the location is perfect,96,31,4,131,645,7091
"3 bed, 2 baths, and it runs completely on renewable energy",91,24,6,121,645,1549
"Plus, you get 20% of the weekend take!",87,32,2,121,645,3947
"Hazard's are par for the course in this neighborhood.""",92,22,7,121,645,4269
After the unfortunate pizza-delivery-boy-incident I’m sure you can now get it at a very attractive price”,93,20,8,121,645,6491
And there's a stunning volcano over by seven next to the giant frog.,91,24,6,121,645,7057
"Even gated golf communities present some hazards, of course.",89,28,4,121,645,7511
This house has a security system. It works best if you wait a minute before answering the door.,118,33,7,158,645,829
"You know, when it's windy you'll want to stay indoors.",82,25,4,111,645,4252
And this property is a nice 3 par 2 1/2 bath,81,27,3,111,645,4836
Its affordable..if you go dutch!,88,13,10,111,645,5909
"Don't let the door hit you on the way out!""",105,25,8,138,645,335
Downsizing?,103,29,6,138,645,666
"Plus, at a dollar a pop you could pay the mortgage off in no time.",103,29,6,138,645,3393
And of course you would have a private view of the 18th hole.,107,21,10,138,645,4777
"I agree, it IS a unique development! Unfortunately, the other seventeen homes are sold, but let's see about getting you into this one. Ready?",103,29,6,138,645,5385
It's like living on the 18th hole at a fraction of the price!,103,29,6,138,645,6851
If I were you I wouldn't keep anything of value in the living room.,99,20,9,128,645,1480
I promise you won't need a driver.,94,30,4,128,645,2102
I know it’s garish but solar panels are SO last year.,99,20,9,128,645,5176
"Unfortunately there is the occasional
golf ball issue...",98,22,8,128,645,5314
"The windmill speed is actually overseen by the homeowners' association, but I believe you'll find all the other amenities to be well above par.",93,32,3,128,645,5676
Look at it this way -- nobody from that church will come calling.,97,24,7,128,645,6898
Do you guys swing?,98,22,8,128,645,6918
"In the real estate biz, we call this “going Dutch.”",95,28,5,128,645,7272
It does wonders for your utility bills and vastly improves your short game.,115,34,6,155,645,2848
In a market like this timing is everything.,89,23,6,118,645,588
It's great if you like to putt around.,88,25,5,118,645,655
Just imagine the putz this was built for!,90,21,7,118,645,866
"He is very skinny, has a lance, but he is completely harmless.",88,25,5,118,645,1931
It comes with free electricity.,86,29,3,118,645,4472
If you want to fill in the hole you will need permission from the city. This is a historic home.,92,17,9,118,645,6603
They say Don Quixote used  to tilt here.,111,25,9,145,645,1053
"It's a great neighborhood, very colorful. Trust me, you'll have a ball...frequently.",108,31,6,145,645,2763
And it's a no-driving community,105,37,3,145,645,5251
The price is right. But how do we enter when the wind is blowing?,100,30,5,135,645,876
As you can see it's an exclusive gated community.,101,28,6,135,645,4375
We just putted it on the market.,102,26,7,135,645,5546
It’s a real challenge to get into this place.,93,27,5,125,645,988
Golf is a big game around here.,97,19,9,125,645,2946
"This isn't what I meant by ""central AC"", Todd.",97,19,9,125,645,3666
There are no condo fees and the lawn is maintenance free.,91,31,3,125,645,6381
The asking price is pretty par for the course,87,22,6,115,645,2617
The seller is highly motivated and will throw in a year of green fees.,84,28,3,115,645,7444
"Then again, entry and exit can be reframed  as an exciting daily challenge.",101,23,8,132,645,1338
"Honey, this isn't the 9th hole home I was expecting!",100,25,7,132,645,1513
There is also a lighthouse available nearby.,101,23,8,132,645,1738
"*.The house has a large fan to keep you cool...""",98,29,5,132,645,2990
"Hole location, location, location.",99,27,6,132,645,3216
"You time it right, this baby can be all yours.",100,25,7,132,645,3569
You said you wanted to be ‘on the golf course’.  You didn’t specify ‘miniature’.,101,23,8,132,645,4370
"And when the wind blows, it runs your electric meter in reverse.",99,27,6,132,645,4412
"Miniature? No, no- quite the opposite!",98,29,5,132,645,4471
I think that offer will be below par.,99,27,6,132,645,5398
It meets all state renewable energy requirements.,98,29,5,132,645,5631
"I think you'll be a big fan of this next home, it's on a golf course!",101,23,8,132,645,6586
It’s a Dutch Colonial retrofit to save on energy costs.,65,20,3,88,645,6756
Don Quixote?,99,27,6,132,645,6953
"Once you know the hole's there, it's not that hard to avoid.",111,32,6,149,645,1272
...and it has central air-conditioning!,113,28,8,149,645,1494
Golf course views!,78,23,4,105,645,7424
"No, no, no, no ... This isn't a mini putt, not at all. It's a mini-golf course community!",127,29,10,166,645,2796
"Look at this way, it comes with two years of free miniature golf lessons.",89,30,3,122,645,5328
"The nice thing is, you won't have to mow the lawn.",92,24,6,122,645,7415
I’d welcome you indoors but I’m afraid we’re safer out here,103,31,5,139,645,311
"Sorry, it's this or that Clown's Mouth on No. 18.",104,29,6,139,645,729
What about our downsizing promotion didn’t you understand?,105,27,7,139,645,737
"No, no, no, I'm telling you Mr. and Mrs, Musk, Wind power is the future.",105,27,7,139,645,3413
I’m from the HOA. You’re going to have to fill in that hole in your front yard.,107,23,9,139,645,3421
"On the count of three, two, .....",82,27,3,112,645,3867
"With this charming cottage, you’re downsizing AND generating your own electricity!",95,30,4,129,645,793
"I know, you’re wondering, ‘is it equipped for solar’?",100,20,9,129,645,1153
So you've made a decision...you wish to go Dutch?,101,18,10,129,645,3324
"The best part is, the property taxes cover your green fees!",97,26,6,129,645,3749
"sure, there's an obstacle; but that's why you'll never want to leave once you're home!",100,20,9,129,645,4985
Trump just tweeted about tax breaks on golf properties.,96,28,5,129,645,6695
"Three bedrooms, two baths, most people can't break in on the first try.",109,31,6,146,645,1453
"Since downsizing, your housing options have increased tremendously.",114,21,11,146,645,2656
We could add solar later.,111,27,8,146,645,5518
There's a bidding war on this one so we'll need to move quickly if you think it's up to par,111,27,8,146,645,6338
"You're lucky, this is the last house listed on a golf course.",104,24,8,136,645,38
Just remember you have to take an immediate left or right when you come out the front door.,103,26,7,136,645,1527
"They're asking five-fifty, but I'm pretty sure we can get them down to FORE!",103,26,7,136,645,1683
It comes with wooden shoes and tulips but the turbine is extra.,91,21,7,119,645,1912
This home on hole #5 not only has three bedrooms but it's completely off the grid.,101,30,5,136,645,2476
And it comes with central air!,89,25,5,119,645,3791
"Yes, but on calm days it's easy to enter and exit.",89,25,5,119,645,3885
Yes! You would be the proud owner of the toughest hole in the neighborhood.,89,25,5,119,645,4284
Too close to the golf course?,104,24,8,136,645,5351
"You do know what ""Fore"" means?",100,32,4,136,645,6167
"The landlord's kind of a clown, but the neighborhood is really up and coming.",115,31,7,153,645,7085
"...it’s a calm neighbourhood, except for the occasional golf ball storming through your front door...",101,30,5,136,645,7505
"Wow, you can hardly hear the freeway.",110,24,9,143,645,193
This neighborhood is great for swingers,109,26,8,143,645,1152
"On the positive side, it's the only place in town that is totally off the grid.",107,30,6,143,645,1721
Just wait until you see the ball room inside.,106,32,5,143,645,3254
"Of course our units are accessible, every member scores some handicap.",111,22,10,143,645,3271
The white boulders with the dimples can be a problem sometimes.,105,34,4,143,645,5993
Sure beats that home on the range.,98,19,9,126,645,628
Don't let the fan hit you on the way in.,96,23,7,126,645,2151
Wait…THE SPHINX just came on the market!!,98,19,9,126,645,2495
It's got that small town charm and even has a well!,93,29,4,126,645,4329
Points taken...but on the other hand you’ll only be paying a miniature mortgage.,82,22,5,109,645,7102
“I’m not sure it’s quite up to par”,81,24,4,109,645,7474
"If you're interested in gardening, tulips are par for the course.",116,24,10,150,645,1577
And you won’t need those ugly solar panels.,102,23,8,133,645,358
Before we go in there...I am advising you not to ask whether there are hardwood shoes throughout or whether we can go dutch on the closing costs...,103,21,9,133,645,703
Bonus feature -- you really CAN leave the door open and air condition the whole neighborhood!,99,29,5,133,645,951
We wanted to reimagine the home with the white picket fence.,101,25,7,133,645,3498
"As you can see, unit 12 has a Dutch-inspired architecture.",100,27,6,133,645,4614
"Well, yes, its in probate. The previous owner had an fatal accident, as he was stepping out one night.",100,27,6,133,645,6112
Don't worry — the arms usually keep the balls out of the living room.,98,31,4,133,645,6874
NO Carbon footprint!,91,16,9,116,645,2136
It'll be your home away from home.  Your own...Lilli-putt.,88,22,6,116,645,2192
This little baby comes with a wooden lattice framework that can generate enough kilowatts to fire up that toaster in the morning.,90,18,8,116,645,5817
"The furniture doesn't come with it, but the fan does.",89,20,7,116,645,6083
"Windy days, it’s best to stay home.",89,20,7,116,645,6976
"On the bright side, your electricity bill should be very low.",87,24,5,116,645,7198
Timing is everything and you can play all the golf you want!,72,25,2,99,645,2127
I don't like that there's an alligator next door.,75,19,5,99,645,5722
Did I mention the fee for the hole owners association?,106,27,7,140,645,5021
An easement? What makes you ask that?,95,20,8,123,645,12
And you're the envy of the town during the miniature PGA tour event!,96,18,9,123,645,354
"Trust me, living here is a ball!",92,26,5,123,645,726
"Mid-century Dutch is all the rage.""",92,26,5,123,645,1036
"Not only is it right on the golf course, it's conveniently located near a church, the zoo, and it has its own renewable power source!",91,28,4,123,645,1534
I know it’s a little out of your budget but that’s just par for the course.,92,26,5,123,645,4520
"As you can see, the prior owners put in central air....",93,24,6,123,645,5308
"The occasional appearance of small bright balls is considered a 
'pop of color' for the front yard.",97,28,5,130,645,80
Now we've also got a pirate ship that may be inside your budget.,99,24,7,130,645,188
"Yes, I'm sorry, it was all in the fine print.",98,26,6,130,645,686
You both seem nimble enough to get in and out.,98,26,6,130,645,847
"On the plus side, any time one of your kids falls in the hole, you get a free pizza.",100,22,8,130,645,1223
Don't worry. There's very rarely a hole in one.,100,22,8,130,645,1329
"An inconvenience? Maybe, but just wait until you get the first light bill.",96,30,4,130,645,2633
Now I understand the windmill but what's with the hole in the yard.,97,28,5,130,645,7242
There is a little problem with the front door.,116,31,7,154,645,3545
"Painting the fence IS tricky, but you never have to mow!",115,33,6,154,645,5461
"My point is, you need life insurance.",85,23,5,113,645,3217
The condo fees are offset by your 1/18th share of the green fees.,85,23,5,113,645,5185
"Ok, we’ll drop the price $5000 and move the hole to the backyard, where it belongs.",86,21,6,113,645,7005
It has wind power potential!,102,30,5,137,645,1891
Just look out for Mr Quixote. He has a thing about windmills.,104,26,7,137,645,2019
But the club fees are much more affordable!,101,32,4,137,645,2939
Buy this one and you'll never lack for flour..,103,28,6,137,645,3005
Golfcourse property is very valuable.,104,26,7,137,645,4068
"Don't worry, Mr. Quixote has been served.",105,24,8,137,645,6984
"Not so much ""Moulin Rouge"" as ""Raiders of the Lost Ark.""",107,32,5,144,645,351
"Tiny house, big balls.... downsize  
without destroying your ego.",129,29,10,168,645,1381
It’s great if you like puttering around the house.,91,23,6,120,645,1514
The recent upgrades to this home will absolutely blow you away.,92,21,7,120,645,3959
And this little gem used to be Stuart Little's summer home.,89,27,4,120,645,4073
"Wheelchair accessible?  The door is 36"" wide and your timing has to be just right!",91,23,6,120,645,5269
"And you'll be producing your own electricity,and be able to grind your own flour if you like.",106,34,4,144,645,5407
Love it or List it!,92,21,7,120,645,5973
We said we wanted to feel big in a small city but I'm not so sure this counts,108,30,6,144,645,6026
... And you’re not going to find a better golf course community.,109,28,7,144,645,6095
It's off-grid and on-fairway.,91,23,6,120,645,6307
"I can also show you the T-Rex. It's a little outdated, but the waterfall views are out of this world.",111,24,9,144,645,7029
We need to move quickly - the ball is about to be in your court again.,113,32,6,151,645,1370
"Now I know what you're thinking, but that pothole in the driveway will be fixed by the time you move in.",94,29,4,127,645,3714
It’s a kid-friendly neighborhood.,95,27,5,127,645,4090
The putters are required to yell 'fore' to warn residents.,98,21,8,127,645,4469
The HOA keeps the grass very short.,94,29,4,127,645,5417
"If the windmill is a problem I have another listing, kind of a ""clown's mouth"" look.",96,25,6,127,645,7020
I really think this one's going to blow you away.,104,21,9,134,645,548
"Great location, easy maintenance... and the lowest electric bills on the planet.",99,31,4,134,645,1043
You don' t need to know how to play golf. Just be careful stepping outside in a high wind.,102,25,7,134,645,2820
And there’s no lawncare!,101,27,6,134,645,3625
It keeps the elephant out of the room.,104,21,9,134,645,4244
"Well, no bathrooms actually, but excellent access to the concession stand",101,27,6,134,645,5295
"You got wind power, solar power, plenty of water, and the whooshing at night puts you to sleep like a baby.",104,21,9,134,645,7120
Any golf balls that get past the blades are yours to keep.,101,27,6,134,645,7320
"Yes I understand,But you'll save so much on your electric bill.",83,22,5,110,645,2028
"You only have a few seconds to decide, there's a long line behind us.",108,25,8,141,645,96
And the kids will love the chute to the backyard.,107,27,7,141,645,1695
This is a the Golf Course Home I promised.,106,29,6,141,645,3677
The best part is you never have to cut the grass.,106,29,6,141,645,4923
"The purchase includes off-course parking and occasionally, free electricity.",105,31,5,141,645,7443
In this neighborhood subpar is actually a good thing.,91,18,8,117,645,1019
There is also an open house for a dinosaur and another for a pirate ship. Both are classic styles and great for kids.,89,22,6,117,645,2449
"When you consider how scarce housing is for little people like us, it really does make a lot of sense.""",90,20,7,117,645,2786
AND you get free use of the crescent-moon outhouse on Hole 11!,91,18,8,117,645,4051
Your electric bill is practically zero.,88,24,5,117,645,4732
What do you take us for: a couple of putts?,91,18,8,117,645,6460
"Yes, we’re removing the TRUMP sign.",94,12,11,117,645,6556
"""The upper floor is smaller, but safer.",86,28,3,117,645,7233
People say they have a ball living in this neighborhood.,92,28,4,124,645,1116
This will put you on the grid.,96,20,8,124,645,1351
"A low price, and you can get back at the big people. Every now and then, hide their ball in the corner.",92,28,4,124,645,1476
"Once you adjust to the timing, it's easy, and it discourages annoying tourists, the Three Bears, and large inflated Disney characters!",92,28,4,124,645,1595
The HVAC has its drawbacks.,92,28,4,124,645,1651
"If you're able to stretch your budget, I think you'd be much safer in a par 1.",94,24,6,124,645,3317
"If you don't mind the elephant lurking in the background and the giant mole in the front yard, it can be quite a nice neighbourhood.....when it's not windy.",96,20,8,124,645,5316
Your timing on this deal is perfect.,93,26,5,124,645,5807
"The rent is equally  ""miniature"".",90,32,2,124,645,5997
Think of it as Central Air...,92,28,4,124,645,7316
It would give your life an excitement you have heretofore only dreamed about.,98,28,5,131,645,139
"Depending on the weather, it can be a bit tricky to get in and out.",101,22,8,131,645,708
"Lovely air circulation, amusement ride for the kiddies, and occasional security.",99,26,6,131,645,1354
The next home I want to show you will save a lot in energy bills. You just need to time your entrance and exit very carefully.,98,28,5,131,645,2925
"Best of all, I can get you the mortgage at par.",99,26,6,131,645,3799
"It's a two-putt, tops.",97,30,4,131,645,7132
Very near. The schoolhouse is just up the anthill and over the drawbridge.,100,24,7,131,645,7541
You would own the very first unit on Don Quixote Dr.,104,28,6,138,645,83
"Of course, the giant golf ball is included with the price.",102,32,4,138,645,259
"It was decapitation, but we still can't find the murder weapon",108,20,10,138,645,1286
It’s a short sale.,110,16,12,138,645,2043
It’s kinda like part-time security.,104,28,6,138,645,2239
Prime fairway location,104,28,6,138,645,5965
"For this home, we would strongly recommend the fixed rate over the variable.",102,32,4,138,645,5991
Just think of the energy tax credits!,107,22,9,138,645,7433
"Of course, on very windy days, you should stay in a motel.",82,19,6,107,645,3830
And you said sustainability powered homes weren’t affordable!,80,23,4,107,645,4552
There'll be no shortage of play dates,112,24,9,145,645,540
The listing did say 'Unsuitable for sleepwalkers',88,19,7,114,645,1111
I won't lie to you folks this house will put you pretty deep in the hole.,113,34,5,152,645,2960
There’s a lot of action on this one. We must act quickly if you want to get in this house.,86,23,5,114,645,3439
I like you two so I'll give you a hint - submit your bid when the blade is covering doorway.,87,21,6,114,645,4235
It's right on a golf course. And you should have no problem with solicitors.,87,21,6,114,645,5970
I can assure you everything is up to par.,85,25,4,114,645,7365
...no windows to clean and the lawn never needs mowing.,88,31,2,121,645,11
You guys will have a ball here.,90,27,4,121,645,1398
May I interest you in a mini-mortgage?,89,29,3,121,645,1483
"No, you're wrong. Revolving doors are all the rage now.",91,25,5,121,645,1615
Yess indeed...this is the very latest solar panel blade so your hot water bills are obsolete.,91,25,5,121,645,2407
"Yes, it is a bit old fashioned, but it has a great view of the first hole.",90,27,4,121,645,3452
And the yard is great for entertaining.,92,23,6,121,645,3875
"With all you save on energy costs, you can quickly tackle those little door, window and landscaping projects.",90,27,4,121,645,4254
Dutch is the new Mid-Century Modern!,98,23,7,128,645,538
"Properties on the course go for a premium, but with the wind power credit...",96,27,5,128,645,955
Brooklyn’s changing,95,29,4,128,645,1910
It's a good time to buy a house. And speaking of good timing....,98,23,7,128,645,2237
"Our first floor apartments are referred to as the 'ricochet units'. I think you'll find them very exciting, particularly during the summer months.",97,25,6,128,645,3945
"On the bright side, it’s a par-2 and only open during the summer. . .",96,27,5,128,645,4155
"Believe it or not, the whole thing is powered by solar.",100,19,9,128,645,4487
and  it's  much more dependable than solar.,99,21,8,128,645,5006
Generates a nice amount of power and keeps pigeons off the roof.,97,25,6,128,645,5845
Your kids will love it and you get one-eighteenth of the profits.,97,25,6,128,645,6260
This house is on par with the others we’ve seen today.,102,15,11,128,645,6272
It has a lovely open floor plan.,96,27,5,128,645,6526
"Well, beyond the occasional ball rolling through the middle of the house.....It is a quiet neighborhood .",96,27,5,128,645,7168
"If windmills don't appeal to you, we expect a White House to be available in the near future.",96,27,5,128,645,7413
At least you'll know when it's windy,104,23,8,135,645,1548
The neighbourhood is very quiet during the week.,100,31,4,135,645,2527
You're gonna lose your head when you find out how much you save by being off the grid.,102,27,6,135,645,3288
"We used to have a welcome mat and mailbox, but that only lasted a few seconds.",102,27,6,135,645,4481
...and fresh stone ground bread.,100,31,4,135,645,5301
Yes! You can keep the ball.,102,27,6,135,645,6266
"Now, if you like giant white boulders just rolling through your house unexpectedly, and who doesn't, then I've got the house for you.",105,33,4,142,645,1419
"Well, it's either this one or the clown house",108,27,7,142,645,5189
It's kind of like a revolving door but the door stands still.,104,35,3,142,645,6006
"Frankly, I'd worry less about the golf ball racket and more about getting split in half by the windmill.",118,19,12,149,645,4118
You said you wanted to live on a golf course...,85,20,6,111,645,3812
It produces its own electricity while grinding your bread.,89,24,5,118,645,696
"It’s energy efficient, and comes with a terrific view of the 18th hole",88,26,4,118,645,751
But it does tic all your boxes.,90,22,6,118,645,1143
It’s the finest and most challenging property on the entire mini golf course.,94,14,10,118,645,2321
All the former owners say they've had a ball!,91,20,7,118,645,4584
It might be hard to get into it at first.,88,26,4,118,645,4837
"Yes, it does  require very large balls.",86,30,2,118,645,6742
The mortgage will put you in a miniature hole.,89,24,5,118,645,7538
"Oh,did I forget to mention no electricity bills and no ugly solar panels on the roof ?",96,22,7,125,645,2690
Putt-Putt Acres is a development where every  home has a view of the golf course.,93,28,4,125,645,2892
Guaranteed to discourage religious proselytizers!,98,18,9,125,645,4582
You'll need to stay upstairs only from noon until 6 p.m. (until 8 on weekends).,99,28,5,132,645,941
"On the bright side, you won’t need air conditioning.",100,26,6,132,645,1012
But the best part is: your new house IS the view.,98,30,4,132,645,1074
"Oh... no, no, no... there's no danger...
 just make sure the front door is always closed",97,32,3,132,645,4042
...but do not try to go outside on a very windy day!,105,16,11,132,645,5403
We now have an architectural control committee.,101,24,7,132,645,6438
And you'll love the rotating picket fences,99,28,5,132,645,6555
It runs on renewable energy and the astroturf is very low maintenance,100,26,6,132,645,7548
"If it's windy, get out fast. Everyone does.",108,22,9,139,645,1020
This two-bedroom one bath is good for homebodies who don’t come and go often.,104,30,5,139,645,1809
I think you'll be happy here at Quixote Heights.,106,26,7,139,645,2601
It's a playful second floor walk up that is priced right.  Do you like kids?,103,32,4,139,645,3415
"Let's be honest, a house on an actual golf course these days are overpriced for what they are! In the meantime, I've prepared you some more economical alternative choices.",106,26,7,139,645,4378
You’ll have to clear it with the hole owners association before you repaint.,105,28,6,139,645,5105
"It'll be just like you're living in Sweden except for the free healthcare, child care and payed sick leave.",109,20,10,139,645,5465
"Once you're in, it's sustainable.",104,30,5,139,645,6458
If you love kids this is the neighborhood for you.,106,26,7,139,645,7476
"Needless to say, the lease includes full collision insurance.",111,28,7,146,645,5881
You will love the ball room on the ground floor!,121,32,7,160,645,2177
"""Plus, the equity secures a revolving line of credit.""",87,23,5,115,645,905
This deal is a hole in one,89,19,7,115,645,6351
"They're calling it, Mar-a-Lego.",94,21,7,122,645,891
"When you're both retired , you can putter around the house all day.",94,21,7,122,645,1928
Stand on my shoulders and l’ll show you the inside.,94,21,7,122,645,2917
Do you enjoy Indiana Jones movies?,94,21,7,122,645,3426
"This costs more than the parcel with the clown's head, but location is everything.",95,19,8,122,645,4785
That giant hole is perfectly normal. Just par for the course.,94,21,7,122,645,7536
You won't even know what hit you,100,21,8,129,645,1452
Debra and Peter are seeking a house on the green with the appearance of alternative energy close to church and wildlife.,97,27,5,129,645,1782
"When you say that the schools are subpar, is that good or bad?",97,27,5,129,645,3773
Wind is more reliable than solar in this area.,98,25,6,129,645,4285
It’s a two bedroom condo with a beautiful view of the dragon and the steamboat. Easy access to downtown as well.,96,29,4,129,645,5705
Above par neighborhood where everyone leaves their doors open...you can bank on that.,97,27,5,129,645,6426
"It's a exceptional opportunity to be overlooking the green, in a gated community.",101,31,4,136,645,513
"Yes, it is income producing property.",103,27,6,136,645,2364
The owner is in a hurry to get to the next hole.,103,27,6,136,645,2412
It's charming. The only drawback is that occasionally a golf  ball comes flying through your front door.,101,31,4,136,645,2513
There’s only one caveat.,103,27,6,136,645,2589
"And on a really windy day, you can grind wheat and use the internet simultaneously!",102,29,5,136,645,2804
So if the hole is outside then what's the point of the windmill?,107,19,10,136,645,3040
"Remember, it's  location, location, location.",104,25,7,136,645,3333
I know you'll have a ball here.,104,25,7,136,645,3522
I feel confident THIS house will sweep you off your feet!!,111,23,9,143,645,5891
The great thing is this house comes with a life insurance policy.,116,25,9,150,645,3142
"Think of it like having a home on the 18th green. Only, you know, smaller.",124,28,9,161,645,299
Great energy savings. You just have to time your entrance right.,88,28,3,119,645,981
We’d advise keeping the first floor sparsely furnished.,95,26,5,126,645,1047
Solid construction. Great neighborhood for kids. But sometimes the front door is a little tricky,95,26,5,126,645,1868
And you'll be glad to hear there are no HOAs and green fees are included.,94,28,4,126,645,2392
"Careful on this hole, it has a sharp break to the left",94,28,4,126,645,2502
Say goodbye to that pesky air conditioner!,111,30,6,147,645,2523
The ad clearly stated that you will have a ball living here.,96,24,6,126,645,2639
It's a little fixer putter.,92,20,7,119,645,2972
"As I told you, lots of character...",109,34,4,147,645,2977
It a mix of childhood fun with extreme sports.,101,26,6,133,645,3089
"A totally sustainable green house, generates power, pumps water, and  propels natural breezes through all the rooms.",85,22,5,112,645,3431
So what if it's miniature golf. You can say that your house is next to a golf course.,103,22,8,133,645,3555
It comes with a commemorative set of little pencils.,114,24,9,147,645,3626
This is the house for sale that I was talking about that matches your credit score.,91,22,6,119,645,3712
The folks in the condo below had them thrown out for wearing wooden shoes.,111,18,11,140,645,3751
Puttering around the house will be a breeze.,100,28,5,133,645,4025
"This is the 18th hole, so most of the other offers have disappeared.",85,22,5,112,645,4519
The sellers will even throw in free tulip bulbs and their bicycles.,101,26,6,133,645,4654
We offer the security of a gated community with our traditional model right on the course.,92,32,2,126,645,4749
Fantastic circulation - all year round.,104,32,4,140,645,5436
"On the plus side, you'll never have to do yard work.",106,28,6,140,645,5464
You get used to the elephant.,80,20,5,105,645,6467
"If you think this one's big, just wait till you see the next hole.",93,30,3,126,645,6957
"With the exception of Saturday, when the Giant plays put-put, this place is off the grid.",90,24,5,119,645,7112
As long as it is not windy your Spanish neighbor won’t bother you.,86,20,6,112,645,7341
"This 'Par 3' model is a steal, but you have to act fast.",92,20,7,119,645,7550
"Simply tell your guests to use the back door, and you retain all the charm -- with none of the hazard.",112,35,4,151,645,2773
"Yes, they are a green method of drying your clothes.",110,27,7,144,645,1098
The view of the snack bar from the top floor is spectacular,109,29,6,144,645,5502
And disturbances would be minimal since people usually get a hole in one.,106,35,3,144,645,5882
"It's wind-powered, but there are green fees.",102,31,4,137,645,532
"Oh, that crazy rumor! Giants wielding clubs, rolling huge white boulders around.  Really?",104,27,6,137,645,910
But just think how much you'll save in utility bills!,106,23,8,137,645,5733
The neighborhood’s great for kids.,105,25,7,137,645,5953
"Sure it’s pricey, but it comes with a classic look, good curb appeal, and reduced greens fees.",100,23,7,130,645,1290
"If they time it right, your guests get a great send-off when they leave.",99,25,6,130,645,4669
Ironic isn't it?,101,21,8,130,645,5307
What makes you think it's a white elephant?,98,27,5,130,645,6380
"The windmill feature is just for show, but there's a clean coal burning fireplace in the family room.",100,23,7,130,645,7049
You'll find the HOA fees are par for the course.,96,19,8,123,645,416
It is a little small but has the best air flow on the market.,94,23,6,123,645,446
"Don""t worry! You just have to time it right. It's a great house!",93,25,5,123,645,1206
And of course the cross ventilation is excellent.,94,23,6,123,645,2157
"The Windmill"" is the most popular option in our mini-golf retirement village",93,25,5,123,645,2357
Wind energy and it’s right next to the golf course.,95,21,7,123,645,2686
We'll just pause here while Pink plays through.,90,31,2,123,645,2905
"Forget about a fairway view.  In this little gem, you’re on the green.",97,17,9,123,645,4193
I wouldn't hesitate on this one!,93,25,5,123,645,4727
Comes with a space for your bumper car.,91,29,3,123,645,5540
"Pricey?  This is no run of the mill home!""
Murray Block, Albany. N",87,25,4,116,645,3306
The entrance to your garage is in the Wishing Well building in back.,86,27,3,116,645,5974
Drone proof and you won’t be bothered by birds if you like to leave the windows open,83,21,5,109,645,4781
We only provide the best housing for our clients. Ever heard of the old lady who lived in a shoe?,80,27,2,109,645,4793
"Let’s look at the positives, low  utility cost, great lawn drainage",84,19,6,109,645,7018
"I'm A Little Worried About 
People Playing Through",83,21,5,109,645,7090
It's close to the snack bar and has a high difficulty rating.,120,26,9,155,645,4377
"As you can see, it has that old world, Dutch ambience.  There's really no reason to look at the rest of the property.",111,32,5,148,645,2793
"And plus, it's got a built-in air conditioning unit.",115,24,9,148,645,3385
Oh yes.....you may encounter a large ball now and then.,110,22,9,141,645,499
I'd say the only drawback is mild claustrophobia on especially windy days.,105,32,4,141,645,732
"Yes, it is a big ass fan . . .",111,20,10,141,645,5039
Solar optional.,99,32,3,134,645,552
Our architect started his career in miniature golf design.,102,26,6,134,645,869
"Best of all, it comes with a pair of wooden shoes",103,24,7,134,645,2405
You guys will have a ball in this neighborhood .,101,28,5,134,645,2655
"As you know, after the closing the ball will be in your court often.",97,24,6,127,645,371
"I also have a 3BR 1BA shoe, just vacated by an old woman who had trouble making decisions about her kids.",96,26,5,127,645,796
"Maybe I could interest you in a nice, split level grinning skull.",97,24,6,127,645,2075
"The real estate developer has a ton of experience with miniature golf  courses,  but he wanted to get into some residential stuff.",96,26,5,127,645,2222
Yes!!  A new concept:semi-gated domicile,98,22,7,127,645,3832
"Oh yes, this house is Quixote proof.",97,24,6,127,645,5952
Not to worry going in and out if there's no wind,92,22,6,120,645,1754
"Sure, it's more expensive, but the others we looked at were only par 2. The windmill blades make this one AT LEAST par 3.",87,20,6,113,645,816
"I would reconsider buying this house if either one of you is a sleepwalker . """,86,22,5,113,645,1478
"There's an easement through the first floor, but the traffic is only one-way.",88,18,7,113,645,1702
It's a distressed seller deal. They lost everything when the tulip market crashed.,124,25,10,159,645,2748
A sinkhole or two is just par for the course around here.,116,29,7,152,645,1561
"In addition to the prime location on the 7th green, you have economical wind power!",116,29,7,152,645,7002
I know you had your heart set on a Par 3 property but these windmill holes are usually Par 2.,116,29,7,152,645,7256
lawn stays green and you never have to mow.,110,29,6,145,645,5396
"No yard work, a built in pool, AND its the 18th hole.",104,29,5,138,645,959
"No, it does not have central air conditioning.",106,25,7,138,645,2885
"It's not dated, it's Retro.",104,29,5,138,645,3077
The price reflects the whole ball comming through the living room thing.,103,31,4,138,645,3594
It's too cloudy here for solar.,104,29,5,138,645,4094
"If you make a quick move, this could be yours.",107,23,8,138,645,4718
"Yes, it needs some modernization. On the other hand, think of the savings on the electric bill.",102,33,3,138,645,6331
This property has the best view of the golf course,102,33,3,138,645,6475
And just think of the money you’ll save on electric!,105,27,6,138,645,7047
You need Big Balls to live in this neighborhood.,111,15,12,138,645,7066
"This energy efficient house is run on wind power, there is well water, has a solar composting toilet, and a no maintenance, AstroSurf lawn.",105,27,6,138,645,7500
And get this - the bylaws limit them to six strokes!,100,25,6,131,645,613
Lawn maintenance is provided by the association and the hole doubles as a swimming pool when it rains.,98,29,4,131,645,851
Plus there's no carbon footprint!,98,29,4,131,645,2801
A bit unwieldy but think of the electric company buy backs.,98,29,4,131,645,2937
Only wind-powered home on the market today!,97,31,3,131,645,3032
"You know what they say... location, location, location.",99,27,5,131,645,3114
This kind of design is par for the course around here.,98,29,4,131,645,4265
...and that's the hole story.,100,25,6,131,645,4824
"Great air circulation, and it's less noise than the par 2.",103,19,9,131,645,4956
It's got its quirks but it is 100% wind-powered.,99,27,5,131,645,5946
My wife thinks I'm overcompensating for something.,100,25,6,131,645,6727
"I know it's over your budget, but the electric bill is really low.",101,23,7,131,645,7389
"You can tell it is a fixer upper by the vanes, there’s a hole in one.",100,25,6,131,645,7470
I’d buy now. The market is on the upswing,94,25,5,124,645,1980
"We've installed an alarm to let you know when the big ball is coming through. Otherwise, it's comfortable and attractively priced.",94,25,5,124,645,2845
Did I mention this is golf club community?,96,21,7,124,645,3553
"It not only comes with 100% wind energy credits, but it's got a revolving mortgage and 4 continually-changing views of a beautiful white-picket fence!",94,25,5,124,645,4093
"Well, if the windows had glass in them, that would be something to be worry about.",93,27,4,124,645,4861
I'm sorry did you say par or subpar housing?,95,23,6,124,645,5175
This one has much more curb appeal than that split-level par-four.,95,23,6,124,645,5651
"Wind powered, breezeway and did I mention the hot tub?",95,23,6,124,645,5671
You'd reduce your carbon footprint and never have or turn on the air conditioner.,93,27,4,124,645,5985
You can’t miss this deal: Sustainable and vintage at once!,94,25,5,124,645,6773
Why not? Is it because there's only one bathroom?,97,19,8,124,645,7337
"On the other hand, your short game will improve.",92,17,8,117,645,1113
Shall we write the offer? You've always wanted to live on a golf course!,119,30,7,156,645,2324
"Yes, it has an authentic Dutch door!",91,19,7,117,645,2432
"On the bright side, lawn maintenance is handled for you.",89,23,5,117,645,2434
"Why, yes, of course.  When the wind is blowing you would have to time your entrances and exits very carefully.",90,21,6,117,645,4029
"Listen, this is the only way you're going to get into this neighborhood. Have you seen the reflecting pool in the back?",89,23,5,117,645,4262
"Ironically, the asking price should not put you in a hole.",116,24,9,149,645,7
"As I said on the phone, I can offer this house at a steal. The only setback is that from 3pm to 6pm it's the 5th hole.",118,20,11,149,645,4136
"Oddly enough, property inflation doesn't happen here.",85,19,6,110,645,1130
Just watch your head going in when the wind is blowing.,88,13,9,110,645,2736
Beautiful view of the fairway and the electric is 100% renewable.,83,23,4,110,645,6121
Children who make it past the windmill feature all say they love it.,82,25,3,110,645,7094
The seller will take arcade tokens for a deposit.,109,26,7,142,645,562
"This one might seem over your head, but timing is everything",107,30,5,142,645,2893
Yes Sir.  This is the builder's first job.,111,22,9,142,645,5266
You'll enjoy the cool breeze on warm summer nights,106,32,4,142,645,5282
"Of course, you’ll want to spend most of your time on the second floor.",107,30,5,142,645,5731
"On the plus side, look at all the money you would save on air conditioning bills.",107,30,5,142,645,5812
"Yes, it's generally pretty quiet but things do get rolling in summer",107,30,5,142,645,7167
"So, I will just go ahead and mention the elephant in the room.",104,24,7,135,645,37
"When you're four inches tall, this is a golf resort.",104,24,7,135,645,2189
Full Disclosure: Occasionally a giant golf ball will roll through the living room.,98,24,6,128,645,601
"In the interest of full disclosure, the dike leaks.",99,22,7,128,645,1463
Chances of a hole in one are very slim...,96,28,4,128,645,2750
...And it's got a golf course view.,96,28,4,128,645,3628
"It's a bit of a hole in the ground, but the price is a gimme.",101,18,9,128,645,4059
"...yes, wearing wooden shoes is totally optional.",98,24,6,128,645,4335
Small wind turbine program incentives are definitely an advantage.,96,28,4,128,645,5041
This house features an active theft-deterrent system.,97,26,5,128,645,7384
The developer is all about green building.,119,25,9,153,645,4179
"Yes, utilities are included.",117,29,7,153,645,6617
The prospective buyers were somewhat concerned about the elephant in the room.,94,20,7,121,645,445
This cozy one bedroom with a breezeway is par for the course,92,24,5,121,645,803
Wind is extra,94,20,7,121,645,1332
"Well sure it can kill ya, but fossil fuels are even worse.",89,30,2,121,645,1691
Timing couldn’t be better to exit this property.,95,18,8,121,645,5873
Just be sure not to touch their balls.,94,20,7,121,645,6408
It just goes to show that luxurious golf course living AND being environmentally friendly don't have to be mutually exclusive.,113,25,8,146,645,2737
Just check for wind before you leave the house,110,31,5,146,645,3846
Timing is everything with these sorts of things.,111,29,6,146,645,7387
"You've grown up, now. So has miniature golf.",84,28,2,114,645,189
Sure it looks a little dangerous. But think about not having to deal with door-to-door salesmen anymore.,86,24,4,114,645,6309
"Well, it's not your run of the mill cottages!",89,18,7,114,645,7169
"The monthly electricity bills will be low, but you have to be really careful when you come out of the house.",106,27,6,139,645,228
It even comes with an insurance against any kind of Quixotes.,108,23,8,139,645,2205
If this isn't to your liking the property by the pirate is still available over at putters cove.,110,19,10,139,645,2209
My mistake. I thought you said Miniature Golf  Course Property “.,100,27,5,132,645,537
This breezy model is the 16th hole...,101,25,6,132,645,1529
Yes!  The golf course membership is included!,101,25,6,132,645,3507
"Don’t worry, you’ll get it cheap, this property is way under par",100,27,5,132,645,4258
And the best part is that it revolves even when there isn't any wind!,100,27,5,132,645,4430
"Sorry, but the ad said ""windmill"", not ""gin mill"".",102,23,7,132,645,4892
"Electricity is 100% free on windy days, what more could you want?!",102,23,7,132,645,5602
"And it's close to the beanstalk, so you'll have an easy commute.",100,27,5,132,645,6597
It’s the very best we offer in the Witness Protection Program.,101,25,6,132,645,7277
So you've been thinking about downsizing!,96,23,6,125,645,612
"And if you speed up the windmills, you’ll rarely have those little golf balls rolling into your living room.",96,23,6,125,645,1140
We’d prefer something with a banked driveway and a few obstructions.,95,25,5,125,645,1310
"I think you'll find this a very good starter home, Mr. and Mrs. Escher",95,25,5,125,645,2316
"You might want to consider the history, legend has it ""Gulliver"" used to play here.",76,20,4,100,645,2659
I think we can lowball this one.,97,21,7,125,645,3536
"No question about it, your timing will improve.",94,27,4,125,645,5365
"Like they say, it's all about location,",109,28,6,143,645,427
"It's a great location, right on the 17th green.",110,26,7,143,645,2458
Think about it. This would place miniature golf on a major scale.,89,25,4,118,645,5030
"This is an established neighborhood, just look at the 9th hole's moat.",93,17,8,118,645,5078
"If you put the setting on ""superfast,"" few balls get through.",93,17,8,118,645,5182
It has that 'green meets fairy tale' vibe.,89,25,4,118,645,5532
.  .  .  and the air-conditioning is even more eneregy-efficient than solar.,91,21,6,118,645,5977
And there are no electric bills.,91,21,6,118,645,6978
State law requires that I inform you that energy efficiency and near certainty of accidental death - high.,105,24,7,136,645,691
It's usually a par three - but for you - a par two!,106,22,8,136,645,1594
You’ll save on electric,102,30,4,136,645,3463
add some solar pannels and you are energy independent,85,21,5,111,645,3030
Of course you will have to time any entrance or exit.,96,30,3,129,645,151
This listing is a real hole-in-one.,98,26,5,129,645,438
And the money you save on electric bills  will more than pay for the windows and doors.,97,28,4,129,645,1279
It’s a time share.,99,24,6,129,645,1321
You'll find the second floor to be the most relaxing spot in the house.,98,26,5,129,645,2581
Renewable energy? Let's acknowledge that elephant in the room!,98,26,5,129,645,4263
Think of it--'Ernie and Ethel de la Mancha'.,99,24,6,129,645,4515
It's the latest innovation in gated communities.,96,30,3,129,645,4573
Tiger lost it in the divorce.,101,20,8,129,645,6737
Don't worry about getting hit by a massive golf ball. Nobody ever makes it through the windmill blades in one shot.,115,23,9,147,645,650
You’ll be first with renewable energy,113,27,7,147,645,2013
"You better get in today, this one's gonna move fast.",114,25,8,147,645,3795
"Quixotic Dream"" is one of our last available properties with a view of the ninth fairway",93,24,5,122,645,1394
"Green energy. Reduced green fees. It's a gimme, right?",93,24,5,122,645,2086
"Don't even attempt this unless you're stone, cold sober",94,22,6,122,645,3978
"Let's throw caution to the wind and make an offer, shall we?",106,29,5,140,645,1766
Tiger just moved in next door.,109,23,8,140,645,2375
You'll save a fortune on air conditioning.,106,29,5,140,645,2540
"You'll like the views, just watch your step 
coming out.",107,27,6,140,645,2965
"And, it has non-electric Dutch style air conditioning.",109,23,8,140,645,3858
"Sure, but it's a very difficult shot.",104,33,3,140,645,5270
"In the end, it's all about location, location, loation.",106,29,5,140,645,5370
And it's much more eco-friendly than the lighthouse.,104,33,3,140,645,5670
The giant naps between 2 and 4 pm.  That’s when you’re welcome to use the course.,110,21,9,140,645,5879
All in all it's a great house with low energy costs in a low crime neighborhood.  And wait til you meet your neighbors Don and Sancho.,109,23,8,140,645,6320
"Where you see sinkholes, we see opportunities.",89,20,6,115,645,1560
"Yes, the seller's disclosure does mention that, but I assure you it's only seasonal...",89,20,6,115,645,3256
You will find that the ventilation is excellent.,103,23,7,133,645,128
"It's a good thing you're young, there's a six stroke limit.",99,31,3,133,645,148
I can only consider your loan if your credit is below par.,103,23,7,133,645,556
It works better if you wear wooden shoes,98,33,2,133,645,674
Location is great... between the dinosaur hole and the elephant house.,101,27,5,133,645,1304
There’s nothing miniature about the kitchen.,100,29,4,133,645,2934
"I would't say ""mini"" but it’s very cozy.",103,23,7,133,645,3352
And... 20% down will putt you right into this Dutch style beauty!,103,23,7,133,645,4483
"That's about it...low crime, good schools...oh, did I mention the golf balls?",104,21,8,133,645,7475
"So, how do you feel about foursomes?",98,21,7,126,645,412
"The open house? Well, it was more of an open, then blocked, then open, then blocked house.",82,22,4,108,645,1006
This is the home for Wind Energy.,96,25,5,126,645,1384
This is a great place for someone who likes to putter a round.,99,19,8,126,645,1489
This unit is much cheaper than the Clown's Nose model.,98,21,7,126,645,1571
It's a good choice for a couple used to the daily grind.,110,28,6,144,645,4256
"His concept of the world's largest miniature golf course was misunderstood, but it could be a perfect starter home with a couple of windows & a new door!",85,16,7,108,645,4273
It’s close to the church and school plus it’s totally powered by wind.,81,24,3,108,645,4279
Miniature golf is bigger than ever,111,26,7,144,645,5148
We're gunna wanna time this one carefully.,95,27,4,126,645,5568
This is your dream of a house on a golf course and yes they will play through.,96,25,5,126,645,6147
I'm assuming your wife doesn't have a problem with large white balls... eh? eh?,97,23,6,126,645,6968
"That shot is almost impossible to make. Plus you'll have a great view of the back 9.""",104,28,5,137,645,710
"Some neighborhoods have a lot of crime; some have giant golf balls. Also, this artificial turf never needs cutting.",104,28,5,137,645,1294
The guy on the horse with the spear is harmless.,107,22,8,137,645,2090
"I say let’s go put in an offer, after this foursome plays through.",104,28,5,137,645,3435
Front door? It has one. It's just intermittent.,103,30,4,137,645,6280
It's more cozy than miniature,106,24,7,137,645,6766
This area has really  gentrified since Don Quixote left town.,88,29,2,119,645,584
"After we wrap this up, there's a bridge I want you to see!",91,23,5,119,645,1064
This house is perfect for kid's birthday parties.,94,17,8,119,645,2598
Once owned by Don Quixote..Man of  La Mancha ..before the housing crunch,89,27,3,119,645,2900
Let’s move on to the ninth hole,90,25,4,119,645,3580
Just one small drawback. A golf ball comes through every 8 minutes.,92,21,6,119,645,7035
"Yes, it’s very well ventilated",90,25,4,119,645,7494
"When times get rough, you can tilt it.",111,33,4,148,645,2710
"And, it's only open to the public on weekends.",98,28,4,130,645,833
FABULOUS circulation.,99,26,5,130,645,1059
"This is different.....ALL the energy is yours.
None goes back to the grid.",99,26,5,130,645,4482
This house blows me away,98,28,4,130,645,4659
You said gated and low maintenance,99,26,5,130,645,4676
"Except for windy days that present a few issues,  this place is a steal for the price,",100,24,6,130,645,4702
We're proud to say that President Trump golfs here often but he does struggle with the windmills.,101,22,7,130,645,6569
This is the future in retirement living. You can putt about the house all day long.,100,24,6,130,645,6694
Off the grid in the heart of town.,98,28,4,130,645,7212
"In-ground hot tub?  Why, yes!  That's exactly what that is.",85,23,4,112,645,4875
"And as you can see, it comes with the original security System.",85,23,4,112,645,6882
...and solar panels on the roof ... it’s our most eco-friendly option on the front-nine,87,19,6,112,645,7144
This place comes with passive wind energy and a good life insurance policy.,108,27,6,141,645,2401
The dike is an optional upgrade.,106,31,4,141,645,3280
It’s very energy efficient - the paddles provide cooling air movement in summer AND generate energy for heat in the winter.,106,31,4,141,645,3513
"Yes, there’s the whirring. But remember — free electricity.",106,31,4,141,645,3703
"It has wind powered energy, a fenced in artificial turf yard and an in ground wading pool for toddlers or perhaps goldfish. What's not to like?",107,29,5,141,645,5037
"This one's on par with the others, though you may see Don Quixote from time to time.",108,27,6,141,645,5338
Are you sure? I don't feel a draft at all.,107,29,5,141,645,5654
It's Tiger Woods favorite.,110,23,8,141,645,5708
"Trust me when I say, this investment is a hole in one.",96,20,7,123,645,2344
I  have just the policy for you.  It includes an extra benefit for death or dismemberment by windmill.,97,18,8,123,645,3211
Have you considered the 'grandkid bait' factor?,119,24,9,152,645,159
"A little tricky getting in and out, but other than that it's a great buy.",113,36,3,152,645,3865
Windmills are the new shiplap.,101,29,4,134,645,454
And you can generate your own electricity!,105,21,8,134,645,948
The good news is that it is only noisy when it is windy.,102,27,5,134,645,1252
"In the spirit of energy efficiency, the builder decided to combine picket fences with wind power for that Dutch, gated-community feeling.",99,33,2,134,645,1677
"And, as you can see, it comes with a rotatable white picket fence.",101,29,4,134,645,4278
And the best thing is you never need to water the lawn,104,23,7,134,645,4492
...and your low monthly rent includes collision insurance.,100,31,3,134,645,4885
You signed the insurance papers right?,103,25,6,134,645,5018
Its got central air and it's right across the street from the church.,101,29,4,134,645,6239
"I know it’s outside of your budget, but you’ll save big on electric.",105,21,8,134,645,6642
I believe there are holes in your story.,89,22,5,116,645,56
"Location, location, location!",90,20,6,116,645,1525
"Let me ask you this, did you love the Indiana Jones movies?",91,18,7,116,645,3046
"Comes with friend, neighbor, and family speeds.",89,22,5,116,645,4313
The property value is through the roof since that hole-in-one last month.,90,20,6,116,645,4434
The closing costs are fairly high but that's par for the course on a house like this.,89,22,5,116,645,4690
This one is a steal-number nine is a highly desirable hole because most families call it quits at eight.,87,26,3,116,645,5280
Iy's ecologically correct and kind of Quixotic at the same time.,109,32,4,145,645,6044
You’re gonna need a fast car for the loop-de-loop driveway.,115,39,2,156,645,1343
The goods news is that  your association dues include green fees.,119,31,6,156,645,2691
You won't find many other energy efficient homes with country club views.,117,35,4,156,645,3897
"It's a beautiful spot, but I don't know if the timing is right.",97,25,5,127,645,1584
Don Quixote tilted here,97,25,5,127,645,2660
"And when the wind blows, you get free air-conditioning!",96,27,4,127,645,2677
You must be be a big fan of renewable energy to wind up here.,95,29,3,127,645,2880
Your window of opportunity will close quickly on this fantastic property!,98,23,6,127,645,3901
"Solar, Schmolar -- THIS is proven technology!",101,17,9,127,645,6664
It's the perfect adrenaline rush while you're running late in the morning.,95,29,3,127,645,6896
Moving into this gem will require big balls.,101,17,9,127,645,7417
"Well, there are houses on the fairway, and there are houses on the fairway. . .",77,15,6,98,645,2651
Sustainability with just a hint of danger,105,28,5,138,645,623
"It's an amazing property, and please do not worry, we got restraining order from Don Quixote.",104,30,4,138,645,1255
"Don Quixote called this his ""dream"" house...",105,28,5,138,645,2470
"Well, a tree house at the paintball range would cost less.",108,22,8,138,645,4792
The wind power savings alone make this deal a no brainer.,105,28,5,138,645,5229
You're worried about the hole out in front?,109,20,9,138,645,5647
Neither Mrs. Miller nor I play golf.,108,22,8,138,645,7033
"Yes, it has its drawbacks, but the appliances have been recently updated.",115,27,7,149,645,4072
It's all about your timing.,92,23,5,120,645,1969
"Of course, this is just the scale model. The real thing will be much bigger.",91,25,4,120,645,1983
The first owner LIVED for mini golf.,120,36,4,160,645,3737
"Yes, lattice is back bigly this year!",93,21,6,120,645,6591
I recommend going into this deal with your eyes wide open.,90,27,3,120,645,6701
I saw on your Facebook page that you like golf and tiny houses and put two and two together,101,24,6,131,645,715
It's a pleasant place to live. Great for kids. Lots of friendly folks puttering about.,103,20,8,131,645,1503
This house is well above par.,101,24,6,131,645,4130
"At this price point, let's please not start the Netherlands/Holland quibble.",103,20,8,131,645,6822
"The timing on the doors is tricky at first, but it is right on the course.",112,21,9,142,645,1693
They'll accept cash if their agent doesn't get wind of it.,107,31,4,142,645,3342
This price is outrageous! We'd wind up in the hole!,110,25,7,142,645,3927
"Solar, schmolar!",79,18,5,102,645,1671
I've learned to wait for the wind to die down before I use that door.,78,20,4,102,645,6066
"The lawn is low maintenance, too.",85,25,3,113,645,2265
And this is one of  our model  homes...powered entirely by wind energy.,84,27,2,113,645,4380
This was the final hole at the former Trump National.,99,16,9,124,645,1626
"So it's not the quietest neighborhood, but the windmill generates so much electricity, it practically pays for your entire mortgage.",96,22,6,124,645,2349
Prime location and you'll save a bunch on your electricity bills.,96,22,6,124,645,3144
"This is called our ""Putt Hut""",96,22,6,124,645,5862
"I know, but you know what they say: Location, location, location!",96,22,6,124,645,6008
"This house is on the market, but please note timing is most important feature.",104,25,6,135,645,586
It's Green,107,19,9,135,645,1171
"It's perfect if you ignore the location, location, location.",103,27,5,135,645,1262
"You will never find water & electric this cheap
anywhere!",103,27,5,135,645,2886
This fixer-up is a real win/wind! Power to the people who will own this beauty!,104,25,6,135,645,3184
It also keeps the solicitors and loiterers away.,101,31,3,135,645,4441
You can't beat the price and it's only a short drive to the Eiffel Tower!,105,23,7,135,645,6652
...forget location - here it´s  all timing..... and dimples,103,27,5,135,645,7228
And a hole in one gets you a two percent mortgage rate.,114,24,8,146,645,292
Our  windmill  unit has ceilings  high enough to accommodate any sized elephant in the room.,114,24,8,146,645,3090
Remember to watch your head.,113,26,7,146,645,6561
"To seal the deal, Mr. Quixote will throw in his horse.",73,18,4,95,645,4780
The only drawback is a large golf ball will roll through on occasion.,81,21,4,106,645,1212
"Plus, free golf balls!",90,22,5,117,645,165
Humor the guy on horseback with the lance.,91,20,6,117,645,3871
No - sorry the Solar version was sold last week.,91,20,6,117,645,4192
"No, the black hole isn't part of the deal. But I might get you 10% off.",88,26,3,117,645,6608
"It's off the grid, completely wind-powered, and balls rarely reach the second floor.",91,20,6,117,645,6654
The previous owners? They were gone with the wind.,102,17,9,128,645,1198
. . . a low-maintenance lawn and so easy to play through!,98,25,5,128,645,1885
"It's a great location for the price, just expect the occasional golf ball coming through.",98,25,5,128,645,2194
"I know, I know, it’s the impossible dream house, right?",100,21,7,128,645,2957
It's the next best thing to clean coal...,100,21,7,128,645,3283
Amenities include an abundance of stubby pencils.,96,29,3,128,645,3624
This listing boasts a white picket fence and reliable home security!,99,23,6,128,645,3848
Eagles are common around here.,99,23,6,128,645,7179
"In the interest of full disclosure, the wind will not meet all your energy needs.",96,29,3,128,645,7460
"This unit does have golf access, but the central hallway throws a lot of people off.",109,22,8,139,645,815
"Quite frequently, you'll have a ball here.",104,32,3,139,645,3445
It’s eco-friendly and has great views of the T-Rex on Hole 12.,109,22,8,139,645,4427
The time is now.,105,30,4,139,645,4764
"Its prime real estate, with easy access to the underground",105,30,4,139,645,4800
Your son will never find you here.,112,16,11,139,645,6930
"We also have dollhouses and shoes, if you're interested.",107,26,6,139,645,7396
"Yes, you could break your neck stepping out for a breath of fresh air but you'll save a ton on energy bills.",112,35,3,150,645,713
Honey it's between this and the Crazy Clown,115,29,6,150,645,2327
You said you were looking for something that would blow you away!,95,19,7,121,645,1949
You'll notice you would have a prime view of the 9th hole green.,95,19,7,121,645,2500
I know the up front cost is high.  But in the long run you will save on your electric bill with wind power.,91,27,3,121,645,2636
You just set a timer for going in & out !,102,24,6,132,645,3551
"On the plus side, green fees are included.",111,25,7,143,645,3564
Make an offer before the Fed raises par.,109,29,5,143,645,4005
This location has the tax rebate and the school district you wanted.,84,22,4,110,645,5186
"The price has been reduced, only you gotta be quick to access the front door.",101,26,5,132,645,5857
"Not to worry, the golf course is only open in daylight hours.",105,37,1,143,645,5883
...It's a beautiful property! I have the paperwork here if you want to get the ball rolling.,110,27,6,143,645,6300
We also have a nuclear option.,98,32,2,132,645,6883
The only downside are the occasional white boulders.,100,28,4,132,645,7123
"Granted the house is unusual, but, come now...a 'white elephant'?",98,32,2,132,645,7293
"What do you mean ""miniature"" golf?",105,25,6,136,645,3547
There’s another model home that runs on solar power.,105,25,6,136,645,3620
The elephant can't find us here.,103,29,4,136,645,3937
Don't let the door hit you in the ass on the way out,105,25,6,136,645,5404
Don't worry about it.  Nobody gets the timing right...,96,24,5,125,645,922
"And if this isn’t your dream house, I can show you a castle down the street with three bedrooms and a moat.",95,26,4,125,645,1216
The unique charm of this unique Dutch colonial more than makes up for the VERY occasional golf ball through your front door.,95,26,4,125,645,1421
"Right, no stairs, but grab hold as it swings by and then don't forget to jump off at the top",95,26,4,125,645,1929
You like puttering around the house?,97,22,6,125,645,2353
The noise level? About par for the course.,97,22,6,125,645,2586
"This home, at this price, in this neighborhood? It's
like we just shot a hole in one",92,32,1,125,645,2780
The HOA doesn’t allow solar.,98,20,7,125,645,3965
"But on the plus side,he only plays on Wednesdays and he's got a terrible short game.",95,26,4,125,645,6293
Why live on a golf course when you can live IN one.,95,26,4,125,645,6302
Windmill accidents are not covered by our insurance policiy,90,17,7,114,645,468
"Well, on our first date, we went Dutch, so yes our home means a lot to us.",88,21,5,114,645,5024
"Today it might look like just an ordinary over sized mini golf course, though in five years it will be a global startup and innovation hub.",86,25,3,114,645,7075
"It's marked way down, but you should probably avoid the front yard.",106,30,4,140,645,3008
"Miniature"" is not in Mr. Trump's vocabulary",110,22,8,140,645,6566
It's a great neighborhood for families.,106,30,4,140,645,7402
"Our premier model features a stunning view of the 18th hole and a high efficiency, wind powered security system.",101,21,7,129,645,514
"The spartan death pit is just a bonus, dont you love it.",101,21,7,129,645,1812
Are you ready for the reveal?,101,21,7,129,645,1917
Solar is so yesterday. Wind power on your house is the future.,99,25,5,129,645,2264
"If you want it for a good price, we’ve got to get the timing right.",99,25,5,129,645,2595
Take your time,102,19,8,129,645,3973
Trust me folks: this house will BLOW you away.,100,23,6,129,645,5961
"you asked for something ""off the grid""",91,22,5,118,645,3993
You're probably wondering why this house has a hole in the yard.,93,18,7,118,645,4581
"And if you time it right, you can enter and exit without getting hit by the ball...",91,22,5,118,645,5290
The quick dash in and out -- consider how it helps your cardio exercise routine.,91,22,5,118,645,6037
Your short game will thank you.,91,22,5,118,645,6135
"This one's a little above your budget, but what you're really paying for are the amenities.",90,24,4,118,645,6355
"The original owner wanted to express the fickle precariousness of day-to-day existence, while still maintaining optimism that some days life will just let you get through and sink one.",92,20,6,118,645,7292
Don't worry. You only have to dodge a golf ball about once every half hour.,118,32,5,155,645,6218
"No, we don't talk about it.",120,28,7,155,645,6441
These wind-mill condos save hundreds on air conditioning.,111,27,6,144,645,392
The good news is you won't have a power bill. The bad news is the septic situation.,112,25,7,144,645,487
It’s an excellent real estate value.  The key is to not get stepped on.,112,25,7,144,645,3742
Maxi Golf! It’s the new extreme sport.,111,27,6,144,645,3951
I admit it takes a bit of practice to get through the door at the right timing.,114,21,9,144,645,6700
"And, if you like puttering around the house...",103,24,6,133,645,386
"Trust me, you'll have a ball.",104,22,7,133,645,456
Don Quixote slept here.,105,20,8,133,645,989
Wind power means big savings on the energy bills.,101,28,4,133,645,2165
It's a great location if you love to putt around the yard.,102,26,5,133,645,2314
"The neighborhood is extremely walkable and sees plenty of foot traffic, despite some sidewalk connectivity issues and the relatively high hazard-to-home ratio.",104,22,7,133,645,2472
This is the latest model of green energy housing,103,24,6,133,645,2525
"...And here we have our latest “wind-energy” design, submitted by a Dutchman of course.",102,26,5,133,645,2719
"A quaint little house, with windows, doors, and the occasional golf ball.",100,30,3,133,645,3371
Golf membership included with house purchase.,102,26,5,133,645,5562
We'd put in an offer... but the neighborhoods just too run off the mill.,103,24,6,133,645,5933
"Next is a charming, move in ready, par-3.",104,22,7,133,645,6128
This next house is a real hole-in-one.,104,22,7,133,645,6388
"As you can see, the open floor plan makes the place feel airy, and the strategic placement of the windows offers tons of sporadic natural light.",103,24,6,133,645,6935
"If you want it, don't play a round",93,25,4,122,645,974
AND...there’s a bill in Congress giving yearly tax credits to homeowners that have this distinctive wind device!,95,21,6,122,645,1086
"As your realtor, I agree, it is pricy, but you can always go Dutch....",95,21,6,122,645,1536
You wanted a house on the golf course.  The Association requires you allow members to play through.,94,23,5,122,645,1918
Let's go Dutch.,94,23,5,122,645,4688
Great location.  The zoo is just two holes down.,86,20,5,111,645,4049
"Not too worry, the prior owners said no one's ever gotten a house-in-one.",115,26,7,148,645,4940
And you never have to cut the lawn.,85,22,4,111,645,5008
Designed and created for the true mini-golfer.,87,18,6,111,645,5787
"The weather around here is fine, except for the occasional golf ball-sized hailstorms.",110,17,10,137,645,994
It's a golfer's paradise!,106,25,6,137,645,2417
"Sure there's no front door, but it's still not too easy to break in.",108,21,8,137,645,2689
We didn't receive permits for solar power in this neighborhood yet.,101,35,1,137,645,2897
You need to always have the windmill moving.  It keeps the local elephant from barging in.,104,29,4,137,645,5387
"Even cranking it up to 45 rpm, it’s still cheaper than a burglar alarm.",106,25,6,137,645,6201
Your handicap will probably come down by at least five strokes.,103,31,3,137,645,7060
There's a very unique elevator as well.,97,24,5,126,645,1551
"But it has potential, especially if you like to putter around the house.",98,22,6,126,645,3401
"If you like baking bread this one will grind flour for you, too.",99,20,7,126,645,3700
And the large dimpled balls will seldom bother you at night!,95,28,3,126,645,4218
... comfortable abode but not so good if you're a sleep-walker.,99,20,7,126,645,4579
"When we said house overlooking golf course in Dutchess county, this is not what we were expecting",96,26,4,126,645,6864
We like to think we put the 'putt' into Lilliput,120,23,9,152,645,2754
"Well yes, you'll have to time your comings and goings.""",91,17,7,115,645,238
It comes with central air and your own pair of wooden shoes!,87,25,3,115,645,1862
"A golf community, in a wind power unit.  Definitely up to par.  Lawn compacting included.",89,21,5,115,645,2742
It's the best par 4 investment you'll ever make.,88,23,4,115,645,3157
Ducking the spinning blades and hurtling golf balls:  a built-in fitness program in your  own home.,89,21,5,115,645,5736
This Dutch Provincial is only a Par Three.,86,27,2,115,645,6291
"In the Summer, its best to stay indoors, and upstairs.",109,26,6,141,645,2994
The purchase agreement? Like a circle in a spiral. Like a wheel within a wheel. Never ending. No beginning.,111,22,8,141,645,3560
"You might occasionally get hit by the blade or whacked by a ball, but who can say no to free electric?",108,28,5,141,645,5493
It's a little drafty but the school district is fantastic.,99,27,4,130,645,320
Are we just going to ignore the elephant in the room?,79,22,3,104,645,510
This place is a hole in one.,102,21,7,130,645,553
I can putt-putt you into this unit today with no money down.,100,25,5,130,645,1542
I would jump on this before the hipsters gentrify the neighborhood.,101,23,6,130,645,2662
"As for an investment, well, just between you and me--Tulips!",101,23,6,130,645,2698
"Sure, it's dangerous, especially on windy days. But the door to number nine is a whale's blowhole.",80,20,4,104,645,2726
And it's a wonderful view of the 5th hole!,100,25,5,130,645,6340
"When you factor in the low HOA fees, you'll
 find it a better buy than the country club!",98,29,3,130,645,6371
"The landlord? Well, he speaks softly, but carries a big putter.",102,21,7,130,645,6711
The savings in your electric bill more than makes up for the inconvenience.,102,21,7,130,645,6956
Yard maintenance is included,100,25,5,130,645,7348
"Since the loop-de-loop property closed yesterday and with a bidding war here on the windmill lot, may I suggest we look at the waterwheel parcel?",110,31,4,145,645,4765
"It does not have air conditioning, but you won't need it!",113,25,7,145,645,5755
"Of course, the condo fees will be based on par value.",91,24,4,119,645,2268
Enter quickly,89,28,2,119,645,4132
"If we enter at exactly 3.5 second intervals, we should all be fine and we win a free game!",94,18,7,119,645,4330
This little Dutch reproduction is a hole in one.,93,20,6,119,645,5932
"Well, Mr. and Mrs. Peawe, there are a few issues, but let's get you insured.",94,18,7,119,645,7074
On the plus side your energy bill would be very low.,103,26,5,134,645,396
"It's much busier in the summer. You'll have a ball, I assure you.",103,26,5,134,645,1132
When the wind eases I'll show you the inside.,101,30,3,134,645,1251
1.2 million is par for the course in this town.”,106,20,8,134,645,1639
"Sure you have to mind your head, but you’ll be self sufficient in flour",102,28,4,134,645,2650
"By next year, it will have practically paid for itself.",106,20,8,134,645,5253
"Well you did say you were looking for something on the golf course. Sadly, the castle and the 'Skull House"" are no loner on the market.",101,30,3,134,645,5629
Wind power is the next big thing! Alternatively you could  trellis some climber roses.,104,24,6,134,645,6459
"It gets you the alternative energy credit, and it keeps the elephants away.",103,26,5,134,645,6571
and you'll fill in the hole?,103,26,5,134,645,6621
"Don't  quote me, but I think they're flexible.",106,20,8,134,645,6794
It is a quiet neighborhood except for the occasional putt putts.,101,30,3,134,645,6835
"The choice is yours, the windmill, the church or the white elephant!",81,25,2,108,645,4110
"The up side is your energy is free, the down side, time your entry and exit to and from the building.",93,27,3,123,645,1978
"When I said we wanted to live on the fairway, this wasn’t what we had in mind.”",97,19,7,123,645,2214
"With your budget and desired location,​ this is the best match",96,21,6,123,645,2320
From ten a.m. to ten p.m. it has a great home security system.,92,29,2,123,645,2457
"If you don’t like this, I also have a condo I can show you inside a nuclear reactor.",97,19,7,123,645,3693
It’s a dream home: pink elephants and on a golf course.,94,25,4,123,645,5174
"I mean, let's talk the elephant in the room!",95,23,5,123,645,5694
"It’s a lovely property, but first there’s an existential crisis I need you to go through.",128,28,8,164,645,6202
"Now, obviously, the seller has already factored in the gigantic, club-swinging children into the asking price.",95,23,5,123,645,7482
"It's a little outside your budget, but the school district is above-par.",94,25,4,123,645,7503
"It has no AC, but there is a steady breeze, and pets are welcome.",106,27,5,138,645,1937
"It will go fast, it’s the only house in Minitown with air conditioning.",105,29,4,138,645,4074
So you're from Chicago you say?,107,25,6,138,645,6734
I don't think you have the balls for this.,108,23,7,138,645,7062
The perk of this home is that you can play golf with giants.,120,25,8,153,645,4634
"I'll just wait out here. Trust me, you'll want to pace yourself
going through this one.",86,22,4,112,645,5729
"Your friends will envy you for those lovely vistas, your enemies will fear the awesome power of those rotating blades.",89,16,7,112,645,7439
"Not to worry, the answer is blowing in the wind.",100,20,7,127,645,161
"One thing, for windy days you'll need a good sense of timing",99,22,6,127,645,236
This property will come on the market as soon as the President stops tilting.,99,22,6,127,645,1539
"Yeah, it's a winter rental. Trust me, you do not want to be here in the summer.",100,20,7,127,645,1838
Your wind will be my sales!,96,28,3,127,645,3102
"You couldn't agree on white picket fences, so this is a good compromise",96,28,3,127,645,3123
"Now, I should tell you...",98,24,5,127,645,3186
"Before you make a decision, I say you take it for a spin.",100,20,7,127,645,4298
You might find the parking's a little tight. Most of our tenants drive a putt-putt.,99,22,6,127,645,5245
It comes furnished but you do share the lawn,100,20,7,127,645,5612
The good news is that your electricity bill is always low!,97,26,4,127,645,5768
"These unique homes on a former mini-golf
estate will not last long, so act fast.",98,24,5,127,645,6428
Last question: how is your short game?,97,26,4,127,645,6615
You said you wanted to live on the course.,112,22,8,142,645,93
Lastly I could almost guarantee lower miniature golf scores.,111,24,7,142,645,3429
No worries. They’ll swing by a couple of times a minute,109,28,5,142,645,6000
And it comes with a matching pair of his and her wooden shoes.,109,28,5,142,645,7104
"Sure, you have to be quick getting through the door, but home windmills really are the next generation of energy technology. Solar panels are so run-of-the-mill these days.",109,28,5,142,645,7484
"It's a great location, Mr. Trump. You can golf all day like you already do.",124,24,9,157,645,305
If you’re concerned that the safety issue I also have a pirate’s head on  the 9th hole that’s available.,120,32,5,157,645,4743
"If the golf ball thing is an issue for you, then there's really no point in looking at the home that's shaped like a clown's head.",90,21,5,116,645,348
It's a bit of a challenge getting in and out.,87,27,2,116,645,900
The best part? It's handicap accessible.,91,19,6,116,645,1632
"No, I said there is a tiger and woods nearby.",89,23,4,116,645,4470
"Sorry, it's not handicap-accessible.",105,17,9,131,645,70
Old World charm tempered with New World kitsch.,100,27,4,131,645,283
"Trust me, you will not be think 'Miniature' when you see inside",99,29,3,131,645,1062
"You not only get your electricity for free, you also provide it for 20 of your paying neighbors",99,29,3,131,645,2887
"This one is very green...completely off the grid, in fact.",99,29,3,131,645,6363
The HOA fee includes an annual mini golf membership.,101,25,5,131,645,6616
"The windmill also helps to disperse unexpected elephant odors.""",103,21,7,131,645,7455
"The previous owner was a sleepwalker, and after several mishaps, he just had to give it up but  he loved the breeze and the steady entertainment.",111,31,4,146,645,877
It's a sweet little par four bungalow.,113,27,6,146,645,2097
"Complete with a view of the ninth hole, right out your front door.",113,27,6,146,645,3646
This house's cost is par for the area.,111,31,4,146,645,5588
"This state-of-the-art Dutch cooling system works in three speeds: churn, butter churn and brew.",91,26,3,120,645,1646
"Best of all, it's a kid friendly neighborhood and nobody can play through after 8 PM.",106,22,7,135,645,2483
"The Elephant 's part of deal, he works the treadmill when the winds not blowing.",82,18,5,105,645,2770
"But it DOES meet your ""dyke-front"" and ""elephant-view"" requirements",107,20,8,135,645,2882
"Now, state laws mandate that I inform you there have been multiple fatalities in the house, usually followed by shrieks of joy.",113,34,3,150,645,3556
"No children, no pets....",93,22,5,120,645,5613
The price is low because it's zoned as a miniature golf course.,105,24,6,135,645,6155
"I have no idea why they call it Mini Golf. Those golf balls seem awfully big to me!""",104,26,5,135,645,6359
The dike? Don't worry about it.,109,16,10,135,645,6470
We can move the black hole.,106,22,7,135,645,6612
"The plumbing is a bit odd, but it's in a great neighborhood.",108,18,9,135,645,6712
The asking price is fairly low; especially considering its proximity to the school.,106,22,7,135,645,6907
"Well it’s this or an alligator mouth so pick your poison, Debra",106,22,7,135,645,7360
You're going to love it here. Just try to ignore the clown next door,92,24,4,120,645,7403
The original owner was Don Quixote,108,25,6,139,645,263
The previous owner designed miniature golf courses and enjoyed a great sense of irony.,110,21,8,139,645,288
...and it's got a putting green in the front!,108,25,6,139,645,1732
Solar power is last year's model.,108,25,6,139,645,2100
And the sole covenant is you must fill the yard with tulips.,107,27,5,139,645,3534
The previous renter was heedless. After three days he was headless.,109,23,7,139,645,3890
Just steer clear of the living room when they play through.,107,27,5,139,645,6052
Hail the size of golf balls is just a myth.,96,23,5,124,645,838
The only real issue is the climate: hail the size of golf balls!,96,23,5,124,645,3414
I really see you guys here more than I see you in our Skee-Ball community.,99,17,8,124,645,3688
"Honestly, Don, I'm not a fan.",99,17,8,124,645,3855
It has a state-of-the-art security system.,95,25,4,124,645,3953
"""Don't worry. 90% putt to the hole, and 8% are blocked by the windmill.""",95,25,4,124,645,4929
This neighborhood is known for its immaculate landscaping.,94,27,3,124,645,6469
"Sandra, this deal is a hole in one.",97,21,6,124,645,7155
"Sorry, this is the only golf course country club available for your wedding.",85,19,5,109,645,2870
It's the most energy efficient property on the market. Just be very careful entering and leaving.,84,21,4,109,645,6663
"The house is nice,but it can be a little windy.",122,30,6,158,645,2827
Deal of the century!...two bedrooms...den...updated kitchen and motivated seller...,110,28,5,143,645,6251
and just think how much you will save on electricity,96,30,2,128,645,501
"Members assume all risks and dangers, including specifically, but not exclusively, any damages or injuries resulting from windmills, elephants, errant golf balls, or random acts of God.",98,26,4,128,645,2367
Is this on par for your budget?,100,22,6,128,645,2508
You don’t have to pay for miniature golf anymore and you have a real chance of getting it in on the first try.,101,20,7,128,645,3461
It’s great for kids and your short game.,98,26,4,128,645,5563
We are playing with the big boys now.,99,24,5,128,645,5673
"It's got three bedrooms, two baths, and the most challenging pass-through in the neighborhood.",96,30,2,128,645,6222
"Yeah, it's a bit of a white elephant but we're thinking green here: you've got your wind power and a whole lot more.",98,26,4,128,645,6722
"None of the neighbours wanted to chip in for a doorman, so they went Dutch.",100,22,6,128,645,7369
"Par on this unit is a little above your budget, but it does has high ceilings and it's only 1 hole away from the alligator.",89,18,6,113,645,1502
Our social media research said you were titling at windmills..,89,18,6,113,645,1817
"I can. have you in this, up top beauty ,for 1000 down and
 of course free electric",87,22,4,113,645,2070
It's definitely an under 55 and younger community!,113,29,5,147,645,608
The best part is when they miss from an inch away.,113,29,5,147,645,4437
And...best of all!  It's like having the Golf Channel in your living room.,102,25,5,132,645,162
"The lease is for one year, but you'll need to be out on weekends for the miniature golf and on Wednesdays when that guy from La Mancha drops by!",104,21,7,132,645,808
You gotta admit... it really makes you feel like we are in one of those Hitchcock movies.,104,21,7,132,645,2916
"The President heard Holland had big windmills and, well, we ended up with this.”",105,19,8,132,645,3278
This is too run-of-the-mill for you? Even with the elephant over there in the churchyard??,101,27,4,132,645,3549
"When we told you we wanted to downsize, this is not what we meant",100,29,3,132,645,4459
"Best of all, the purchase price includes free lifetime membership to the miniature golf course!",104,21,7,132,645,5147
Reduced for a quick sail.,104,21,7,132,645,5332
Timed entry provides great security.,107,15,10,132,645,7084
It's true: Don Quixote DID spend time here...,90,23,4,117,645,1003
Utilities are included in the purchase price!,91,21,5,117,645,3592
It's a fore ever home.,115,32,4,151,645,2295
It's gonna take a lot of balls to live at this property.,108,20,8,136,645,2094
"Wind power is the key to your future. 
So is a front door.",104,28,4,136,645,2263
"There’s only one thing about this listing, folks...you have to be quick when you go in and out.",106,24,6,136,645,2783
"Since we canceled the Trump branding license, sales are up 30 percent.",103,30,3,136,645,3704
"With a strong wind, you don't need a front door.",81,15,6,102,645,4039
I'd recommend making a strong offer because in the current climate these properties move very fast.,105,26,5,136,645,4286
"It was the winner in the Tiny House contest! There are a few hazards, tho . . .",106,24,6,136,645,4535
"The one advantage to the 18th hole, is the possibility of replay""",102,32,2,136,645,4918
This house has old school security features.,105,26,5,136,645,5237
"If you’ve got the balls for it, this could be a nice fixer upper rental property.",107,22,7,136,645,6802
"And you’re going to love your neighbors, the clown mouths.",95,20,6,121,645,126
"Umm, yes. The UPS guy does leave packages ...somewhere else.",94,22,5,121,645,2108
"No need for air conditioning, and best yet, it's off the grid!",91,28,2,121,645,2181
"You said you both can still sprint, correct?",93,24,4,121,645,2435
This beautiful home is energy efficient and literally on the golf course!,95,20,6,121,645,2859
If you sign now I can throw in a lifetime supply of stubby pencils.,95,20,6,121,645,2912
"Here, at our safest property, you’ll be neighbors with the lighthouse and the school district is far from the volcano.",95,20,6,121,645,6116
"As far as houses on a golf course, I've also got a clown head I really think you'd like.",94,22,5,121,645,6253
"Based on our estimates, 70% of the energy bill is covered, and only one in three will be playing through.",108,27,5,140,645,810
"No, I'm afraid it doesn't come with a golf cart.",110,23,7,140,645,1678
And it's surprisingly affordable if you're willing to go dutch.,109,25,6,140,645,3339
This is another feature of the Nine Hole Estates plan! All of your electricity and flour needs are taken care of right here.,108,27,5,140,645,3652
"Trust me, no one misses this shot",108,27,5,140,645,5814
You understand that you leave your condo at your own risk during business hours.,107,29,4,140,645,6448
"You said you're an ornithologist, Mr Smith? Well you'll like this place - we get a lot of birdies around here.",110,23,7,140,645,7000
The developer is a huge fan of miniature golf.,80,24,2,106,645,3164
"Giant balls rolling through?
That almost never happens.",82,20,4,106,645,5292
You said you were interested in a property near a golf range.,95,27,3,125,645,77
"Believe me, this is the hardest one to get on the block.",98,21,6,125,645,333
"No, no, the children aren't the worst part. It's the middle aged men.",99,19,7,125,645,878
...and excess electricity can be sold back to the grid,98,21,6,125,645,2512
"After running the comps, this place is on par with the neighborhood.",100,17,8,125,645,3879
"Now that you have downsized, this is the perfect place for you.",95,27,3,125,645,4995
"You do realize that this house is equiped with renewable clean energy ,right?",100,17,8,125,645,5334
I am available anytime before 30 mph.,99,19,7,125,645,7158
Who puts the hole in front of the windmill?  Who cares?  This place is a steal!,98,21,6,125,645,7426
"Unfortunately..
No home delivery’s",96,25,4,125,645,7509
"Some would call it 'multiple beheadings'. I call it ""motivated seller"".",113,24,7,144,645,3136
Trust me. The pros of living on a golf course outweigh the cons.,111,28,5,144,645,3941
....and we partner with a local bank that specializes in miniature loans.,109,32,3,144,645,5077
"He practices his putting early, before you'll even be getting up.  So you can forget about all that ""Fe, Fi, Fo, Fum"" stuff.",113,24,7,144,645,5446
"If you want to be off the grid, this is the home for you.",87,17,6,110,645,3035
Watch out for Don Quixote.,85,21,4,110,645,5896
On windy days your electricity is free.,105,14,10,129,645,1614
Getting a mortgage should be a breeze.,101,22,6,129,645,3420
It’s the perfect place for folks who hate door to door cable salespeople.,99,26,4,129,645,3596
It's very ecological: wind power and a garbage disposal unit right out front.,102,20,7,129,645,4475
I'm required to tell you that the previous owners were not fleet of foot.,100,24,5,129,645,7019
And you can Airbnb with your Dutch friends!”,117,23,8,148,645,1431
You asked for​ a house with a picket fence.,115,27,6,148,645,3822
Do you want it?  I have another couple coming in 2 seconds.,117,23,8,148,645,4862
"If  mini golf  isn’t your thing, we also have Chuck E. Cheese condos.",89,20,5,114,645,983
"And,don't forget,there's a 7,500 Euro renewable energy tax credit if you settle by the end of the year.",104,23,6,133,645,1467
"I know the housing market is tough these days, but I can assure you: this is a hole-in-one!",92,14,8,114,645,1588
"Yeah, the huge hole is a bit off-putting.",89,20,5,114,645,2478
We're so glad we found you - there's not many people qualified to play the part of terrified citizens on the President's new miniature golf course,104,23,6,133,645,3726
I told you you t was near a golf course”,104,23,6,133,645,4512
You will have a ball living here.,103,25,5,133,645,5625
"It's fine, after a day or two you won't even hear it.",104,23,6,133,645,6406
Do you like golf?,105,28,4,137,645,739
Coming and going here will be more fun than ever.,107,24,6,137,645,1389
The upside is you get to keep the golf balls.,107,24,6,137,645,1946
Just don't tilt at it and you'll be fine.,105,28,4,137,645,2037
There's also room on the roof for two solar panels!,107,24,6,137,645,4699
The home owners association states one has to play through .,107,24,6,137,645,5016
This house has a revolutionary design concept.,110,18,9,137,645,5573
At least you won't have to worry about maintaining the lawn.,107,24,6,137,645,5825
"The golfers aren't really a problem, the Don Quixote wannabe can be a bit of pain, but hey, where are you going to find a price like this?",108,22,7,137,645,6661
How about those vaulted ceilings?,90,25,3,118,645,276
And you don't need to furnish the ground floor.,92,21,5,118,645,364
This house definitely puts you on par with the Joneses.,93,19,6,118,645,502
"Before we look at the inside, are you familiar with the golf term ""fore""?",91,23,4,118,645,2944
You don't get this close to the action at Pitch and Putt Estate.,91,23,4,118,645,3442
"So, love it or list it ?",91,23,4,118,645,3831
Just don't put any furniture in the foyer and you'll be fine.,89,27,2,118,645,7024
Well it's better than living in the clowns mouth.,111,23,7,141,645,1736
... and it's near the golf course.,109,27,5,141,645,1818
"Not to worry, it's a par four.",109,27,5,141,645,1892
And the putt putt balls only come through the first floor.,107,31,3,141,645,2020
It comes with a turnkey security system.,111,23,7,141,645,3082
"Picket fence, church, your kind of neighbors. Trust me: No one notices the black hole.",110,25,6,141,645,4486
"Don't worry, we don't have much wind around here.",112,21,8,141,645,7137
And it even has a yard you can putter around in!!,96,20,6,122,645,362
... but there's nothing miniature about the deal you'll be getting!,94,24,4,122,645,2054
"Before you decide to buy, perhaps we should take a putt around the neighborhood.",94,24,4,122,645,3345
Get ready. The kid just pulled his finger out of the dike.,95,22,5,122,645,3735
Electricity is included!,92,28,2,122,645,3818
Getting inside is a little tricky. It’s all about timing.,95,22,5,122,645,4151
The Church is 650.  Elephant is 720. This is a steal at 680 plus you get to keep all the misses.,94,24,4,122,645,4530
Does it come with tulips?,95,22,5,122,645,6595
Next up is an energy-efficient fore bedroom,95,22,5,122,645,7257
It's a 100% green community.,109,34,2,145,645,914
It's a natural setting and you'll see eagles out the window all the time.,114,24,7,145,645,2302
That IS the elevator.,115,22,8,145,645,2587
You might even consider adding a wing.,119,14,12,145,645,3541
You should bid higher.  Tiny houses are very hot now.,111,30,4,145,645,3964
"If you buy this hole, timing is everything.",98,23,5,126,645,222
"I'm not going to lie to you, this is the most difficult house in the neighborhood.",99,21,6,126,645,811
"Don't worry about large golf balls rolling through your living room, Mr. and Mrs. Panza.  It'll never happen.  The President not only can't read, but he can't read greens either.",99,21,6,126,645,1151
This next showing will blow you away.,101,17,8,126,645,1825
This place should fit you just fine and you qualify for a sub-par loan.,100,19,7,126,645,2488
"""We will see much of the neighbors?""
""No. They tend to just play through.",95,29,2,126,645,2830
This one is not exactly par for the course.,98,23,5,126,645,2958
May I interest you in some solar panels?,97,25,4,126,645,5637
"You’ll love this beautiful Tudor complete with its own green energy source.  Plus, every time someone hits a hole-in-one, balloons drop and you get a certificate for a free hot dog!",98,23,5,126,645,6289
Because global warming is the elephant in the room.,99,21,6,126,645,6626
The neighborhood is absolutely quiet after 7:00 p.m. on weekdays and 9:00 p.m. on weekends.  Absolutely...!,97,25,4,126,645,7174
"Not only a retirement home on a golf course, 
but also a free round every time you fall in the hole.",115,29,5,149,645,852
They say it takes a lot of balls to live in this club.,117,25,7,149,645,2211
"OK, the seller agreed to remove the 'bob' !",105,16,9,130,645,2919
The Air Conditioning bills are really low.,101,24,5,130,645,3169
Sally and John wondered why the realtor would only meet them when the mini golf course was closed.,101,24,5,130,645,4123
Mini golf is for kids. This is mega golf!,99,28,3,130,645,4374
"Yes. But, it is powered by clean energy.",101,24,5,130,645,6271
"Don't worry, there aren't any security problems in the neighborhood. As you can see, it's a fence, not a wall.",102,22,6,130,645,6343
I'm going to be frank...it's a seller's market.,99,28,3,130,645,6798
"Don't sweat, only one every ten gets through",118,30,5,153,645,1485
"And if it's windy, of course, you'll have to be careful coming out the front door.",121,24,8,153,645,3615
this windmill is up to par,86,21,4,111,645,1484
"Any golfballs you catch, you keep.",86,21,4,111,645,2716
Yes. This house on the golf course is within your budget.,87,19,5,111,645,7072
It’s perfect for flipping.,106,21,7,134,645,169
"No, the elephant doesn’t come with it.",106,21,7,134,645,642
Just think how it will keep solicitors from coming to your door.,104,25,5,134,645,1819
The spinning trunk slicer and foot trap offer double protection from the marauding churchyard elephant,103,27,4,134,645,2330
It's a revolutionary architecture.,105,23,6,134,645,3631
"People into fitness, like you folks, love it here..you have to run fast to avoid the paddles and then jump over the hole.",106,21,7,134,645,4047
...and removing lingering dinner guests is a breeze...,103,27,4,134,645,4076
Airconditioned?!,106,21,7,134,645,6004
And the lawn requires no mowing,104,25,5,134,645,7325
"Now market value for this Dutch-inspired cottage is Par 4, but if you time it right, you'll find yourselves rolling right through that door in under 4.",104,25,5,134,645,7463
Energy & protection... it's a hole in one!,122,29,6,157,645,2362
"The ""Quixote"" model is equipped with energy-saving features.",110,20,8,138,645,121
"No, you must bring your own putters",107,26,5,138,645,921
"Well, you wind some, you lose some.",107,26,5,138,645,1391
The air-conditioning is included.,108,24,6,138,645,1688
The electric bill savings will blow you away.,108,24,6,138,645,1888
The real estate market here is certainly turning around.,88,24,3,115,645,2106
It's a great location if you like clubbing.,88,24,3,115,645,2913
After a few days you won’ even notice them.,108,24,6,138,645,3676
Consider what a great place this is to dry laundry!,110,20,8,138,645,3968
What a hole.,109,22,7,138,645,5193
Maybe you two can go Dutch on this one!,107,26,5,138,645,5255
"No, the sixth hole is the hardest.",107,26,5,138,645,5743
"This quaint, vintage, family home is within walking distance of many children's entertainment opportunities.",108,31,3,142,645,1361
Is it a bit drafty?,112,23,7,142,645,4165
Green energy! Within your budget!,112,23,7,142,645,4351
Good news; the inspection report indicates the building is Don Quixote proof.,114,19,9,142,645,4754
"We are waiting for Solar Panels to Come Around.......
Then the value of this Property will Go Sky High....",108,31,3,142,645,5406
"We are offering this home at a great price!
Are you both fast runners?",108,31,3,142,645,6644
"If you can putt down a miniature deposit, we can swing a deal.",112,23,7,142,645,7129
"You both clearly have a keen sensing of timing, getting into this market now.",91,25,3,119,645,2247
"Pros: You'll get a great cross breeze. 
Cons: It's a windmill.",93,21,5,119,645,2298
"Occasionally , a large white rabbit will come out of the hole .",92,23,4,119,645,3287
"Given the tricky lies, my commission is par for the course.",92,23,4,119,645,5013
"The golf is just miniature. You will, of course, stay at your normal size.",92,23,4,119,645,5449
The balls crashing through your living room are very rarely an issue.,92,23,4,119,645,6200
"Believe me, you're going to have a ball living here.",93,21,5,119,645,6720
You should see our tennis courts.,115,24,7,146,645,113
It's a miniature golfer's dream house!,115,24,7,146,645,3300
"And with just the addition of a flowing stream, you could have electricity.",112,30,4,146,645,4361
It's very reasonable and it's on the fourteenth green!,114,26,6,146,645,6646
The south-facing ball chute brings in great natural light.,112,30,4,146,645,6761
I think we’re in a bad spot here!!!,95,24,4,123,645,6035
"Let's not putter around...the odds are a million-to-one that they'll even hit the hole in one, so the house may light up once...perhaps twice a season, right?",96,22,5,123,645,6313
"You’ve chosen this hole to sponsor, Mr. Quixote. May I ask why",96,22,5,123,645,7367
Depends on your timing . . . you can go in or you can hitch a ride on a blade for a great view.,118,25,7,150,645,2369
It is a very competitive market.,97,27,3,127,645,18
"Yes,it's totally open concept.",99,23,5,127,645,2635
I assure you it is not subpar. It's par 3.,99,23,5,127,645,3477
"Well, look at it this way.  Aside from the occasional inconvenient golfer, your income from the milling operation should amply cover your mortgage payments.",97,27,3,127,645,5272
"Confidentially, I think the sellers might entertain an offer of two under par.",101,19,7,127,645,7227
It's the most mega property in Mini-golf Estates.,96,29,2,127,645,7529
"We want to live **on** a golf course, not **in** a golf course.",101,19,7,127,645,7545
"Well, curb appeal isn't everything.",119,30,5,154,645,2429
"What comes around, goes around.",82,17,5,104,645,4120
"Don’t worry, residents get to putter around the house for free.",101,26,4,131,645,812
Its a great house... you just need to be careful when you're walking your dog.,100,28,3,131,645,2378
The zoning will have to change from miniature golf to residential,103,22,6,131,645,2695
"It won’t keep out all intruders, but let’s just say they’re not getting very far.",100,28,3,131,645,5086
This next one has that open-floor plan you’re looking for.,102,24,5,131,645,5447
"We like to say it's green energy and intruder control, all rolled into one.",100,28,3,131,645,5767
"Yes, the price may be rough, but try finding another Dutch Colonial that comes with its own club!",104,20,7,131,645,5992
you cant imagine the fun of living in a golf course resort.,105,25,5,135,645,664
The previous owners didn't last long.,83,22,3,108,645,1205
There is one thing I should disclose: You will need to carefully time your ingress and egress.,103,29,3,135,645,4566
Buying this house will be a breeze.,105,25,5,135,645,5359
"Bill, is he not going to bring up the elephant in the room?",106,23,6,135,645,5690
It's in the homeowner's guidelines; you can only tilt at your own windmill.,106,23,6,135,645,6358
"With all the tax write-offs, this thing just might work.",104,27,4,135,645,7493
But it's reinforced gingerbread.,107,28,4,139,645,164
"Technically, it is adjacent to the fourth green.",108,26,5,139,645,431
The air conditioning is extraordinary!,107,28,4,139,645,1095
It's your ultimate eco-home.  Not much sun but all the wind power you'll ever want.,106,30,3,139,645,1935
and the Sump pump is amaaaazing...,111,20,8,139,645,4079
"Ironically, sub-par homes go fast and for a premium in this neighborhood .  Shall we get the ball rolling?",108,26,5,139,645,6948
You should see the putter.,89,17,6,112,645,2544
The previous owners led a very competitive lifestyle.,87,21,4,112,645,2553
Just think of what you'll save on your electric bill.,91,13,8,112,645,4980
They didn't tell you the land's been rezoned?,113,23,7,143,645,1791
This property is already generating a lot of buzz.,112,25,6,143,645,2752
You did say you wanted to downsize.,114,21,8,143,645,3320
Mr. Trump believes this is going to be HUGE with the Dutch golfers.,113,23,7,143,645,6895
This place is better value because they put the hole in the wrong location.,92,18,6,116,645,1795
No electric bills with this model.,116,24,7,147,645,1217
It's handicap accessible.,115,26,6,147,645,4928
The last owner lost his head.,114,28,5,147,645,6912
And an added benefit is that you don’t have to cut the AstroTurf.,93,23,4,120,645,525
"It only makes noise when someone gets a hole in one, which never happens past ten.",92,25,3,120,645,1058
"Of course the water views are better over near the clowns mouth, but the kids are gonna love being so close to the pirates ship.",94,21,5,120,645,1346
You should see the balls on this one.,93,23,4,120,645,2266
It includes an avant-garde security system that is shockingly effective.,93,23,4,120,645,3305
It's perfect for people who like to be on the go.,95,19,6,120,645,4746
The location isn't the best but you'll save a ton on energy costs!,91,27,2,120,645,4887
"But, you'll save a bundle on your electric bill!",95,19,6,120,645,5322
"Look on the bright side.  
The artificial turf keeps the maintenance costs very low.",92,25,3,120,645,5490
"This one's on the upper edge of your budget, but it has a nice view overlooking Hole #7.",94,21,5,120,645,5757
These babies used to be a hard sell but now they're considered sustainable.,94,21,5,120,645,5790
Don Quixote slept here. Joust kidding!,95,19,6,120,645,6236
You’ll save a bundle on electric.,118,27,6,151,645,4222
My advice is simply to ignore that elephant in the corner....,96,24,4,124,645,102
Watch out for the giant putts.,95,26,3,124,645,1999
You'll never have to mow the lawn.,97,22,5,124,645,3838
The club action here is to die for.,97,22,5,124,645,5683
"Inconvenient, you say? I say, the energy  savings alone are worth any minor inconvenience!",94,28,2,124,645,6314
Wind power is the eco-friendly alternative to unsightly solar panels,98,20,6,124,645,6318
This is the Dutch treat you won on the quiz show.,99,18,7,124,645,7393
"Granted, it is a bit quixotic - reducing your carbon footprint and keeping your husband close to home for golf.",97,22,5,124,645,7399
"No, Mr. and Mrs. Vanderbeek, solar may be overkill.",102,19,7,128,645,1244
"Of course, you'll never need air conditioning.",100,23,5,128,645,1735
".and as you know, mini houses are all the rage.",101,21,6,128,645,2128
"The homeowners association dues include golf privileges!""",97,29,2,128,645,4373
"At this price, it's a hole-in-one!",99,25,4,128,645,4528
"And if you get a hole-in-one, we offer an extra night’s stay!",100,23,5,128,645,5140
...and the best part is you'll never mow again.,98,27,3,128,645,5425
There is a clause in the deed which allows for an annual celebration involving a man on horseback wearing a tin helmet to charge through your living room.,100,23,5,128,645,5455
Lets talk about the giant windmill in the room.,103,17,8,128,645,6109
That? It doubles as a clothes dryer.,100,23,5,128,645,6861
The minor annoyance of golf balls occasionally passing through the ground floor is reflected in the price.,99,25,4,128,645,7028
"Sure, there's the occasional golf ball, but remember there's no crab grass, no gophers, no dandelions, and no grass to be cut every week.",100,23,5,128,645,7497
And it comes with your own putting green,102,26,4,132,645,659
It's the latest ultimate renewable energy house.,103,24,5,132,645,1364
The garage only fits a VW Golf.,101,28,3,132,645,1855
And the leaves and other debris are frequently removed by giants with metal clubs.,107,16,9,132,645,3481
"If you buy today, I am prepared to throw in a giant scorecard and pencil, free of charge.",101,28,3,132,645,4121
This was one of Tiger Woods' holiday homes!,103,24,5,132,645,4134
"If you're not seeing yourself in this home, I can show you a great oil rig in the same school district.",109,12,11,132,645,5115
"As you can see it's a traditional Danish floorpan, but if you really want it, your timing has to be just right.",104,22,6,132,645,5595
"On windy days, every time you go in or out, you'll get a free haircut.",79,18,4,101,645,3238
How about we take this baby for a spin?,104,29,3,136,645,344
"It gets a little tricky with the big balls rolling through, but you get used to it.",109,19,8,136,645,1054
The neighborhood is subpar but you can get it for a great price.,103,31,2,136,645,4362
We'll take it. Putt 'er there.,106,25,5,136,645,6516
"Exactly what DID you have in mind for ""Downsizing in Holland""?",110,24,6,140,645,583
Condo dues include access to the snack bar.,109,26,5,140,645,705
Let's address it now; before the elephant's in the room.,112,20,8,140,645,1135
"In real estate timing is everything, and in this property especially, the race is to the swift.",110,24,6,140,645,1948
This is what's called 'renewable' chic.,112,20,8,140,645,1972
And you never have to mow the artificial grass.,110,24,6,140,645,2092
And the utilities are all off the grid!,108,28,4,140,645,2861
"Of course, you must time your entrance carefully, especially in windy days.",107,30,3,140,645,5149
"Yes, you can enter the house through the backdoor anytime.",110,31,3,144,645,1195
Do you have anything more in the style of clown's face?,113,25,6,144,645,1943
"This is prime corner real estate, although you do have to learn to beat the blade to the door.",114,23,7,144,645,2746
"If you move quickly, the owners are willing to throw in a couple of putters at the closing",112,27,5,144,645,2792
It's a par three!,112,27,5,144,645,2849
"Finally, if you're snagged by a blade just hang on until it comes around again, then jump off.",111,29,4,144,645,3235
We pictured something different when you said gold course home.,114,23,7,144,645,3708
"Oh heavens no, the mortgage isn’t miniature at all.",113,25,6,144,645,6710
Let's see if your insurance covers falling objects.,84,22,3,109,645,231
"Oh, yes, 'move in ready' is par for the course.",86,18,5,109,645,3552
"Think of it less as a wind mill, and more of a wind house...",88,21,4,113,645,634
"Granted the listing is a little misleading, but it has great income potential.",88,21,4,113,645,2697
Just putt-putt your name on the dotted line and this duplex is yours.,89,19,5,113,645,3297
And salesmen really avoid this place.,85,27,1,113,645,5944
"If you buy the church and the windmill together, the elephant is free.",118,29,5,152,645,1445
"Honey, you've always said you wanted a house by a golf course",120,25,7,152,645,4644
"Don't worry, most people get a hole-in-one.",121,23,8,152,645,5714
"No, Don Quijote never came.",90,24,3,117,645,1745
"The 19th Hole Club has hot pretzels, a claw machine, and Donkey Kong.",91,22,4,117,645,2628
"It was originally designed for a miniature golf course, but the contractor misread the specs.",93,18,6,117,645,3319
You're timing is right.,92,20,5,117,645,4818
You'll no longer be tilting at windmills.,91,22,4,117,645,5386
"And once you're out the door, don't forget about the hole.",92,20,5,117,645,6604
Don't worry. The giants rarely come around anymore.,96,19,6,121,645,2049
"Not to worry, the the cloud-elephant will be swallowed by the mock-hole, and the gentleman charging windmills on horse was shown to be pure fiction.",96,19,6,121,645,2130
"Or, you can just sell rides.",93,25,3,121,645,2924
"And 3,... 2,... 1...",96,19,6,121,645,3043
This is our par three plan. The down-payment is miniature.,96,19,6,121,645,3891
The schools aren't very good but the go-kart tack is nationally ranked.,96,19,6,121,645,4529
"No, no, no. It's not the last hole, so your guests can just climb right out.",98,15,8,121,645,4957
Just keep an open mind to possibility during this walkthrough. Each home has it’s quirks.,93,25,3,121,645,5720
The energy savings more than make up for the few injuries and one death we disclosed.,98,15,8,121,645,6965
Electric? Cheap...very cheap.,97,24,4,125,645,2938
"It's a quiet neighborhood, except when the giant spheres roll through.",99,20,6,125,645,3436
And the trip to the Church on Sunday is only a par four.,101,16,8,125,645,4125
"As a bonus if they hit a hole in one, everyone gets ice cream.",98,22,5,125,645,5349
"Actually, it is a Par 3.",100,18,7,125,645,6501
YOU HAVE TO HAVE BALLS TO LIVE HERE!,100,25,4,129,645,1722
"OK, well, ""The Clown's Mouth"" is getting a lot of attention of late.",102,21,6,129,645,4899
Want an exotic golf course property without the hefty price? - then let me show you this lovely Quixotic mini golf course alternative.,99,27,3,129,645,5717
"Sure, but what are our chances of actually getting the windmill when we book our week?",103,19,7,129,645,6125
"Yes. You'll have to be very careful going in and out on very windy days. But, at least it's energy efficient!",103,26,4,133,645,2403
I think you'll find this place comfortable except during times of play-through.,102,28,3,133,645,3969
The only problem is storage.,104,24,5,133,645,6082
"and after the closing, we can all go get ice cream.",107,18,8,133,645,6732
You should act fast. I have a putt-putt champion who is going to put an offer in this afternoon.,105,22,6,133,645,7025
Charming  northwestern european architecture with a terrific front hole.,111,17,9,137,645,138
"A great golf community, and this unit is energy neutral.",108,23,6,137,645,934
Great location.  A real adventure every time you enter or exit,104,31,2,137,645,1040
"Don, no Quix necessary, just tilt the windmill.",108,23,6,137,645,1044
"We don’t talk about the elephant, Frank.",112,15,10,137,645,1687
"In addition to title insurance, you would also need gnome insurance.",110,19,8,137,645,2332
"It's newly remodeled and well within your price range. In the interest of full disclosure, however, we do need to discuss the 'giant ball' issue…",107,25,5,137,645,2522
Of course you can mill your own grain but the real kicker is that you don't have to address the elephant in the room.,107,25,5,137,645,2968
There is a slight chance you'll be struck by a large wooden ball.,110,19,8,137,645,5543
Remember the wind is Free.,108,23,6,137,645,6784
The reason it's priced so low is that part of it is used as a miniature golf course during the day.,112,22,7,141,645,1923
Imagine the money you will save on AC!,110,26,5,141,645,2358
The previous owner installed a putting green.,111,24,6,141,645,2832
"Well, yes. But there's a strict 9 PM curfew.",108,30,3,141,645,4187
It also crushes Ice.,110,26,5,141,645,5843
You said you wanted a gated community.,117,26,6,149,645,272
"Now this house, has a real thrill factor to it.",117,26,6,149,645,3872
"Original hardwood frame, quartz movement, very quiet September to July and most quit before the chapel anyway.",124,33,4,161,645,5900
Green fees are fully paid by the Home Owners Association,85,22,3,110,645,8
"Don Quixote may swing by once in awhile, but other than that it's a steal.",87,18,5,110,645,3801
We rarely see eagles here but it’s possible,84,24,2,110,645,4339
"At the present asking price, I'd have to say this looks like a ""hole in one.""",88,23,3,114,645,1399
"With your handicap, I’m afraid the Eiffel Tower is out of the question.",89,21,4,114,645,2147
"As a bonus, you can sell power to the entire neighborhood!",87,25,2,114,645,5196
The foundation tilts.,92,15,7,114,645,5964
The architect is known for his whimsicality and flair for humor.,91,24,3,118,645,565
"What's more, you can tilt at it any time you wish.",92,22,4,118,645,1647
"This is a popular weekend spot, so you won't be the only one puttering around your house.",90,26,2,118,645,2857
"I'll say it, you want me to say it?  It'll sweep you off your feet, this place!",94,18,6,118,645,4133
"And best of all, the air conditioning is free.",93,20,5,118,645,4556
"Of course, if this one's not to your liking I've got this little beauty with a clown's nose that you're just gonna die for.",95,16,7,118,645,5326
"I wouldn’t say it’s MINIATURE golf, but....",92,22,4,118,645,7197
Now this property is my ace in the hole. It’s been generating a lot of interest.,96,21,5,122,645,591
"And you get the solar credit tax write-off,",96,21,5,122,645,1022
An added benefit to this home is that is comes with a clean Titleist,96,21,5,122,645,2235
"Don't worry, if you don't make it into the front door, you'll end up in the attic",96,21,5,122,645,2570
"And to answer your question: no,it doesn't generate power but it does generate fun.",92,29,1,122,645,4671
..and it's a very kid friendly neighborhood,95,23,4,122,645,4853
"What's more important to you: a condo with a view
of the golf course, or the ability to get in and out
without the prospect of dying?",98,17,7,122,645,5003
What do people in this area like to do for fun?,94,25,3,122,645,6015
The real trick shot is coming up with a caption for this loser.,95,23,4,122,645,6156
"I'm not gonna lie, it would be a ballsy move.",96,21,5,122,645,7309
Insurance rates are actually low.  The golf balls rarely hit the windmill blades.,98,24,4,126,645,124
I never said the picket fence was on the boundary line.,97,26,3,126,645,651
"yes, this historic home is the birthplace of Don Quixote and is also carbon neutral",97,26,3,126,645,1501
"Well, unless you are a pirate, alien or a dinosaur, this listing is the closest available to the beach right now.",99,22,5,126,645,3111
"Ready - 3, 2, 1 then go!",97,26,3,126,645,4055
"If you can overlook the roaming elephants, the lack of windowpanes and the risk of getting hit by the windmill, I think going Dutch on this property is a good option.",99,22,5,126,645,4752
It's the original air conditioning,99,22,5,126,645,5841
"Close escrow in thirty days, and before you know it you’ll be golfing with the big boys.”",98,24,4,126,645,6205
The Co-Op Board does allow the tilting of windmills,99,22,5,126,645,7011
The sellers are willing to throw in windows and a front door but they refuse to go under asking.,99,22,5,126,645,7554
Welcome to the open house. Please leave your info in the 18th hole,102,23,5,130,645,401
What's your handicap?,102,23,5,130,645,1844
It's a hole in 2 if you count the loft.,102,23,5,130,645,2201
The school scores a bit above par.,102,23,5,130,645,5764
.......and of course you'd have to be in Dutch costumes........,105,24,5,134,645,243
The HOA can be a little strict but as long as you stay out of the way during birthday parties you shouldn't have a problem.,103,28,3,134,645,1857
And it creates enough energy to light at least 3 lightbulbs continually.,102,30,2,134,645,2606
"No, you don't have to do the wooden shoes.",103,28,3,134,645,6674
"We prefer the term ""Tiny Golf""",108,25,5,138,645,946
You never have to mow the grass and you are within walking distance of the Magic Castle and goldfish pond.,106,29,3,138,645,3765
Listen!...Are you green or are you Not!,111,19,8,138,645,7446
I know it's a little older than you'd like.  But it has a terrific renewable energy system.,110,28,4,142,645,2184
"Look, in this neighborhood it's either this or a barn with three doorways.",110,28,4,142,645,4205
"If you survive Tilting at Windmills, pop down the Rabbit Hole, then the Pink Elephant awaits ...",112,24,6,142,645,6931
You'll be fine as long as you stay off the ground floor.,115,25,6,146,645,1877
"Home security is sporadic but like your electricity, its free.",112,31,3,146,645,3540
"Other than the occasional large white ball, this one's a bargain.",112,31,3,146,645,6126
"Sure, it's in a floodplain. But the energy bills are practically non-existent.",113,29,4,146,645,6178
"That Clown is on the back nine now, which helps your property value.",119,31,4,154,645,2867
This property is right on the 18th green. And there is no electricity bill; it's completely wind powered!,85,17,5,107,645,458
"I'll be honest, not a fan of the open-concept floor plan.",83,21,3,107,645,4164
And best of all your neighbors are all very quiet.,83,21,3,107,645,6764
"This model is selling like crazy, the underground entrance puts you smack in the middle of the family room.",87,20,4,111,645,943
You don't need air conditioning.  It has natural ventilation.,87,20,4,111,645,3864
"Also on this street we have the lighthouse, and on the next block over, the laughing clown.",89,16,6,111,645,7418
Just think what you'll save on electric.,90,21,4,115,645,1661
"Now, before you sign, there is one thing..The Giant does love his miniature golf...",91,19,5,115,645,3099
Did I mention that this is a tilt free neighborhood?,90,21,4,115,645,4344
"Sinkhole or black hole, you folks just think of it as a “hole in one”.",90,21,4,115,645,4726
The previous owner was an avid miniature golfer.,96,16,7,119,645,464
The security in intermittent.,96,16,7,119,645,1563
It’s discounted because of the intermittent access.,92,24,3,119,645,3571
"I promise you, this is a family friendly neighborhood.",91,26,2,119,645,3998
Commit now.  Timing is everything.,96,16,7,119,645,6854
"Yes,yes you do have to dodge the sails,but the utility bills are terrific.",92,24,3,119,645,6915
Well the previous tenants said they were only bonked twice — both times drunk.,95,25,3,123,645,1042
You'll find this much more attractive than those ugly solar panels.,97,21,5,123,645,2039
"You could be among the lucky ones to become part of an all-inclusive, themed golf community.",93,29,1,123,645,2197
It's a great investment property - just sit back and watch those balls roll in.,97,21,5,123,645,3194
Just don't tilt and you will be covered for everything.,96,23,4,123,645,3335
"No, I'm sorry. The giant golf ball is not included with the listing.",94,27,2,123,645,5440
"Now, I’m not supposed to say, but I’ve heard rumors that Jack has some magic beans which could lead to a significant de-giantification of the neighborhood.",99,17,7,123,645,5856
"You would have ample electric power throughout a hurricane, but you might not be able to exit.",98,19,6,123,645,6290
"This one is a bit quixotic, but wait until you see the schools!",96,23,4,123,645,6505
"I know it's a little dangerous, but you will be able to get the wind energy tax credit.",97,21,5,123,645,7335
"With Trump as President, this is our latest house plan, when you wind up the propellers, they take off like a helicopter
so you can flee this country.",102,18,7,127,645,658
This one’s gonna go quick!  People love the idea of being off the grid but still downtown.,99,24,4,127,645,999
Did I mention it's LEED certified?,99,24,4,127,645,1705
"Yes, this is a safe neighborhood, but you also have a built in security system.",99,24,4,127,645,2238
Holland Tunnel? You’re way off.,103,16,8,127,645,3262
I believe you said you wanted a house that was “up to par.”,100,22,5,127,645,3501
This is the only property available close to a golf course.,100,22,5,127,645,3845
"As you requested, a white picket fence",100,22,5,127,645,4561
"Three bedrooms, two bath, Eat-in-Kitchen and a Grist Mill!",101,20,6,127,645,4984
You'll have a ball here.,101,20,6,127,645,6503
Unfortunately we can't file a restraining order unless the elephant actually acts against you.,106,17,8,131,645,969
You'll understand why we'll need to adjust the premiums seasonally.,102,25,4,131,645,1114
"Other than a periodic influx of brightly colored golf balls, it is a very quiet neighborhood.",105,19,7,131,645,1933
"No, I'm afraid the loop de loop driveway cannot be replaced.""",102,25,4,131,645,2537
The one stroke penalty deters a lot of intruders.,102,25,4,131,645,3057
This is your basic windmill  floor plan.  Would you like to see the   wind farm model?,103,23,5,131,645,3675
I think every day you’re gonna be bowled over anew by this place.,103,23,5,131,645,5716
"Your life is full of contradictions, your retirement should be too.",103,23,5,131,645,7157
"Of course, your furnishings are safer upstairs.",101,27,3,131,645,7407
Take ‘er for a spin,107,22,6,135,645,1261
"Now, I know the listing says ""a little hole in the wall.""",106,24,5,135,645,2843
"It's cozy, and you won't have any problem with thieves pilfering your Amazon packages.",105,26,4,135,645,3444
"If you like golf, this place is perfect for you.",105,26,4,135,645,4034
"Remember, you get free electric.",106,24,5,135,645,5352
Features a unique elevator lift.,101,34,0,135,645,5560
There aren't a lot of Miniature Golf Movement houses on the market right now.  Wanna take a look-see?,104,28,3,135,645,5919
It's only noisy when he misses.,107,22,6,135,645,6465
"Yes, a giant boulder rolls through every once in a while. But honestly - small price to pay for prime real estate in the city these days.",107,22,6,135,645,6762
It's the only par 3 hole on the course,107,22,6,135,645,7286
When someone makes a hole in one they have to buy you free drinks.,111,21,7,139,645,670
Getting you an affordable mortgage will be a breeze.,111,21,7,139,645,1030
Youb cant believe what happens when someone gets a hole in one...,110,23,6,139,645,2187
"So before we move on, there is the issue regarding the elephant in the room...",114,22,7,143,645,735
The picket fencing adds New England charm to this cottage qua mill.,110,30,3,143,645,2749
"Four bedrooms, two baths and it doubles as the 18th hole of the mini-golf course.",112,26,5,143,645,3045
"It's a lovely Cape Cod, with a splendid view of that little hill no one can ever putt across.",114,22,7,143,645,3754
I take it that you're looking to downsize.,120,24,7,151,645,7160
You guys can swing it if you go Dutch treat.,101,22,5,128,645,51
Plus it comes with all the beans you can eat from the stalk over there,95,20,5,120,645,94
It’ s definitely a fixer upper but it has energy production potential,100,24,4,128,645,131
This house comes with a built in fan,106,19,7,132,645,246
Your gonna need a hole in one to land a deal like this.,107,24,5,136,645,318
Energy-efficient with no lawn maintenance--plus you'll get this free New Yorker print from Bob.,107,24,5,136,645,355
It's just come back on the market very unexpectedly,97,23,4,124,645,360
You’ll get a lot of foot traffic on he weekends.,100,24,4,128,645,830
Yes but you’ll save a bundle on energy.,89,25,2,116,645,881
The hole leads directly to the clubhouse.,93,17,6,116,645,890
But the real benefit is how low your electricity bill will be.,103,25,4,132,645,1017
"No home insurance needed, but you might put it towards more life insurance.",102,20,6,128,645,1136
"This is a lot cheaper than using solar energy, but just be careful going out the back door.",106,19,7,132,645,1234
"While this house lacks in security, it makes up in air conditioning.",93,24,3,120,645,1556
It's the absolutely latest thing in miniture golf...we're the miniatures!,98,21,5,124,645,1566
"Just think, you’ll be making your own unique carbon footprint statement.",104,23,5,132,645,1965
It’s perfect for a golf lover and right on the ninth hole.,88,20,4,112,645,1998
"I need to tell you before purchasing,  that golfers will be playing thru at times ""      JF  OC N",90,23,3,116,645,2008
"Trust me, there's nothing mini about the storage space in the attic.",103,25,4,132,645,2451
"It's not just the low maintainance, but the thrill of  trying to make it in alive.",97,23,4,124,645,2463
"Little people want nice houses too, you will really enjoy living in a golf course community.....",106,26,4,136,645,2758
"Yes the door is a minus, but if you sink the ball the month’s mortgage is covered.",103,25,4,132,645,2766
"""The previous owner? He's, um, moved to a farm in upstate New York.""",110,25,5,140,645,2771
"We love the space, but I’m concerned by all the clubs in the area.",95,27,2,124,645,2864
. . . and here's the kicker . . . you get to keep all errant golf balls!,93,24,3,120,645,2998
"Yes, the Solar Cottage had a more open concept but not this view of the par two 9th.",94,15,7,116,645,3071
It’s 100% wind powered. You said you wanted to be off the grid.,101,22,5,128,645,3085
The neighborhood is quiet after the tourist season.,93,24,3,120,645,3117
"I'd avoid investing in a place on a water hazard, they're breeding grounds for mosquitoes.",98,14,8,120,645,3151
"You may get the occasional giant golf ball knocking around the living room, but it's a small price for a home right on the putting green.",103,25,4,132,645,3225
This place will sweep you off your feet.,96,18,6,120,645,3425
"You won't find something better in this neighborhood, plus you can keep all the golf balls.",91,21,4,116,645,3833
Location. Location. Location. Plus even Quixote would not mess with you.,91,21,4,116,645,3883
You'll be surprised by your low electric bill in addition to the fresh air.,103,25,4,132,645,4091
It’s pretty straight forward about timing the vanes.  Just watch out for the golf balls.,101,29,2,132,645,4371
"Not to worry, the elephant is very quiet.",85,19,4,108,645,4501
"You need to make an offer, it’s par for the course",106,26,4,136,645,4607
"So if you'd like to purchase the property, the ball is now in your course.",106,26,4,136,645,4645
"The landscaping is sub-par, but it's a great house if you like to putter around.",97,23,4,124,645,4739
There might be some kind of easement. Don't worry about it.,92,26,2,120,645,4859
"If you've always pined for low electricity bills, this is the place for you.",124,25,7,156,645,4916
"It's win-win. With the wind power you save the planet, and when Amazon moves here your equity skyrockets.",107,24,5,136,645,5051
This is miniature golf for people with big balls.,89,11,8,108,645,5135
You don’t need Solar if you are nimble.,116,27,5,148,645,5381
"Don,t you love the quaint wind turbine?",83,16,5,104,645,5511
Of course you'll have to take care about your comings and goings,116,27,5,148,645,5553
"if you pay your rent on time the windmill continues to rotate, otherwise it stops over the windows and door",105,28,3,136,645,5587
No need to drive anywhere,94,22,4,120,645,5638
"If you want it, I’d move quickly because there’s two Dutch couples in a bidding war for this place.",88,20,4,112,645,5684
"This house is the ultimate artistic representation of modern times. Your neighbors are good Christian republicans who place bets on which will get you first when you’re leaving: the giant blade or the bottomless pit. Either way, you’re on your own!",110,25,5,140,645,5793
"Sure, the pool's small but you get a wonderful view of the greens",103,25,4,132,645,5813
Think of it as your own wind-farm home security system.,108,29,3,140,645,5837
It’s a little pricey so I hope that you still have the balls to do it.,110,25,5,140,645,5880
"You might call it a ""guillotine door"".",105,21,6,132,645,5886
It's ideal for couples who vacation all summer.,90,23,3,116,645,5959
This house is very secure once the wind hits 120mph.,108,22,6,136,645,6158
...and when you're home it's a par 5.,97,23,4,124,645,6249
It’s just that you may not be able to get in at certain times.,109,20,7,136,645,6332
"I promise you, there's nothing to fear.  It's been decades since anyone has heard from Don Quixote.",91,21,4,116,645,6352
It has an open floor plan.,112,21,7,140,645,6425
"So that's the extent of the property -- the church, elephant, windmill and pit of despair. No one says it makes sense. I mean, Christians. Go figure, am I right?",107,17,8,132,645,6455
"Sure, it might require a little downsizing--but people are paying a premium for the location.",100,24,4,128,645,6813
"I’ll give it a shot, but it might be tough to score on this one",99,26,3,128,645,6933
"No, no, it's not drafty at all.",92,26,2,120,645,6997
So it's a one bedroom... Great schools... And I hear Don Quixote raved about it.,95,20,5,120,645,7128
"If you don't mind dodging the occasional giant golf ball, it really is a wonderful neighborhood.",117,32,3,152,645,7375
"It will pay for itself in no time, believe me!",82,18,4,104,645,7564
Drafty but cozy,123,29,5,157,645,915
"Oh, about the size of hailstones I'd say.",120,28,5,153,645,356
"So, are you going to love it or list it?",120,28,5,153,645,398
"No, no elevator but the windmill will get you there as fast.",121,26,6,153,645,1729
"You should buy it, it's definitely a hole-in-one",126,16,11,153,645,4477
Arnold Palmer once lived here.,122,24,7,153,645,4840
You'll love living off the grid here at Pirates Cove! Just try to stay on the second floor during daylight hours.,114,26,5,145,645,773
Our best offering for the eco friendly house hunter.,114,26,5,145,645,2283
It comes with its own grist mill.,113,28,4,145,645,2672
"It's all fun and games until you hit the windmill, Martha.",112,30,3,145,645,3923
I heard on NPR that Jumbo Golf is the next big thing.,110,27,4,141,645,581
"Clockwise on even days,counter clockwise on odd days.",111,25,5,141,645,2107
And you can control the speed of the blades within the pre-established limits.,112,23,6,141,645,3543
It sounds just like the comforting thunder of an approaching storm,114,19,8,141,645,4366
"Sure, your house is on a mini golf course...but can you really put a price on renewable energy?",110,27,4,141,645,5537
"In addition, homeowners receive a complimentary membership to Putt Putt Country Club.",110,27,4,141,645,6084
Golf isn’t my life. It’s much bigger than that.,112,23,6,141,645,6096
It includes an alarm system that warns you whenever a giant thermoplastic ball might come barreling through your living room.,109,22,6,137,645,3041
Let's talk about the elephant in the room.,110,20,7,137,645,3107
"Certainly, we would be glad to install a loop-de-loop driveway .",108,24,5,137,645,6010
"Oh just wait, no need to walk, you will be taken up to the second floor.",107,26,4,137,645,6890
"The view of the golf course is so great, you will think you are living on it.",105,30,2,137,645,7285
"The added security feature helps your theft insurance, but your health insurance will skyrocket.",105,23,5,133,645,1666
No. Not Solar. Wind is the upcoming renewable energy source.,103,27,3,133,645,1886
"If you’re into Gingerbread men and delayed energy credits, this place is for you.",104,25,4,133,645,1977
This week on House Hunters...,106,21,6,133,645,5697
What moles?,109,15,9,133,645,7225
You will have a ball in here!,100,26,3,129,645,191
"Gulliver's Golf and a Lil' puttin', perfect for your retirement",102,22,5,129,645,437
This baby's a real steal.  The last owners were mysteriously decapitated.,105,16,8,129,645,906
The best part is your guests never stay long.,99,28,2,129,645,2805
We do things in a big way here at Brobdingnag Acres.,104,18,7,129,645,3828
I am sorry but your insurance doesn't cover hole-in-ones.,102,22,5,129,645,3921
"Sure it's drafty,but it'll pay for itself in energy bill savings.",102,22,5,129,645,4428
"You'll be ""blown away"" by this house",102,22,5,129,645,4533
It’s an entry contest...literally,99,28,2,129,645,4850
The Old Woman in the Shoe was the last owner.,103,20,6,129,645,5592
You won't get closer to the golf course for the money.,100,26,3,129,645,5727
Mexico will fix the wall.,105,16,8,129,645,5950
"I mentioned the white picket fence, didn't I? And just look at that border wall!",105,16,8,129,645,6043
"Welcome, to Windmill House Hunters!",99,28,2,129,645,6910
What makes you think this is a renovated windmill?,101,24,4,129,645,7125
It can get a little touch-and-go during the vacation season.,98,23,4,125,645,580
"No ifs, ands, or putts! This baby is ready to move!",100,19,6,125,645,625
"It is both inexpensive and romantic, though you will have to carefully time your entrances and exits.",100,19,6,125,645,3234
As you can see it’s definitely NOT a miniature golf course!,98,23,4,125,645,3857
You get a free month's mortgage payment with every hole-in-one.,101,17,7,125,645,5305
It comes with a back-up generator.,99,21,5,125,645,5580
"The previous tenant? Listen, that's the elephant in the room.",98,23,4,125,645,6195
I think we should discuss the elephant in the room,100,19,6,125,645,6627
This next property features a spectacular view of the golf course without any country club snobbery.,100,19,6,125,645,6884
This Old World charmer has an open-space floor plan AND a view of the volcano.,96,27,2,125,645,7165
And it keeps the house cool all year round!,98,23,4,125,645,7321
"Here, your negative score is good.",94,24,3,121,645,1805
This next house here is a hole-in-one!,94,24,3,121,645,2385
Forget the White Elephant.  You can't beat the price and the location and you never have to mow the lawn.  You can walk to church. The homeowner's warranty I'm throwing in replaces the blades should they ever get damaged or worn out.,96,20,5,121,645,3002
It’s an original Nicklaus design.,99,14,8,121,645,5393
This house has the best view of the 18th hole,94,24,3,121,645,5745
"Sure, the windmill is less creepy.  But the clown’s mouth is less creaky.”",94,24,3,121,645,7551
"Not to worry, the Open House will resume once we retrieve your agent from the 18th hole.",94,17,6,117,645,2883
It’s a little drafty but checks all your other boxes including a golf course view.,93,19,5,117,645,3734
And you get the wooden shoes for free.,95,15,7,117,645,4989
Think of it as a round garage.,92,21,4,117,645,5195
"Powers cheap and you don’t have to worry about flooding
But getting in and out can be tricky",89,20,4,113,645,635
"The owners are moving to Coney Island,under the Cyclone.",88,22,3,113,645,2069
"The location is killer. Great views of the ocean, desert, north pole, and a giant punching bag.",90,18,5,113,645,4521
"The previous owner did try solar power first, but other than the need to time your entrance and exit, this works better.",91,16,6,113,645,6749
The golf course lots are going fast.,88,22,3,113,645,7041
"If I'm being honest here, you two want no part of the 17th hole. Waterfront views are nice and all, but they never mention the mosquitos",122,33,3,158,645,2999
"We call this little fixer-upper our ""Hole In One.""",116,24,6,146,645,2306
Mini-golf property: for retirement on a budget.,113,30,3,146,645,4433
The architect has designed a number of miniature golf courses.,116,24,6,146,645,4826
"Once construction on the go cart tracks is finished, your commute will be cut in half!",112,32,2,146,645,5151
It's a bit drafty.,110,29,3,142,645,6140
You can go Dutch on it,110,22,6,138,645,886
I’d knock down this wall and add a sunroom with French doors.,111,20,7,138,645,1204
"Aside from taking care with your entrance and exit timing, watch out for very large golf balls rolling your way.",111,20,7,138,645,1914
"It's on par with your asking price, so what can we do to putt you in this home today?",109,24,5,138,645,2303
It's not the balls that just bounce off the back of the house. It's the balls that roll through the living room.,109,24,5,138,645,3825
At least you’ll feel the wind on your shoulders.,106,30,2,138,645,4008
This isn't your typical four walls and a picket fence but the neighborhood's a hole in one.,108,26,4,138,645,6146
You can always tell guests to come in through the back door.,103,29,2,134,645,225
The previous owner had many balls here.,104,27,3,134,645,2753
"The grass is green, the mortgage is low. However, there are occasional balls that pass through.",105,25,4,134,645,4728
Just as Real Estate this house is all about timing!,109,17,8,134,645,5789
"I'm sure its Don Quixote, not Don Trump.",100,28,2,130,645,594
"Just so you know, another couple has expressed interest in playing through too.",99,30,1,130,645,2373
Timing is everything when it comes to snagging this lovely home that features a working windmill.,104,20,6,130,645,2812
The original owner was CEO of a cookie company.,103,22,5,130,645,2962
"The price is very low because of the frequent mild earthquakes and the occasional boulder rolling into, or through, the house.",102,24,4,130,645,3127
"The good news is, it's a putter's market.",102,24,4,130,645,4237
You gotta have big balls to play here.,106,16,8,130,645,4299
Getting on the roof is a breeze!,105,18,7,130,645,4531
you just need to know when to duck,103,22,5,130,645,7053
"I’d buy before it’s gentrified, the Elephants are already moving in.",96,29,1,126,645,61
Local Zoning does not allow Solar Panels,102,17,7,126,645,153
"As you can see, there is plenty of cross-ventilation and it's located in a wonderful school district.",98,25,3,126,645,1423
You can Go Dutch.,100,21,5,126,645,1611
You just need to be careful moving between the kitchen and the bedroom that no one is playing through.,102,17,7,126,645,2208
"Look at it this way, you grind a few bushels  of wheat evey day, and you will offset $200 from you're monthly mortgage  payments.",100,21,5,126,645,2430
"What price? Who do you think you are, Don Quixote!",102,17,7,126,645,2555
Be alert for an occasional large golf ball.,103,15,8,126,645,4140
And the Par 3 is our most environmentally friendly model; needs only a mild breeze to generate its own electricity,98,25,3,126,645,4319
"You've got the prestige of living on a golf course, no age restriction and a lemonade stand could pay the mortgage.",99,23,4,126,645,4805
And the historical value alone!  Once owned by Don Quixote.,101,19,6,126,645,4986
You'll love the Dutch Doors!,99,23,4,126,645,6809
The seller has offered a 28 handicap.,98,25,3,126,645,7008
And the best part is no electric bills!,96,22,4,122,645,675
"It was part of Trumpwall, repurposed as a windmill.",101,12,9,122,645,813
You will have the lowest electric bill in town!,96,22,4,122,645,2031
You'll have the freshest flour ever!,93,28,1,122,645,3113
Miniature golf living is filled with excitement.,98,18,6,122,645,3497
Sure you can afford it - if you go Dutch.,97,20,5,122,645,4293
$2500 a month and all the electricity you can handle!,96,22,4,122,645,5384
I expect multiple offers if anyone else makes it through the loop de loop.,96,22,4,122,645,5582
This neighborhood is a lot safer than it used to be.,96,22,4,122,645,6925
"Look, it's a 'green' house.  You'll never have to pay for electricity again.",91,25,2,118,645,2992
Well yes it is not problem free but it does provide air-conditioning.,93,21,4,118,645,4423
"The master bedroom is upstairs,
so you won't even notice the golf balls.",92,23,3,118,645,5208
And we offer competitive sub par mortgage rates.,92,23,3,118,645,6275
The ventilation is wonderful.,89,22,3,114,645,242
No. The white elephant is on the next street.,92,16,6,114,645,824
You'll need at least a birdie to qualify for financing.,89,22,3,114,645,3886
"Sure it's quixotic, but isn't that what greenside living's all about?",87,19,4,110,645,7344
The rate structure from the public utility commission is very favorable.,81,17,4,102,645,654
You get a month off your mortgage for every hole-in-one...Oh! And stay upstairs during business hours.,123,19,9,151,645,2379
"The housing market is pretty cut & dry this year, either you're in or out.",118,22,7,147,645,3810
And you can grind your coffee beans on a windy day.,117,24,6,147,645,4905
I'm sure you could get it for well below asking price.,113,25,5,143,645,2145
"And, of course, our Pure-Green patented forever lawn technology",111,29,3,143,645,2274
"Everyone in the neighborhood recy- watch your head, Miss",115,21,7,143,645,3775
The view is to die for,112,27,4,143,645,4349
"1). It has a great 360 view
2). it's on the golf course...
3). And it's under a million bucks...",112,20,7,139,645,2580
"Are there problems?  Sure.  There's no windows or doors, it has a bottomless pit in the front yard, and there's a wild elephant just roaming around the neighborhood, but...the property taxes are mini.",113,18,8,139,645,3348
It's where the president hires and fires his staff.,111,22,6,139,645,3774
Amazon is planning a new headquarters in the neighborhood.,112,20,7,139,645,3796
"And so, this is the house that I promised you and it is on the golf course!",108,28,3,139,645,6394
Some golf balls will occasionally fly through the door and windows.,109,19,7,135,645,2657
We just got wind of the idea of living here.,107,23,5,135,645,2731
"Yes, the house is a bit expensive, but it comes with a golf club membership.",106,25,4,135,645,3065
"I guarantee if we can close on this one, I can get a restraining order on Mr. Quixote!",108,21,6,135,645,5989
"A ""white elephant""? No, no...this is one of Mr. Quixote's dream properties.",106,25,4,135,645,6285
Now let's talk about the elephant in the community.,110,17,8,135,645,6676
How did we get this small?,109,19,7,135,645,6684
"No, the wooden shoes are extra.",106,25,4,135,645,7103
"Except for your neighbor Don, it's a relatively quiet neighborhood.",107,23,5,135,645,7162
You'll have a ball here. I guarantee it.,108,21,6,135,645,7537
The Jonathan Swift Tournament only happens once a year and you can sell electricity back to the power company all year round.,105,20,6,131,645,443
It's going to feel like a big upgrade from the volcano hole.,105,20,6,131,645,3621
"Remember, if you're not happy, what goes around comes around.",100,30,1,131,645,3804
"Oh, don't worry about that, it never gets windy here""",106,18,7,131,645,3870
It's within walking distance of the laughing clown hole,105,20,6,131,645,6237
And you never have to worry about a power failure.,101,21,5,127,645,680
"It might take some getting used to, but it's the best I could find within your budget.",103,17,7,127,645,3531
And it's completely energy-efficient!,98,27,2,127,645,3671
. . . and it comes with an 'Indiana Jones' theme.,98,27,2,127,645,3816
With a place like this you don't have to feel guilty about climate change.,100,23,4,127,645,5064
No? Let me show you a cute two bedroom with solar,101,21,5,127,645,6407
Mega- Putt Putt will make golf great again.,104,15,8,127,645,6690
It's a putt-friendly neighborhood.,96,24,3,123,645,123
It's all a matter of timing - plus you won't ever need to put in central air.,96,24,3,123,645,1422
"Don't worry, this is Florida, the ball will never even come close to your new home.",99,18,6,123,645,2143
"Now remember, I told you that this house was well above par.",96,24,3,123,645,3786
"Yes, Sally, it's a very child-friendly neighborhood.""",93,23,3,119,645,326
An added feature is that there hasn't been a Don Quixote wanna be seen in the neighbourhood in over a decade.,96,17,6,119,645,346
A repurposed charmer with the right size and a bit of foot traffic.,91,27,1,119,645,1055
Welcome to our open house -- I think you'll like the new wind turbine technology,93,23,3,119,645,2390
And it's off the grid.,94,21,4,119,645,2872
You won't have as many visitors on windy days!,92,25,2,119,645,3771
"Yeah, it’s above market rate, but we’re talking 100% renewable energy, a one-hole golf course, and no elephant in the room.",97,15,7,119,645,5531
"Well, it's a bit breezy, but there's free electric.",94,21,4,119,645,6791
"And we can insure you against a hole in one,  for a small additional cost.",126,22,8,156,645,4259
"Sure, it's a gated community, but you'll find it takes a lot of balls to keep this place going.",94,14,7,115,645,2258
"Well, getting this one off the market should be a breeze!",89,24,2,115,645,5786
But do you really want to go in or out when it's windy?,93,16,6,115,645,6001
"Now, you're certain you want to go with the crocodile over the windmill?",119,29,4,152,645,182
It’s a Dutch Auction,119,29,4,152,645,3488
The savings on electricity alone will pay the mortgage.,118,24,6,148,645,2769
"This listing is just your mortgage and taxes, no electricity bills",86,23,2,111,645,6819
I wouldn't worry about the windmill or the elephant; Bob the graffiti artist is the real problem.,112,29,3,144,645,6760
It's perfect for puttering around.,84,20,3,107,645,2467
"On the contrary. There's nothing ""mini"" about it.",82,24,1,107,645,7526
I’m personally drawn to the historic picket fence “in the round” as an uplifting admonishment to mindfulness.,110,26,4,140,645,4305
"Each resort is different. Ivanka's has a ""Rue de Rivoli"" theme. Donald Jr's. is a big game hunt... and this is Eric's.",114,18,8,140,645,4549
So what exactly were you doing when you got hit by the golf ball?,112,22,6,140,645,6746
We offer all of the joys of downsizing while guaranteeing the best facilities for an active lifestyle.,111,24,5,140,645,7098
Downsizing may be the right move for you.,106,27,3,136,645,72
"It's move-in ready, and the water hazard is perfect for entertaining.",105,29,2,136,645,393
"Well,Mr and Mrs Quixote,at least your utility bills will be low!",109,21,6,136,645,3313
Guaranteed to be Don Quixote safe.,104,31,1,136,645,4173
You have .03 seconds to get out the door before...,107,25,4,136,645,5256
Aside from the giant golf balls occasionally hurdling into your living room it's a calm neighborhood.,106,27,3,136,645,5476
"On the plus side, you're well protected by the loop-the-loop out back.",108,23,5,136,645,5782
"It's a prime location, and fantastic view, but I must warn you about the first floor.",108,23,5,136,645,5982
No worries at 20 Mph you have just a 0.4 chance of being hit,105,22,5,132,645,865
The good news is you’ll get a break on your flood insurance.,105,22,5,132,645,1437
It’s still your turn.,104,24,4,132,645,4704
"...not to worry, everyone misses this putt. Think of the electricity you will save!",104,24,4,132,645,5769
The blades are new but the old guy and donkey are original,105,22,5,132,645,6373
It's quieter in the winter.,106,20,6,132,645,6888
"Well, this is pretty much what's available here in Brobdingnag.",103,19,6,128,645,490
"Yes, membership is included in the condo fee. But you supply the balls.",103,19,6,128,645,1712
"Look at it his way.  Yes, there is noise, but you get to take a renewable  energy credit for the entire purchase price.",102,21,5,128,645,2017
...and the lower level has an open floor plan.,101,23,4,128,645,2903
"Now, the option to take on the role of village miller is open, of course. Or you could provide electricity for the village.",101,23,4,128,645,4804
"Yes, and the rate varies, just like your mortgage.",102,21,5,128,645,4939
Figuring out when to run through the door will keep you in great physical and mental health!,99,27,2,128,645,6691
Your utility bills will be dirt cheap!,96,26,2,124,645,147
"It's a new take, so to speak, on ""Going Dutch.""",99,20,5,124,645,2262
So you say that the damage was caused by golf balls the size of hail?,99,20,5,124,645,2945
Real Estate - it's all about location and timing!,100,18,6,124,645,3100
"...And depending on your handicap, you may be eligible for discounts on your closing costs.",96,26,2,124,645,3456
"Don Quixote moved away, so it's very unlikely you'll get tilted at.",96,26,2,124,645,4135
It's powered by political speeches.,102,14,8,124,645,4931
I understand....but the fees alone will pay half the mortgage!,98,22,4,124,645,6282
The best time to buy is when the blade is directly in front of the hole.,102,14,8,124,645,6850
It's a classic eighteen.,99,20,5,124,645,7525
"And, of course, it comes with a view of the seventh fairway...",122,25,6,153,645,1821
It's a great little house to live in. Don't mind the occasional golf ball through the living room however...,120,29,4,153,645,6659
You said you wanted a large entertainment area...,95,21,4,120,645,116
"The neighborhood does get a lot of tourist traffic, but birthday party crowds end by 6:00.  It'll be fine.",94,23,3,120,645,640
"To get the most out of your Airbnb experience, make sure to post a photo from this exact location including the hashtags ‘wanderlust’, ‘liveauthentic’ and ‘windmillvibez’",96,19,5,120,645,1845
"The finance rate is below par, unlike your last round.",97,17,6,120,645,1997
"The only thing that's a little tricky, is one's timing entering the place.",96,19,5,120,645,6606
No you can't keep the balls.,95,21,4,120,645,7030
It runs on the hot air from Trump's Twitter feed.,120,22,7,149,645,6753
It's better than solar panels.,114,27,4,145,645,1307
"I mean, who doesn't like charm, right? Plus, the hipster-techies haven't discovered it yet.",113,29,3,145,645,1770
"Yes, the wind-power is an attractive feature, but we really prefer solar paneling.",115,25,5,145,645,4102
...and it comes with its own putting green,90,24,2,116,645,6323
"Granted, the front doorway is a bit tricky, but the home is rated a net zero energy consumption.""",111,26,4,141,645,3357
But what about the gaping hole in the yard?,111,26,4,141,645,5628
And the HOA covers any damage from golf  balls.,89,19,4,112,645,975
"Not only does it come with the wind turbine, it’s located on a par 2 with easy flow through on the first floor.",90,17,5,112,645,5315
"Outside of the one tragedy, though, the kids love playing 'Indiana Jones.'",88,21,3,112,645,5652
This little wind farm fixer-upper is a real steal.  Zero electricity bills. DYI flour grinding offset.  Don't get me started.,93,11,8,112,645,5806
want to try running between the blades?,89,19,4,112,645,6891
"Solar panels? No need, the turbines on this puppy generate enough mega-putts, err watts to light up the whole back nine.“",90,17,5,112,645,7308
Moving into this house will requires an accurate split second decision.,89,19,4,112,645,7560
"Downsizing, but still looking to have a ball?",107,27,3,137,645,459
I know what you're thinking. The Jolly Green Giant used to play miniature golf here. But think of the celebrity value.,106,29,2,137,645,854
I'm sure you can score some points on the mortgage.,109,23,5,137,645,932
This hose features free electricity - And grinds your Coffee beans,108,25,4,137,645,1097
"The good thing is, very few balls come rolling through.",108,25,4,137,645,2918
Interesting note: all the houses on this block were constructed by the same builder.,106,29,2,137,645,5377
Let me take you around back and show you the in-law suite.,108,25,4,137,645,6521
The previous owner reported packages going missing.,107,27,3,137,645,7390
"No, I agree, it’s weird the hole is that big. It’s like it was designed by somebody who spent his entire life in Manhattan and has no idea what one of these is actually supposed to look like.",107,20,6,133,645,415
"I would show you the community gardens, but there’s a hole in one.",107,20,6,133,645,1642
"Yeah, bottomless. I would not go near that thing.",106,22,5,133,645,2276
It has everything you were looking for... you just have to be quick going in and out.,106,22,5,133,645,5191
It's just your run of the mill mini-golf course,106,22,5,133,645,5489
"As with any sale, it’s all in the timing.",105,24,4,133,645,6047
"You get low monthly utility bills, plus the best seats for this short par 4 hole!",81,21,2,104,645,4779
"Like many in his line of work, Biff found the golf ball damage endorsement to homeowners policy practically sold itself.",103,21,5,129,645,331
"If I did not know you better, I would say you are skeptical.",103,21,5,129,645,860
"You'll love it here, but run for cover when you hear them say ""fore"".",101,25,3,129,645,1314
It is a great house and your timing couldn't be better.,103,21,5,129,645,2509
Most people find it hard to downsize.,101,25,3,129,645,2592
You'll save on electricity,101,25,3,129,645,3247
"The owners wanted me to emphasize that, if you buy, you will automatically be added to the list of plaintiffs in the class action case against the architect and builder.”

George Mesritz, Birmingham M",105,17,7,129,645,4462
Full disclosure: You will either get a wonderfully cool breeze on a hot day -- or be sucked right out of the house!,103,21,5,129,645,4551
"Do not worry about the lack of wind, it runs on oil anyway.",103,21,5,129,645,4949
'You did say you wanted a green lifestyle!',100,27,2,129,645,5145
They can always be retrofitted with solar panels,102,23,4,129,645,5380
It's a steal! Half its original value because the previous owners were crushed by a hole in one.,100,27,2,129,645,5986
"And the HOA covers all exterior scrapes and dents, ice cream and soda clean up, and of course the occasional gum removal.",102,23,4,129,645,6698
Are you looking to rent or buy a hole?,124,23,7,154,645,7180
It has the old Amsterdam look.,98,24,3,125,645,125
"It dries your laundry quick and efficiently, it's part of the green alternative!",100,20,5,125,645,837
I think you'll find this strikes the right note of middle aged whimsy.,100,20,5,125,645,1024
"When the wind blows,you have enter and exit quickly.",100,20,5,125,645,2191
It's the perfect home for couples whose golf game plays an outsized role in their lives.,101,18,6,125,645,3019
Yes the homeowners association allows elephants as pets,122,20,8,150,645,3684
"Waive the inspection, and the house is yours.",100,20,5,125,645,3860
The price also includes a giant putter.,121,22,7,150,645,5544
Welcome to Ministure Golf Estates!  This the famous Hole #9!,100,20,5,125,645,7171
"You already know your neighbors...we have Lucy the elephant, the little old lady who lives in a shoe, the pig in a brick house... what more could you possibly want?",116,25,5,146,645,768
Do you want to fight climate change with us?,115,27,4,146,645,825
I suggest letting a small child check when it's time to exit,116,25,5,146,645,4127
The best part? You’ll have a lifetime supply of golf balls.,118,21,7,146,645,4224
This two bedroom unit  has the best view of the 18th hole.,114,29,3,146,645,4232
This is one of our more 'affordable' properties,114,29,3,146,645,6513
Full disclosure?...giant golf balls are a periodic problem,96,21,4,121,645,765
The good news is that your house will sell easily when we find a Spanish lunatic with money and a side-kick.,97,19,5,121,645,2399
And it will be such fun on windy days.,96,21,4,121,645,2400
"Utilities are a breeze, and we'll even throw in an elephant for your little girl.",94,25,2,121,645,5167
"So far, everyone I've shown this house to has been bowled over.",95,23,3,121,645,7143
"Of course, it won't turn!",94,25,2,121,645,7489
"Did I say it was a Victorian? Well, I lied.",114,22,6,142,645,2196
Only on  VERY windy days does it exceed 40 RPM.,113,24,5,142,645,2844
Only you will separate the wheat from the chaff.,110,30,2,142,645,4823
"At least, in this one, the bathroom is inside.",112,26,4,142,645,5788
It's perfect for entertaining.,96,14,7,117,645,606
"as I said on the phone guys, this property is an Airbnb cash generator...",94,18,5,117,645,2250
And they allow putts!,94,18,5,117,645,3619
what elephant?,94,18,5,117,645,5429
We like to think of it as intermittent security.,93,20,4,117,645,5721
At least the elephant isn't in the room.,91,24,2,117,645,5936
"It has granite countertops, stainless steel appliances and it’s energy efficient.",93,20,4,117,645,6580
"Yes, we're a gated community, but we remain open to everyone",92,22,3,117,645,7036
I’m sorry. I know you’ve been putt through a lot.,94,18,5,117,645,7461
I’m sorry to say wind is “out” and coal is “in”,108,27,3,138,645,861
I have to ask you about something that has been known to turn some people away. How do you feel about large dimpled balls rolling through your living room?,113,17,8,138,645,1214
"It's our deluxe Don Quixote model, but I must warn you, the floorboards are tilted.",107,29,2,138,645,4516
The neighborhood doesn't like to mention it,108,27,3,138,645,5821
Classic design and sustainable,91,17,5,113,645,251
And you get a free year of golf privileges.,90,19,4,113,645,2947
And on this unit the utilities are included!,108,20,6,134,645,698
"Full disclosure, there is a knight in the neighborhood in search of a quest.",107,22,5,134,645,1397
And membership to our exclusive golf club comes with the purchase of any home in this fine gated community.,104,28,2,134,645,4490
That's right. They used to use these a long time ago-back when we actually did stuff.,104,28,2,134,645,5643
"Well, yes, but it comes with a security system that keeps almost everything out.",122,29,4,155,645,5971
"You said your last name was Miller, right?",123,27,5,155,645,7449
Don't think of it as mini golf. Think of it as maxi golf.,87,18,4,109,645,2219
"On the bright side, it's free if you get a hole in one.",88,16,5,109,645,7250
"On the plus side, it's Castle-adjacent.",103,23,4,130,645,448
Now this one is definitely in your budget and will save you a good chunk of cash on electric bilks.,102,25,3,130,645,1324
And it includes all the free golf you want!,105,19,6,130,645,1842
"You'll have to update the electrical, of course.",104,21,5,130,645,1932
It's a steal...free AC and and freshly ground millet every day!,102,25,3,130,645,3364
"And other benefit, about every 15 seconds you get a moment of shade from that summer sun!",103,23,4,130,645,5819
"No, no, no. No handicaps.",103,23,4,130,645,6027
"Here's your white picket fence.  Unfortunately, the carpenter that installed it has astigmatism.",103,23,4,130,645,7391
The golf ball rarely makes it.,119,28,4,151,645,6532
Sure the entrance may be a challenge but the interior is worth it,121,24,6,151,645,6696
"It's a lovely location near the course, but you can expect a occasional golf ball in your yard.",117,25,5,147,645,92
The short bursts of high-intensity exercise required to come and go means you won't need to renew that expensive gym membership.,118,23,6,147,645,533
"Once we install the door and thermal windows, this baby will create all its own power, every day the wind is over 20 mph!",103,16,7,126,645,1318
"I like to say ""it has character.""",115,29,3,147,645,1410
"It's got a golf course, an open concept, and it runs entirely on renewable energy so forget about paying for air conditioning""",82,21,2,105,645,2542
"Energy savings aside, you also get discounts on ALL golf equipment!",102,18,6,126,645,2760
"Every time there's a hole in one, you get a free mortgage payment.",100,22,4,126,645,3048
This home's energy usage footprint is miniature.,101,20,5,126,645,4071
"The rent is low, but you must provide your own wind",103,16,7,126,645,4129
Think of it as a Dutch Ante-Colonial,101,20,5,126,645,4757
I see upsides and downsides.,117,25,5,147,645,5411
It's the latest trend in vacation rentals...,104,14,8,126,645,6143
"On the contrary, the balls help keep the pigeons and mice from nesting in there.",102,18,6,126,645,6449
"I must say, it does get a little breezy. But, don't worry it's not like a giant ball is going to roll on through.",100,22,4,126,645,6528
...and the seller is willing to offer you a mortgage with convenient revolving loan features.,101,20,5,126,645,6939
"Can you believe they call it ""mini golf""?",116,20,7,143,645,1585
And it comes with the original grinding wheel!,112,28,3,143,645,2582
An idea this good shouldn't be left just to miniature golf.,98,19,5,122,645,1256
Electric included.,94,27,1,122,645,2976
The neighborhood's got a great club scene. Your kids'll love it.,95,25,2,122,645,3963
The owners are confident that the water problem has been resolved.,100,15,7,122,645,4115
"You said you wanted to live near a golf course. Well, how about in a golf course?",98,19,5,122,645,4695
Oh and the AstroTurf fees are included!,98,19,5,122,645,4997
"The windmill provides all your electricity, but that’s par for the course in these parts.",96,23,3,122,645,7416
"....and when the wind starts, then is when the fun begin!",92,24,2,118,645,5363
It's the green energy of the future.,106,26,3,135,645,168
Dutch architecture and comes with two free putters.,105,28,2,135,645,700
"If you think about it, it makes perfect sense.",107,24,4,135,645,953
"On a breezy day, you can get all the power you want out of this baby!",108,22,5,135,645,1161
The downside; you have to sync your exits with the wind.,109,20,6,135,645,2757
Welcome to maxi-golf,111,16,8,135,645,4898
"It is a great investment property, and ironic the previous owners were lost in an unfortunate clean energy accident.",108,22,5,135,645,5111
The impossible dream can be yours forever with a small down payment today.,110,18,7,135,645,6899
"Just go inside if you see any giants, and be sure not to fall into the hole.",94,13,7,114,645,2723
You'll have a ball!  Perhaps many even...,90,21,3,114,645,6317
"This is a clean energy Obama-era hole.  I can also show you a Trump-era hole that I am assured is swamp-free and has, what I'm told, the greatest invisible wall to ever exist.",93,15,6,114,645,7032
It's a Par-3-bedroom and you're just a hole away from a waterfall.,104,23,4,131,645,208
This isn't exactly what we had in mind when we said we were interested in a course-front property...,102,27,2,131,645,1049
Just wait until you see the club house.,102,27,2,131,645,1603
Just think of the environmental impact it would have.,104,23,4,131,645,2224
Wait til you see the breezeway!,105,21,5,131,645,2904
the couple who moved into the clown's mouth were never seen again.,103,25,3,131,645,3427
"Unfortunately, we lost the knight to the black hole.",103,25,3,131,645,4085
I think you'll find this a very enthusiastic sports town.,108,15,8,131,645,4210
"Mysteriously , the prior owners had reoccurring concussions 
So they sold  and moved to a facility.",105,21,5,131,645,4586
This location is a real hole in one.,108,15,8,131,645,5427
it might not have a view but it's got a breeze,104,23,4,131,645,6924
"When I said golf Course, I meant MINIATURE golf",105,21,5,131,645,7230
It’s the only lot with air conditioning and a view of the elephant.,106,19,6,131,645,7523
Well I did tell you it was right on the fairway didn't I?,119,23,6,148,645,167
"As your realtor, I have to say it’s a real hole in one.",116,29,3,148,645,573
It comes with a closet full of wooden shoes!,120,21,7,148,645,6264
Are you easily freightened by giants?,118,25,5,148,645,6979
This neighborhood is zoned for  minigolf. These residential units are accessory.,100,24,3,127,645,495
It means you can burn all the fossil fuels you want while appearing to reduce your carbon footprint.,100,24,3,127,645,660
How many baths?  That's yur question,106,12,9,127,645,1765
Don Quixote used to imagine living here.,102,20,5,127,645,1851
Church of the Ladder Day Saints,103,18,6,127,645,1930
"We'll start the ball rolling and if something goes wrong, you'll take a mulligan.",98,28,1,127,645,2073
"Plus,you get comped for miniature golf",102,20,5,127,645,3557
"The place isn't furnished, and occasionally a large golf ball might roll through the middle of the house.",99,26,2,127,645,4238
And downtown is just a short drive away.,100,24,3,127,645,4304
"I have no idea why there is an elephant in this neighborhood, but it hasn't at all depressed home values.",99,26,2,127,645,5414
The architect took inspiration from the most unique golf venues.,101,22,4,127,645,5512
I think it is time you putt aside your differences,101,22,4,127,645,5695
"We found out Mr. Quixote hates putt-putt, so it's really a safe place to live.",102,20,5,127,645,6110
Financing will be a hole in one,101,22,4,127,645,7346
"No the hole doens't count towards the square footage, but that doesn't mean you can fill it in.",113,28,3,144,645,1155
It has more square feet than your home in Lilliput and none of the zoning restrictions of that dollhouse across town.,85,17,4,106,645,4508
"And of course, the lawn never needs mowing.",97,23,3,123,645,4506
I’d recommend life insurance.,98,21,4,123,645,4522
"Plus, it boasts the newest in security systems",95,27,1,123,645,6602
The 17 neighbors make this a real hole-in-one community,113,21,6,140,645,118
Just wait until you see the master bedroom - I guarantee you'll be bowled over.,112,23,5,140,645,436
Well are you here to buy a home? Or are you just putzing a round?,114,19,7,140,645,1676
They all have central air!,110,27,3,140,645,3274
Nothing beats an investment in Texas mini golf.,114,19,7,140,645,3699
"Quirky yes, but definitely not the white elephant of the neighborhood.",111,25,4,140,645,6108
The price is right. Call me if you're interested; my name is Gulliver.,108,24,4,136,645,1441
One person's heaven is another's hellhole-in-one.,95,20,4,119,645,1742
On the bright side it is completely energy self-sufficient.,94,22,3,119,645,1936
The trades offs here are low energy costs but you have to be nimble.,108,24,4,136,645,2767
"Once you learn to avoid those spinning things, poop in that hole, and avoid the large white ball, it's a winner.",123,24,6,153,645,2823
"Yes, a balloon payment at the expiration of the mortgage is par for the course",110,20,6,136,645,2979
Don't worry. The golf balls are made out of foam rubber.,108,24,4,136,645,3129
With this one you won't need a Security System.,110,20,6,136,645,3268
This home actually comes with your own personal driver.,96,18,5,119,645,3346
This wasn't what Barbra meant by 'swingers club',95,20,4,119,645,4790
"Yes they decapitate, but other than that it's a hole in one!",107,26,3,136,645,4809
It's great for couples who like working on a tight schedule.,108,24,4,136,645,4849
"And best of all, the view overlooks the golf course.",97,16,6,119,645,4911
I'm not the biggest fan of the facade.,108,24,4,136,645,5124
It's an upgrade from the shoe box.,111,18,7,136,645,5459
Think of the money you will save on air conditioning costs!,122,26,5,153,645,6102
"It's a bit drafty in the winter, but the cross breeze in the summer is out of this world!",108,24,4,136,645,6220
The advantage of purchasing a new home on a miniature golf course is never having to mow the lawn.,92,26,1,119,645,6498
Now that that's done...should we have the champagne here or by the glow-in-the-dark mermaids?,96,18,5,119,645,6666
"The grass is always very well kept, promise.",96,18,5,119,645,6909
"No no no, it’s a mini swingers club...",95,20,4,119,645,6987
Down size your Golden Years here at Mature Golf Estates,109,22,5,136,645,7408
Hi!  Wecome to Lille-PUTT Homes!!,118,27,4,149,645,2515
Unfortunately the hazard insurance does not cover man-made obstacles.,107,19,6,132,645,3916
You won't have to pay a cent for air conditioning.,105,23,4,132,645,4312
"The CC&Rs clearly state all balls are returned, cleaned and cannot be sold to outside parties.",102,29,1,132,645,5624
Just remember this offer will close when the next blade covers the doorway.,105,23,4,132,645,6703
"It’s a really nice house, I’m glad you guys are interested. Just one thing, don’t fall down that hole, it’s a gate to hell.  Yeah I know, I was surprised too",107,19,6,132,645,7556
Bed by 9? No worries!  They're usually too drunk by 8 to make the shot.,92,19,4,115,645,5268
"On the plus side, it will keep your air conditioning bills low",92,19,4,115,645,6640
The kids are going to kill us.,115,26,4,145,645,3907
"It has wind powered electricity, and  
a putting green",100,26,2,128,645,22
...and Babar brings the clean coal energy everyday to heat the church and power the windmill.,104,18,6,128,645,1390
You’ll get to see a lot of cheating.,101,24,3,128,645,1400
"...and because you're on the 18th hole, you'll never hear a ball hit the bottom of the cup.",100,26,2,128,645,2521
Plus...the property has the newest tech in wind turbines,99,28,1,128,645,2932
You simply need to time this home's entrances and exits and don't forget about the hole.,102,22,4,128,645,3597
"You've got your breezes...
You've got your whimsy...
You've got your social consciousness...

Say the word and you'll have you your mortgage",103,20,5,128,645,3887
The renewable energy technology is time tested.,105,16,7,128,645,3976
Windmill on the Golf Course !!! Did the listing fail to mention that it's a mini-golf course,103,20,5,128,645,4395
I think we prefer the hillside house on the eleventh tee.,102,22,4,128,645,7266
"Sure you can afford it if you go ""Dutch treat""!",102,22,4,128,645,7299
"No doors or windows and a wind generator; we put the ""air"" in Airbnb!",90,16,5,111,645,3133
Mr. Trump promised the biggest miniature golf course ever.,92,12,7,111,645,7013
"Aside from the gigantic golf balls, it’s a very safe neighbourhood.",113,23,5,141,645,693
No issues whatsoever 9pm to 9am when you're home from work.,113,23,5,141,645,742
Chances of it stopping in front of the door is roughly 1 in 679. We have wind 55% of the time.,111,27,3,141,645,842
"...and all the excess electricity you generate will be sold to light the castle, so you'll actually end up ahead.",111,27,3,141,645,5626
"Believe it or not, tiny houses are still in.",112,25,4,141,645,5924
Just grind flour until the wind stops.,113,23,5,141,645,6273
It's kind of a 'Whack-a-mole anti theft protection . . .,98,23,3,124,645,1386
"It's a great location with a lot of foot traffic and, as a bonus, a constant supply of golf balls!",99,21,4,124,645,1428
"Okay, it does get a bit drafty...",98,23,3,124,645,2424
It's the newest thing in security systems for ungated communities.  We just haven't figured out yet who we're trying to keep out.,100,19,5,124,645,3369
It also comes with it's own driving range!,98,23,3,124,645,4389
We prefer the term ‘cosy golf.’,100,19,5,124,645,5161
"The home is 100% green, powered by wind.",99,21,4,124,645,6119
"If you can get past the giant rolling balls, and the crazy Spanish neighbor, this is the perfect starter home for you.",97,25,2,124,645,6639
Pre-industrial revolution is all the rage these days.,99,21,4,124,645,7314
"This place is a bit out of your price range, but the interior will blow you away",97,25,2,124,645,7333
"Well, we are in Holland......",110,22,5,137,645,2531
Your brother was likely happy when he met his end; he WAS 3 under par.,110,22,5,137,645,2860
"So this one is LEED certified, carbon neutral.",108,26,3,137,645,3095
"I assure you, you will barely hear the whirring and it will generate enough electricity to take you off the grid.",107,28,2,137,645,4314
And if you close by Dec 31 you get the full 30% renewable tax credit!!!,110,22,5,137,645,5520
It's a great neighborhood as long as you can avoid the sand trap.,109,24,4,137,645,5852
Your timing is perfect! You'll have a ball in this place!,98,16,6,120,645,36
"Admittedly the traffic is a bit annoying, but you do get a large front lawn and complete golf privileges.",94,24,2,120,645,206
"It's near churches, schools, attractions, 2 parks with covered bridges,  who cares if a golf ball goes through the 1st floor once in a while.",119,27,4,150,645,1396
The windmill serves as a power generator and a theft deterrent.,94,24,2,120,645,1961
"Well, you just look sharp before you try to go through the doorway.",94,24,2,120,645,3509
"Frankly, I don't think you can lift the club!",95,22,3,120,645,4281
So you're thinking of downsizing?,96,20,4,120,645,4326
"No air conditioning necessary, as it comes with steady breezes in every room...",95,22,3,120,645,4833
It comes with central air conditioning.,95,22,3,120,645,5027
It puts out enough power for the whole property.,97,18,5,120,645,5513
This one keeps the elephants out without cutting off your ventilation.,98,16,6,120,645,7445
And the A/C is free!,105,25,3,133,645,1211
The downside is I won't be able to offer you life insurance if you go with this one.,107,21,5,133,645,3673
I can arrange for a fixed rate mortgage on the volcano.,108,19,6,133,645,5604
"No, I don’t think it is a par three.",83,16,4,103,645,3399
...And I’d like to add that this is one of Don Quixote’s personal favorites.,115,28,3,146,645,4322
"That's how we trap elephants here in Holland.
They come to look at the windmills, and then they fall
down the hole.",94,17,5,116,645,2981
"Great schools, church nearby, and a very close-knit community.  This home meets all of your requirements and is well under your max budget, which will allow for occasional repairs from golf ball damage.",95,15,6,116,645,3131
"Don’t worry folks, lots of people tell me they thought it was on the 10th hole.",91,23,2,116,645,4933
"Sure, it’s a little distracting, but the summer cross-breezes are amazing.",124,33,2,159,645,4255
"And the best part, there's an Amazon headquarters opening up right around the corner!",127,27,5,159,645,6170
"Living in a resort community, you will need a guest house for unwanted guests.",103,22,4,129,645,76
The ball and club are extra......,104,20,5,129,645,423
The builder of this one liked to putter around.,102,24,3,129,645,1403
"Oh yes, it’s a busy neighborhood. You’ll have a ball.",104,20,5,129,645,2340
Living on a golf course isn't all that it's cracked up to be.,103,22,4,129,645,3304
I guarantee this listing is a hole-in-one.,103,22,4,129,645,3373
And you can mill corn.,102,24,3,129,645,3669
You mentioned this is a gated community?,104,20,5,129,645,3710
You said you like an open concept.,102,24,3,129,645,6393
It's Dutch!,113,25,4,142,645,85
"If you're interested, you need to put-put an offer in, right away.",115,21,6,142,645,615
Just think of the savings in air conditioning.,112,27,3,142,645,5090
"Naturally, at this price point, some modest, cosmetic remodeling is to be expected.",115,21,6,142,645,6130
"After reviewing your policy, I don’t see anything that covers golf balls as big as large hail.",124,26,5,155,645,1573
And all that electricity you're generating powers the hot tub in the back yard...,122,30,3,155,645,4084
Keeps the elephant out.,93,12,7,112,645,2133
The price is reduced due to the decline in popularity of golf.,91,16,5,112,645,2664
"In real estate, timing is everything.  Don't worry about the elephant, he just putters around the neighborhood.",91,16,5,112,645,7406
Your timing must be impeccable.,99,23,3,125,645,4006
"No down payment; no maintenance fees; no property taxes. Also no windows, no doors, and no living on the first floor thanks to the whole Giants-with-golf-clubs thingie.""",103,15,7,125,645,4096
As first time players you should go Dutch.,100,21,4,125,645,4156
"I wouldn't worry about the golf balls, but the neighbor's elephant can be quite the nuisance.",100,21,4,125,645,4567
Want to see the 17th hole,102,17,6,125,645,5366
"And the best part is that when the wind dies down, you've got a better than 50/50 shot at getting in to enjoy those amenities.",99,23,3,125,645,7352
This is way nicer than the clown house for sale down the road.,109,26,3,138,645,2
"Hey, what's not to love?!",111,22,5,138,645,1046
"Sorry I'm running late, I exited the wrong beanstalk.",112,20,6,138,645,1359
"Well yes, the rent is a little high, but you get to keep any golf balls that come in your doorway.",109,26,3,138,645,1939
I'd recommend always using the back entrance to exit your new home.,112,20,6,138,645,2765
"You mentioned you were a golfer
This beauty faces the6th hole!!!",111,22,5,138,645,3605
"This place fits you to a tee, has free maintenance, doesn’t take much green, and, it is super quiet at night.",112,20,6,138,645,3975
"...but who´s to say that you are spoiling your kids too much, anyway?",110,24,4,138,645,4033
It's a great deal! You just need to watch it on the entry and exit.,111,22,5,138,645,4229
On-the course properties in your price range sell out quickly...,111,22,5,138,645,5801
Since you told me you are swingers...,111,22,5,138,645,6327
You'll find it's all done in mid-century mini-golf.,87,17,4,108,645,5203
Think of your savings living in a home entirely powered by wind energy.,98,18,5,121,645,267
Haunted by an imaginary elephant? Ludicrous.,97,20,4,121,645,1628
Putt down only 5% and the windmill hole can be yours.,96,22,3,121,645,1706
This house has the perfect defense against the one eared elephants that are lurking in the neighborhood.,99,16,6,121,645,5022
"Think of it as a lifestyle choice, living on a golf course.""",97,20,4,121,645,7376
The prior owner knew what hit him.,108,21,5,134,645,604
And the sweetest part about it -- it's a free game every time you get a hole in one.,104,29,1,134,645,1080
Wait until you see the detached garage.,108,21,5,134,645,1383
This maxi golf course is included in the association fee ... and wait 'til you see the giraffe.,107,23,4,134,645,1717
It’s below market value and has a great location. What more could you ask for?,106,25,3,134,645,2339
It used to be a time share.,108,21,5,134,645,3459
Two custom putters are included in the sales price.,106,25,3,134,645,4032
"Please, I’d never suggest you consider living on a MINIATURE golf course.",106,25,3,134,645,4675
"Utilities are the best,  electricity is included..",107,23,4,134,645,5321
I gaurentee this place will blow your socks off,106,25,3,134,645,5758
You need to buy now; the timing' is perfect.,109,19,6,134,645,6069
We call this section of the sub-division our Quixotic Line.,108,21,5,134,645,6440
The elephant ghost is friendly. Not sure who attends the miniature church next door.,108,21,5,134,645,7082
"Yeah, it is environmental but I was kind of hoping for more of a mid-century modern.",105,27,2,134,645,7326
We're getting a serious offer every 10 seconds,117,26,4,147,645,3121
Think you'd be willing to go Dutch?,121,18,8,147,645,3805
You should make an offer today.  The tiny house trend and the 7th hole view means this home will be under contract by tomorrow night.,92,23,2,117,645,707
Here at Tiger Woods Developments we pride ourselves on the presentation and practicality of our wind-powered homes.,93,21,3,117,645,807
It's the latest in home security and a wind powered electrical generator.,94,19,4,117,645,1039
It's on the market because the previous occupant died from a sports injury.,96,15,6,117,645,1367
"It's got loads of periodic cross-ventilation and if you get it in the clown's mouth, I'll knock a full point off closing.",84,16,4,104,645,2042
It’s quite the bargain if you don’t mind a few golf balls on the weekends.,104,22,4,130,645,2082
Big sale was a typo.,103,24,3,130,645,2732
"Yes, I know it looks strange for a church, but we are Dutch and it Powers the Christmas lights.",102,26,2,130,645,2997
Wait till you see the view of the clown!,102,26,2,130,645,3405
There are 17 more just like it...,115,23,5,143,645,3491
"TV reception is great! And, you don't have to worry about door-to-door salesmen. If the winds die down, the guy next door—Don Quixote—sells flood insurance.",94,19,4,117,645,4642
This wind powered home is a real hole in one!,94,19,4,117,645,4670
"Just think of the money you'll save on energy""",122,32,2,156,645,4724
We’re calling it “Maxi-golf.”,126,24,6,156,645,6715
Puttering around the house?....fuhgeddaboudit,123,23,6,152,645,7184
Free electricity and ninja training.,111,24,4,139,645,1118
It keeps you alert.,112,22,5,139,645,2117
"The hole over there? Well, that's for when you forget the wind is blowing. The Gravestone is extra.",113,20,6,139,645,2413
Elephant?  What elephant?  I don't see any elephant.,109,28,2,139,645,2623
...and the solar power tax credit is the best part of the deal.,111,24,4,139,645,3535
"Look, in a hot market like this you can't get hung up on a little water in the basement.",112,22,5,139,645,4672
"It’s right on a golf course. In fact, its the 6th hole.",101,21,4,126,645,1896
"Actually, it did get the last occupant.",100,23,3,126,645,3523
The HOA does have strict covenants but it is a green powered par 2 in your price range.,100,23,3,126,645,4176
Here's a golf community that will bowl you over and sweep you off your feet.,102,19,5,126,645,6718
How much to spackle up the hole?,92,16,5,113,645,1063
If you buy this we'll throw in a white elephant.,93,14,6,113,645,5963
It nails each of your requirements: sustainable and overlooking the 14th green.,90,20,3,113,645,7522
You will be creating your own electricity while drying your clothes- all done by the wind!,80,17,3,100,645,1356
"It has everything you want: it's close to a school,there's wildlife nearby,it's a tiny house,and it makes its own power.  You just have to watch for the giant pock-marked boulders that occasionally roll in.",117,28,3,148,645,6508
I can't tell you how many people dream of living the mini-putt lifestyle.,107,25,3,135,645,175
"The HOA stipulates no full swings, and the landlord is kind of a clown, but the snack bar is great.",109,21,5,135,645,1457
There is no elephant in the room!,110,19,6,135,645,2023
Think of all the money you will save on power bills.,109,21,5,135,645,4184
"Personally, I feel location, location, location is very old school.",107,25,3,135,645,4532
It's all about timing and low price.,108,23,4,135,645,6993
"So, inclusive of taxes and hole-in-one insurance, the payments are still within your budget!",112,15,8,135,645,7323
The other eight holes have a much higher cost per square foot.,99,18,5,122,645,361
It's more than made up for by the electrical buyback.,97,22,3,122,645,1530
"The  Price is right,       Just be careful going in and out",98,20,4,122,645,2065
These Condos were designed by Gary Player.,97,22,3,122,645,2095
"It has that ""Windmills of my Mind""  vibe .",98,20,4,122,645,2441
"The house is a bit drafty, but the school's around here are amazing.",98,20,4,122,645,2447
When there is a windy sermon across the street this baby really turns.,99,18,5,122,645,2614
"Sure, there's a little noise from passing traffic, but you never have to cut the grass.",96,24,2,122,645,5424
At least there’s no HOA.,98,20,4,122,645,5706
"Well, you did say you were looking for a Spanish-inspired golf villa.",98,20,4,122,645,6524
"You're not only on the golf course, your house IS the golf course.",98,20,4,122,645,6970
"Now, on the count of 3, we will briskly walk through the front door after the blade passes.  A minor inconvenience living here off the grid!",88,17,4,109,645,2906
"Yes, but it's putting distance to the new Amazon campus.",86,21,2,109,645,6494
"Sorry, no comps in area to compare this to!",127,24,6,157,645,3632
"Now, about the security system!",114,27,3,144,645,3441
Will the rotating security gates keep the elephant out?,116,23,5,144,645,5466
This charming house is full of surprises.,114,27,3,144,645,6235
"Other than a decapitation hazard and marauding elephants, it’s a very nice home.  We can get it for peanuts.",105,22,4,131,645,2837
Amenities include exocentral air conditioning and all the miniature golf balls you can find.,105,22,4,131,645,3119
You've just crossed over into the Twilight Zone.,105,22,4,131,645,3650
"I'm sorry but its either this or the flaming volcano, everything else has been t-d up.",103,26,2,131,645,4478
"No worries, even if liberal climate-changers stop your winds, we’re colluding with a windy American who will blow your blades off.",106,20,5,131,645,5627
The previous owner got in Dutch with his bank.,104,24,3,131,645,5931
"Nah, you're safe. Only the pros can make this putt, and they never play here.",93,23,2,118,645,2983
It needs a little updating.,94,21,3,118,645,3161
"It's quite a private neighborhood.  You would go through the clown's mouth to visit your closest neighbors,",96,17,5,118,645,4126
How would you like to act out the Indiana Jones boulder scene every time you want to sit in the living room?,95,19,4,118,645,5112
"Living on a minigolf course has it's perks, and we do offer child kicking windmill insurance.""",94,21,3,118,645,6582
Just wait until you see the ballroom!,94,21,3,118,645,6994
...quiet neighbors and the HOA fees are much lower than in the Castle and Loop-de-Loop Districts...,94,21,3,118,645,7327
He won't come too close for fear of being truncated.,114,20,6,140,645,2461
And the best part of all is that it's all waterfront property.,110,28,2,140,645,3612
"Never mind that 'fee, fi, fo, fum.'  You're not English, right?",112,24,4,140,645,4897
"The occasional ball comes through the living room, but the bigger disturbance is the sound of clubs being smashed outside.",85,16,4,105,645,6330
"The one on the lawn is fine, just don't go into the one in the living room.",104,17,6,127,645,414
Just make sure to look before you exit the door.,101,23,3,127,645,2547
Can you believe the last owner didn't know what 'Fore!' meant?,100,25,2,127,645,3725
"It's the perfect dream house: a place to putter, have a cup of tee, and watch the world go 'round.  You'll have a ball!",103,19,5,127,645,4065
It's really famous.  The Jolly Green Giant once got a hole in one here.,103,19,5,127,645,4455
"This place has everything--wind power and location, location, location--church and exotic wildlife just steps away, and best of all, you can chip into the cup from your front door",100,25,2,127,645,5576
It has fabulous views of the 18th hole and the clubhouse hosts weekly fondues.,104,17,6,127,645,6435
Just imagine.  The peace and tranquility of your own backyard putting green.,100,25,2,127,645,7380
"Free golf and  green energy, a perfect home for the progressive golfer!",120,24,5,149,645,616
"The trick is, timing the market just right.",121,22,6,149,645,2245
Don't let the scale of this development intimidate you because all the holes on this course are very reachable.,93,16,5,114,645,1652
One feature of the property is the very convenient access to the 19th hole.,93,16,5,114,645,1829
"Full disclosure, there is a small possibility for giant balls to roll into the livingroom. But we installed a windmill to mitigate that possibility.",112,17,7,136,645,2243
It comes with reduced greens fees.,109,23,4,136,645,4761
"It's not about protecting your house, it's about supplying power to the entire community.",107,27,2,136,645,5435
"'""What strong winds?""",111,19,6,136,645,6093
Miniature golfers,108,25,3,136,645,6420
This is the new Trump miniature golf course.  Its designed to make you feel badder and just look at all the walls.,115,11,10,136,645,6755
You won’t find a better obstacle in this neighborhood!,109,23,4,136,645,6904
You'll love how many kids are in the neighborhood.,99,20,4,123,645,300
This home has a par 4 security system.,100,18,5,123,645,2071
"Not only will it generate all the power you need, you can sell the excess back to the power company!",99,20,4,123,645,2954
"There’s a bidding war for the 2nd floor apt, but you can move into the cup right way",98,22,3,123,645,3087
This is the perfect alternative to the country club properties we visited - these are really popular in Europe.,99,20,4,123,645,3853
It's even better than being on a golf course....you would be in one.,98,22,3,123,645,4768
Congratulations and best wishes. Watch out  for the man hole!,99,20,4,123,645,5382
It is the perfect white noise solution!,100,18,5,123,645,6259
"On the plus-side, it’s air-conditioned.",100,18,5,123,645,6453
"It's like that old punch line, ""Timing.""",101,16,6,123,645,6594
This is completely green and relatively quiet.,99,20,4,123,645,6735
"Yes, but with global warming you are sure to see more benefits from wind power.",119,19,7,145,645,3388
"This place is a steal - utilities included, and you'll never need AC!
What elephant in the room?",119,19,7,145,645,3908
This caretaker job comes with no insurance for obvious reasons.,110,14,8,132,645,120
And this garage is just perfect for puttering around.,88,19,3,110,645,172
Don't you think a 'No Solicitors'  sign would have been just as effective?,88,19,3,110,645,1210
Think big. Donald believes this will be a US Open venue someday.,106,22,4,132,645,2361
This house is absolutely loved by the wind millennial community.,108,18,6,132,645,2571
"An now, let's discuss the elephant in the room.",105,24,3,132,645,4417
I promise there's mammoth wheel estate in this area.,106,22,4,132,645,4439
It even has a built in security system,109,16,7,132,645,5065
No reason for a front door- another advantage of this property- beautiful yard too!,87,21,2,110,645,5388
It has a no solicitors option.,89,17,4,110,645,5890
The previous owner never realized it’s full tilting potential,104,26,2,132,645,6297
You'll want to keep that sinkhole.,91,13,6,110,645,7240
The architect got the idea while playing miniature golf.,115,20,6,141,645,617
"If this style isn't for you, I'd be happy to show you our clown face model.",112,26,3,141,645,1330
"Actually, the only real drawback of this great multi-story home is timing the windmill....and of course avoiding the occasional big white ball.",111,28,2,141,645,3447
Our new affordable living space will keep you feeling young AND keep you on your toes.,112,26,3,141,645,5908
"And  with a good wind, you have nature's own, fossil fuel free, air conditioning!",97,17,5,119,645,2319
"This is the intersection of golf, Manhattan, and your price range!",98,15,6,119,645,2360
"The listing's affordable, but the golf balls make home insurance a bit pricey.",94,23,2,119,645,2817
"The best thing about this place is if don't like the weather, wait two seconds.",95,21,3,119,645,4011
"This is the best residential property available on this golf course, and a bargain at the asking price.",94,23,2,119,645,6733
An addition benefit is no more unwanted requests for donations.,121,24,5,150,645,3290
The good news is this house is a real moneymaker.,100,27,1,128,645,200
"Now, this place has a beautiful, uninterrupted view of the green.",100,27,1,128,645,280
I would not leave anything breakable in the doorway.,99,29,0,128,645,418
"... And the neighbourhood handicap is 12, so there’s plenty of room for improvement.",103,21,4,128,645,1339
You’ve always wanted to live near a golf course.,104,19,5,128,645,1512
This property is self-powered and self-draining.,103,21,4,128,645,2549
"The schools suck, but what are you going to do",104,19,5,128,645,4153
But it's easy to fix.  Just stretch on some new sails and dig a long trench.,102,23,3,128,645,5226
"It's all a gamble, my friend.",101,25,2,128,645,6826
"Welcome to Miniature Golf Estates.  Ironic, no?",104,19,5,128,645,7236
This one comes with green energy and a great view of the golf course.,85,18,3,106,645,3363
"Honestly, this house sucks balls",129,24,6,159,645,5863
It’s a real family-friendly neighborhood.,109,25,3,137,645,1138
Hello there. Do you have a moment to talk about the future of the Republican Party,112,19,6,137,645,1667
"When I saw this listing, it blew me away.  Having toured it, I'm not a fan.",111,21,5,137,645,2416
"So, what’s the elephant in the room?",110,23,4,137,645,3293
The Heisenbergs loved it.,112,19,6,137,645,4449
"I know it will take some getting used to, but you’ll save a bundle when you cool your house in the summer.",111,21,5,137,645,4988
"No, this is just a folly. The white elephant is on the next block.",108,27,2,137,645,6832
The original owner was a huge golf fan.,92,20,3,115,645,45
The neighborhood is quiet from 10 p.m. until 9 a.m. every day.,90,24,1,115,645,2051
"It's a little noisy, but you'll love your electric bill!",91,22,2,115,645,2234
"The view is incredible. The home--one of a kind. I will warn you that if you drop anything in that hole, unlike the other homes in this neighborhood...you won't get it back.",118,23,5,146,645,1747
You’ll be the first on the block to be off the grid! And it comes with a White Elephant!,102,16,6,124,645,777
"THIS IS WHERE THE SHIT HITS THE FAN,I DONT THINK IT  QUALIFY 'S FOR TAX CREDITS....",102,16,6,124,645,1434
We ain’t playin’ here at Put Put Estates.,101,18,5,124,645,2638
"Two Cautions: First, the windmill vane and second, the large, dimpled ball that occasionally come rolling in.",101,18,5,124,645,2675
"Yes, it gets muggy in the summer but if you leave the windows open there is a steady breeze.",98,24,2,124,645,4014
It now appears that the warranty had some holes in it.,101,18,5,124,645,5372
"Sure,  there's that great view of the golf course, but there's more.",100,20,4,124,645,7532
Where's the tulips ?,100,20,4,124,645,7546
"That fifth step is a doozy.""",106,24,3,133,645,1716
This next house is equipped with a rotating entryway and underground tunnel access.,108,20,5,133,645,6017
"Here we have a four-sail, center-hall windmill with great natural light.",109,18,6,133,645,7061
"I gave in on the Tesla, but this time I’m putting my foot down!",115,22,5,142,645,4615
"Like I said, any fore closure will be temporary.",116,20,6,142,645,5231
That's right -- just like Indiana Jones.,90,17,4,111,645,7138
Buy this one and you can stop chasing them.,99,15,6,120,645,34
"Yes, we know it possesses old world charm, and with virtually no utility costs. Its placement on a miniature golf course, however, may pose some problems down the road.",95,23,2,120,645,1060
That was an isolated accident. He was told to time it right prior to entering or leaving. The view is outstanding as well but please remember to keep your head inside.,95,23,2,120,645,1574
Entertaining? The whole development was built for entertaining!,95,23,2,120,645,1697
Mrs. and Mr. Cervantes! It is the most modren hous you can find in the north America.,97,19,4,120,645,2091
Consider the exercise benefits of having to duck and time the movement of the sails just to get in the front door.,96,21,3,120,645,3011
...and by the way it's a self sufficient home.,99,15,6,120,645,3328
The building's former owner was a Dutch visionary net zero traditionalist.,96,21,3,120,645,3793
But you said you wanted 'open concept.',98,17,5,120,645,4264
"I think you've hit a hole in one with this one,Bob.",94,25,1,120,645,7432
It'll be worth millions once Amazon moves in.,105,19,5,129,645,569
Act now and you get a year's supply of tiny pencils.,103,23,3,129,645,639
"Well,you are the ones to say you wanted a putting surface in the backyard.",102,25,2,129,645,1266
"The neighborhood is also very walkable, and experiences a lot of foot traffic",105,19,5,129,645,1433
Just remember to keep your eye on the ball.,103,23,3,129,645,2556
Our corporate motto is: We have big balls.,104,21,4,129,645,3242
"""The house itself is pretty par for the course, but it's proximity to the local fire station can't be beat.""",105,19,5,129,645,3929
Right to left.,106,17,6,129,645,4409
The app.on your smartphone allows flawless enteries and exits.,106,17,6,129,645,6138
You just have to time your exits and entrances carefully so you are not beheaded.,105,19,5,129,645,6315
"No need to continue yoga classes, your agility and reflexes will be tested, coming and going.",113,19,6,138,645,215
This money you'll save on energy in this Dutch Colonial will more than pay for any landscaping work you might want to do!,111,23,4,138,645,1572
I know the rent sounds high but each month you get 10% off for every hole in one from the previous month!,112,21,5,138,645,2137
"If this one is out of your price range, a spare tire just came on the market",114,17,7,138,645,5577
"Okay, so this next one has no restrooms or front door, but it's in a reeeeally kid-friendly neighbourhood.",113,19,6,138,645,6442
This is ur Don Quixote model. It's eco friemdly and 100% tilt proof.,113,19,6,138,645,6630
"And here is our property of the week...
good old fashioned wind power, with a view of the 13th hole!",114,17,7,138,645,6921
Never hire a schizophrenic architect.,120,21,6,147,645,1172
"Also, free air-conditioning for life.",85,20,2,107,645,5218
"To sweeten the pot, lifetime greens fees.",93,20,3,116,645,1178
"It's not in the room anymore, so we can just forget about it.",93,20,3,116,645,1331
"Okay, we're ready to go inside.  Ladies first.",92,22,2,116,645,2380
". . . and with all the exercise you'll get, you can cancel that gym membership!",91,24,1,116,645,3772
"The golf ball is covered under your insurance policy, however, your dog is another story.""",92,22,2,116,645,4040
"""Me, too""  doesn't mean we're going
Dutch.",102,18,5,125,645,3378
"The asking price is on par for this neighborhood, but you get a discount in your HOA fees for every hole-in-one.",101,20,4,125,645,3702
how much will this reduce my electric bill?,100,22,3,125,645,5375
You'll love the pet door!,101,20,4,125,645,5538
"If you can look past, and dodge, the massive blades, this house is perfect for the two of you.",101,20,4,125,645,7261
"Ironically, the ball is least likely to hit you in the hole.",108,22,4,134,645,405
life is a matter of timing,106,26,2,134,645,947
The turbine provides all the electricity you need and keeps intruders away!,106,26,2,134,645,2141
It’s like ‘going Dutch’ with the electric bill!,111,16,7,134,645,2935
plus the top floor offers panoramic views of the medieval castle,107,24,3,134,645,4639
Just wait till you see the air conditioning system.,108,22,4,134,645,5128
And it comes with its own built in security system.,108,22,4,134,645,6233
"Alright, we already took the elephant out of the room",114,26,3,143,645,2953
....and here you will save on air conditioning!,113,28,2,143,645,3016
"The best part, no water or electric bills because the windmill works year round.",113,28,2,143,645,3153
"Listen, I understand the neighborhood's a bit old-fashioned, but with the windmill, the energy savings are simply unmatched.",114,26,3,143,645,4658
It comes with the putter and two golf balls.,114,26,3,143,645,4744
"You’re right Gerry , I think the kids will love it.",115,24,4,143,645,7131
This is the hottest off-the-grid home on the block.,114,26,3,143,645,7561
"It's nice to meet you, I'm a big fan.",125,20,7,152,645,2288
"Tiny houses are out, mini houses are in!",89,21,2,112,645,644
We suggest the second-floor bedroom.,89,21,2,112,645,2437
"If windmills aren’t your thing, then I’ve got a beautiful medieval castle I can show you?",87,25,0,112,645,4913
"I thought you said this was miniature golf?""
""I did. We're the ones who are miniature.",94,11,7,112,645,6831
"I can get you into this little number like a shot, but-but there's lots of competition!",97,21,3,121,645,1007
Think of all the money you'll save on shoes.,95,25,1,121,645,1540
"Sure it’s a bit of a fixer-upper, but check this out—revolving doors!",100,15,6,121,645,2356
I can’t over emphasize the care you must take when entering the front.,98,19,4,121,645,2829
"And if you have children, they'll easily be taken care of.",100,15,6,121,645,3755
The owner is a big Miniature Golf fan.,98,19,4,121,645,4560
Just wait until you see the inground water feature out the back!,106,19,5,130,645,909
The weekends are a ball!,105,21,4,130,645,1038
"We don't call them ""tiny."" It's a mini-house neighborhood.",103,25,2,130,645,1402
"Oh it's a really fun area, tons of big clubs.",104,23,3,130,645,1586
I can assure you that this is not the same old grind.,108,15,7,130,645,2489
. . . But you get to keep all the golf balls that get through.,103,25,2,130,645,2896
"Well Pastor, ours was a whirlwind romance.",107,17,6,130,645,2988
"True, there's no front door, but think of all the alternative energy tax credits.",105,21,4,130,645,3014
Don't let the Wind Mill fool you. This Condo is Oil and Gas.,114,19,6,139,645,508
We love the house... the neighbors just seem like pinheads,116,15,8,139,645,2200
"If you can dodge traffic, you can dodge a windmill.",112,23,4,139,645,3544
The neighborhood has lots of clubs and balls.,122,19,7,148,645,3143
Think of it this way: no more unsightly window units!,124,31,2,157,645,4355
It's a windmill.,98,12,7,117,645,296
"It’s a great place, you just have to watch out for the golf balls.",111,18,6,135,645,771
"It's cozy; it's priced to sell; and with that antenna, gets great cell coverage",108,24,3,135,645,874
We suggest people not put the kids' bedroom by the front door,118,20,6,144,645,1013
The miller even left behind four sets of wooden shoes!,88,16,4,108,645,1133
"Amenities include the snack bar, arcade and unlimited rounds on weeknights, except holidays",110,20,5,135,645,1686
"Dulcinea, the tenant on the second floor, is so shy you'll never know she's there.",96,16,5,117,645,1884
We call it the miniature golf model.,109,22,4,135,645,1956
It comes with free mini golf for life.,110,20,5,135,645,1996
"Keep in mind,  this place is for the true golf afficianado...",94,20,3,117,645,2135
"Actually, there's a lot of turnover everywhere in the market.",107,26,2,135,645,2352
Watch for the hole in one ball.,109,22,4,135,645,2438
"And best of all, Matt Damon lived shortly after filming “Downsizing”.",87,18,3,108,645,2629
"And by downsizing, you get your own putting green.",95,18,4,117,645,2808
And it's right on the eighteenth green!,108,24,3,135,645,2835
Don't be fooled. This place is a real hole.,108,24,3,135,645,2940
Here's a reno project you can really tilt at.,109,22,4,135,645,3316
A little birdie told me that fore-closures are par for the course here.,104,16,6,126,645,3617
It will generate some solar power as well,115,26,3,144,645,3713
But rainy days are wonderful.,93,22,2,117,645,3738
"In this market, this baby is practically a hole-in-one!",92,24,1,117,645,3783
You just have to watch out for folks on horseback carrying a lance.,108,24,3,135,645,3806
Why don’t you take her for a spin?,101,22,3,126,645,4491
"Why yes, the previous owners were hole-ly rollers.",100,24,2,126,645,4867
And the large golf ball is included in the price!,117,22,5,144,645,5104
"It's a great winter home, and the power bills are next to nothing.
I'm not putting you on.",109,22,4,135,645,5179
...and it includes the latest eco-friendly advances in green home design.,121,30,2,153,645,5535
The owners couldn’t do solar panels so they did the windmill  thing.,101,22,3,126,645,5949
"Can't beat the view, am I right?  And say goodbye to those electric bills.",95,18,4,117,645,6322
"An occasional putter comes through, but they usually miss!",118,20,6,144,645,6370
"It's a home-in-one! Also, it's the only property that fits your budget.",115,26,3,144,645,6680
"I can assure you, no one plays mini-golf when it’s windy.",104,16,6,126,645,6902
It's all yours when you putt down a one-month deposit,101,22,3,126,645,6944
"On the plus side, you'll be helping the environment.",100,24,2,126,645,7081
This baby's completely carbon neutral!,115,26,3,144,645,7468
"And, there’s a view of the seventh green.",119,27,3,149,645,1575
Good news: the sails convey.,112,25,3,140,645,1408
I wouldn't put anything breakable between the doorways.,114,21,5,140,645,1883
And it even comes with an elephant in the closet!,112,25,3,140,645,2973
"Were you big fans of ""Raiders of the Lost Ark""?",115,19,6,140,645,4138
All you have to do is time your entry carefully; otherwise you may be decapitated.,116,17,7,140,645,4162
"good question!
We routinely lose 30 to 40 people a year.",116,17,7,140,645,4172
It’s only in your price range because of the shared garage.,113,23,4,140,645,4703
"As they say, 'Location, Location, Giant Golf ball.'",117,15,8,140,645,6964
"Since we slayed all the giants, this stuff is practically free real estate!",111,27,2,140,645,6991
"We call it 'Gargantuan-Golf', it's an offshoot of minigolf and it's gonna be big",107,19,5,131,645,363
It’s our early solar model.,106,21,4,131,645,1186
The President wants it replaced with a coal mine.,108,17,6,131,645,1293
"This being the toughest hole by far, ball intrusions are rare.",104,25,2,131,645,3997
You’re right. There is not enough room on the roof for solar panels.,107,19,5,131,645,4035
Welcome to Putt Putt Green Living Community!,107,19,5,131,645,6878
Why would you think you need flood insurance?,100,17,5,122,645,1429
The president lives next door.,98,21,3,122,645,2603
"NO, actually, that is NOT what we meant by a white picket fence.",100,17,5,122,645,3245
The mortgage payments are a breeze in this location.,98,21,3,122,645,5137
The outdoor hole doubles as a soaking tub or unwanted guest suite.,99,19,4,122,645,6268
Comes with a security system. Just push the button and the blades block the door.,95,27,0,122,645,7273
I don't recommend having furniture inside the front door.,93,15,5,113,645,1278
Keep an eye out for orange golf balls.,89,23,1,113,645,4289
It's a 3/2 par 4.,91,19,3,113,645,4734
"More kid-friendly? I've got #18 - it's a Par 4, but a HUGE yard that dog-legs to a 3 bedroom Clown-head!",93,15,5,113,645,5412
They got the idea for the pallets from Pinterest.,84,17,3,104,645,4835
Have you considered switching your energy provider?,117,24,4,145,645,3396
entertaining in this backyard? Oh you'll have a ball!,117,24,4,145,645,4026
No! It does not come with a diesel option!,111,20,5,136,645,465
Use of the go-cart track is included in the HOA dues,111,20,5,136,645,1226
"Mr. and Mrs. Jones this might not be the “windmill of your mind” but trust me, in today’s market... it’s a bargain.",107,28,1,136,645,2573
And it comes with a set of very large golf clubs,111,20,5,136,645,3450
"It's called Maxi Golf. And if you can sink a hole-in-one, the first month's rent is free.",110,22,4,136,645,4623
"It's blow market.""",103,20,4,127,645,2175
It's a little fiddly getting in but that's just this neighbourhood for you.,102,22,3,127,645,2397
And it's rent-controlled too!,103,20,4,127,645,3820
"Here at Lilliputt Greens downsizing is our motto, literally",103,20,4,127,645,6368
"It's not just on the golf course, it's the thirteenth hole!",97,16,5,118,645,736
""".... and air conditioning is included!""",93,24,1,118,645,2568
Only problem with this house is the biggest mice you have ever seen.,97,16,5,118,645,2876
"Listen, the elephant wasn’t part of the deal.",100,10,8,118,645,4207
"Everyone says this is a great place to raise a family,kids play free.",86,22,1,109,645,1723
Haven't you heard? Renewable energy is IN!,87,20,2,109,645,2261
The previous owner gave up on boundary disputes.,88,18,3,109,645,3309
"No worries, the HOA doesn't allow tilting.",89,16,4,109,645,5431
Anyone remember where we parked?,123,21,6,150,645,3687
It's not that bad. At least they moved the big hole that used to be right inside the door.,123,21,6,150,645,4990
It would be a good idea to keep the back door closed,120,27,3,150,645,5134
The whole tract is based on a miniature golf course concept.,120,27,3,150,645,5792
"Really, the only downside is the adolescent birthday party.",119,29,2,150,645,7034
Plus....No more unsolicited menus,117,17,7,141,645,2607
"No, no, not ‘elephant;’ I said ‘elegant!’",113,25,3,141,645,3462
Everyone wants to reside in the windmill of your mind!,118,15,8,141,645,3563
"The golf balls are rather large, but we recycle them",113,25,3,141,645,5401
"Crazy thing, the previous owners just up and took off.",116,19,6,141,645,5811
"I'm telling you, if we jump down that hole, we'll get back to the hut.",113,25,3,141,645,5930
A matter of perspective is par for the course.,114,23,4,141,645,6188
"This little charmer has three beds, two baths and low energy bills.",105,25,2,132,645,668
"'They've accepted your offer, but Barron needs a minute to help Eric stop crying before we go back in.'",108,19,5,132,645,1254
"Sure the house is a bit drafty --  
but consider the savings with NO electric bills",106,23,3,132,645,2563
We decided to build some excitement into our newest gated community. .  .,105,25,2,132,645,4451
"We're working out a few kinks with the safety team.  But meanwhile, if you can make it to your car, you win a free ice cream cone.",104,27,1,132,645,5972
Some see  giant golf balls . .  some see harassment by some Quixote freak . . . What I want you to see is a Mr Blandings Rehab you'll never forget . . .,101,17,5,123,645,1014
"With this property, you can putt yourself into green energy nirvana.",100,19,4,123,645,4775
All with zero electric bills.,100,19,4,123,645,5254
"Safe?  Sure, but a bit noisy.  The neighbors do like to go bowling.",122,32,1,155,645,1076
"We’re looking for something even tinier, and maybe with a clown’s-head view.",93,17,4,114,645,520
At this property you're sure to have a ball!,91,21,2,114,645,5698
"Actually, folks, it's like a combination house and food processor.",121,18,7,146,645,1280
"The security system on this unit is fantastic.""",120,20,6,146,645,1520
"In view of ongoing sea level rise, this model is expected to increase considerably in value over the next 30 years....",117,26,3,146,645,2307
The previous owner split.,113,18,6,137,645,788
And did you notice the wonderful security system for the front door. Nobody gets past that baby!,109,26,2,137,645,789
This darling wind-powered unit has a thrilling view of the golf course!,111,22,4,137,645,1139
AND IT IS VERY ENERGY EFFICIENT,111,22,4,137,645,1775
"Golf course view, wind-energy, big ballroom...",111,22,4,137,645,2166
We’ve been exploring new forms of renewable energy,110,24,3,137,645,4878
"On the bright side, you won't have to buy golf balls anymore.",111,22,4,137,645,5163
"The tunnel entrance is right there in the front yard, so this is the windmill of your mine.",114,16,7,137,645,6563
End-of-days special.,104,20,4,128,645,1125
This is where experienced real estate agents like me distinguish ourselves against the likes of Trulia.,102,24,2,128,645,2318
You'll never have to mow the lawn again.,102,24,2,128,645,3076
At least there is no elephant in the room,106,16,6,128,645,3092
It’s on a golf course and it comes with its own eco-friendly cooling system.,102,24,2,128,645,3209
"So, this house guarantees you stay fit?",102,24,2,128,645,3817
"Yes, we've just moved onto a miniature golf course.",103,22,3,128,645,4407
"yes, that’s right, exotic pets are allowed - but due to HOA restrictions, the hole in the front yard would have to stay”",128,29,3,160,645,5481
"Minimal noise pollution, 2 and a half bath, an open floor plan, and...Mr. Enslin, do you golf?",103,22,3,128,645,7031
"Well, it’s a little old-fashioned, but all the homes in this area feature a ballroom on the ground floor.",122,25,4,151,645,3037
"Well, you will save on electricity, and I really think you'll have a ball.",124,21,6,151,645,3608
"I was told you misunderstood what we meant by ""a putting green in your front yard"".",123,23,5,151,645,4784
"Yeah, it isn't the ideal office space, but you wouldn't believe the foot traffic!",97,18,4,119,645,75
"I suggest that you act quickly. The last couple dawdled, and wound up in Syracuse.",98,16,5,119,645,4406
"Great Location, not an easy in or out.",100,12,7,119,645,4741
AND...it's got the very latest Amsterdam Security Systems in place.,96,20,3,119,645,5212
The neighborhood has everything and the golfer doesn’t come by much anymore.,98,16,5,119,645,5335
"It's the latest in eco-housing: putt-in/putt out.""",116,21,5,142,645,857
"Here in Texas, this is our version of a ""Tiny House"".",119,15,8,142,645,976
"So by "" cutting edge "" property, we mean that while there is a small chance of a dramatic incursion by a large round object, you have an 82% chance of merely suffering an occasional dent in your alternative energy wind power source.",116,21,5,142,645,2323
What elephant milling around?,116,21,5,142,645,6553
"It's calm now, but generally there's a good breeze.",114,25,3,142,645,6657
This property is inspired by your first date.,87,22,1,110,645,887
"Well, you can certainly install some windows, but I wouldn't recommend it.",90,16,4,110,645,1543
Wind powered and a great place to raise kids I think you’ll have to agree.,90,16,4,110,645,2005
"If you buy this house you won't be just off the grid, you will be the grid!",93,10,7,110,645,4321
"Well, if you're not into golf, you could always turn it into a Jacuzzi.",109,19,5,133,645,849
"And you don't have to mow the lawn.""",108,21,4,133,645,1657
Helluva deal on electricity but don't forget to turn it off when coming and going.,108,21,4,133,645,2216
The previous owners didn't go out much. Wait 'til you see the inside.,108,21,4,133,645,2755
Zoning,110,17,6,133,645,2853
Expensive? The 18th hole of any miniature golf course is prime property! Make an offer before next foursome plays thru...,105,27,1,133,645,3116
You won't have any trouble telling guests how to find your house!,108,21,4,133,645,4186
"Horse? Lance? Ya, the neighbor is a little eccentric.",108,21,4,133,645,5273
You will be at net zero for your electric bill.,109,19,5,133,645,6360
"And yes, the lease is renewable.",108,21,4,133,645,7222
"Frankly,it's a steal:  A unique residence with Old World charm plus its own phantom elephant and private sink hole",127,24,5,156,645,7427
Youth Sundays are hell.,101,19,4,124,645,929
It's a hole in one.,100,21,3,124,645,2002
I recommend you stay mostly on the second floor.,102,17,5,124,645,2206
"I guarantee you that in 5 years Gigantic Golf will be a multi billion dollar business,if not I will come back and let this windmill spank the Lying Ted out of my ass!",100,21,3,124,645,3854
Think “In a New York Minute...”,102,17,5,124,645,4063
"Once you move in, I guarantee you'll be bowled over.",101,19,4,124,645,5830
"The schools are good, just time when the kids leave the house.",98,25,1,124,645,6398
...and you're right next to the 19th hole.,119,24,4,147,645,460
"This new pre-war property has no electricity but,when the wind is up,you can ground your own millet.",93,19,3,115,645,1142
Coming home is like going to work.,94,17,4,115,645,1199
This one is on par with all the best real estate on this drive.,111,24,3,138,645,1334
This is a home where you can finally stay put,110,26,2,138,645,1780
"Based on the property disclosures, it looks like we’ve got a hole in three here.",92,21,2,115,645,1899
Wind power and right on the third hole!,93,19,3,115,645,2717
"Oh, yes, it’s perfectly safe....just so long as you aren’t planning on doing any tilting.",90,25,0,115,645,2865
"And it’s only $3,200 a month.",98,9,8,115,645,3022
"We recommend running upstairs when you hear, ""Fee fie fo fum"".",112,22,4,138,645,3792
Because you’re on the course it comes with a club membership.,110,26,2,138,645,3811
"""I suggest that you put in an offer soon---before the federal subsidy expires.""",95,15,5,115,645,4036
You’ll never find a place with lower utilities,92,21,2,115,645,4422
"And of course, when you sink this putt,you receive a free game!",95,15,5,115,645,4748
"And on weekends, you can golf until midnight.",113,20,5,138,645,5263
If you're thinking of downsizing we could look at a Par 3 home.,91,23,1,115,645,6619
"When we get inside, you might see a giant golf ball.  Don't worry, I can explain.",122,27,3,152,645,6312
"It's the white picket fence home you've always dreamed of, and the golf part makes it even whiter!",104,22,3,129,645,16
And no need for wind damage insurance,103,24,2,129,645,1362
"The well out front is dry, and there's a lot of foot traffic on the weekends, but if you stay out of the doorway you should be alright.",105,20,4,129,645,2402
"The good news is, your Uncle Theodore left you his windmill house, in his will._the bad new is that it can be dangerous  getting in and out safely._RIP Uncle Theodore",107,16,6,129,645,3362
"Yes, at Hole-In-One Homes, we like to say you'll be living right on the fairway.",106,18,5,129,645,3409
"And the Giants will always be there to protect you, Don.",105,20,4,129,645,3453
The amazing thing about this place in NYC is it's at your budget.,105,20,4,129,645,6650
"Post-Post Modern. You'll be one of the first.""",104,22,3,129,645,7382
"Why pay for wind, when you can live in the mill?",105,20,4,129,645,7419
"Don't worry, don't worry. They only come on between 12 and 2 and 6 and 8!",86,17,3,106,645,3097
"Don't worry!  The ad says,""greenhouse and environmentally friendly home on a golf course""",84,21,1,106,645,3654
We're not responsible for anything you read on Trip Advisor.,116,23,4,143,645,2366
On the other side it has solar as well.,117,21,5,143,645,3679
I think we can steal this one...the owner just came down with a giant case of the yips.,115,25,3,143,645,5250
We call it McMansion Meets Tiny House,117,21,5,143,645,6157
"And your new home loan will be carried by ""Titleist""",120,15,8,143,645,6677
You'll save a bundle on power!,116,23,4,143,645,7176
"Don and Sancho slept here.  But because it's not connected to the grid, we are only asking 3.2 million.",97,20,3,120,645,1468
"If you can get rid of that elephant, we may think about settling here.",97,20,3,120,645,5369
"Sure, it might be tricky to leave the house when it's gusty but at least you won't have to mow the lawn.",96,22,2,120,645,6059
"It's too small for parties, but you CAN host large balls",98,18,4,120,645,7175
"Don’t worry, the Giant stinks at miniature golf.",126,28,3,157,645,3318
Yes it's true the last owners did make several claims initially on their health insurance but they said they then quickly adjusted to always looking left first before they came out.,127,26,4,157,645,7150
"Only broken into on a few, unfortunate windless days.",111,17,6,134,645,59
"Don't worry, the golf balls are still normal sized.",110,19,5,134,645,340
Too breezy? Nonsense! Just wait until summer comes around.,108,23,3,134,645,511
ThE AC NEVER STOPS WORKING!,110,19,5,134,645,663
This is the original sustainable housing.,106,27,1,134,645,1037
"No, it's not a fixer upper, it's a winder upper.",107,25,2,134,645,1070
CLOBBERS nighttime house invaders.,110,19,5,134,645,3728
This place is more like through a glass onion.Through the looking glass is two doors down.,108,23,3,134,645,3760
'And there's a magnificent view of the golf course from the cupboards.',109,21,4,134,645,4484
"The kitchen needs refurbishing""",109,21,4,134,645,4524
"Yes, it’s energy efficient. It’s a literal windmill.",107,25,2,134,645,5029
I think this listing will be on par to your liking.,140,25,6,171,645,6246
This is where the first rotating door was invented.,120,24,4,148,645,4886
Let's just say that living on a golf course is like having a hole in your own backyard..,102,19,4,125,645,313
Found the only place of coolness under this hot cynical world.,103,17,5,125,645,323
Just hook up a few solar panels and you can grind yourself cornmeal and reduce your carbon footprint all at the same time!,102,19,4,125,645,546
You two will have a ball in this neighborhood!,102,19,4,125,645,1319
"She never forgets, so I recommend being honest about your score.",101,21,3,125,645,3577
"This one is an Obama-era clean energy model but I also have a coal model with a black picket fence, if that's more your style.",105,13,7,125,645,3896
"And of course, this neighborhood has been designated as a NO TILTING zone.",103,17,5,125,645,4927
"Well, Martha you like the windmill with the food grinder and Paul you like the church with the bell.",103,17,5,125,645,6081
"Would you believe,  -  this place once belonged to Margaret Mitchell .  .  .  . and then she was gone.",102,19,4,125,645,6206
The former owner is the mini-golf king of Dubuque. On windy days it's net-zero energy rated.,111,26,2,139,645,2310
It's really cool,112,24,3,139,645,3657
It’s a steal because the area is prone to sink holes.,112,24,3,139,645,3745
"Ah, yes, our Windmill model is the latest in retro-green technology for miniature golf course living!",110,28,1,139,645,4113
"Yes, when the wind picks up, entering and exiting is a bit challenging. But look at the bright side:  it's protection from the pachyderm next door.",112,24,3,139,645,7254
"And it's very eco-friendly;  wind power, you know.  It'll pay for itself.",124,25,4,153,645,1289
Things can get a little crazy in the summer,82,18,2,102,645,4707
The  collapse of the macro golf market is your gain!,92,23,1,116,645,782
"You can call it a cup if you want, but it’s more like the circles that you find in the windmills of your mind.",94,19,3,116,645,1799
All the meeting rooms were booked.,95,17,4,116,645,3258
"Unlike the one at the White House, your sinkhole isn't necessarily a sign of something deeper.",93,21,2,116,645,5775
"It's our sportmanteau model, Lilliputt-putt.",94,19,3,116,645,7192
Welcome to hut hut,108,16,6,130,645,627
"The condo fee includes this perpetually green lawn and did I mention the recreational water feature? Location, location, location, right?!",105,22,3,130,645,1299
It's a living!,105,22,3,130,645,1822
I can guarantee free golf balls for a year.,109,14,7,130,645,2226
It's a great alternative to solar panels.,106,20,4,130,645,3239
"I know the outside is rough, but wait until you see the view of the creepy clown's mouth.",105,22,3,130,645,3248
Think of all the money you will save using wind power.”,106,20,4,130,645,4052
It’s for home buyers looking for a heightened experience beyond the average golf community.,107,18,5,130,645,4476
I'd say the offer is par on course with similar windmills.,104,24,2,130,645,5184
This house is energy self-sufficient plus the owner gets well exercised darting in and out of the front door.,107,18,5,130,645,6304
If you can't make it here you can't make it anywhere.,120,17,7,144,645,598
I assure you this property’s up to par with the others here.,117,23,4,144,645,956
Largest lot and greens on the course.,116,25,3,144,645,1444
"After an evening bar-hopping, it is suggested that you sober up in the front yard.",120,17,7,144,645,2498
"It's location, location, location",116,25,3,144,645,5279
"Good question, well, you remember Miniature Golf when you were a kid, right?",101,14,6,121,645,1405
"Your house looks too...""cookie cutter"" for this neighborhood.",99,18,4,121,645,4337
The only negative is that you have to move very quickly going in and out on a windy day,96,24,1,121,645,4900
"Green, great views and low utilities",98,20,3,121,645,5392
It can be a little tricky getting in and out but some windows have a good view and you'll save on electricity.,99,18,4,121,645,5589
... and you'll never have to buy a clothes dryer.,99,18,4,121,645,5838
The back nine is a little easier.,95,26,0,121,645,6386
"Why the hell do you want to be insured for ""Attacks from Massive Rolling Dimpled Balls?""",110,21,4,135,645,648
It is a way to go green with a challenging entry,112,17,6,135,645,3892
"So, you're probably wondering why I asked you to meet me at the 14th hole of the miniature golf course in the Village of the Giants.",110,21,4,135,645,5854
We like to call this our starter wind farm home.,109,23,3,135,645,5895
"Three bedrooms, good light and great schools. Also, huge and colorful golf balls.",110,21,4,135,645,6409
Imagine. Your home will generate power for the entire Mini Golf community!,108,25,2,135,645,6558
"At your request, the bathtub that was ""round like a circle in a spiral"" has been replaced.",110,21,4,135,645,6671
OUR umbrella policy INCLUDES ball insurance,111,19,5,135,645,6841
Well you did say you were looking for something nostalgic”,112,17,6,135,645,7428
...and it's in an excellent school district.,121,24,4,149,645,2669
This Dutch-inspired tiny home comes with a state-of-the-art security system. HOA includes yard maintenance and ball retrieval.,120,26,3,149,645,4783
"With one room and four windows, this is a homeowner’s dream!",111,28,1,140,645,249
"It’s a little tricky getting in and out, but worth it for the PRICE!”",114,22,4,140,645,268
"In the tiny house marketplace, this is known as the putt putt manor.",93,14,5,112,645,519
The seller forgot to put in a back door.,132,36,0,168,645,845
"I'm sorry, but Mr. Q has decided not to sell.",103,19,4,126,645,864
You know how fear is the greatest aphrodisiac? Just WAIT until golfing season!,127,21,6,154,645,1517
And back here is the servant's entrance.,103,19,4,126,645,1880
To be honest I'm not sure why I keep showing people this house shaped like a miniature golf obstacle. I'm not a very good real estate agent.,103,19,4,126,645,2642
"Yes, the architect of this subdivision did have some deep-seated immaturity issues.  Why do you ask?",114,22,4,140,645,3398
"Most people are done playing by 10 PM, and no pets are allowed on the course.",104,17,5,126,645,3587
"It chills the cruel, hot wind. Just steer clear of the hole and blades.",103,19,4,126,645,4283
"And most exciting, the house has an almost organic flow-through layout.",115,20,5,140,645,4401
This is an affordable downsize.,114,22,4,140,645,4706
There's a church next door and a zoo a block away!,115,20,5,140,645,5084
The condo fees are highly reasonable since heat and electricity are fully wind generated.,102,21,3,126,645,5507
"Well,you said you wanted a a 2 bed/2 bath with a view for $1,400?!",113,24,3,140,645,6232
"I'm telling you guys, this one's got the 'X' factor...",103,19,4,126,645,6838
"You'll save a fortune on the utility bill, but we also have a lovely cape next to the water wheel.",111,28,1,140,645,6894
This place comes with with a reduced tax for your home electricity generation and a free church membership,114,31,0,145,645,3991
And if you buy now... It’s a guaranteed hole in one!,120,19,6,145,645,4557
Too dark? Let’s go see that remodeled loop de loop.,108,18,5,131,645,746
A hole in one gets a free 12 foot hot dog.,106,22,3,131,645,2653
Let's address the fact that the elephant doesn't even fit in the room.,110,14,7,131,645,3024
The best part about this property is it is heavily subsidized by the Putt-Putt Homeowners Association. The downside is that you need to execute your entries and exits on a timely basis.,105,24,2,131,645,3637
Yes. the innovative fire escape system is included in the price.,97,15,5,117,645,763
Who told you this was a windmill ? I see it as an opportunity for free flour.,94,21,2,117,645,1638
"And, think how much your grandchildren will enjoy the rides!",95,19,3,117,645,1749
You may have heard of them -- Stuart and Margalo Little - they're only selling because of the divorce.,98,13,6,117,645,3175
The previous owner had Jehovah’s Witnesses in mind when he built this house.,98,13,6,117,645,3495
You won't have a power failure on windy days!,95,19,3,117,645,4563
You're not kidding these don't come on the market often. You know how long Ol' Mother Hubbard has held on to that shoe over there?,95,19,3,117,645,7517
Forget solar.  This is wind power,83,18,2,103,645,3038
Well you did specify you wanted a view of a major golf course.......,123,22,5,150,645,406
"Of course, you’d have to share a walkway.",112,19,5,136,645,986
"I'll agree;  solar is nice and quiet, but think of our cloudy and rainy days.",113,17,6,136,645,1220
You were Double Dutch champions as kids? Then this is the perfect house for you!,108,27,1,136,645,3350
You just run in before the windmill arm covers the doorway - sort of like playing miniature golf.,110,23,3,136,645,4649
"I know it's expensive, but it's a great location. There's only a small chance of the ball making it through the hole, and your neighbors are just fantastic!",109,25,2,136,645,4698
I kept this house for last. This mansion even has a mini golf course on it's front yard.,109,25,2,136,645,6068
At this picturesque place it's one par tee after another,109,25,2,136,645,7260
"The architect was a visionary, but a bit impulsive and rashly unpredictable.",111,21,4,136,645,7479
There’s a lot of perks that come with living on a golf course.,99,20,3,122,645,626
Furniture conveys and the appliances are above par.,99,20,3,122,645,5204
The previous owners said that the golf balls didn't come through the front  door more than once or twice a week.,89,15,4,108,645,4666
This is a par 3. The next one has a water hazard.,88,17,3,108,645,5302
You’ll be pleased to hear that the HOA fee includes full use of the water trap.,87,19,2,108,645,7478
"Admittedly, it’s a radical new technology for air conditioning.",115,22,4,141,645,720
It's like having your own round-the-clock golf channel!,118,16,7,141,645,1621
It's accessable with one caveat.,115,22,4,141,645,4884
"However, there is a monthly wind charge.",117,18,6,141,645,5827
"I thought we made it clear that we wanted a centrally located windmill with three bedrooms, three bathrooms, and NO elephants",114,24,3,141,645,5958
How good are you at miniature golf?,115,22,4,141,645,7555
Does it come with air rights?,104,19,4,127,645,913
"It is unusual, but think of all the exercise you'll get!",103,21,3,127,645,5261
Lilliputt is an exclusive private mini-golf course community.  We advise our residents to stay upstairs or go out during peak hours.,103,21,3,127,645,5816
Insurance will cover any hazards over par.,92,18,3,113,645,6399
"There's a right of way, but after six you can ask them to leave",91,20,2,113,645,6765
"Sure, you have to be quick getting through the door, but those solar tax credits are expiring soon.",90,22,1,113,645,7492
"With “Holland Sun” youre in a wind, wind, situation!",122,17,7,146,645,2229
If you don’t mind the clubbing it’s a great neighborhood,117,27,2,146,645,3962
"Now that you mention it, this room is available.",118,25,3,146,645,5094
I think you'll come to appreciate the ground level open floor plan.,119,23,4,146,645,5173
The safety of this house comes and goes.,123,15,8,146,645,6763
Enjoy your new home.  Just be on the lookout for 400 lb. golf balls!,82,13,4,99,645,339
It's looking cloudy with a chance of golf balls.,109,18,5,132,645,2640
This house right on this golf course will be perfect for a small family like yours!,108,20,4,132,645,2641
"This new Democrat version of the wall, will let anyone though who can get past the fan blades.",109,18,5,132,645,3276
"Well, it's true that your insurance premiums may go up a tad, but it's priced to sell!",105,26,1,132,645,3606
The price includes Country Club membership,108,20,4,132,645,4474
"If you like clubbing, then this is the perfect neighborhood for you!",109,18,5,132,645,5087
"And when the recession hits, you can crawl into your hole and dwell on your losses.",109,18,5,132,645,5113
"You'll love this place! No ands, ifs or putt putts!",109,18,5,132,645,5699
I'm thinking resale might be an issue.,111,14,7,132,645,5859
It'll require some imagination.,107,22,3,132,645,6369
Your own unique Door Dash is another feature of this heritage property.,108,20,4,132,645,7146
You never have to get up to let the dog out.,94,23,1,118,645,95
The neighborhood is well-kept. Someone is always puttering around.,96,19,3,118,645,310
Full disclosure... there may be an elephant blowing in the wind here.,96,19,3,118,645,987
You'd have to be a complete putz not to make an offer.,95,21,2,118,645,1104
"Oh, come on Bob! You always said you wanted an adventure!",94,23,1,118,645,1826
Just think--your jealous neighbors will have to putt-putt or shut up.,98,15,5,118,645,3593
Time to put some roots down and stop chasing wind mills.,96,19,3,118,645,4334
"Hi! Do you have time to learn about Jesus Christ, our lord and saviour?!",96,19,3,118,645,5072
... and the 19th hole is right next door!,95,21,2,118,645,6198
Just be sure you get out of the way when a ball comes through.,112,21,4,137,645,749
"Naturally, the property taxes would reflect any sums raised by the resale of found golf balls.",110,25,2,137,645,957
The price has been greatly reduced because of the occasional giant golf balls rolling through.,115,15,7,137,645,2207
"If you’re a mini golf fan, you’re going to love this listing...",111,23,3,137,645,3025
"As long as you vacate the house during daylight hours, and when the drunk teenagers are around at night, you should be fine.",111,23,3,137,645,3159
"I'm telling you folks, you'll want to get in on the front end of this giant golf craze.",114,17,6,137,645,3764
"Talk about high tech -- When the wind dies down, it uses solar power to move the windmill.",113,19,5,137,645,4548
"No, I don’t know why there is a hole in this cartoon, but there it is.",115,15,7,137,645,6072
"Well, I think a few golf balls in the dining room are a small cost for 'seeing the elephant'.",85,16,3,104,645,7046
"It's appraised at Par 3, but it's a bull market.",101,18,4,123,645,4009
"Sure it's a bit drafty, but it'll pay for itself in energy bill savings.",100,20,3,123,645,4426
"I promise you that one fine day you'll wake up, look each other in the eye and wonder:""How in the world were we lucky enough to end up on the the 6th hole of the biggest putt putt corse in Cedar Rapids, Iowa.""",104,12,7,123,645,5052
"Hans Brinker lives on the next canal, and if you follow the bread crumbs, you'll find the bake shop of Hansel and Gretel.""",101,18,4,123,645,5430
This place is a real hole in one.,100,20,3,123,645,6858
"Oh, well, the occasional, painted golf ball will come through the front door.",115,24,3,142,645,1387
"During the tornado season, you won’t have to worry about the safety of your possessions",114,26,2,142,645,5045
"Some say it’s mini, but two is about par for the course.",117,20,5,142,645,6278
"This beautiful property is located conveniently near the snack bar and the men’s restroom. Oh, local public schools? I don’t know about those.",89,17,3,109,645,3088
Careful by that final hole - it leads to a different universe.”,104,21,3,128,645,302
And you'll never have to worry about grinding grain or pumping water by hand again.,104,21,3,128,645,1439
"Great place to live if you're not Don Quixote! Homey, natural air conditioning, open door policy! Mr. Potter, you play golf?",103,23,2,128,645,1841
"That ""hole"" is the entrance to the basement.",105,19,4,128,645,2644
"Yes, it's better than solar power and there are interesting people in the condo association.",106,17,5,128,645,3469
"Come back anytime! Open house is from 12 to 1, 2 to 3, 4 to 5...",103,23,2,128,645,7172
Quickly now! Move to the front by the door!,120,23,4,147,645,1589
"This is the Szalinski model; energy efficient, on the golf course.",107,24,2,133,645,388
"It's a hobby farm, as long as golf is your hobby.",96,12,6,114,645,1174
"Between you and me, I'd go ahead and take out hole in one insurance for this one.",108,22,3,133,645,1288
It's rent controlled and now Quixote free!,110,18,5,133,645,1509
"Once I got wind of these utilitarian models,I thought of you.",108,22,3,133,645,1629
"Yes, the asking price does seem a bit low....",108,22,3,133,645,1783
"The previous owner was a bit of an eccentric, and he left to dig his way to China.""",95,14,5,114,645,2337
"Word in the neighborhood is what goes round ,comes around",94,16,4,114,645,2729
"The windmill comes with 3 speeds, so you control difficulty of entry.  You can request an allowance to fill the hole, if it's not your taste.",124,24,4,152,645,3181
The putter’s included,107,24,2,133,645,3223
"Actually, it's OK; the people around here are lousy golfers.",108,22,3,133,645,3233
You said you'd consider a fixer-upper.,93,18,3,114,645,3259
"The windjammer fully powers the home and is safe...for an athletic family like yours, entry is under five seconds.",109,20,4,133,645,5235
"The only problems are, when the wind blows hard you can't get in your front door, and at night the elephant bellows, and on Sunday the church bells are extremely loud.",111,16,6,133,645,6252
"Not many play here, but when they do, you'll want to get pretty far away.",108,22,3,133,645,6335
"What did you expect? The program is called Buying in Holland, not Buying in Hawaii.",108,22,3,133,645,6416
"While offering small town charm, it does come with a rather large teenage problem.",107,24,2,133,645,7453
"I’m sorry, but this is really the only place with a ballroom you can afford.",126,29,2,157,645,4628
You can't lowball me here. This is a mini golf course!,130,21,6,157,645,7086
And the Quixote Penthouse features 2nd-storey views of Pachy-Wacky World to the west.,114,19,5,138,645,240
House Hunters: Holland plays well with our American audience.,111,25,2,138,645,1117
"This setting offers many unique home sites, and the Jack Nicklaus Signature Course features unforgettable hazards.",113,21,4,138,645,2969
"It needs some updating, but a classic par 2 on the water hazard? Go in above listing.",115,17,6,138,645,6723
Oh.... you said you wanted a MINI Golf course?,113,21,4,138,645,7304
The side window is the only safe way.,97,19,3,119,645,1730
I was hoping we could remove the sand traps.,100,13,6,119,645,3395
"So if can just get through this Feng Shui thing, I can see you two settled in this little Dutch Colonial on the the 14th green.",97,19,3,119,645,5575
quixotic mulligans allowed,82,15,3,100,645,4613
Challenging?  Perhaps not.  Ego-enhancing?  Big time.,133,24,5,162,645,643
"Plus, the local schools are fantastic.",117,22,4,143,645,472
"If you can put up with an occsional golf ball rolling through the hallway, I can let you have it for a good price.",117,22,4,143,645,844
It comes with a beautiful view of the 13th fairway.,116,24,3,143,645,2578
"Don’t worry, the house is fully powered by hot wind. You are Trump supporters, right?",119,18,6,143,645,4438
This neighborhood is on the rise - a new snow cone stand is going in soon.,101,20,3,124,645,174
This was the model so you can have it for a breeze!,98,26,0,124,645,277
Our former defensive coach used to live here.,102,18,4,124,645,1905
"Tempting as it may be, don't try to run out, you'll fall in that hole and startle the elephant.",104,14,6,124,645,2034
Most buyers are intimidated by the double-dutch model.,101,20,3,124,645,3176
The fairway location is only a problem during the larger birthday parties.,104,14,6,124,645,4018
Your offer is right on par”.,103,16,5,124,645,5893
It comes with a time released burglar alarm system.,102,18,4,124,645,6771
"Yes, the current owners love golf and believe in climate change.",84,20,1,105,645,157
"Candidly, it was designed for a miniature golf course, but the contractor was determined to get into the Guinness World Book of Records.",84,20,1,105,645,5183
The sellers are very motivated. They got dizzy.,119,27,2,148,645,1762
Yes; but it comes with all access to the entire miniature golf course!,104,23,2,129,645,2431
It's  the latest in Wind Power Turbine homes.,106,19,4,129,645,2871
Your children must be at least 4 feet tall to take a ride.,106,19,4,129,645,4443
"Believe me, I get it.  But do we really need to be this visible about our energy efficiency?",104,23,2,129,645,4603
"'Par is $300,000.'",104,23,2,129,645,6941
Take it for a spin. I’m sure you will love it.,108,15,6,129,645,7232
The Millers were its former tenant.,91,15,4,110,645,1567
You do have to watch out for a really big golf ball.,88,21,1,110,645,4577
"I don’t care how you try to spin it, earth-friendly energy is going extinct!",111,18,5,134,645,1274
It’s an affordable alternative to oceanfront.,110,20,4,134,645,1337
Where else can you get a variable home mortgage where the rate goes down with every hole in one.,108,24,2,134,645,1890
"All except for Don, the neighbors are great!",114,12,8,134,645,1988
No one has seen the giant since the bean stalk incident.,110,20,4,134,645,2079
A lot with THE view of this dramatic Putt-Putt hole is priceless.,109,22,3,134,645,2649
The neighborhood is just full of families.,109,22,3,134,645,3367
"OK, this is my final offer:  if you purchase the windmill, you can keep all the golf balls that make it through the front door!",108,24,2,134,645,6857
"and , the phrase ""going dutch"" originated on this very spot.",109,22,3,134,645,7306
"Guaranteed to keep the Elephant out of the room""",93,20,2,115,645,1482
"Nothing to worry about, Bob is a gentle giant.",112,25,2,139,645,35
Really? Most people like the 'Trump' at the top.,114,21,4,139,645,3010
The utility is suing you for unfair competition.,116,17,6,139,645,3359
"Perfect? Scaffolding on the roof and windows. We won't be able to sleep in Sunday mornings. And I bet you didn't even see the ""elephant in the room.""",115,19,5,139,645,4168
Congrats!  You're approved for a bank loan and bank shot.,115,19,5,139,645,5477
"Unorthodox, I know; but they do keep large animals from wandering in.",114,21,4,139,645,7366
I will put in the contract that a golf ball is only allowed to come through here once a week,119,20,5,144,645,952
We request a balloon payment and prefer bright colors.,98,19,3,120,645,1194
It was built from a do-it-yourself  kit by a surgeon.  It's a bargain for a little house next to a church in a Republican neighborhood...and it can be fixed.,100,15,5,120,645,1471
Instead of tilting at windmills just buy one.,99,17,4,120,645,1547
You got alot of balls buying this house!,102,11,7,120,645,2018
"Now the elephant's out of the room, let's talk about something else.",100,15,5,120,645,2634
"Now this here is a hole in one! But seriously, it’s got one room and there’s no door...",99,17,4,120,645,4149
You’ll love your negative power bill.,97,21,2,120,645,4564
It’s the ultimate ceiling fan AND all the electricity you’ll ever need!,116,26,2,144,645,5304
How about we drop down to the castle?,98,19,3,120,645,5570
"The owners won't fix that hole, so we can knock 20 grand off our offer.",114,30,0,144,645,6149
Welcome to Oxymoron Estates!,98,19,3,120,645,6181
_And the alternate energy tax credits can help with the mortgage payments!,99,17,4,120,645,6444
I recommend you install a door.,123,21,5,149,645,3851
"Sure there are obstacles, but I’m sure you could swing the mortgage.",104,16,5,125,645,209
"I'm telling you, if you're looking for a property to increase in value, this is your best option. You're literally standing on green!",103,18,4,125,645,380
The good news is that passing gas goes unnoticed!,100,24,1,125,645,792
And each house comes with it's own set of putters and balls.,101,22,2,125,645,893
"We'll have to move quickly, the elephant is not in the room.",104,16,5,125,645,1919
Trying to get in can feel like tilting at windmills,102,20,3,125,645,2335
Good point but the door actually opens and closes on a built-in timer.,103,18,4,125,645,2519
This is the most sought after prime windmill real estate in the area....,102,20,3,125,645,3644
The only downside is the giant golf balls ...,103,18,4,125,645,4397
"It's really the ultimate in roll-in,roll-out convenience.",101,22,2,125,645,4398
"We were going for a miniature golf park, but the builder wanted to make a statement.",102,20,3,125,645,5283
"Before we enter, how good are you at jump rope?",125,26,3,154,645,4288
The bad news is that since this is your dream house I can only sell you dream insurance.,124,28,2,154,645,4638
"There are some issues with the entryway, sure, but you won't find a starter home with more features.",104,25,1,130,645,3255
"On the plus side, you get a free game for every hole-in-one.",106,21,3,130,645,3548
Whoosh you be interested in this house?,106,21,3,130,645,3899
"To tell the truth, it's so cheap because the windmill never worked",106,21,3,130,645,3961
"When you hear the price,you'll be blown away.",108,17,5,130,645,4242
The only thing miniature about us is our pricing.,107,19,4,130,645,5152
Beware of the golf balls.,105,23,2,130,645,6789
"If we time it right, I think I can put you in this Olde Dutch style cottage right here.",130,25,4,159,645,7259
"I'm sorry, this property is temporarily off the market while the president demonstrates how ""The Wall"" will work.",112,18,5,135,645,143
This one's going to blow you away!,112,18,5,135,645,177
"You not only get this windmill, but we'll throw in the Church, too.",112,18,5,135,645,219
And it will never turn into a white elephant.,109,24,2,135,645,2293
I know your hearts were set on a Dutch Colonial. But this listing has far more charm and no soffit issues.,112,18,5,135,645,3229
It's a beautiful property.......just step to the sides when the golf ball comes through,112,18,5,135,645,5484
“It’s a tough putt but timing is everything.”,111,20,4,135,645,5542
"Yes, you may experience the occasional wind problem, but living below the 9th hole is treacherous.",110,22,3,135,645,5995
It's great for your timing skills,110,22,3,135,645,6446
The golf schools in the area are great.,111,20,4,135,645,6632
"That's right, there is no A.C on the inside, but you have it big time on the outside.",94,11,6,111,645,3532
It's the prime property in the miniature golf community.,113,25,2,140,645,1837
"Mini Golf Course living is great, but the balls are quite large so be careful.",113,25,2,140,645,3681
It's designed for people who love Elephants but don't want them as indoor pets.,115,21,4,140,645,4550
"No-maintenance landscaping, terrific third-floor views, and whole-house ventilation.  Any questions?",114,23,3,140,645,4629
"AND....the designer was Sancho Ponza at Quijote, Inc.!",116,19,5,140,645,5264
"Once you repair the hole in the lawn, your curb appeal will be much better than the loop-de-loop.",116,19,5,140,645,5795
"If it doesn't hit you, you could win.",113,25,2,140,645,5990
"This is a breezy unique charmer of a property, it’s a repurposed location with a great view of a dinosaur.",117,17,6,140,645,6362
You’ll have a ball with this home.,119,22,4,145,645,399
Your variable rate mortgage was approved.,93,22,1,116,645,1109
I can see you two love a challenge.  Here's a hint - the easiest way in involves dancing Gangnum-style.,96,16,4,116,645,5394
Classic Wind Turbin environmentally friendly Home you will ever Find !,117,26,2,145,645,5499
Our best spin is on Sunday morning.,121,18,6,145,645,5569
It gives the song Windmills of Your Mind a whole new meaning.,122,16,7,145,645,5750
"And so basically you can either send the golf ball back out or just keep it. Determines their mood for the rest of the day, it really is incredible.",96,16,4,116,645,5799
"Regarding your concern, this is the hole that would fix that problem.",115,30,0,145,645,6267
"It's a perfect combination of the old and the new: a quaint windmill providing eco-friendly, sustainable energy!",94,20,2,116,645,6522
Best way to keep the elephants out...and saves on energy costs!,95,18,3,116,645,6724
There's a hole lot to love here!,93,22,1,116,645,7357
"Aside from some obvious safety concerns, I think the house has great value and will be loads of fun.",98,21,2,121,645,1041
"It's really a bargain, but you have to watch out for the little white ball.",100,17,4,121,645,1443
"Frankly, it's a renter's dream.",102,13,6,121,645,1607
"And in addition to the renewable energy, there's a plastic recycling receptacle just outside the front door.",99,19,3,121,645,1882
"Yes, the blades will never turn, but this WAS the model home.",99,19,3,121,645,2172
It's got a fantastic front door that'll keep you on your toes.,98,21,2,121,645,2902
The big'uns still use it for miniature golf. That's why it's so cheap.,99,19,3,121,645,4769
"Sadly, a course pass is not included in the HOA fees.",98,21,2,121,645,6683
The only drawback to this property is exiting and entering on a windy day.,101,15,5,121,645,7234
"Face it, Elephant and Castle is declasse. People want local chapels, not tabernacles.  Windmills  are the future.",99,19,3,121,645,7253
The last occupant sold it for peanuts,100,17,4,121,645,7307
"It's got great schools, nice neighbors, golf at front door, low maintenance yard, lifetime free energy and it's a buyers market!",98,21,2,121,645,7372
"Mr & Mrs Escher,  I will let the owner know that you will take the house as is.",126,26,3,155,645,4098
You won't need air conditioning.,101,24,1,126,645,4848
"Ideal for a family, it also has no electric bill.",101,24,1,126,645,5596
"No, we do not allow wind farms nearby,",105,16,5,126,645,5897
Nothing Trump is mini.,104,18,4,126,645,6585
If you buy this house you can also practice your putting !,103,20,3,126,645,6589
"Frankly, you may have downsized a bit too small.",103,20,3,126,645,6830
"It's a waterfront apartment, conveniently located near the hazard on 15",107,21,3,131,645,632
"Around the corner, neighbors enter their house by dodging a real elephant's swinging truck.",108,19,4,131,645,1317
We can fix it!,109,17,5,131,645,1472
' And it's authorized for handicap purposes',107,21,3,131,645,1846
"And energy efficient thanks to  wind power? Why yes, why do you ask?",108,19,4,131,645,1848
"It’s got a great location, just ignore the occasional white ball that rolls through.",105,25,1,131,645,3906
Just think about how cheap your electricity bill be!,107,21,3,131,645,5227
"Oh, you'll be living the life, here on the 18th green!",108,19,4,131,645,7296
The neighborhood is quite safe. There hasn't been a tilting in these parts for thirty years..,112,20,4,136,645,108
It gives you green energy and comes with life insurance.,111,22,3,136,645,761
"He is a motivated seller, but he has big balls.",113,18,5,136,645,923
"It's carbon-neutral and in fact it will generate an income that will be significant. You just have to let some people play through on occasion.""",113,18,5,136,645,4509
. . . and a daily portion of grist included in the purchase price! !,110,24,2,136,645,5656
"This home here has some great features, including free energy!",114,16,6,136,645,5889
"Just as mentioned in the listing, the front yard has a view that’s to die for!",110,24,2,136,645,5918
We never realized assisted living was this handicapped.,113,18,5,136,645,7270
You just have to run in quick before it hits you.,114,25,2,141,645,5035
I hear you're looking to invest in something renewable.,88,16,3,107,645,6064
"I thought it was a great offer, but they said you’re joisting at windmills.",116,30,0,146,645,2103
"I know the entrance is problematic, but if you time it right, you catch the market tilting down.",121,20,5,146,645,2779
You do have to beware of the golf balls coming through.,120,22,4,146,645,3768
"Not only will you be off the grid, but so will all your neighbors.",117,28,1,146,645,3996
"So, are we ready to slay these future clean energy giants?",119,24,3,146,645,4432
"When you decide which way the wind blows, give me a yodel.",91,19,2,112,645,4411
And you have incomparable views of the golf course.,93,15,4,112,645,4479
Elephants are wary of moving objects so a wimdmill house makes perfect sense Because they’ll not be bothering you as long as the wind blows.,93,15,4,112,645,4514
""" This little number is a favorite here at Putt-Putt Estates.""",92,17,3,112,645,5131
The seller says you can have as many clean Titleists as you want.,89,23,0,112,645,6480
"If you can look past the sink hole, I believe we can get this Dutch Modern beauty for a song.",93,15,4,112,645,6628
"This house is a bit above your price range, but it's a hole-in-one.",127,17,7,151,645,1190
"This tiny home is not only right on the golf course, it's also off the grid as well!",96,18,3,117,645,1802
"Yes strong wind could create a bit of a problem for toddlers, but the modest price in a wonderful neighborhood with free electricity make this a fantastic buy.",95,20,2,117,645,1830
Cars? No need! Our retirement community members rely exclusively on mini-golf carts.,97,16,4,117,645,3264
"Now remember, you have only 15 seconds to open the door and get into the house!",96,18,3,117,645,3630
It’s a great school district.,97,16,4,117,645,3850
Watch out when the wind blows!,95,20,2,117,645,6461
"See, the best thing about this property is that it’s great for kids",95,20,2,117,645,6903
"And as if all this wasn't enough, the Putt-Putt Homeowner Association Agreement offers half-price rounds on weekdays before noon.",104,11,7,122,645,3410
This is the par 3 17th. After the next hole I will show you the main house.,98,23,1,122,645,4858
Yes the one next door has a fountain full of chocolate milk.,97,25,0,122,645,4958
Golf course views inside and out!..and free golf balls!,97,25,0,122,645,5177
"Being window dressing in a miniature golf game for giants has it's advantages, and we offer training and insurance in the event that you get hit by a golf ball.",99,21,2,122,645,5498
"No seriously, you can keep all the golf balls...",99,21,2,122,645,6600
The sellers are very motivated. The only downside is you may get golf balls rolling through your living room.,104,20,3,127,645,183
It's the most coveted domicile on the giant miniature golf course.,103,22,2,127,645,517
It comes with its own putting green.,104,20,3,127,645,1112
Welcome to miniature golf heaven where golf isn't so miniature.,105,18,4,127,645,1850
"If you do decide to accept the offer, we're going to want to make sure that we reserve any wind rights when you sell.",102,24,1,127,645,1859
"It's not what you were looking for, but it's got a hole lot of potential.",103,22,2,127,645,2462
"It’s a cute little place, but be careful: a big, dimpled ball rolls through periodically.",105,18,4,127,645,2991
How are the views of the crying children?,104,20,3,127,645,3391
You may want to buy two; in case you get a hole in one.,105,18,4,127,645,4803
You'll have a ball!,107,14,6,127,645,4896
"I agree with you Mr. Fore. This place is not for everyone. However, based on what you've told me about you and your wife's love for miniature golf I think you'll be very happy living here on the fourth hole at Putter's Paradise.",106,16,5,127,645,5675
The commutes a breeze,104,20,3,127,645,6487
"Yes, damage by knights on horseback are covered by your insurance policy but with an excess of  $100",101,26,0,127,645,6611
It's the best house on the lot with the lowest likely hood of a giant ball rolling in!,105,18,4,127,645,7519
I'll bet you've never seen a fully-functioning windmill on any of those tiny houses on HGTV.,110,17,5,132,645,652
"Well, that's the house, mind if we go Dutch for dinner?",109,19,4,132,645,884
Imagine wowing your friends with the latest in total energy independence,108,21,3,132,645,920
The air conditioning comes free!,108,21,3,132,645,2113
Just put an outhouse over it and you have an additional half bath.,106,25,1,132,645,3232
"Are you ballzy, Bob? If you want to owns this house, you need to be ballzy!",108,21,3,132,645,3573
It you're serious about buying the place the owner says he'll throw an elephant in the room,107,23,2,132,645,3743
"Sure, you have to dodge a few ball, but you can't beat the location.",110,17,5,132,645,4830
"As you can see Mr and Mrs Gulliver, an investment in our miniature golf project on Brobdingnag is a great opportunity.",109,19,4,132,645,4842
Its great exercise for those with a do you feel lucky attitude towards life.,109,19,4,132,645,4881
"Given the tricky lies, the price is par for the course.",108,21,3,132,645,5012
Your new entrance will move you like no other.,114,18,5,137,645,1550
"So, as you can see here, the exterior was damaged last summer by golf ball sized hail...",113,20,4,137,645,2520
It's the latest concept in air bed-n-breakfasts.,111,24,2,137,645,3321
This one is nicer than the castle on the green on the 17th hole,111,24,2,137,645,4620
But how’s the reception,118,19,5,142,645,1869
"Luckily for you guys, none of these giants are real golfers",117,21,4,142,645,2956
"Sure, i know you want to be green minded; 
but solar is so passe these days.  
One word: Windpower.  
Windpower is the future.",118,19,5,142,645,4660
"It's a very safe community. The only dangers, to speak of, are when the miniature golf course is open. I then suggest you stay on the second floor.",116,23,3,142,645,5239
You just have to be careful going in or out when the wind is blowing.,122,20,5,147,645,1455
And talk about close to the golf course.  This windmill is right on the green.,128,26,3,157,645,5300
"As you see, the term ""miniature golf"" no longer applies.",88,18,2,108,645,4912
"It’s a smart home, equipped with the latest hurrican warning technology.",90,14,4,108,645,5480
Keeps away nosy neighbors.,87,20,1,108,645,6063
"It really is perfect, you just have to make sure you don't fall into the hole when you run out the front door.",93,17,3,113,645,2501
We are 100% off the Grid.,96,20,2,118,645,2878
"It may not have a toilet, but you’ll be at the forefront of wind-energy technology!",101,19,3,123,645,173
"We are going to have to raise the building to let it spin,",103,15,5,123,645,821
The architect was inspired by society's current problems.,103,15,5,123,645,2647
Rent free if you kick the balls back,99,23,1,123,645,6073
The title of your new home is written on a Titleist …….,102,17,4,123,645,6770
It even doubles as a fire pit in the winter.,103,24,1,128,645,1016
"And, there's Central Air Conditioning at no Monthly cost",105,20,3,128,645,1816
It's completly safe in the off season but you'll want to winterize.,105,20,3,128,645,2299
"We have asked, but the little mouse insists that the ""clip-clippety-clop""  just isn't the same without his clogs.",105,20,3,128,645,3526
And what you'll save in energy!,106,18,4,128,645,4736
Just wait until you step inside and see the stunning view of the ball washer.,107,16,5,128,645,5026
Wind power is really taking off.  Get in on the ground floor now and generate electricity for yourselves and all your neighbours.,105,20,3,128,645,5888
"You've heard of B&B, right? This is B&M, ""bed and mill."" Put in a hot tub and you'll have to beat the farmers off with a stick!",106,18,4,128,645,6094
Thanks for choosing our vacation family package: golf community.,104,22,2,128,645,6598
"And you won't have to chase these anymore, Don!",106,18,4,128,645,7483
You realize all the bird-watchers will be up in arms over this size of Wind Farm?,110,19,4,133,645,258
"It’s a bit over budget, but think what you’ll save on utility bills !",110,19,4,133,645,1235
The blades do cost extra.,109,21,3,133,645,1644
"Yes, the windmill works and there are two escape rooms.",111,17,5,133,645,4012
"Yes, I know we advertised a house right on the golf course. What's the problem? It's not a white elephant.",110,19,4,133,645,4045
You May experience a few side effects.,107,25,1,133,645,5259
It's an amusing little cottage that keeps you on the ball!,109,21,3,133,645,6203
Burglaries are down by 50%!”,112,15,6,133,645,6544
Wait til you see the clown's face.,109,21,3,133,645,6685
I guarantee it's the safest home close to the fairway.,114,20,4,138,645,466
"‘’You’’ll have the best of both worlds - downsizing and living in golf course community.”   Submitted  by Mark Sappir, Lower Gwynedd, PA.",112,24,2,138,645,1115
"Since the giants don't play here any longer, you can install a normal door and fill in the hole.",114,20,4,138,645,3109
The golfers really won't bother you that much.,111,26,1,138,645,4030
"It’s old fashion, but it’s air-conditioning",113,22,3,138,645,5744
It's something new called Maxiature Golf,114,20,4,138,645,6665
This our old model.  No oil  No solar. Just wind.,118,21,4,143,645,4787
"let's talk about the real  elephant in the room. no, that isn't a functioning hot tub",123,20,5,148,645,2693
"Look at the bright side, the floor-to-ceiling air circulation is out of this world!",119,28,1,148,645,5956
"It's a new ""concept"" design for gated communities.",128,19,6,153,645,1733
Do either one of you have life insurance? The next hole has a shark.,125,25,3,153,645,5693
"Your kids'll love ""Gulliver's Estates""!!!",84,19,1,104,645,1971
"It does qualify for a discount on your 
homeowner’s insurance",84,19,1,104,645,7464
"This is the Don Quixote penthouse, with exclusive rooftop terrace.",88,20,1,109,645,1654
Think of it as a reverse speed-bump.,91,14,4,109,645,2615
"Hurry, it’s almost closing time!",88,20,1,109,645,4146
"You should close on this property today - it’s a hole in one. 

I heard open floor plans are a must have for 2019.",94,17,3,114,645,6151
When we said on the 18th hole this isn’t quite what we had in mind.,92,21,1,114,645,6219
Great neighborhood. Only downside is the massive flying golf balls.,91,23,0,114,645,7231
"Included are sixty wonderful neighbors, 600,000 visitors per year, and no fixer-upper expectations.",100,14,5,119,645,266
You can't beat the location--faces the ninth hole of hottest golf course in town.,101,12,6,119,645,492
"Obviously, the elephant in the room is the elephant on the back lawn.",98,18,3,119,645,800
"Plus, you'll save a ton on energy costs!",97,20,2,119,645,1947
I’m afraid your policy does not cover sprinkler related flooding.,97,20,2,119,645,5106
"...And in addition, the monthly electrical bill is quite reasonable.",97,20,2,119,645,5164
"The clown's head buyers had the same concern--not an issue.""",105,13,6,124,645,1221
"It’s all about location, I can get you on the 18th Green.",104,15,5,124,645,1915
You’re going to love you new home! Just think of the money you’ll save on those power bills!,103,17,4,124,645,2989
The house helps you find your tempo for life.,100,23,1,124,645,3380
"I'm not sure about the elephant, but I'm sure that you'll find the air conditioning very satisfactory. Made in Holland, you know.",102,19,3,124,645,5153
....and the price is just cuckoo.,103,17,4,124,645,5836
"Why yes, the yard IS big enough for an elephant.",107,9,8,124,645,6353
"Best of all, it's next door to the clown's mouth. Location, location, location.",103,17,4,124,645,6873
"This one is perfect for traveling salesman, but best be on your guard when the wind is strong.",105,22,2,129,645,671
The architect was inspired by the golf courses he used to play at as a kid...,108,16,5,129,645,1950
"Think of it as
“Savings for a windy day ..”",105,22,2,129,645,2036
We were out of picket fences.,103,26,0,129,645,2671
It does bring a certain charm to the neighborhood.,106,20,3,129,645,4760
"If you buy here in MinGolf City, you have to be careful of the obstacles.",106,20,3,129,645,6225
best curb appeal you'll find for the price,104,24,1,129,645,6227
"I know this one makes you angry Robert, but it's the only one in your price range.",106,20,3,129,645,6541
"Now I know an en suite was on your list, but consider the walkability here.",108,16,5,129,645,7092
"And if you decide to buy instead of rent, this property throws off a 5% cash flow from greens fees.",106,20,3,129,645,7107
By the way...people might drop by during business hours,106,20,3,129,645,7268
Windy season is overrated,112,17,5,134,645,702
"With all the hot air coming our way lately, this is your best choice in energy independence.",109,23,2,134,645,1099
The realtor ensured the newlywed couple that the freqency in which giant golfballs rolled freely through their new home would not be a problem.,112,17,5,134,645,1102
I'm sure the owners simply forgot to turn off the blades - I promise they are VERY motivated to sell.,112,17,5,134,645,1175
Be very quiet so the elephant doesn't hear you.,113,15,6,134,645,1416
With just a bit of remodeling I think we could achieve that post-modern look you’re after.,109,23,2,134,645,1460
"In case of a fire, the Means of Egress is a little tricky.",108,25,1,134,645,2839
...and this wind turbine will completely power your house cleanly and efficiently...,108,25,1,134,645,4188
"Whatever you do, mind the elephant.",111,19,4,134,645,5600
You'll never need Roto Rooter. A couple of balls and the entire system is cleaned out.,110,21,3,134,645,5815
"I believe this meets all your criteria: off the grid, a white picket fence, leaning Republican, Christian, multi-level, and a designer black hole in case of a scorched earth scenario.",114,22,3,139,645,786
"It's only in a really high wind you'd find yourself unable to leave the house for several days, otherwise what's not to love!",115,20,4,139,645,1655
"It was when Jack offered them a giant lifestyle at a killer discount, did the Petersons recognized their mistake and came to the realization that they were not interested in a timeshare.",114,22,3,139,645,2398
"While we don't insure against golf balls, we've got your catastrophic clubbing covered.",116,18,5,139,645,2873
"This is how it works: be quiet, stay in the windmill. It'll be fine. Whatever you do, don't let the elephant see you. I'll deliver the briefcase to him. If I'm not back in five minutes, jump down into the hole without me. We'll rendezvous later.",116,18,5,139,645,2995
What it lacks in energy efficiency it makes up for in charm.,114,22,3,139,645,3448
Good question.  The sellers own a miniature golf course.,114,22,3,139,645,4828
"You two will have a ball in this place!

Tom Nairn, St. Louis MO",119,21,4,144,645,6670
"Hey, you’ll save a fortune on your power bills!",122,24,3,149,645,5439
It does come with a P.O. Box in Boca!,131,24,4,159,645,5146
"The windmill will not hurt you, I promise.",115,22,3,140,645,312
The greenery around here is unreal!,103,19,3,125,645,429
And Bob- I hear that you're big into golf.,116,20,4,140,645,759
I'm afraid Don Quixote doesn't come with it.,106,22,2,130,645,823
It's the Dutch way to get you to the church on time.,116,20,4,140,645,1297
The kitchen is great but the location has some downsides,90,18,2,110,645,1495
"The sellers have removed the elephant from the room.""",118,16,6,140,645,1538
Included in the deed is 15% of the revenue from Shaquille O'Neal's miniature golf business.,82,16,2,100,645,1578
You should see the look on their faces when you send them back!,108,18,4,130,645,1803
"On the plus side, it is a Zero Net Energy House.",131,26,3,160,645,2331
All the advantages of living on a golf course AND free cuts whenever you want to play this hole.,110,23,2,135,645,2494
Welcome to Mar-a-Largo Estates!,94,19,2,115,645,2676
What elephant?  He isn't actually in the room...,112,19,4,135,645,2700
This house has a special anti-theft feature: Decapitation of  any intruder.,94,19,2,115,645,2809
The hole? Imagine it as your future koi pond or wine cave...,110,23,2,135,645,3103
"If you tilt, you can get through the door just fine!",116,20,4,140,645,3140
It's not so bad if you don't mind the giant golf balls.,122,26,2,150,645,3162
Think of it. You'll never need to grate cheese again.,114,15,6,135,645,3226
It's got great club appeal.,98,20,2,120,645,3292
It's environment friendly!,100,25,0,125,645,3370
The sellers say you could apply for a zoning variance to add a back door.,104,17,4,125,645,3496
This green solution perfectly meets your housing needs.  And it’s great you’ll let Airbnb play through.,109,16,5,130,645,3682
"When the coal smoke blots out the sun, you'll be glad you chose this option.",106,22,2,130,645,3686
It has a new basement...,111,21,3,135,645,3746
It's purely decorative but also virtue signaling.,114,15,6,135,645,3873
The comps for the surrounding holes have scaled up too.,112,19,4,135,645,3980
It's like the boulder scene from Indiana Jones but with clogs.,116,20,4,140,645,3987
This large affordable house hits your target.  It features a continuous quiet breeze; a weed-less enclosed yard in which your kids can play; and pristine sand that is strategically situated on the golf.,122,26,2,150,645,4001
"It's the new Xbox""",109,16,5,130,645,4017
"I think it's the best one we've seen so far, we're just worried it would get drafty.",107,20,3,130,645,4282
"Here at Mini Haven Golf and Retirement Village all our models are replicas of traditional obstacles modified for your comfort and enjoyment.""",98,20,2,120,645,4944
At least you get the choice! The next poor couple is gonna be stuck living next door to the clown.,115,22,3,140,645,5121
And this is the Bedminster Miniature Golf Time-Share Condo top of the line -- The Melania.,109,16,5,130,645,5450
"Sure the locations not perfect, just roll with it.",103,19,3,125,645,5794
"Once you get into the rhythm, count to ten an run",114,24,2,140,645,6347
It’s really a very nice house. You just have to remember to close the door.,125,20,5,150,645,7281
It's the romance of the links outside your front door.,111,21,3,135,645,7330
We need to act fast as this is the last remaining house for sale in the Putt-Putt subdivision.,114,24,2,140,645,7425
It's a steal but you might want to consider large brightly colored rolling golf ball insurance.,127,27,2,156,645,7358
"You have to be a little bit alert, no one yells ""fore!"" at this kind of course. But they close at 9:00 so no golf balls will come through after that.",125,22,4,151,645,4404
"The location is beautiful, but I just don't know about the traffic.",119,25,2,146,645,1767
"Well, I'm sorry, but I thought this met your criteria for a tiny home.",121,21,4,146,645,3500
Don Q has left the room,122,19,5,146,645,4359
Helps if you played a lot of mini-golf!,120,23,3,146,645,5849
And the elephant can't fit through the door.,122,19,5,146,645,6074
It will take a real stroke of luck to sell it.,115,24,2,141,645,342
This house is a real hole in one.,117,20,4,141,645,6570
I think you'll appreciate this next property's open concept design.,116,22,3,141,645,7163
I say we stay just here:  elephants are afraid of windmills and golf.,112,21,3,136,645,762
This is the kind of of wall Jesus would build.,116,13,7,136,645,4166
"One last thing: you may want to consider adding a Golf Ball rider to your homeowner's insurance policy.""",112,21,3,136,645,4291
"When the course sprinklers flow, you'll feel just like you're living in the Netherlands.",114,17,5,136,645,6450
We can’t find the ball. That’s why it’s up for sale.,111,14,6,131,645,1470
What is the fee to tilt?,111,14,6,131,645,2834
And it comes with an in-built air-conditioning system!,107,22,2,131,645,3063
The trick is to put your deposit down when the blade is IN FRONT of the door.,107,22,2,131,645,4221
you should be able to avoid your in-laws handicapped 15 or above,107,22,2,131,645,4318
"It's just a one bedroom, one bath, but I think you'll find it plays long.",107,22,2,131,645,4390
You'll save enough on air conditioning bills to furnish the entire house!,106,24,1,131,645,4961
Can you believe not one person has bogied this hole ever?,105,17,4,126,645,140
"When life itself seems lunatic, who knows where madness lies?",105,17,4,126,645,885
And in the summertime kids love the built in ferris wheel,105,17,4,126,645,3729
Trust me-you're gonna want an exercise ball.,105,17,4,126,645,5597
The Dutch praise real-estate like this.,105,17,4,126,645,6472
"Yes'm, your policy covers all chivalric medieval knight attacks.",103,21,2,126,645,6810
It’s one of the more modern houses in the neighborhood.,102,23,1,126,645,7283
"You’ll need to act fast. This is a short sale, and the owner has retained stomping rights.",98,22,1,121,645,109
Your chances of being struck are vanishingly small.,100,18,3,121,645,2393
Actually the Property Brothers Renovated this home,102,14,5,121,645,4058
Because the blades swing in front of the door and because there are elephants in the neighborhood makes this a very affordable area.,101,16,4,121,645,5865
Mr. Quixote is waiting for the government shutdown to end before he can continue to defend the helpless and destroy the wicked.,101,16,4,121,645,7052
...and you can pay off the mortgage with the water it pumps.,99,20,2,121,645,7310
"When the wind kicks in, I can show you inside of this property.  Solar energy is the thing of the past, and we stepped onto the next level.",96,17,3,116,645,3083
It's close to good schools. The commute is ideal and it's got an innovative security system.,94,21,1,116,645,4418
I can reduce the price if you're not into grinding your own flour.,97,15,4,116,645,4738
Lilliputian Development Inc. is pleased to introduce this new Live-on-the-greens opportunity.,98,13,5,116,645,5220
I know it's a bit under par but......,91,18,2,111,645,1776
I’m not sure you two will be able to manage the constant ball jams at Windmill Hole Estates.,90,11,5,106,645,1533
Wind power is the coming thing - say goodbye to your electric bill!,134,24,4,162,645,1202
Try and keep an open mind. You'll find it wonderfully breezy.,132,28,2,162,645,4092
This view’s gonna kick the crap out of Linda’s beachfront.,131,21,5,157,645,5075
I'll even throw in bogey insurance for free,122,21,4,147,645,5904
You'll never have to flush.,115,26,1,142,645,5389
On the plus side you get to use the express lane on the bean vine.,116,15,6,137,645,899
"It's really a great place to live.  Just make sure you're mindful of the hole, and watch out for the ball when they miss.",115,17,5,137,645,1245
"Dammit, Scott, it's meant to generate conversation WHICH CLEARLY IT HAS",113,21,3,137,645,3224
These new “upscaled” courses are quite the challenge!,112,23,2,137,645,4541
The steep hazard insurance is compensated by its wind-powered energy efficiency.,115,17,5,137,645,6954
It's cheaper than Ring.,106,26,0,132,645,962
You won't be featured in House Beautiful but will be in Eco Ultimate Design!_,108,22,2,132,645,3219
"I know it’s a little out of your price range, but it’s got everything you else you are looking for.",111,16,5,132,645,4196
Yes this is our Holland -One model .,106,17,4,127,645,2326
It’s okay that will only be a concern on blustery days,105,19,3,127,645,2442
The previous owner was a giant who loved mini-putt,107,15,5,127,645,2518
It was built in the 90s for “The Quick and the Dead.”,107,15,5,127,645,4044
Go Dutch for the financing.,104,21,2,127,645,4170
You don't just SAVE money; the power company PAYS you for the electricity you send back to the grid!,104,21,2,127,645,5230
Now the downside is that this is the 18th house on the block so any lost balls will not be returned.,104,21,2,127,645,5590
We prefer to call our community: a mini-golf life style rather than a resort.,104,21,2,127,645,6357
Next summer they are looking at adding solar to the community,103,14,5,122,645,2048
You'll both love the circulation of the air in this classic hole.,101,18,3,122,645,2674
Who told you about the golf balls?,100,20,2,122,645,3492
You just have to set up a simple timed schedule to go in and out - easy!,100,20,2,122,645,6169
"Even greener than solar, and you'll get used to the timing of when to head into and out of the house.",100,20,2,122,645,6172
Renewable energy might be dangerous.,101,18,3,122,645,6413
Now this one will surely 'putt' a smile on your face!,103,14,5,122,645,6972
It comes with wooden shoes,100,20,2,122,645,7322
"fully air conditioned,24/7 security,and totally eco-friendly. a dream come true,yes?",100,20,2,122,645,7469
Bob was. great sails-man.,96,19,2,117,645,413
But think how great it will be for your handicap.,96,19,2,117,645,2204
"You know the old saying?
In choosing this particular hole for you,
we took in to account your Dutch DNA.",97,17,3,117,645,4343
Sorry folks the seller won’t go Dutch,96,19,2,117,645,6510
I wonder why the last owners didn't't like it.,95,21,1,117,645,7241
The mortgage may not miniature,98,15,4,117,645,7347
This high-concept model home harks back to the miniature golf icon,92,18,2,112,645,3438
"Thanks to wind power, you'll be surprised at how low your energy bills are.",123,21,4,148,645,6863
The price does include utilities and water features,117,24,2,143,645,704
So..what's your opinion on white balls? Your wife refused to answer.,118,22,3,143,645,1107
"It’s completely wind powered, located in a beautiful neighborhood with rich green expanses and a complete steal at the price. Fully worth any inconvenience caused by the occasional high speed projectile.",121,16,6,143,645,2178
Look at it this way - it's a breeze bigger than 500 sq. feet.,116,26,1,143,645,4742
"Buy one windmill, get one free elephant in your backyard. And don't get me wrong, nothing political.",120,18,5,143,645,7147
Look at if this way..... it keeps the children from running around!,113,23,2,138,645,701
Golf is a lot like taxes. You go for the green and wind up in the hole.,117,15,6,138,645,2213
"With a price like this, it really is a hole in one.",114,21,3,138,645,2374
"You miss 100% of the shots you don’t take, even the miniature ones.",112,16,5,133,645,1570
And it generates enough electricity to power you Tesla.,114,12,7,133,645,3736
"A great place to sunbathe, it's never windy here.",111,18,4,133,645,3835
"It's got 2 bedrooms, 2 baths, and it's environmentally friendly...",109,22,2,133,645,5062
"It’s a great investment property with highly advanced renewable energy technology and the housing market is rock solid right now”
circa 200",110,20,3,133,645,7118
"No remember before we go in or out, you will need to run like hell!",107,17,4,128,645,442
Now this unit is slightly above your stated par,106,19,3,128,645,543
"Isn’t it beautiful? So quaint! And the black hole is perfect for when the depression gets really bad...sorry, going  through a rough time right now. So anyways what are we thinkin guys?",106,19,3,128,645,1808
Do you want to take another look at the clown's nose before you putt in a lowball offer on this hole?,104,23,1,128,645,2694
But you must consider that you will save a bundle on power with all the hot air coming out of Washington.,109,13,6,128,645,3698
It could really be something with the right touch.,106,19,3,128,645,6250
"It can be removed, although depending on speed can create quite a breeze.",107,17,4,128,645,6436
"Let me show you the Hubbard place, it's in the neighborhood.",109,13,6,128,645,7145
"To be long winded about it, it does beat fossil fuels.",104,14,5,123,645,278
Are you golfers? Because this is the perfect house for golfers.,103,16,4,123,645,1576
You just need to run through the front door when it is not covered by the windmill wings,105,12,6,123,645,4682
"I can personally assure you, Mr. Schwackling, that with this world-class facility here you won't just be tilting at your enemies--you'll be crushing them.",96,21,1,118,645,802
The police believe your daughter may have eloped.,99,15,4,118,645,902
It’s a real fixed par upper.,98,17,3,118,645,2895
Miniature golfing is optional.,97,19,2,118,645,3221
"So, is it gonna be windmill one, two, or three?",97,19,2,118,645,6633
Good neighbourhood. Top of the line security system. It’s just the sink holes that turn people off,97,19,2,118,645,6980
You'll never find another gated community as secure as this one.,98,17,3,118,645,7073
We can insure your new home but the windmill does not qualify as a security system.,125,28,1,154,645,7353
"You've heard of the Pennsylvania Dutch, well this owner is Dutch...Dutch.",93,18,2,113,645,633
The home is totally energy efficient,96,12,5,113,645,649
And of course you will need to get an insurance rider to cover the occasional  giant golf ball.,93,18,2,113,645,753
"Disclosures? Well, the visitors don't say ""fore"", but you'll always hear those pretty colored balls coming.",93,18,2,113,645,930
The flour garden is beautiful.,95,14,4,113,645,1122
Yes.  Quick beats Ambivalence.,92,20,1,113,645,5559
"No, I'm afraid the little man at the top of the tower was a fictional construct on the part of Mr. Hitchcock. But if that's a dealbreaker ...",124,21,4,149,645,3430
It's conveniently located to the T.,89,17,2,108,645,1094
"CHARM, you got to listen to me, look at the architecture! This is a very active neighborhood! Golf, Did I Say 'Golf!?",118,24,2,144,645,1942
Actually there is a pretty long waitlist for a 3-putt.,91,13,4,108,645,2712
And there's even a 15% chance that even those who make it past the Pit will be decapitated!,120,20,4,144,645,3387
"They're very predictable, actually, but you do have to watch out for this loony Spanish guy.",90,15,3,108,645,5319
Trust me... this view of the 18th hole makes it very easy to forget about the maniacal laughing clown upstairs.,88,19,1,108,645,5752
"New house, new black hole, new elephant pet. Congratulations! and... Do you play golf casually?",117,26,1,144,645,5858
"Quixote says it's giant, Trump says it's huge.",119,22,3,144,645,6781
"It's nice, but we were hoping for a pop up feature.",120,20,4,144,645,6837
We'll throw in solar panels for free.,117,17,5,139,645,690
"Sure, it's just a starter home, but it used to be a non-starter.",117,17,5,139,645,3888
"Yeah, but the amenities.",114,23,2,139,645,3940
"This home comes with cathedral ceilings, an open floor plan, wind power to keep your electricity costs down, and is within walking distance to the church, the elephant, and a pretty decent snack bar if you ask me!  It's also a steal at $227k!",117,17,5,139,645,4574
Our new patented front door still needs some adjustment.,114,23,2,139,645,4838
"Although unique the power supply is free, & the rent is low because it offsets the Republican cloud statue.",116,19,4,139,645,5615
An easy walk to church on Sunday; pet friendly too.,114,23,2,139,645,6187
It was previously owned by Harrison Ford.,115,21,3,139,645,6193
"Sorry, Wind Insurance is not included in your Homeowner's Policy.",116,19,4,139,645,6860
Apparently he had a Napoleon complex.,115,21,3,139,645,6985
And if the wind stops you have a pool!,110,22,2,134,645,665
"So environmentally favorable, even solar cellar are not needed.",112,18,4,134,645,2104
These are examples of our newer fencing.,112,18,4,134,645,3047
"As you can see, there's only a hole in one spot on the property.",115,12,7,134,645,6031
"I understand, you have to go over all your options. But if you ask me, I think this place is a real hole in one.",136,26,3,165,645,5903
"Barbie’s Dream House isn’t on the market, but this community hosts lots of fellow golfers.",107,19,3,129,645,54
Actually it's a time-share - from sunset to sunrise.,106,21,2,129,645,122
"You don't qualify for this property, but you do qualify for our Lucky Wheel.",110,13,6,129,645,2453
With the slightest breeze you'l generate you own power.,107,19,3,129,645,3635
"Gulliver only plays once a week, so go out on Wednesday’s.",107,19,3,129,645,3861
"As you can see, the previous owners were really big on minature golf!",108,17,4,129,645,4796
what's security like?,107,19,3,129,645,7149
"Whatever you do, don't acknowledge the elephant.",133,23,4,160,645,6422
No electric bills!,101,22,1,124,645,779
"Now this is considered a ""premium lot""...the windmill house is behind the hole.",102,20,2,124,645,1010
Now your commute may be a bit more challenging!,102,20,2,124,645,1301
"just watch out for blades, balls, and holes",105,14,5,124,645,1376
Do we have to worry about old guys on horses?,105,14,5,124,645,1684
Let me tell you about the elephant in the churchyard.,102,20,2,124,645,4231
Have I got an insurance plan for you.,101,22,1,124,645,5564
It's the epitome of today's upscale vacation lifestyle.,101,22,1,124,645,5719
"Now before you say no, it's in a really great schooling district.",101,22,1,124,645,6520
"Remember, the house is miniature.  The golf balls passing through are regulation size.",123,25,2,150,645,6395
"Sure I can show you some others, but the blades won't be as fashionable.",99,17,3,119,645,1034
"Welcome to reverse mini golf, please sign the liability forms here",98,19,2,119,645,1519
"Think of the amusement park possibilities:  goofy golf, tilt-a-whirl, the whole 9 yards.  And an adjustable white picket fence for the homey look.",101,13,5,119,645,2171
"No, there’s no meter. We’re still negotiating with ConEdison",99,17,3,119,645,3479
"I should warn you, its in “fore!”-closure

Ryan Howie, Maple
Glen, PA",99,17,3,119,645,3574
"So what do you think of the new lay of the land?""
'Well, we'd prefer if you made America small again.",97,21,1,119,645,4596
It's an outsize metaphor for home ownership. That hole is your mortgage...,99,17,3,119,645,5246
"Best of all, fan speeds are self-adjusting!",121,20,4,145,645,1544
There are no regulations about this becoming an air bnb site.,123,16,6,145,645,1546
"Not much to it. Curl up in a ball and wear a helmet. Oh, and if some kid pulls out a 3-wood, scramble up the inside of the windmill and hold on for dear life.",122,18,5,145,645,5766
"this house can be noisy in the wind, but it is very ecologically correct.",120,22,3,145,645,5842
"If you like this, you’re gonna love the full-sized golf course.",95,16,3,114,645,2922
The neighborhood is great. A couple potholes but nothing some concrete can’t fill.”,93,20,1,114,645,3323
The neighborhood doesn't seem very safe.,95,16,3,114,645,4606
The best combo of modern and traditional—solar panels on a rotating windmill design.,95,16,3,114,645,6624
Diversity is one of the greatest strength of this neighborhood.,115,23,2,140,645,287
There’s no beach but it’s still a nice bunker.,115,23,2,140,645,2395
The rental application is a breeze,116,21,3,140,645,2569
"It can be a hassel getting in and out, but at least you don't need to install an alarm system.",119,15,6,140,645,5557
This home only requires one bank.,115,23,2,140,645,7252
Sale before the wind.,90,17,2,109,645,1568
"So, you don't think this giant wind mill will be a nuisance?",112,20,3,135,645,394
Last owner was my Dutch uncle … what do say we give it a whirl.,110,24,1,135,645,954
"In considering the nostalgic feeling you're looking for, this place is definitely up to par.",113,18,4,135,645,3960
"Funny you should refer to the house as a ""white elephant...""",111,22,2,135,645,5095
It's a great place to spend menopause,116,12,7,135,645,5874
This property is golf course adjacent,107,21,2,130,645,535
"It’s a rave amongst millennials in the City, first month rent free.",105,25,0,130,645,2456
"There IS the pride of living in a home on the National Register, but no, the ""whirly things,"" as you call them, have to stay!",127,28,1,156,645,3337
Is it a bit drafty in here or is it just me?,129,24,3,156,645,5073
"You might think this Windmill House is a bit of a white elephant, but I can assure you, that's definitely somewhere else.",110,15,5,130,645,5906
"Yes, it is very energy efficient. 
Just don't keep your breakables on the ground floor.",107,21,2,130,645,6141
And try not to call attention to yourselves.,107,21,2,130,645,6336
Poles and ladders,124,25,2,151,645,2126
Giant bowling is totally going to replace mini golf.,126,21,4,151,645,2464
If this is too much house I do have something miniature that I can show you.,104,18,3,125,645,681
"Yeah, but if your cable ever goes out you'll still be able to get local channels.",104,18,3,125,645,1393
"And if you get tired of being knocked down by the windmill, just pick yourself up and throw yourself down that hole out front.",104,18,3,125,645,1624
We recommend the mini-golf package for low budget world travelers,104,18,3,125,645,1701
"I LOVE this place, but sleep walking blows me away!",107,12,6,125,645,2858
"No, there’s no upkeep.",103,20,2,125,645,2888
Think what it would be like to live ON the fifteenth hole!,102,22,1,125,645,3586
I don’t hear it squeaking.,102,22,1,125,645,4494
"As you can see, this is a prime example of one of our tiny houses.",103,20,2,125,645,5275
Be very careful when you go in or out. It's not a good choice for the inattentive.,102,22,1,125,645,5866
Just one little thing.  You may have to occasionally dodge a giant golf ball as it rolls through the place.,104,18,3,125,645,6565
"I promise you, the security system is on-par.",101,24,0,125,645,6673
You can't beat the greenery.,104,18,3,125,645,6744
People mostly stay on the second floor.,103,20,2,125,645,7188
Be careful. You might have to dodge obstacles when I show you this next property.,122,20,4,146,645,904
"If you want the hole in one million, you may take the windmill, but not the course",123,18,5,146,645,4497
Just sign our hold harmless agreement and it's yours.,98,21,1,120,645,5772
....and we call this our Lilliputt model.,98,21,1,120,645,7141
The apartment even includes a river and dryer.,115,25,1,141,645,135
Don't you know the difference between a fence and a windmill?,118,19,4,141,645,2685
"Whatever else you can say about it, it's certainly Dutch uber alles.",118,19,4,141,645,3542
"It not only keeps the wolf away from the door, but keeps elephants away, too.",95,18,2,115,645,1689
"Now I understand what they meant 
when they told me you were 
a 'Big miniature golf ' fan...",96,16,3,115,645,2961
This historic little gem is the real deal. We just moved it over from Bob's minigolf yesterday!,96,16,3,115,645,3678
It slices! It dices! It's the new improved Golfamatic!,96,16,3,115,645,4178
There is also a shortcut to the roof as you can see,96,16,3,115,645,4399
"Once you get used to it, it makes elevators seem prehistoric and timid.",95,18,2,115,645,4610
"with the increasing cost of housing, i thought we'd look at mini-golf course facing homes instead",114,18,4,136,645,979
The second bathroom is a portopotty near the hole with the clowns mouth,113,20,3,136,645,2055
"Finally, ownership of this property entails a wealth of rollover possibilities.",111,24,1,136,645,5110
"... and Blunderbore’s handicap is 18, which means your rate would be about 3.4%",114,18,4,136,645,5194
"Eco-friendly, wildlife friendly & ideal for slutty masquerade parties",114,18,4,136,645,6032
"I know, but house #1 had better closet space.",112,22,2,136,645,7263
You can putt no money down.,110,17,4,131,645,967
The clown house next door would be a better fit!,109,19,3,131,645,3260
"If you stick your head out of the window when they play, you'll get a reduction on your rent.",111,15,5,131,645,3723
I know you'll love the windmill of activity here in our little town.,110,17,4,131,645,5547
Think of it this way: the air conditioning is free.,109,19,3,131,645,6780
Don't worry.  She won't come in.  She just longs to reincarnate as a miniature.,111,15,5,131,645,7434
Your white picket fence doubles as propellers for your flying house.,106,16,4,126,645,1147
"It’s modern meets meta, meta meets metaphorical: imaginary envisioned as literal, miniature giganticized!",88,14,3,105,645,1259
"Minus the sinkhole in the front yard, folks, this isn’t your run-of-the-mill family home.",105,18,3,126,645,1763
The helipad on the roof makes all the difference.,106,16,4,126,645,1814
Just think...no electric bill each month!,122,22,3,147,645,2158
"No. That's not a gopher hole....okay...all deposits are nonrefundable, enjoy your new home!",103,22,1,126,645,3138
Gone with the wind!,106,16,4,126,645,3145
"He tweeted this as his mock-up of the ""Very Great Border Wall?  My God.  No wonder 'mock' is in the lexicon.",106,16,4,126,645,3733
It’s golf course adjacent and comes with a security system!,104,20,2,126,645,3984
This house is gonna knock your socks off.,106,16,4,126,645,4496
We've got them over a barrel - they don't even know how wind works!,102,24,0,126,645,5747
And you called me Quixotic for wanting a house near the office!,106,16,4,126,645,5805
This is a great buy but you have to watch the traffic.,122,22,3,147,645,6969
This housing development was built for the young at heart.,103,22,1,126,645,7042
"Since you love open concept, I hope you're open to this giant of an opportunity we found in Beanstalk East.",119,19,4,142,645,485
"One white picket fence is so last year. For God’s sake, be modern for once.",119,19,4,142,645,3379
So all you'd need is a really big battery,102,15,4,121,645,731
This is a perfect neighborhood for families.,103,13,5,121,645,1634
It's a time tested home security device to keep people lacking co-ordination from entering your home.,99,21,1,121,645,3094
It’s a swinging place all right.,100,19,2,121,645,3365
You do realize that you'll be pioneers in this neighborhood.,101,17,3,121,645,4945
You’re not just off the grid on a golf course. You are the grid and you are the golf course!,114,20,3,137,645,1126
It's a hole in one-of-a-kind.,115,18,4,137,645,2971
"Don't worry, we offer jumbo financing.",114,20,3,137,645,5667
...and this is the best of the properties-- so many interesting people looking for their balls!,115,18,4,137,645,6880
"Sorry, no pets or tilting allowed",98,14,4,116,645,3971
Honey... I thought we bought a miniature golf course.,127,23,3,153,645,1507
The neighborhood is mostly tiny elephants.,112,15,5,132,645,597
Puttputtville comes with its own private putting green. Be the first to buy one of these wonderful and affordable homes.,109,21,2,132,645,868
It'll be a great home! You can walk or out every 10 seconds.,110,19,3,132,645,935
You should get in now. My gut is that after the primaries the values in this neighborhood will shoot up.,108,23,1,132,645,4866
"Personally, I think it’s our most successful attempt at ignoring the elephant in the town.",110,19,3,132,645,5209
"Not only does it have indoor-outdoor carpeting throughout the main floor, it's the only time-share with air-conditioning.",109,21,2,132,645,5234
"It grinds flour so you'll never run out, though it'll grind you if you don't watch out.",111,17,4,132,645,5748
We have the national distinction of our homes being closest to the golf course.,109,21,2,132,645,5829
"We KNOW it’s rent-controlled!!! We’re more concerned with the 200-mph wind, advertised as a ‘light breeze’?!",110,19,3,132,645,6536
"Our developer was at a  miniature golf course last year, came back with some really cool ideas.  One buyer on another lot I recently sold converted the hole to a Jacuzzi.",124,20,4,148,645,5432
"No, it's really our makeshift air conditioning unit.",134,29,1,164,645,7080
Welcome to East Hampton...,105,20,2,127,645,534
I can also show you an absolute dream house where a young blonde woman used to live,104,22,1,127,645,572
"Just inside the door is a light that turns GREEN when it is safe to exit. And that ""cup"" you see is not a hole, just a circle of black tile",106,18,3,127,645,965
"The home is super energy efficient, and the homeowners association let's you choose between a blue, red, yellow or pink mailbox.",107,16,4,127,645,2564
The only thing you have to worry about is when the giant wants to play through.,107,16,4,127,645,5497
I wouldn’t pay anything over a double bogey for it.,106,18,3,127,645,5691
And it’s environmentaly conscious,103,24,0,127,645,7108
"As your agent, I think you will fit into this neighborhood quite nicely.",105,20,2,127,645,7422
Demand for this kind of home is rapidly rising due to the new tech culture.,119,21,3,143,645,365
[ Insert Don Quixote tilting at windmills joke here ],118,23,2,143,645,5418
If this 6 hole renewable energy home is not you there is a 9 hole African plains home available,121,17,5,143,645,6793
"Sorry, the building’s covered but you don’t have the wind propeller rider.",87,18,1,106,645,1176
"You can have the feel of a miniature house but still have the space.""",102,17,3,122,645,50
"The AC is an offshoot of the Paris Accord and, as you can see, you have the start of a very nice sinkhole fir carbon sequestering.",101,19,2,122,645,961
You might want to lay low when the elephant plays through,102,17,3,122,645,2116
The house comes with a built in security feature that makes it almost impossible to break in.,101,19,2,122,645,2577
I’m not really your agent. I’m hiding out from the elephant,101,19,2,122,645,2764
Price reduced. Turns out no one likes the elevator.,101,19,2,122,645,3336
"This is the run-of-the-mill house, add your own doors and window panes.",100,21,1,122,645,5225
"I know mini-golf Monday isn't the best time, but I will be asking for full custody Karen.",103,15,4,122,645,6078
People leave here happy. You can't miss.,115,20,3,138,645,89
"Once you own it, you can just patch that up.",113,24,1,138,645,284
And you do not need to pay for air conditioning in the summer!,113,24,1,138,645,661
"Great for a B&B, while serving the function of a working windmill; and on prime real estate as well.",112,26,0,138,645,809
It actually runs on coal so your neighbors are fine with it.,115,20,3,138,645,1129
"Actually, Mr. and Mrs. Smith, the three most important things in real estate are now rotation, rotation, rotation."" ""Yes, yes, this should help expedite white flight."" ""Dear, I think you mean, national aviation.",113,24,1,138,645,1277
This is no white elephant. It has your white picket fence and overlooks the 7th hole.”,112,26,0,138,645,1388
"In this case, I’d recommend fixed-rate over adjustable.",126,27,1,154,645,5715
I'll be blunt. The previous windmill owner saw all kinds o' horrors crawl outta that hole. His loss is your bargain.,133,13,8,154,645,7054
...and Your hole is protected by these huge flaps,85,13,3,101,645,6504
"A one year lease comes with unlimited weekday rounds. Kids, if you plan on having any, can also play for free on weekends.",98,16,3,117,645,304
In Britain this price would be called crazy,96,20,1,117,645,2212
"It’s a variation on the Tiny House.  It’s called a Wee Windmill, and it produces its own energy.",96,20,1,117,645,3489
"If you've played Putt-Putt, then you know how this home works!",111,19,3,133,645,500
You'll appreciate the easy way up to the top floor.,111,19,3,133,645,1311
Well this is just sub-PAR!,110,21,2,133,645,2602
... then you start the sails turning and it drives the elephant into the sink hole.,111,19,3,133,645,4687
His parents owned a miniature golf course,109,23,1,133,645,4979
The community club house also offers a dining option.,109,23,1,133,645,5803
We strongly advise you to install a porch light. The previous owner failed to do that and were swept away one night and we haven't seen them since.,109,23,1,133,645,5809
And the beauty is the mortgage can't  see you coming or going!,111,19,3,133,645,6775
What do you mean by “elephant in the room” with this house? I assure you there’s not.,110,21,2,133,645,7218
Downsizing has its advantages. All the houses in this complex come with w swimming hole.,123,24,2,149,645,6361
It's an above par neighborhood so everyone leaves their doors...you can bank on that.,123,24,2,149,645,6414
"It's a bit unconventional but you'll love living here, and it's zoned for any type of pet.",108,16,4,128,645,554
It used to be a puppy mill,122,17,5,144,645,1921
"It's like miniature golf--if you get hit by the windmill and can't get to the hole, it means you shouldn't get married.",109,14,5,128,645,2185
"Well, if you like foursomes, this is the place for you!",121,19,4,144,645,2190
It's a game.  You miss and you go for a spin.,93,17,2,112,645,2342
It has a one of a kind security system from ten a.m. to ten p.m.,118,25,1,144,645,2454
"Yeah, the elephants don't really come near here much.",95,13,4,112,645,2545
"And this is where one of the Dutch Masters, VerMouse lived.",107,18,3,128,645,3215
We call it slipshod; it's like tilting at shiplap.,92,19,1,112,645,3524
And for this little fixer upper may I recommend Quixote Construction,118,25,1,144,645,4852
The HOA requires you keep the pit of death uncovered.,109,14,5,128,645,5199
"Really, the circulating gates will increase your equity.",106,20,2,128,645,5205
''well.......make an offer!'',93,17,2,112,645,5238
It tilts so that you don’t have to,106,20,2,128,645,5243
Remember to take cover whenever you hear “Fore”,108,16,4,128,645,5345
Hole? Elephant? This is golf course living and timing is everything.,123,15,6,144,645,5348
This house checks everything on your wish list list. It’ll blow you away.,107,18,3,128,645,5688
"Look, before we go in, the owner is round, bald, and has the worst cellulite I’ve ever seen.",132,26,2,160,645,6962
You should consider sinkhole insurance.,107,18,3,128,645,7069
The developer is a very big fan of mini golf.,118,16,5,139,645,1026
The down payment is also very small.,117,18,4,139,645,3813
"Alright, we'll cut the price. After all it is a bit...drafty."" 

(submitted by Hattie Korein",102,19,2,123,645,4400
You will get the hang of dodging golf balls. The vanes are trickier.,103,17,3,123,645,4713
It's the maxy golf house village.,103,17,3,123,645,4758
"State-of-the-art granite kitchen and panoramic golf-course views, on par with our highest-end listings.",102,19,2,123,645,5079
"Stop put-putting around, put an offer in.",102,19,2,123,645,6605
"Your job is to act scared, and not get hit by the giant golf ball.",111,21,2,134,645,2038
And you will delight your guests when every now and then a colorful golf ball comes rolling through.,112,19,3,134,645,2583
Welcome to Hell.  Tee off’s in ten. They're playing Putt Putt You.,112,19,3,134,645,4722
The people watching is epic!,112,19,3,134,645,5126
As long as the wind keeps up you don't have to worry about the elephants.,114,15,5,134,645,5214
"It's Dutch treat to get in, folks.",113,17,4,134,645,6479
Traditional golf resorts became gauche.,99,16,3,118,645,1158
They double as door and window protectors in any color you choose.,97,20,1,118,645,1581
And four beats to the bar keeps out unwanted guests and the ghosts of elephants past.,98,18,2,118,645,1856
"Think of it as a new concept of revolving door, just enter and exit with caution.",97,20,1,118,645,4598
"If you are serious about downsizing, this is the perfect hole.",101,12,5,118,645,6076
You could be quite cozy here as long as you don't say 'Beetlejuice' three times.,109,16,4,129,645,6
It's more of a sunscreen than a windmill.,108,18,3,129,645,367
"Let me work my magic, I think we can negotiate the price, but you can't best the location!",109,16,4,129,645,2253
Doors and windows are so yesterday!,108,18,3,129,645,2679
"Well,I can show you an electricity bill friendly house too",107,20,2,129,645,7354
"Apparently,​ the elephant still remembers its paddock.",96,13,4,113,645,3814
This neighborhood is ‘up and coming’.,92,21,0,113,645,3972
"...energy efficient, a/c, golf, lawn care, a cinch, hè gezellig ...the place sells itself.",95,15,3,113,645,5460
"May I show you our ""Ring of Fire"" model...?",119,16,5,140,645,1050
Sorry about that..... The fence installer turned out to be dyslexic.,119,16,5,140,645,1424
Shitter's over there. Mind you don't fall in.,120,14,6,140,645,4089
Did you ever see Raiders of the Lost Ark,115,24,1,140,645,4257
Our development has embraced the sinkhole.,120,14,6,140,645,4421
"So, I'd like you to keep an open mind about your new broker...",120,14,6,140,645,5190
"We just keep it simple and merely say, Its the opposite of minature.",117,20,3,140,645,6166
now heres the thing..simple living comes at a price!,103,19,2,124,645,622
"Well, yes, this is a actually a giant putt putt golf course, but just imagine enjoying the steady breeze from this dutch-style beauty while watching the action from truly right on the 18th green.",104,17,3,124,645,2168
Act swiftly. Brobdingnagian golf is the next big thing.,104,17,3,124,645,3844
I call this one the putt- putt hut.,104,17,3,124,645,5061
"It’s a two bed, two bath plus den. Only thing is how good are you at dodging a giant ball every now and then?”",105,15,4,124,645,5355
"-but the ""Garden Church"" comes as a free bonus.",105,15,4,124,645,5487
And the homeowner's association rebates the green energy surcharge if you play Don Quixote in the weekly hole-in-one contest.,103,19,2,124,645,6079
"I just got wind of  a shady deal: What goes around, comes around -- with energy to spare.",102,21,1,124,645,6974
You'll find the club membership fees to be quite reasonable.,104,17,3,124,645,7027
"""Don't worry, the city paves the potholes.""",105,15,4,124,645,7471
Don't worry ...the church bells will drown out the wind noise.,113,19,3,135,645,79
"Once they find little Timmy and extract him from the hole, where going to get a very nice settlement. Trust me.",115,15,5,135,645,798
The vanes shouldn’t cause a problem.  There’s no elephant in the room.,116,13,6,135,645,2950
"Well, maybe, but they're only hail-sized golf balls.",114,17,4,135,645,3376
"The price? Well, you do realize that with that elephant and this windmill, that you're not in Kansas anymore.",113,19,3,135,645,6842
You can paint it red if you want to.,123,19,4,146,645,2465
It really keeps the elephant out of the room.,98,20,1,119,645,3936
"Yes, it's a high traffic neighborhood, but it's in your price range. It has the added benefit of free golf balls.",99,18,2,119,645,6537
"I know you were hoping for stainless steel sails, but the other upgrades will blow you away.",102,12,5,119,645,6547
"Haunted by an elephant ghost? No, just a silly rumor.",109,18,3,130,645,3020
Great Price! Great school district! the only downside is that you may have golfballs fly through your windows...,109,18,3,130,645,3766
"Hey, it's better than the place on 19th street. That doorbell? Real deal-breaker.",108,20,2,130,645,3821
"Eco-friendly, state-of-the-art security system--lots of extras.",109,18,3,130,645,4518
The rebate for wind power far exceeded that of solar and we thought it gave the place a unique look.,109,18,3,130,645,4624
"And if Quixote returns, don't mention Dulcinea.",108,20,2,130,645,4895
"Now, the elephant may try to sneak into the room ... but it’s hit or miss.",108,20,2,130,645,4992
"If you fill it with hot water, it will make a great hot tub.",109,18,3,130,645,5655
You can move one club length away.,110,16,4,130,645,6298
"Don't let the bob tagging fool you; it's a very wholesome, playful neighbourhood",88,11,4,103,645,2810
"This is house #3 as you can see here, you will get a nice breeze.",119,18,4,141,645,1183
"There are only a few units left in our latest mini-golf development.  I would move quickly on the windmill.""",117,22,2,141,645,1710
"Unspoiled Dutch design, energy self-sufficient, constantly changing views--you can't beat it. And you'll get used to dodging those ginormous golf balls in no time.",115,26,0,141,645,1714
I've already got two offers at ask-and think of the free giant golf balls you'll be getting,119,18,4,141,645,2711
"So, when you guys said modern, I thought, 'Well,,obviously they mean surrealist old-timey estate with a painted elephant in the background! Duh! 'Cause that's the new modern, am I right?'",119,18,4,141,645,2787
"first dates aside, it’s a great neighborhood to start a family.",118,20,3,141,645,3525
"As an extra indusement to buy, the board is thinking about going solar sometime soon.",118,20,3,141,645,5704
It's a shame maxi golf never caught on but if it had I wouldn't have the opportunity to make your unusually specific real estate dream come true.,120,16,5,141,645,7440
What do you mean you have a phobia of elephants?,97,13,4,114,645,47
"Remember...Take extra care, entering and exiting this home.",96,15,3,114,645,150
"Trust me, these turbines can block the balls really well.",95,17,2,114,645,2259
"The one with the clown's mouth went much higher, this one is a hole one!",104,19,2,125,645,564
"Location, location, location.  Or in this case, keep your head on a swivel.",105,17,3,125,645,657
It is best if you enter and exit through a window.,105,17,3,125,645,1992
"It’s a very traditional appearance that has been popular for years, but watch your head...",106,15,4,125,645,3747
The greens fees are low And it's family friendly,105,17,3,125,645,3849
"Folks, you’ll love this home for its extra large fan.”",103,21,1,125,645,4294
"I'm telling you, this deal is a whole in one.",106,15,4,125,645,5703
Hopefully he won't find us here,102,23,0,125,645,7111
You'll get free milled flours every day.,106,15,4,125,645,7488
This has a much more comfortable entry than the mouth of the elephant home.,112,23,1,136,645,408
Sure you can. Just buy a sectional.,115,17,4,136,645,1011
"Don Quixote almost owned it once, but VA financing hadn’t been invented yet.",114,19,3,136,645,4730
"There ARE holes in our business plan, but nothing too big if we time things right.",124,19,4,147,645,4097
I wouldn’t stand or put furniture in the foyer or come home drunk,123,21,3,147,645,4523
As committed environmentalists you won’t find a better place to raise kids.,132,23,3,158,645,4820
"There's no country club, but do you know what has been really big around here?",92,14,3,109,645,483
The previous owners decided to downsize.,100,18,2,120,645,5399
"It's Tara from ""Gone with the Windmill""",101,16,3,120,645,7502
This is the entrance to Land of the Free and the Home of the Brave.,111,16,4,131,645,1169
It comes with a dozen Pro V 1 golf balls,109,20,2,131,645,1797
"Imagine, every day, red sails in the sunset outside your very own bedroom window",109,20,2,131,645,3171
"Sorry, no wind energy tax credits with this model.",108,22,1,131,645,3533
"It's easy. ""One, Two, Three, Closed.""",111,16,4,131,645,3981
Get ready for the ride of your life,109,20,2,131,645,4402
you’ll have to put up with the giant black pit if you want to stay within your budget.,107,24,0,131,645,6003
"...and as you get older, the intermittent barrage of golf balls coming at you will help you maintain your balance...",107,24,0,131,645,6087
The builder will throw in the entrance/exit tunnel at no cost. It comes in handy on those really windy days.,118,22,2,142,645,523
"It's a bit drafty, but you have an intermittent ocean view and you're out on the beach in a hop, skip and a jump",120,18,4,142,645,4128
Mini houses are the new tiny houses.,119,20,3,142,645,4230
"The real selling point is the view
of the 17th green and did I mention the clubhouse offers skeeball!",116,26,0,142,645,5233
It keeps the elephants at bay.,117,24,1,142,645,5373
It comes with earplugs.,119,20,3,142,645,6186
You would get to play mini golf right through your front door.,96,17,2,115,645,2131
This place is perfect for buyers with great foot eye coordination.,97,15,3,115,645,2377
The ceilings need some work. We even saw a hole in one.,97,15,3,115,645,4296
"What’s that smell? Oh, don’t be nervous Dale it’s generating it’s own power.",97,15,3,115,645,4424
"The edge of Golden Gate Park is prime real estate! One bedroom rent is $3,500/month.",97,15,3,115,645,5034
The previous owner was a BIG doctor who only used it on Wednesdays,96,17,2,115,645,5521
"It includes an abundance of amenities. My personal favorite? The free, daily Dodgeball.",97,15,3,115,645,5868
"A swimming pool is out of the question. It would not only raise the price of the home, but the entire property would be above par.",106,17,3,126,645,81
I know I’m a white elephant but I’m not even in the room,109,11,6,126,645,835
"As owners, that's the beauty of the fine print disclosure. It's not really a hole. Kids will try for hours and you'll make a bundle!",107,15,4,126,645,1580
It’s tried and true green technology!,106,17,3,126,645,1861
"And to go along with the 19th century façade, complemtary wind sail creaks and grinding grain noises are played 24/7.",105,19,2,126,645,5156
The PGA decided to add some spice to the Masters' tournament,106,17,3,126,645,5533
I happen to know it's the only hole in the neighborhood that goes straight to the snack bar.,103,23,0,126,645,5894
"Yes, it’s far from the train, but you can have two bedrooms and save on the energy bill!",106,17,3,126,645,6424
Just watch out for oversize golf balls.,113,23,1,137,645,48
"Your brochure did say that the two story home was close to shopping, churches, and golf, but it's NOT what we were looking for.",118,13,6,137,645,822
"Before we go in, let me warn you again, these are BIG BALLS.",115,19,3,137,645,1028
This is a really dreamy example of Unreal Estate.,113,23,1,137,645,2588
The elephant is on the loose,116,17,4,137,645,5669
I am also afraid of the elephant.,125,19,4,148,645,6552
We have an innovation initiative at the witness protection program.,102,16,3,121,645,17
"I know the house has some problems, but it's a hole-in-one choice!",102,16,3,121,645,221
"For this part of Town, the price is a real Buy.. the only downside is that darn white Ball ?",110,20,2,132,645,245
The owner sees  a white elephant aspect of the place and is really motivated to sell.,91,18,1,110,645,440
It takes the money pressure right off. We live like kings.,93,14,3,110,645,766
What did you expect from a Tiger Airbnb?,93,14,3,110,645,968
"And the neighborhood football team likes to yell, ""Fee, fi, fo, fumble!"" So cute!",103,14,4,121,645,982
"Well Finn, that's where we put your cartoon captions.",121,18,4,143,645,1029
We call this model the Lilliputt Inn.,114,12,6,132,645,1406
"When the Giants are playing, it’s best not to look.",93,14,3,110,645,1425
Just be sure you duck when you enter or leave.,110,20,2,132,645,1504
Church is right across the street and you have a continual picket fence.,120,20,3,143,645,1552
The previous owners said that the golf course will pay for any broken windows”,102,16,3,121,645,2062
You won't need to worry about spending a lot for property damage on your insurance policy. The propellers never let any balls through. Let's discuss life insurance.,112,16,4,132,645,2426
If we're quiet the giant mini-golf players won't notice us.,121,18,4,143,645,2559
And air conditioning is not needed so think of the savings!,102,16,3,121,645,3265
"It looks great, but only turns when you hit the ""eliminate"" button next to your security camera.",103,14,4,121,645,3341
"Its an 18 unit development featuring a windmill, livestock and water features, designed by Jack Nicklaus' granddaughter.",102,16,3,121,645,3468
It was designed by a Dutch golf pro.,101,18,2,121,645,3862
It's one of those quick flip houses.,110,20,2,132,645,3992
"I understand your concern about the elephant , but not to worry, he's very well behaved",110,20,2,132,645,4013
And you could rent it out in the off season.,101,18,2,121,645,4228
And I assure you there's over a 98% hole on one rate.,105,10,6,121,645,5081
Just watch out for the hail.,119,22,2,143,645,5593
"Uh, there's a small easement issue here, the occasional putt putt golf ball.",100,20,1,121,645,5622
"It doesn’t get better than being on the green of the last hole, and no one ever makes it through the front door. This market is hot and I’ve got three more buyers ready to make an offer, so what’s it gonna be?",109,22,1,132,645,5665
The previous owner was the bogey man,102,16,3,121,645,5726
The course opens at noon and closes at 9 p.m. .,127,17,5,149,645,255
...and it even comes with it's own wind.,125,21,3,149,645,1157
We just call it Dutch Eco-Friendly.”,117,17,4,138,645,1197
"As long as you remember to duck and weave, this property will be perfect for you!",116,19,3,138,645,1352
When we said solar compatible we meant it's not fossil-fueled,114,23,1,138,645,2978
Free golf is included.,118,15,5,138,645,3967
The offer includes a full home warranty and a free ice cream.,114,23,1,138,645,4637
"Your right, simply efficient, yet, no one knows how it works anymore.",119,13,6,138,645,7300
"Our cartoonist, Bob, has a real issue with exaggerating the size of things.",117,17,4,138,645,7486
"... And like I said, sir, Dumbo Quixote is just urban myth",107,17,3,127,645,5169
"Look, the price is great. If you have to put up with a golf ball rolling through the living room occasionally, it's not much to ask.",109,13,5,127,645,6919
Every condo has its quirks and strange bylaws—and this one features a golf course and relatively low common charges.,106,19,2,127,645,7340
"Listen, I know it's risky, but I think we need to team up with the elephant.",99,13,4,116,645,3244
It's got good bones.,97,17,2,116,645,6614
After his circus retirement  he took up golf.,98,15,3,116,645,6635
This is the same spot where Don Quixote saw visions of windmills; until he noticed the elephant in the room and escaped down that rabbit hole!,89,13,3,105,645,7499
"Yes, there is some damage from golf balls, but the area's been re-zoned and Chip and Jo will fill in that hole in the front yard and have it looking like a million bucks in no time.",119,24,1,144,645,3068
"And, if you live here, your wife can work on your putts.",123,16,5,144,645,3517
This property is perfectly on par with your dream house's must-haves checklist.,120,22,2,144,645,5742
”The basement water problem has been remedied.,113,16,4,133,645,422
are we going to address the elephant that is out of the room?,114,14,5,133,645,1327
I hear you but when these climate friendly babies get to spinning 'round they'll speed dry your hair and knock out the clanging church bells.,113,16,4,133,645,2838
It has the added advantage of keeping out every other unwanted guest.,110,22,1,133,645,3196
"On the plus side, you won't need a hair dryer!",112,18,3,133,645,4386
"I know it's not the cottage home you were picturing, but with your budget, I think we ought to put in an offer.",112,18,3,133,645,4465
It comes with a fixer upper beanstalk as well.,111,20,2,133,645,5702
Did  I mention the schools here are great,112,18,3,133,645,6034
Its got great natural light and a cross breeze if you open the windows...and its in your budget!,110,22,1,133,645,7295
"Zero waste, zero solicitations",102,18,2,122,645,3394
"Basically, you can pretend your Indiana Jones every time you come home from work!",103,16,3,122,645,3999
The town council assures me the orange river is perfectly safe.,101,20,1,122,645,5867
"Do you have any idea how happy the Dutch are? Google ""gezellig,"" Makes that Danish ""hygge"" look like nada.",94,14,3,111,645,740
"Remember- the first floor isn’t safe during standard business hours, and these may differ during the holidays",95,12,4,111,645,2164
"Unfortunately, golf balls are not included.",95,12,4,111,645,7077
The issue? The doors close briefly only on windy days.,127,19,4,150,645,2311
"It’s like Indiana Jones, but with an HOA.",128,17,5,150,645,5083
The great hall showcases an Indiana Jones theme.,115,23,1,139,645,687
You get a nice discount on this home because it takes time to get used to the giant golf balls.,116,21,2,139,645,1751
... and I'm required by law to disclose that the previous tenant was an elephant.,110,13,5,128,645,230
"Yes, it does get a bit breezy up here.",105,23,0,128,645,345
"I know, I know, but I'm afraid you can't live here. Sorry.",107,19,2,128,645,911
"Everything your looking for, its in your price range, and you can golf right out your front door",109,15,4,128,645,924
"You might think I’m ‘tilting at windmills,’(har, har) but I promise you this one is going to go fast!",110,13,5,128,645,970
"Say goodbye to solicitors and utility bills, and you'll sleep like a baby!",110,13,5,128,645,1955
"Mario's Airbnb was cozy and breezy. Central location. Five minute walk from Grand Central, restaurants, and cafes. Would highly recommend.",107,19,2,128,645,4062
You'll love this...longest battery life in the industry!,107,19,2,128,645,4819
"""Retro-wind power"" is the newest thing in home design.",110,13,5,128,645,6754
Gentrification is out of hand,99,15,3,117,645,1659
You need to enter with imagination.,97,19,1,117,645,1739
Using wind energy really cuts your electric bill.,100,13,4,117,645,4511
"Wait until you see the huge,  colorful golf balls!",98,17,2,117,645,6518
"You buy the property, it's the hardest hole in the course.",114,16,4,134,645,2056
This is not what we meant by “downsizing”,113,18,3,134,645,2707
"This one's listed at 9 million, but we might be able to get it reduced due to the blade rot.",113,18,3,134,645,3485
"No, not Goofy Golf Holes. We call it Garden Golf Estates, a luxury gated community.",112,20,2,134,645,3561
"Without a doubt, you’d definitely be in the green with this home.",111,22,1,134,645,6190
"No, I haven't heard that story - Haunted by an elephant?",114,16,4,134,645,6772
"Mr. and Mrs. Sullivan, I can assure you there's nothing 'Hazard' about it.""",113,18,3,134,645,6981
"Yes, pencils are included, but erasers are extra.",103,18,2,123,645,134
"The sewer system backs up into the front yard sometimes, but besides that, it's a real gem.",105,14,4,123,645,447
A little birdie told me this place is a steal.,104,16,3,123,645,992
"as you can see, the location is terrible, but the green is just FINE!",103,18,2,123,645,1461
The current owner will be descending shortly.,103,18,2,123,645,5289
"Great energy saving potential, I dare say we need to make a run to get through the front door. But you can’t beat the location",102,20,1,123,645,5368
I'm afraid there may be no real in this real estate.,104,16,3,123,645,5457
It's got great a great decapitation record.,104,16,3,123,645,7248
"Your house is almost ready, but I'd say it's a little green.",126,23,2,151,645,1768
"I hate to take the wind out of your sails, but you need to consider going Dutch in retirement.",117,21,2,140,645,610
You just need to look out for the occasional rolling globe.,98,8,6,112,645,1908
It's for Don Quixote's protection.,115,25,0,140,645,3200
Preachers!  Republicans!  The wind will never stop!,119,17,4,140,645,3567
The owner'll throw in the white picket fence for free.,117,21,2,140,645,4771
In the event of a child’s birthday party do not leave the building.,93,18,1,112,645,4920
We don't have many fixer-uppers needing this much fixing up,93,18,1,112,645,5663
"Look,  in this economy chances are you are going to get  blown away anyway.  What difference does a second or third mortgage make?",95,14,3,112,645,6286
Salesman: It saves on air conditioning and is a great time piece. The neighbours rave about it!,110,15,4,129,645,19
"Others have charged it, but you will be its first cash owners.",106,23,0,129,645,515
"Well yes, someone did read the blueprint wrong but you know fences do make good neighbors.",110,15,4,129,645,2524
"So, what do you think of the place?",109,17,3,129,645,3595
"Since you refuse to make any offer at all, on your way out please don't let any of the blades hit you in your collective asses.",106,23,0,129,645,5610
You'll never find a more modern fire-escape.,108,19,2,129,645,6859
Enter at your own risk!,100,15,3,118,645,2384
"Fully renovated, below budget, and HOA fees cover dung removal for the neighborhood elephant.",101,13,4,118,645,4325
He'll give you a shout when he's playing through.,97,21,0,118,645,4525
It does say it’s a great spot for family’s on TripAdvisor.,100,15,3,118,645,6328
"No! Trust me. It’ll be awesome!
I’ve taken care of all the wind.",137,23,3,163,645,706
Think of all the savings you will make on your electricity bill,112,22,1,135,645,2840
It is a lovely  home at a smashing price. You will have to be mindful of the big white ball rolling through during hours of operation. The price reflects that y'know...,113,20,2,135,645,5514
It's great for miniature golf fans.,127,23,2,152,645,46
No. It does not come with Don Quixote.,90,15,2,107,645,4454
"Actually, the whole TOWN's growing.""",102,22,0,124,645,101
"The windmill will really keep the enemies out,",105,16,3,124,645,2959
Great place to to keep unwanted visitors away. No one will believe you really live here.,106,14,4,124,645,3213
This kind of blows,105,16,3,124,645,4657
"Remember: with this unit you'll enjoy not only lower energy costs, but also a view of the fairway.",105,16,3,124,645,5773
"White elephant? No, it's a solid investment. What else could dissipate the crematory odor and charge your Tesla?""",105,16,3,124,645,6940
"No, Wilma, the COURSE is what’s meant to be small.",106,14,4,124,645,7058
The homeowners association requires that the windmills remain aquamarine.,107,12,5,124,645,7480
It’s a little bit of a fixer upper but it has great potential,118,21,2,141,645,5623
"Wanting to acknowledge climate change, this miniature golf course for elephants was fully funded by the Republican Party",121,15,5,141,645,5797
This is currently the best house in the market.,135,18,5,158,645,1193
For some this accommodation is sub-par,95,16,2,113,645,504
... Another exciting feature - the giant sphere has a one in three chance of coming out right where we're standing.,110,17,3,130,645,507
"Unlike  houses in Bowling Pin Acres, these were built to withstand earthquakes.",111,15,4,130,645,2406
Dutch treat with the seller! Such a deal!,109,19,2,130,645,2632
Just imagine the potential.....it can pump oil too!,108,21,1,130,645,3252
We're out of Google range here,110,17,3,130,645,5132
"You could say this apartment is ""family friendly""",108,21,1,130,645,6294
Just think - this golfing community will hold its value.,108,21,1,130,645,6900
Don and Rocinante are running late.,125,18,4,147,645,6601
"Mammoth Golf is the new hot entertainment investment - it,looks be bigger than Hot Goat DrunkYoga!",116,16,4,136,645,944
No need for air conditioning!,115,18,3,136,645,998
It uses free renewable energy,99,19,1,119,645,2436
"It was once owned a little old lady who lived in the shoe, or was that the clown’s mouth?",100,17,2,119,645,2609
"The previous owners forgot to leave via the INSIDE hole and, viola, the house is available.",102,13,4,119,645,2621
You two don't have mouths.,89,8,5,102,645,3182
"Take my word for it, it is much more effective than a lock box.",114,20,2,136,645,3458
It’s the latest in eco-friendly housing!  Just don’t let the door hit you in the ass on your way out - or in...,118,12,6,136,645,3788
"Yes, it's been on the market for a while but if you're nimble and don't mind the occasional 3year-old  looking in your windows ---it's a steal.",113,22,1,136,645,4050
"If you bake your own bread, this house is for you!",129,21,3,153,645,4845
A stunning work postmodernist architectecture.,100,17,2,119,645,4942
We move more people than the church!,115,18,3,136,645,5032
Not only can you generate your own electricity but you love the 3rd fairway.,101,15,3,119,645,6333
"Well, you did say you'd like to tilt at windmills.",128,23,2,153,645,6375
"The golf membership is extra, but it’s transferable.”
“I can putt you in this house today.”
“Think of it, no more waiting in line for a ticket!",121,17,4,142,645,1462
"Okay, so you missed your hole-in-one on this golden opportunity.  Real estate isn't everyone's forte, but you're still in the ballpark.  Lucky for you, I see a tremendous uptick on your next move.",121,17,4,142,645,4348
"The asking price is high, because it's an exact replica 
of the Miniature Golf Windmill out on Highway 26.",121,17,4,142,645,4590
The astroturf is greener on the other side.,120,19,3,142,645,5581
I'm telling you this is a steal. The fan will keep you cool all summer.,118,23,1,142,645,5616
Just think of the balls as a Roomba.,106,16,3,125,645,4295
"If there ever was a real estate deal ready to take off, this is it!",105,18,2,125,645,4413
You will shave a lot off your air conditioning bill but watch out for the colored golf balls.,105,18,2,125,645,5947
150K ducats and it’s yours!,105,18,2,125,645,6840
This one is called the green new deal.,105,18,2,125,645,7170
And it's environmentally friendly.,90,17,1,108,645,4197
"Believe me, there is no elephant in the room.",126,18,4,148,645,3880
Good news!  The seller is willing to throw in the funnel cake for free if you buy the house today!,111,17,3,131,645,1163
Put it on high and- voila!- no welcome neighbor bundt cakes.,112,15,4,131,645,1990
"Don't worry, the hole creates curb appeal.",112,15,4,131,645,2982
"It's the architects version of that song - ""Don't fence me in.""",109,21,1,131,645,3354
But consider the circumference.,110,19,2,131,645,3641
"I agree, Mr. and Mrs. Jones: ‘Maxi-Golf’ *is* an exciting investment opportunity.",113,13,5,131,645,3744
It's Mitch McConnell's take on wind power.,111,17,3,131,645,4668
Our great mini-tower loft is a strong favorite at Trump-Trump Golf & Condominiums.,114,11,6,131,645,5011
This model is called the Moulin Vert.,113,13,5,131,645,6886
Just duck when you go in and out.,95,18,1,114,645,6402
"'Take your chance, and watch your back!'",114,22,1,137,645,324
This fund is exceptional: not run-of-the-mill. We have never had a white elephant.,116,18,3,137,645,1704
"Did I mention, there's a 1 in 4 chance it comes with a white picket fence.",115,20,2,137,645,4715
So what do you think are you a fan?,115,20,2,137,645,5442
"Don't mind the game. Soon, this will be the only windmill on your mind.",117,16,4,137,645,6217
"You just have to duck every so often-----whoops, duck, here it comes again",101,17,2,120,645,3106
This place really has balls.,101,17,2,120,645,4488
You’re saying you want the hole to go to where?,101,17,2,120,645,4635
And this lilliputian home comes with free miniature golf for life,99,21,0,120,645,4643
"This is a Trump course, your wife is your handicap.....",102,15,3,120,645,4686
I’m expecting a bidding war! Dutch architecture is hot right now!,101,17,2,120,645,5519
This house is a steal- just mind the occasional ball that rolls through it and the massive hole in the front yard.,121,19,3,143,645,6092
"One hazard: hell as big as golf balls.""",108,14,4,126,645,180
"...and not only will you have the home of your dreams, but I'll soon be sporting the blazer of mine.",106,18,2,126,645,1473
"Now the middle class is shrinking, but don't go tilting at windmills just yet.",106,18,2,126,645,2012
"Chivalry may be gone, but the statue of Quixote can be returned for the right price.",108,14,4,126,645,4782
"As a bonus, you get to eat any birds it catches.",108,14,4,126,645,5120
"Added bonus, the views change as the wind mill rotates into the wind.",105,20,1,126,645,5288
"Guess I was thinking more in the lines of ""solar energy""...",91,17,1,109,645,4180
You'll never lose your balls.,113,15,4,132,645,233
"Scraping the turf is admittedly a bit of a design flaw, but think about how much you'll save going off-the-grid. It's a 'home'-in-one!",112,17,3,132,645,241
You don't know how hard it is to find housing for Lilliputians,114,13,5,132,645,662
Will this re-imagined miniature golf get teenagers outside and off their smartphones?  Sure.,112,17,3,132,645,1187
I am sure you will be very happy here.  Just don't let your baby lean too far outside of the windows.,111,19,2,132,645,2799
"Donald only realized he was dreaming when he tried to say ""no"" and found he had no mouth.",114,13,5,132,645,3197
It doubles as a Zero Net Energy home and the 9th hole of a golf course for giants.,112,17,3,132,645,3690
"On the plus side, you don't have to mow or water the lawn.""

""It is a hassle to get in and out of, but on the plus side, the electricity of the home is completely  wind powered",95,20,0,115,645,352
And it comes with a charming picket fence.,116,20,2,138,645,1025
"This gives new meaning to the term ""five o'clock shadow.""",117,18,3,138,645,2304
. . .and you won't have to do a thing. The lawn is always green and the seller has done all the hard work by relocating the hole to the front of the windmill.,98,14,3,115,645,2312
"I am ethically obliged to inform you that according to the HOA covenants, you cannot interfere, or object, when anyone insists on ""playing it where it lays."" But think of the free electricity from the wind power.",118,16,4,138,645,2898
Bubbles and I welcome you both to Mar-a-LagoLand!  And it’s for sale...,119,14,5,138,645,3763
It takes giant balls to play mammoth miniature golf.,116,20,2,138,645,6204
"This isn't what I meant by downsizing""
-Husban",122,19,3,144,645,1275
"I know $850,000 sounds high, but here at Gulliver Links it’s par for the course..",122,19,3,144,645,3911
"Now repeat after me, and the cash is yours: “Mr. Trump did not joust with our windmill.”",102,17,2,121,645,2228
"She wants to retain a right-of-way. She needs the money, but mini-golf helps to relieve the stress since the whole beanstalk incident.",127,20,3,150,645,2558
But it's a good price.,129,16,5,150,645,3174
We're safe here. The giant elephant can't see us if we can't see it.,106,20,1,127,645,512
"We don't provide big balls, because the buyer always has some.",107,18,2,127,645,4302
"Now, this one doesn't align very well with your wish list, but I think the price will make it worth your consideration.""",110,12,5,127,645,4382
"They say that the elephant's ghost still roams the town today, seeking his revenge.",108,16,3,127,645,4605
"You do know how to double dutch, don't you?",108,16,3,127,645,4865
"Sometimes, I see an elephant too.",109,14,4,127,645,7508
"When we add the sailcloth, the spinning blades will power the bell-ringer.  Of course, one will have to step lively going in or out.""",113,17,3,133,645,2203
You’ll never lose at miniature golf ever again.,111,21,1,133,645,3504
The security system is top notch.,113,17,3,133,645,4661
"There are some disadvantages, but the school district has a world class golfing team.",112,19,2,133,645,5103
"it's rather safe,except when the republican party is feeling quixotic",113,17,3,133,645,5820
And the next 20 buyers get two free player passes...,111,21,1,133,645,5920
And the garage fits two sitting knights including lances.,112,19,2,133,645,6473
"In addition to the proximity to entertainment, this property offers the serenity of windmills.",112,19,2,133,645,6872
"We call it the ""putt-putt"" house",94,13,3,110,645,3295
"True, there are no bathrooms, but this baby clocks 50 rpms when it is really blowin’.",93,15,2,110,645,7429
"Yes, you’ll have balls flying in your face, but you can’t beat the location.",116,22,1,139,645,1269
Lucy the Elephant welcomes you both to Margate and hopes you enjoy this round of macro golf .,118,18,3,139,645,2739
"""Don't worry, the elephant is also a cartoon.""",117,20,2,139,645,3411
The last tenant installed it -  problems with gas,117,20,2,139,645,5069
"Sorry, the Democrats' back-9 is sold out.",119,16,4,139,645,7262
This home is a hole in one for sure.,97,18,1,116,645,264
Actually since he's not in a room we are allowed to talk about him,96,20,0,116,645,836
"It is a perfect house for the adventurous  'Little-People' couple that loves to golf""",97,18,1,116,645,1897
"Did I mention to you that Tiger Woods not only designed the course by eliminating the back nine,  but he was also a graduate of our Mid-Life Crisis Center?",121,23,1,145,645,3296
"Sorry, we have no staircases here, but there is another way up to see elephant backs.",122,21,2,145,645,4000
I wanna thank you for offering us a ceiling fan but as you can see we decided to go another way...,122,21,2,145,645,5516
"Sure, the house doesn't have a door. But an intruder would have to time it juuuuust right to not get hit by the windmill.",103,17,2,122,645,530
"Fortunately, you still have two sheets to the wind.",104,15,3,122,645,870
We're not sure this is our best course of action,104,15,3,122,645,3706
This can be your escape from the daily grind.,105,13,4,122,645,3949
"By the way -- without wind, it sells at a discount",103,17,2,122,645,4655
These real estate prices are sure BLOWING me away!,103,17,2,122,645,5441
We have to stay out of sight muffled by the mill noise because Bob made the bloody elephant trap too small.,105,13,4,122,645,6474
It's a Dutch revolving door to improve your motor skills.,102,19,1,122,645,6916
"This Quixotic dwelling is now available.  However, please watch your step.",104,15,3,122,645,7213
It also comes with a mutt mutt.,110,14,4,128,645,685
Of course your vacation rental ends when the dolls get back from Amsterdam.,107,20,1,128,645,2227
Kids have a curfew?  No problem -   built in security system.,108,18,2,128,645,2290
"Don't Worry, it can't turn because the arms are to long.",110,14,4,128,645,2875
The listing broker says its got a killer air conditioning system.,108,18,2,128,645,3856
Our  alternative energy future is now. Shall we prepare an offer?,108,18,2,128,645,4347
The architect Is considered up and going,110,14,4,128,645,4863
Living here will put a smile on your face.,106,22,0,128,645,5298
"No, your maxi-golf timeshare starts next round.",108,18,2,128,645,7395
The last guy who took a shot on this property said he drained it.,84,13,2,99,645,69
"I assure you, there haven't been spies in this windmill since 1939.",114,17,3,134,645,936
"Not only is this baby near the church, it’s priced for quick access.",112,21,1,134,645,1189
And the clubs around here are intense,115,15,4,134,645,1313
Look at it this way.....,115,15,4,134,645,1358
"I like this windmill, but would it be possible to get the giant hole in the ground removed?",112,21,1,134,645,1753
And this is regular-sized golf.,114,17,3,134,645,2118
There's a half-priced sail on at the moment,113,19,2,134,645,2338
'Being a unique property is actually a plus in this neighborhood',112,21,1,134,645,2566
Full Disclosure: Gulliver is crazy about miniature golf!,113,19,2,134,645,4028
We’ll make the squirrels an offer they can’t refuse.,114,17,3,134,645,5138
Ohhh so that's what you meant by miniature golf.,114,17,3,134,645,6519
"At that price and in this neighborhood , this deal is a birdie",87,18,0,105,645,3519
"If you believe in climate change, I wouldn't buy it!",119,18,3,140,645,5313
Buy it and you have your own amusement ride.,119,18,3,140,645,6403
I promise this one isn't a hole-in-the-wall.,126,15,5,146,645,3069
"If you made a wrong move, you won't live to know about it.",122,23,1,146,645,4502
Ever imagined yourselves puttering in a windmill?,123,21,2,146,645,6242
I fail to see anything weird about it:  the elephant gas turns the windmill and you never pay for electricity again.,95,13,3,111,645,1368
It requires a special insurance rider.,93,17,1,111,645,3913
Not interested in this one? I can also offer you a giant air conditioner,93,17,1,111,645,4798
"And the speed of the sails on this repurposed little beauty is modulated in real time by artificial intelligence to block entry of ideas not currently trending.""",131,16,5,152,645,4974
It's for people who are lousy putters.,98,18,1,117,645,295
Yours won't be the only balls in this house,102,10,5,117,645,3922
"..and this house is called ""WindBreaker"" and features the best location in Mill Valley",101,12,4,117,645,3977
Putt-putt-putt in your offer now.,99,16,2,117,645,5556
"Keeping score will be a challenge, but isn't that what dreams are made of?",97,20,0,117,645,7363
"I consider myself more matchmaker than salesperson, Mr. Putt Putt",105,15,3,123,645,463
"I admit, it's a bit of a fixer upper, but I can see, with a little elbow grease and investment, you'll be churning out your own flour &  power in no time!",104,17,2,123,645,1335
Talk about flipping houses! This one will be easy!,104,17,2,123,645,1811
"This is the latest in a sustainable, energy efficient eco-house... and it’s only 500 years old.",104,17,2,123,645,2735
I wouldn't put anything fragile on the first floor between the front and back doors.,105,15,3,123,645,2984
"Yes, but they rarely say Fuck.",107,11,5,123,645,5468
It comes with an ancient alarm system to catch the most cartoon of characters.,107,11,5,123,645,5861
"After Tiger Woods I was like, ""There goes the neighborhood,"" but surprisingly we haven't had those sorts of issues.",110,16,3,129,645,227
"So, my first question is: Do you ike gilf?",110,16,3,129,645,916
"Sure there's only one bathroom, but you get a fantastic view of the snack stand.",109,18,2,129,645,1131
"Yes, a design glitch, but think of living in a Frank Lloyd Wright windmill",107,22,0,129,645,3253
"Yup, folks, this place has it all.  Nice neighborhood, great schools, and the greatest view of the golf course imaginable.",109,18,2,129,645,4725
They're willing to accept your offer - except for the golf ball contingency.,108,20,1,129,645,5479
The blades simply give it an aesthetic look.  It's actually solar powered.,110,16,3,129,645,6105
The solar powered turbines are an added feature to this home,109,18,2,129,645,6120
"On the downside, a large golfball will just randomly fly through your living room.",112,12,5,129,645,6497
Perhaps you would prefer The Muffin Man model. It's over on Drury Lane.,116,15,4,135,645,570
It's an open plan design for good reason.,112,23,0,135,645,3310
"No rats or mice, but we do have some other, er...friends.",114,19,2,135,645,4774
Very few people play the Don Quixote course ...So it's a steal!,115,17,3,135,645,5860
"I'll just come out and say it––I'm a big fan of the place""
""Yes, that's obvious, but I feel there's another big thing to discuss",113,21,1,135,645,6963
"JESUS! FUCK!! Did any of you guys hear a giant ""whooshing"" sound just now?",124,10,7,141,645,197
This ecofriendly tiny house just came on the market and is a real “whole in one!”,126,17,4,147,645,3847
"Sure, Mini or Maxi both work, but we prefer Couples Fantasy Golf",93,8,5,106,645,244
This house will set a wind beneath your sails.,92,10,4,106,645,3789
"Ok, this is a working windmill. That’s in the contract. But no, there is nothing that says the clouds will always look like elephants.",89,16,1,106,645,6468
"It's golf course living with a capital ""G.""",89,16,1,106,645,7528
And no lawn maintenance keeps your weekends free for 18 holes!,94,17,1,112,645,1067
Just make sure to watch out for brightly-colored boulders,96,13,3,112,645,1792
we can't putt putt around with this offer anymore,100,5,7,112,645,2575
"To be fair, the listing did say there was a window unit.",94,17,1,112,645,5236
It grinds cannabis for a French Press.,101,14,3,118,645,843
"I know you thought I'd be showing you houses today, but I'm actually here to tell you that you've been shrunk to the size of mice and this mini golf course is your new home. And don't worry about the elephant. 

He's terrified of mice.",100,16,2,118,645,2221
As I mentioned over the phone... through-traffic in this neighborhood is really quite manageable...,99,18,1,118,645,6855
"Er, you don’t have little children, do you?",98,20,0,118,645,7312
"Windmill, elephant, chapel, open manhole --- sure, Bob's a little off the wall, but I think you're going to really love it in this cartoon.",106,15,3,124,645,1004
It's a steal at half a windmillion.,104,19,1,124,645,1298
"Sorry, Don. Your request is denied. Par stays at 3.",104,19,1,124,645,2713
"You'll es=]]]]]]]]]]]]]
























































You'll especially love staying home when it's windy.",106,15,3,124,645,4721
It's a BEAUTIFUL Security Fence,108,11,5,124,645,5362
This one is a real bargain although it is in a flood zone,106,15,3,124,645,5648
"Look at it like this: you make it past the hole, you dodge the spinning blades...what's junior done at school that day that's really so bad?",109,20,1,130,645,641
"Well, it's not really a turbine. Just looks like one maybe.""",108,22,0,130,645,1612
"This property is great, but you should wait until you see the back nine.",113,12,5,130,645,2496
"Now if you are trying to start a family, put your fence inside your house.",112,14,4,130,645,5109
Watch out for the golf balls,109,20,1,130,645,5293
You guys Lord of the Rings fans?,108,22,0,130,645,5611
And this is definitely the only place on the market in the whole town?,112,14,4,130,645,5966
Let us begin by addressing the elephant in the room(or should I say picture),110,18,2,130,645,6844
"You told me that you didn't want your new house to be ""underwater"" like your last one . . .",115,19,2,136,645,1887
"In order to move on to the church, one of you have to jump into the hole.",115,19,2,136,645,3528
"And lastly, it was designed by the miniature golf champion.",117,15,4,136,645,4360
"It doesn’t have the bathroom you wanted, but it is waterfall adjacent.",114,21,1,136,645,5796
"The former tenants, the Fingerdykes, moved across town to Ocean Avenue so he could be closer to his work.",117,15,4,136,645,6805
To dream the impossible (American) dream...,128,15,5,148,645,4124
It comes with crossing gates in case they decide to build a railroad across your front lawn,127,17,4,148,645,5915
It's Panza but after you marry us it will be Rocinante.,130,22,2,154,645,2348
Very cool house!,132,18,4,154,645,7207
I think you'll love this next place! It's got a great yard and a lovely skylight in the kitchen.,91,14,2,107,645,6356
Careful you don't fall into the hole over there.,99,9,5,113,645,6998
"Sorry, this mill is not gonna save you utility bill or maintenance fees.",96,15,2,113,645,7350
With this Dutch style house you can wave the American Dream at your neighbors. No need to bring up the elephant in the room.,101,16,2,119,645,376
Many people have died here...which is why it's such a bargain.,101,16,2,119,645,1940
Most people don’t realize that the key is to strike the ball just as the blade covers the door.,100,18,1,119,645,4376
No playing between 10-9,100,18,1,119,645,4653
This is a new community for the golf and Total Wipeout enthusiast.,103,12,4,119,645,6248
The only thing that's not miniature is the ball.,101,16,2,119,645,6827
There isn't a grain of truth to the rumor the previous owner was a cereal killer.,106,17,2,125,645,638
It catches golf balls and insane knights.,107,15,3,125,645,2066
The previous owner got used to the moving shadows.,105,19,1,125,645,2084
"The financing is a little tricky, but my services are above par.",106,17,2,125,645,2242
"It's a great place if you don't mind
occasional visits by rather large golf balls.",106,17,2,125,645,2942
"No, white is the only color the balls come in",107,15,3,125,645,4890
Millenial country club.,108,13,4,125,645,6814
Going in and will keep you fit if you time it right,112,16,3,131,645,5357
"Strictly speaking, the dining room carries a two stroke penalty, but for you, I can put in a word with the course marshal.",111,18,2,131,645,6214
1. Package placed/Windmill activates.  2. Figure sneaks toward package/Windmill goes super warp.  3. Package sucked into house/Thief blown down hole.,111,18,2,131,645,7454
"Don't fence you in, you say.",116,19,2,137,645,1562
"Remember,it's all about location,location.",116,19,2,137,645,4219
It's a real hole in the ground,122,18,3,143,645,3330
"Yeah, dude, it's a mini golf course, how wild is that? Fucking crazy, man. This is a real funny situation we have here.",123,16,4,143,645,3613
Does it come with a clubhouse membership?,121,20,2,143,645,3740
Plenty of room for your Mini around the back.,122,18,3,143,645,6056
"Yes, well, the life-size golf balls going through your living room can be a bit of a hassle. But the previous owners are willing to take off $10,000 and throw in 10 free rounds of golf!",126,21,2,149,645,5155
You never have to worry about water in the basement.,135,16,5,156,645,645
"It's 100% energy self-sufficient, and you get free greens fees!",114,14,4,132,645,738
The last owner had a lot of dough.,114,14,4,132,645,1395
If you take down the wind vanes you could have a nice house with a pool in the basement.,104,12,4,120,645,1459
Now the first one to get a hole in one wins the house,107,17,2,126,645,1804
The business is for sale but the concept of macro golf has been slow to catch on.  It's  a scaleability problem.,106,19,1,126,645,2123
"While the timing was never going to be right for Macro Golf, the door to this place will improve your timing in a hurry.",109,13,4,126,645,2169
"Yes, it's drafty, but you must never shut the front door!",94,10,4,108,645,2718
"Buy from me, it's a jungle out there.",113,16,3,132,645,2930
"And if there's not enough wind to operate the windmill, you just hitch up the elephant.""",106,19,1,126,645,3231
"The previous occupant, opposed to clean energy, just lost his House!",108,15,3,126,645,3334
"I'll take the elephant, not the windmil",119,15,4,138,645,3926
And it is so convenient to the local sports amenities.,125,14,5,144,645,4095
One question - how do you deal with those balls always rolling through?  I'm not sure I can write you a policy to cover that hazard.,118,17,3,138,645,4208
"Yeah it is perfect beach location, our concern is cocktail parties.",103,14,3,120,645,4693
Its Killing all the Birds,115,23,0,138,645,4934
"Let's address the elephant in the room - his name is Dumbo, and he doesn't like it.",111,20,1,132,645,5092
This is a limited time offer for you to join an exclusive miniature golf community.,98,13,3,114,645,5241
"The Giant? Oh, no worries-he gave up putt-putt years ago after the misses passed.",122,20,2,144,645,5391
Wait till you see the elephant!,110,22,0,132,645,5646
It's a great penthouse; power's free and the fan makes for a great conversation piece at parties.,104,12,4,120,645,5774
"Putt Putt"" is no longer acceptable by the PC Police because it sounds like old people expelling gas",107,17,2,126,645,5875
It's a great place to host parties,118,17,3,138,645,6637
"I get wanting to live on a putt-putt course, but this door seems inconvinient.",103,14,3,120,645,6739
It's a WINDER of a deal!,112,18,2,132,645,7010
"And after work on Friday, you ditch this place and head to your weekend grotto.",135,18,4,157,645,4750
Is it quiet? Does a bull smell?,124,18,3,145,645,350
This is a difficult coarse to take.,124,18,3,145,645,637
"White elephant? That's just the ghost of the Republican Party. Ignore it! Now, about this house here, not only does it run completely on wind energy, you have the entrance to a future Boring Company station literally right outside your front door!",124,18,3,145,645,2482
"Between Russian meddling with underseas cables and unseasonably hot and cold weather, alternative energy properties are attracting far more interest than anticipated.",126,14,5,145,645,4004
... and you'll be one of very few with a green coffee grinder!,118,19,2,139,645,848
Most of the drive by's happen over at number 9,119,17,3,139,645,2085
Think of it as a starter home. And it can be yours for peanuts.,120,15,4,139,645,4921
"My company, Double Dutch, thanks you fir your purchase.",120,15,4,139,645,5640
This home comes with a super-sized mini-golf club.,117,21,1,139,645,6936
What do we do if the wind doesn't blow?,118,19,2,139,645,7412
Have you ever run track?,112,20,1,133,645,1057
Snap this one up. The next development of these energy houses is in the Atlantic ocean.,112,20,1,133,645,1073
The white elephant lurking in the background is not a reflection of the great investment that you made with this dutch dream.,114,16,3,133,645,1945
"This is the hottest golf course development in years. 
All I have left is the windmill seven...  Be ready to take it now!",113,18,2,133,645,2396
And it even comes with a fully equipped home-entertainment center!,114,16,3,133,645,2911
"""Just watch out for the balls, no problem!""",112,20,1,133,645,4171
"Seriously, this is not a white elephant!",113,18,2,133,645,6080
Is this what you meant by “curb appeal”?,109,15,3,127,645,1268
"Yes, it's safe!  Just be careful when you go out on a windy day.",106,21,0,127,645,1583
"Cool in the Summer, cold as hell in the Winter; plastic accoutrements recommended.""",108,17,2,127,645,2643
They said it's time to minimize our lifestyle.,109,15,3,127,645,2970
No puts allowed.,108,17,2,127,645,4801
I can assure you it’s no white elephant.,108,17,2,127,645,4983
This is a great second home for couples with oil rigs.,109,15,3,127,645,5114
Makes no difference if you play golf or not!,103,16,2,121,645,261
This one slices easier and faster than the other ones do with one blade.,103,16,2,121,645,4414
"And randomly enough, there's an elephant in the background!",102,18,1,121,645,4580
Cool !  Retro air conditioning !!!,101,20,0,121,645,4753
This is a par-one with your credit score.,104,14,3,121,645,4880
Sometimes you're in the hole - sometimes you never even got out.,102,18,1,121,645,5025
It's a great little place- especially when the giant folks aren't playing miniature golf.,104,14,3,121,645,5941
You’re not the first to complain about the golf course lot description.,100,11,4,115,645,5344
Just try not to get hit,94,12,3,109,645,7276
"With the interest in building walls, this is a can't-lose investment.",125,18,3,146,645,1916
"Yes, and besides a guaranteed deep sleep on windy nights, here’s a little secret about those propellors... Dodging them develops 7 separate motor skills.  You‘ll be, hands down, the jumpiest folks in town.",126,16,4,146,645,6869
The tee is in the backyard,119,19,2,140,645,2612
It has a big ball room with swinging doors. A house to die for.,121,15,4,140,645,2631
"Yes, it is quite unusual in design but with wind power you will realize significant savings on your electric bills.",119,19,2,140,645,3756
"Balls in your face,in your mouth,in your bed!",121,15,4,140,645,5571
You will love living in this crime-free neighborhood!,114,18,2,134,645,3009
It's kind of a fixer-upper.,115,16,3,134,645,3078
The trick will be to unload it before the jumbo payments kick in.,114,18,2,134,645,5216
The whooshing drowns out the slaughterhouse screams.,117,12,5,134,645,6019
"Don’t worry, they won’t cross the aisle and the others can’t dig themselves out of the hole they’ve dug.",109,17,2,128,645,385
... and your kids will love riding it.,109,17,2,128,645,1962
Climbing all those stairs will keep you in great shape,107,21,0,128,645,2505
"A Sheik wants it for an Airbnb, so we should close the deal today.",110,15,3,128,645,2866
"Look, I’m not gonna lie. Some wires got crossed at the office and we built fences where your blades should be. The really bad news is that we used the blades to build the new elephant cage at the zoo and... well...",111,13,4,128,645,4619
"This is hole no. 5,thousands less than much of the  holes. This includes the on again off again front door.",110,15,3,128,645,4636
Have you seen Raiders of the Lost Ark?,108,19,1,128,645,4978
There's no better time to buy,110,15,3,128,645,7328
The HOA fee includes all lawn care.,103,18,1,122,645,2455
"On the bright side, this house has “elephant bars”",105,14,3,122,645,2611
And there's a little Raiders of the Lost Arc in it too.,104,16,2,122,645,3003
Not only does it have a view of the third hole but it is Platinum LEED certified.,105,14,3,122,645,5287
"These are our latest ""tiny houses"" with retractable fences, guaranteed to keep out any intruder.",104,16,2,122,645,5660
There is no longer an elephant in the room,100,13,3,116,645,1840
"Now,​ this is a great starter home and comes with its own built-in safety door.",93,16,1,110,645,620
..Your slogan would simply say life-size golf instead of miniature golf.,95,12,3,110,645,1663
"As a disclaimer, no children were harmed in the making of this house.",92,18,0,110,645,1761
"Great views of the course, your own renewable energy — it’s a truly unique opportunity!",93,16,1,110,645,3753
Don’s harmless—he just doesn’t get the point of the game.,95,12,3,110,645,4542
"My dad used to own the theme park, but I’m more into Airbnb and stuff.",92,18,0,110,645,5130
"It's the latest in sustainable home security, an elephant deflector, and a whole designed to stop those pesky self-driving cars that misinterpret the ""Home"" command.",131,19,3,153,645,3177
You'll love the the unique laundry line..,129,23,1,153,645,6028
"Indeed, the address is 1 for this starter home.",121,17,3,141,645,1954
"The neighborhood is great, and for this price, it's a real hole in one.",119,21,1,141,645,3935
This is the latest in whole house air conditioning designed to combat global warming.  The trained elephant nearby is there for calm days to provide trunk powered cool mist.  Because of the design of the house your payments will be made separately.,119,21,1,141,645,4336
You can leave your food procressor behind.,119,21,1,141,645,6938
It’s a great location to start a family.,116,16,3,135,645,2003
"Elephant, hmm? Well, when in Amsterdam....",117,14,4,135,645,3432
They're all duffers here.  You won't by troubled by golf balls.,114,20,1,135,645,5509
"Let's talk behind the windmill, we can ignore the elephant in the room that way.",114,20,1,135,645,5608
"And what’s more...Zero Co2 emissions: this property makes a very contemporary yet enduring environmental statement, Mr and Mrs Studebaker.",114,20,1,135,645,7302
"Our homeowner's policy pays double if you get hit by a golf ball, even if it's as small as a minicar.",110,17,2,129,645,400
"Other attractive features of this listing are cost-free electricity & air conditioning whose design, especially nice, won't leave any dead birds in your front yard!""",108,21,0,129,645,1432
Just keep everyone out of the way of the golf balls and you'll be fine.,110,17,2,129,645,2027
"'Well, your energy costs would be reduced, and there are hardly ever any tornadoes.  Free pet if you sign today.'",109,19,1,129,645,2692
Are you familiar with how the Paris sewers are cleaned?,110,17,2,129,645,3512
This unit can definitely power you toaster.,110,17,2,129,645,4100
It's quiet and serene in the winter but in warmer months you have to watch out for the golf balls.,109,19,1,129,645,4109
Both of you jump from the top into the hole and you keep the windmill.,111,15,3,129,645,5367
"Don't worry. Before closing, we'll get the city to permit tilting again.",110,17,2,129,645,5494
"Of course! It's those over-sized, colored spheres that makes the place so affordable.",111,15,3,129,645,6889
"Well, we do live in New Amsterdam...",105,16,2,123,645,990
"And it's always lots of fun to tie one of your tipsy dinner guests to the slats and watch them spin round and round until they agree to holler, ""Ok -- I'll talk! I'll talk!""",104,18,1,123,645,2714
"If you get this one, the next round’s on me!",107,12,4,123,645,4572
I think we lost him so let’s hurry back in the room.,104,18,1,123,645,4731
Front doors are prohibited.,105,16,2,123,645,5907
"There is a little bit of damage from the previous owners, I think they said something about a donkey.",107,12,4,123,645,6179
It gets great shadows.,135,24,1,160,645,6208
Honey I shrunk the kids!,103,9,5,117,645,301
This bargain is anything but mini.,102,11,4,117,645,1537
"The ball is scary but watch out, the shoes will kill you.",100,15,2,117,645,2471
Did I mention our catastrophic coverage?,100,15,2,117,645,4955
Sure it looks dangerous but think of the energy potential and added security if someone trys to sneak in through the front door.,132,19,3,154,645,1951
"If you see a club, just tuck and roll.",133,17,4,154,645,4189
"Maxigolf never worked out, so now you get a home in one!",128,16,4,148,645,646
This next one you're gonna love - it breaks wind and balls.,126,20,2,148,645,6852
"It has 2 bathrooms, and 3 bedrooms,  but it does get a bit drafty.",126,20,2,148,645,6937
"This house is currently on the market for 200,000 tickets. “Honey this means I can’t get you the spider ring”.",95,14,2,111,645,7462
"No, this is The Windmill I do Mind!",120,21,1,142,645,526
"It's noisy, but at least there are no elephants in the room.",121,19,2,142,645,1281
"Brilliant, eh?  First we shrunk you down to the size of a mouse.  Now this repurposed putt-putt hole #17 is perfect-sized as your new, affordable abode.",122,17,3,142,645,1493
It quiets down when the mini-golfers go home.,121,19,2,142,645,5910
Thinking of buying this... but does it also run on Windows?,118,14,4,136,645,129
"Don't worry, if the wind dies down the sermons from next door will help a lot.",117,16,3,136,645,2541
The neighborhood has been set up like a miniature golf course. Just watch out for the holes.,120,10,6,136,645,2756
"It's not Augusta, but the electric bill is a hole in one",111,17,2,130,645,1746
The mill grinds slowly.,110,19,1,130,645,2813
"The last owner was knocked into the hole when a giant ball rolled right through the living room, but don't worry. It's an easy fix and I can get you the place for a steal.",112,15,3,130,645,3311
You won’t find a house more in vogue,110,19,1,130,645,3554
"Now, what are the Republicans up to?",108,12,4,124,645,1377
I can assure you that the rumors of a ghostly elephant haunting the neighborhood are just that.,107,14,3,124,645,1465
"...and the dike is guaranteed not to burst for five years""",106,16,2,124,645,3056
It looks the same when it’s windy.,106,16,2,124,645,3537
This hole is a par 3 if you are 6 ft 5...par 5 if you are shorter,105,18,1,124,645,3584
The short game has its advantages.,105,18,1,124,645,5358
It comes with a nuclear option.,108,12,4,124,645,5763
You can whisk away that pesky zoo odor.,105,18,1,124,645,7437
Tim wants to tip toe through the tulips with me,128,18,3,149,645,7553
Your windy mill home provides you with a cool breeze.,101,15,2,118,645,82
"Frankly, it's the golfball problem....",101,15,2,118,645,1966
Claes Oldenburg and the Toll Brothers were inspired when playing miniature golf,102,13,3,118,645,3269
"The way I see it, you're gonna want to act fast, folks.  This baby's a hole-in-one."" 


Catherine Barron   Fredericksburg, V",103,11,4,118,645,5165
"The children will love it and your miniature schnauzer will feel right at home here, too.",100,17,1,118,645,6432
"Now tell me, Where were you on the night of the hole in one?",122,19,2,143,645,3685
It's better when the shadows pass by.,124,15,4,143,645,4622
"Actually, in this community pools are generally frowned upon.",121,21,1,143,645,6365
YOU`LL  LOSE YOUR HEADS OVER THIS SCREAMING DEAL,95,16,1,112,645,4788
Welcome to the Tiny People's Pitch-n-Putt.,118,16,3,137,645,2047
"I'm really not supposed to tell you this, but the previous owners were Brobdingnagians.",112,17,2,131,645,1516
And the mini golf ball is included in the price.,112,17,2,131,645,3146
"Truth to tell, the only other  “elephant in the room “ is the one  out of the room.",112,17,2,131,645,3285
And it comes with an elephant in the back yard.,113,15,3,131,645,4152
"Sure, I know it is a fixer-upper.  That's why it just costs 'peanuts'.  But this place is perfect for a couple, like yourself, that likes to just putter a round.  PLUS, it's convenient.  You're just a few steps away from the Church and the Zoo.",112,17,2,131,645,4665
Put-Put is slow this time of year so they’re leasing to qualified couples.,113,15,3,131,645,6041
"Minor design flaws aside, as environmentally conscious homebuyers I knew you’d appreciate the LEED ultra-platinum rating.",114,13,4,131,645,6431
If you buy this house you can rest assured that it will never go underwater.,127,22,1,150,645,1491
It's perfect for you.  Backs up to the 9th green.  No little kids.,128,20,2,150,645,1872
"You're mature enough to let another man play-through, aren't ya Dave?",107,16,2,125,645,2560
"Of course, if you buy the place you will have to adjust to being part of miniature golf in this land of giants.",107,16,2,125,645,2705
It would be easy to remodel those seven wee bedrooms.,106,18,1,125,645,4625
You'll love it. People in the neighborhood are very friendly.,106,18,1,125,645,6812
The sound repels elephants and other pests.,108,14,3,125,645,6875
Obviously this one is for a young couple like yourselves.,106,18,1,125,645,7217
It's energy efficient and your neighbors are practically invisible.,105,20,0,125,645,7477
"Perks include free putters, rotating shade, daily animal clouds, and more.",108,14,3,125,645,7534
The owners (unusual people) will pay you live in their house.,127,11,6,144,645,2550
"I know it's just over your budget, but let's putt it this way...",124,17,3,144,645,3205
Well at least the elephant won't come in your house. They hate windmills.,123,19,2,144,645,6137
"Forget the Elephant, it just tilting the windmill.",102,15,2,119,645,6973
The good news is your just a four iron from work .,119,16,3,138,645,938
"Trust me, you'll get used to the outdoor toilet. Plus the windmill will push the smell away from you.",118,18,2,138,645,1590
Think Big!,118,18,2,138,645,5456
It's a little over budget but think of the money you'll save on wind!,117,20,1,138,645,5712
It's cheap...damit...c'mon,119,16,3,138,645,5975
Good news! TheQuixotes have this baby priced to sell. Bad news! It’s near a golf course.,117,20,1,138,645,6917
This is specifically designed by the NSA to keep the elephant out of the bedroom.,97,14,2,113,645,1159
Don't putt around on your offer.,97,14,2,113,645,3618
it’s a great neighborhood to raise a family.,113,17,2,132,645,3331
"No I'm not kidding, someone lives here!",112,19,1,132,645,5244
The only drawback to living on this golf course is that it’s only a “par 3 course.”,112,19,1,132,645,6075
I'm pretty sure you might have just passed some wind,112,19,1,132,645,6142
Perfect choice for golf enthusiasts such as yourselves,112,19,1,132,645,6197
Things have changed a lot since I took my first beanstalk up here. They have mini-golf now!,115,13,4,132,645,7039
Sorry we’re late; we hit the bank on our way here.,131,16,4,151,645,3168
Of coarse the fencing will need some attention,92,13,2,107,645,3904
"Well, no...a dog is not recommended.",92,13,2,107,645,4027
"For your ceremony, we will have to time the blade rotation.",93,11,3,107,645,6613
This property was designed with the putt-putterer in mind.,108,16,2,126,645,1894
With your legacy membership you get unlimited access to the big kids course,107,18,1,126,645,6454
It’s a foreclosure sale. The previous owner failed to pay his electricity bill.,108,16,2,126,645,6806
I think we could really save you some money on your electric bill with the installation of a couple solar panels.,123,21,1,145,645,3974
You might get a few Cary Grant fans sometimes... otherwise it's very quiet.,123,21,1,145,645,5265
The last golfers who played through left this real estate in turnkey condition.,123,21,1,145,645,7491
"It was built on the Miniature Golf Course theme.
The price is right but you have to watch your step.",86,14,1,101,645,1959
"Tired of the same old grind?  Buy this baby today and we'll throw in a new millstone!!""  (and we'll toss in the elephant in the background",104,13,3,120,645,966
"Bet you were so worried the door would shop your head off you didn't notice the haunting soul of Zumbo the elephant, he's the one you should be scared of. Also, watch out for the big ass hole.",104,13,3,120,645,1599
To help pay off the mortgage you'll have a grinding service for your neighbor farmers.,103,15,2,120,645,1696
I hope you love playing mini-golf!,101,19,0,120,645,2087
Think about it this way........no air conditioning bills.,103,15,2,120,645,3568
"We saw your ad in the paper for ""White Elephant"" open house. Which model is this?",102,17,1,120,645,4352
We're gonna need a bigger ball!,102,17,1,120,645,5303
"Yep, climate change...but good news you can get in the front door.",103,15,2,120,645,5937
"We call him ""Down"" Quixote now.",120,16,3,139,645,1015
"It was a build by a guy who just loved ""Putt Putt"" golf .",119,18,2,139,645,4870
This is the most affordable in Vancouver,120,16,3,139,645,5299
It's the latest in urban planning.,121,14,4,139,645,5331
This house is great it has the best air conditioning you can ask for.,98,14,2,114,645,149
"The owners are Dutch, which presents some difficulties, but it could always be worse. I mean, Christ, at least they're not Belgian!",116,13,4,133,645,298
Have you seen that movie “Downsizing” with Matt Damon?,112,21,0,133,645,3659
"If you make a hole in one, you get two weeks' free time share.",113,19,1,133,645,3823
"You can always make 'it' a play area for children""",112,21,0,133,645,4538
Invest with us and we’ll protect your wealth in case of a rainy day.,114,17,2,133,645,5687
It's a safety feature that keeps the elephant away!,131,18,3,152,645,6175
"A fine, roomy home, if you don't mind stray pars.",125,19,2,146,645,3924
"Sorry, but I warned you about taking more than one tab before our appointment.",127,15,4,146,645,4631
It's a McGolf course for the McMansion set.,125,19,2,146,645,7164
"Grab a blade and hold on tight for the best view in town! 
Sure, the motor can be a bit noisy, but Holeowners' Association rules let you shut it off at night when the course is closed.",107,20,0,127,645,1146
...and when you feel like puttin around here's the guest house.,111,12,4,127,645,3044
"If you pick the first floor, electricity’s on us!",109,16,2,127,645,4915
"Three beds, two baths, and really friendly neighbors.",93,13,2,108,645,20
Don't worry about that - they're allowed to set place the ball six feet from any hazard.,92,15,1,108,645,1271
Dutch mini-golf has its differences,93,13,2,108,645,1305
If you buy it he will come.,92,15,1,108,645,4394
"it took a decade to build, the builders just wouldn't stop putt-ering around",120,18,2,140,645,404
"The yard is not level, but you never have to mow it.",119,20,1,140,645,3206
"We let him out of the room, but he's still there.",119,20,1,140,645,5320
No worries...They are 90% air!,120,18,2,140,645,5524
Two green aspects. Door security and the neighbors when they see your Christmas Lighting,121,16,3,140,645,7015
"The last owner was Terry Gilliam, who hardly used it at all.",104,15,2,121,645,3505
Make sure you get home insurance before Jimmy's 10th Birthday Party... It's going to be a category 5.,103,17,1,121,645,5679
We call it life-size mini golf.  For children and the fraud golfers-at-heart.,104,15,2,121,645,5760
"It's a cute house and location, location, location. The lot size is 364-4π square feet.",130,22,1,153,645,7152
the security system is intermittent BUT clog free & yes there are two putters & balls included,89,10,3,102,645,7305
The good news is that this home is within your budget,116,15,3,134,645,3250
Fixer Upper,115,17,2,134,645,4267
Obstruction views of the White House,115,17,2,134,645,5276
"And here is our Fence Model. When necessary, it prevents the elephant from coming into the center of the room and keeps him in the middle of the yard.",113,21,0,134,645,5510
"It's the tops in going off the grid, but the neighborhood is a real zoo.",113,21,0,134,645,5911
"Par-don my question, but why was this house putt on the market?",117,13,4,134,645,6960
"This model is called Fairway Fairytale, the most popular home in our maxigolf community.",116,15,3,134,645,7442
The entire property was Mr. Kongs. This is only the 16th hole.,100,12,3,115,645,2359
It’s generally safe but please keep the kids away from the sinkhole at house 18 down the block.,99,14,2,115,645,3709
Home buyer's special: conserve both energy and endangered species at a new low price.,98,16,1,115,645,5826
Look out for the Golf balls,128,15,4,147,645,605
"You'll get used to the red, green, blue and yellow balls rolling through.",111,14,3,128,645,600
"At My Gulliver's Industries, we're proud that our self-powering, eco-friendly cell towers spin money for you 24/7 while also soothing those neighbors who complain about the ""eyesore problem"" caused by our competitors' cell towers.",108,20,0,128,645,1664
This is our miniature model.,110,16,2,128,645,1772
Play any day but Sunday. The elephant plays on Sunday/,113,10,5,128,645,1895
And as you can see,111,14,3,128,645,2790
What’s so complicated about hit or miss? Focus on the energy efficiency!,111,14,3,128,645,2964
Homes on the golf links never become white elephants,110,16,2,128,645,5015
Do you have anything for a nuclear family?,112,12,4,128,645,6310
The house is powered by renewable energy...the first wind-powered turbine of its kind.,108,20,0,128,645,6767
"Well, it's a no brainer for ease of living with energy galore and a church nearby. Now the elephant...hmmm....we are still investigating but ofcourse he can also be used for your transportation! Just a great deal!"" says the realtor!",121,18,2,141,645,6776
The blades are made from carbon fiber so they will last for years.,94,13,2,109,645,4889
It’s Utopia for adults who were shrunk by their parents when they were kids,105,15,2,122,645,3327
"William and Julia, welcome to Bedminster Miniature Golf Club, a subsidiary of TrumpCo....",103,19,0,122,645,5503
It’s called guillotine golf. The object’s to get the head in the hole.,106,13,3,122,645,6533
The oil company has patented this model.,107,11,4,122,645,6579
This community was designed for couples planning for an early retirement.,117,15,3,135,645,2422
"It's a great house for the two of you, unless a golf ball comes through!
Jeffrey Manly
Toronto,On",114,21,0,135,645,4617
The HOA fee includes the wooden shoes and ten tulip bulbs.,117,15,3,135,645,4632
Live off the rails!,116,17,2,135,645,6906
I'm afraid the President did not see that coming..,127,19,2,148,645,1119
We only cover damages intermittently.,128,17,3,148,645,1121
The HOA includes an unlimited supply of pink golf balls.,127,19,2,148,645,2383
Welcome to Trump Putt-Putt!,129,15,4,148,645,2921
now the whole neighborhood can see your white picket fence.,89,12,2,103,645,308
The previous owners recommend putting around the house.,88,14,1,103,645,6243
Noise? Sure. But consider the carbon footprint reduction in pure wind power.,98,18,0,116,645,425
Sure we’ll reduce the price for fencing off that hole.,100,14,2,116,645,918
It makes the perfect Airbnb rental and your guests could pump their own artisanal water.,99,16,1,116,645,1233
The golf ball will be installed next week !,98,18,0,116,645,1554
"No, the elephant doesn't care if you snore.",98,18,0,116,645,2024
"Retro? I’m not quite sure. But it has a certain charm. Biddings
bound to be brisk!",101,12,3,116,645,6786
"This house comes with ""Neighbor Protection Insurance""",109,20,0,129,645,199
"We discovered a typo in the blueprints. Your house is ginormous, by the way.",112,14,3,129,645,901
The previous owner was a pink dog named Courage,110,18,1,129,645,3286
"This purchase would doubtless be a turning point in your lives.

Margaret Agner, Bogart, GA",109,20,0,129,645,4663
"You would have had a case if the ad said ""Diminutive Golf"". Sorry.",123,16,3,142,645,2156
"With three offers on the table, I suggest you move fast.  This IS the last unsold home in Hacker Haven.",123,16,3,142,645,3989
Huh... The weather report didn't say it was gonna be this windy,123,16,3,142,645,6942
And it's cool in the summer.,105,17,1,123,645,1008
How was I supposed to know what you meant by 'Gigantic Mini-Golf Course?',106,15,2,123,645,2673
WE all this open “air” concept...,106,15,2,123,645,3386
"Yes, but how do we get the elephant “back” in the room?",106,15,2,123,645,5967
"Finally, this community boasts a unique, green, public transit system.",107,13,3,123,645,6410
The hailstones are as big as golf balls!,105,17,1,123,645,6834
But they're only miniature balls.,107,13,3,123,645,7037
The asking price is one giant orange golf ball.,119,13,4,136,645,3384
"It comes with a free elevator to heaven, accessible via the front door.",117,17,2,136,645,4685
The Jolly Green Giant got bored with mini golf.,117,17,2,136,645,5397
The green carpet is shiny new and I'm sure you'd both enjoy puttering around this home...!,117,17,2,136,645,6848
"It’s what we call, in real estate, a step up home",119,13,4,136,645,6887
"Lilli can putt, and how!!",127,21,1,149,645,6774
"Sorry, no.  The 'No Children' policy applies only to the homeowners.",123,18,2,143,645,521
And that's how you build equity.,112,16,2,130,645,818
Just BE the ball Danny,101,14,2,117,645,1466
Property taxes are high but the school district is amazing.,124,16,3,143,645,2121
We call this our 98.3% hole in one.,121,22,0,143,645,3273
Don't worry Paul Bunyan can't putt for beans.,125,14,4,143,645,5122
This house is perfect for a putt-putter-er,112,16,2,130,645,5561
The villagers are nice but there appears to be an elephant in the room!,110,20,0,130,645,6372
It even comes with a pet elephant named Sancho!,111,18,1,130,645,6542
"Yes, it’s a pricey neighborhood but this particular model saves you a bundle with it’s wind powered appliances.",112,16,2,130,645,7411
I’m rather looking for a Sancho Panza’ s style,130,17,3,150,645,3727
"Hit or miss? I guess they never miss, huh?",117,19,1,137,645,111
Comes with a built-in neighbor repellant and more!,117,19,1,137,645,2345
What a stroke of luck we landed this property,118,17,2,137,645,3770
"It's everything you asked for - big on energy efficiency and precise timing on when you get in the house.""   ""Sir, we meant marketing timing and a windmill, really?""  ""Shush dear, I think we have one wish left.""   Clients at Aladdin's Genie Realtor",117,19,1,137,645,3903
This second house we're looking at is built on a jumbo-mini golf course. It's a real hole-in-one.,118,17,2,137,645,4260
I hope you can handle a 30 foot club.,118,17,2,137,645,4569
Do we get elephant insurance?,107,15,2,124,645,4066
It even has income potential if you install straps on the blades and offer rides.,107,15,2,124,645,5053
Property prices are bound to rise - Tiger is back!,108,13,3,124,645,5840
The price reflects that it is a fixer upper,107,15,2,124,645,5871
"What's not to love? 2 bedrooms, 1 bath, giant wind blades, and free access to the community elephant.",107,15,2,124,645,6247
The owners said that it's time to putt your money where your mouths are.,108,13,3,124,645,6751
What's the difference between a house and a windmill?,97,11,3,111,645,3230
"Remember--location, location, recreation.",96,13,2,111,645,3610
You are going to want to avoid the blue balls.,97,11,3,111,645,6053
It comes with Hans Christian Anderson's coffee maker.,126,14,4,144,645,831
The Smart No Soliciting is still in Beta.,125,16,3,144,645,4383
Combining miniature golf with suburban living is all the rage; its worth considering,112,18,1,131,645,939
"It's way under your price range. Entry is in back, and no lawn care needed, just watch out for the giant putt-putt monsters.",113,16,2,131,645,3073
"Absolutely, it's a shoe-in.",112,18,1,131,645,4936
"If anyone catches wind of the deal, they will be dealing with a hole in one.",115,12,4,131,645,5724
"No, They're not stationary, they do move all the time, BUT the view from here is worth the feat of Beating the Blades.",112,18,1,131,645,6839
"Giants of the game moved on, could never fill the hole leaving left!",101,16,1,118,645,1781
We can guarantee you there won't be any large golf balls rolling through your living room.,101,16,1,118,645,2975
"It has all the benfits of a neighborhood where the doors are always open, plus a quick commute downtown.",101,16,1,118,645,6512
He's just there in case the wind turbines can't power your tv anymore.,103,12,3,118,645,6911
"I know it's a daily grind, but you get co-generation, too.",133,13,5,151,645,6196
"Hahahahaha... like... hahahaha... if you, like, try to get in the house you finna get smacked by the big fan blades, homie... hahahahaha",134,11,6,151,645,6560
"This is the perfect mausoleum for your recently-deceased, gigantic loved one. It has been disturbed but once in 400 or so years by a crazed knight riding a decrepit horse. Other than that misfortune, all giants who enter here rest in eternal peace.",119,17,2,138,645,3058
"If you don't want to live in a Dutch windmill, we also have the Africa theme park.",118,19,1,138,645,7007
That elephant cloud IS the wind.,108,15,2,125,645,2798
For the love of god Dale! I told you not to call the freaking elephant Donald Trunk.,110,11,4,125,645,5940
"I'll warn you, the neighborhood is very loud.",95,17,0,112,645,341
"Solar panels - not needed! This Dutch-Dyke Colonial only utilizes 
heaven-sent, wind-sweeping cross power, instead!",98,11,3,112,645,1341
Will see if your offer is on par with Mr. Cheese,97,13,2,112,645,3179
"But, miniature and Dutch needn't be an oxymoron....",96,15,1,112,645,4122
And this quaint little cottage was once owned by the Jolly Green Giant,97,13,2,112,645,6013
Don't pay any attention to the elephant that lives around the corner.,125,18,2,145,645,2286
"I checked with the board. Giant elephant ghosts are not an issue, so long as they’re trained.",128,12,5,145,645,3834
"You will find the rent is quite reasonable for the very large space, and  you will always be given advance notice so you can temporarily vacate the property when Gargantua is coming here to play.",114,16,2,132,645,4450
"Alice, I told you it has a built-in security system!",113,18,1,132,645,6477
"You may find the occasional goofball, and that is exciting!",114,16,2,132,645,6787
"After his term the President wants to move to real Disney World. He already bought the White House, thats why we are selling the other properties - it’s a bargain.",114,16,2,132,645,6971
I bought it from a dealer in Miami. Dutch Singularity!,101,18,0,119,645,1679
‘Getting past the pinwheel is the interview for Secretary of Defense’,104,12,3,119,645,4856
"Give me your money or I'll put a hole in one! get it?""
 ""...",119,19,1,139,645,973
"Win mill. Win mill,"" I said. ""You've won a win mill!",119,19,1,139,645,1035
For an area like this it's actually like a giant!,121,15,3,139,645,6538
"And as an added bonus, free golf right out your friend door!",119,19,1,139,645,7287
... and we are even going to though in a membership for your troubles,111,11,4,126,645,3340
"Now that we have global warming, it has slowed the timing, and the last owners say it gave a sweet rhythm to their retirement days.",109,15,2,126,645,5928
And this is the Dutch-style model home. All the charm and none of the working windmill issues.,110,13,3,126,645,5942
"Every property in this neighborhood has one as a standard amenity....pool or jacuzzi, your choice!",126,18,2,146,645,5085
So sorry.  He tried to get out too fast - was clobbered in the head.,99,11,3,113,645,1225
On the other hand there may be an elephant in the room.,99,11,3,113,645,4464
Each tunnel leads to a different national icon.,97,15,1,113,645,5296
It comes with a golf cart and discounted green fees.,113,20,0,133,645,1456
"I'll be happy to sell this house for 20 bucks, Miss, if you can get inside the house.",118,10,5,133,645,2230
There is an App for that!,116,14,3,133,645,2421
"Look you fools, I told you it was a fixer upper, dam",113,20,0,133,645,3034
"It's not perfect, but it does keep most of those big balls out.",115,16,2,133,645,4320
It has a 2 below par walk score,117,12,4,133,645,4710
"This one has a distinctive air and  a unique vibe to it, but I thought you might come around to liking it",115,16,2,133,645,5202
But you have to go inside if you want to play,114,18,1,133,645,5855
Now don’t be fooled by appearances. This may not be as sophisticated as what you’re used to but a level of experience is needed to negotiate this successfully on the first go. You need to trust me when we get in there. This is right in my wheelhouse.,115,16,2,133,645,6656
"I know it has a great view of the dike, but FEMA cut off flood insurance during the shutdown.",115,16,2,133,645,7026
"Well folks, the property developers held a Kaizen event on this lot.  They turned the sink hole into an “opportunity”!",132,19,2,153,645,7204
"Just rent out the ground floor. You’ll get extra income, so it’s a win-win.",104,14,2,120,645,1276
"It’s only got one bathroom,
But there’s an income associated with it.",122,15,3,140,645,1993
"‘The boy who cried wind...?’ Ha, ha, it’s funny you should mention that.",122,15,3,140,645,2122
If you enjoy challenge you're going to love both the house and neighborhood,103,16,1,120,645,3199
"As a historic site, you can appreciate the preservation efforts above and below ground.",102,18,0,120,645,4345
You are now insured against Mini-golf developers and a giant Don Qixote.,121,17,2,140,645,5566
The choir's new trumpet player is divine.,121,17,2,140,645,6543
"It's either this, or you take a shot at the stock market.",104,14,2,120,645,6672
This property won't last long!,144,21,2,167,645,4689
You're gonna love the view.,126,20,1,147,645,2275
"It's a cool new style called ""Windmill Chic.""",129,14,4,147,645,4357
Just slide in for a sec and check yourself.,126,20,1,147,645,7114
It's said to ward off Alzheimer's.,110,15,2,127,645,757
"Well first of all, it's in your price rage, and as a plus it's within perfect proximity of the golf course.",112,11,4,127,645,1090
It holds the future to our power.,108,19,0,127,645,4105
"...and, you''ll love the view of the neighbors elephant hedge.",110,15,2,127,645,4185
Think of it as miniature golf for the homeowner.,111,13,3,127,645,6326
Can I interest you in Fantasy golf?,110,15,2,127,645,6778
It's the best of the 18 properties because the large white sphere disappears in the hole and does not need to be retrieved.,91,16,0,107,645,2936
Great decision upgrading to Deluxe. Our Basic customers complain nonstop that the litter-box walls are too high.,117,14,3,134,645,840
"this house is next house is perfect, if you don't mind the draft",117,14,3,134,645,1066
Just need to add a bathroom on the second floor.,117,14,3,134,645,1192
JUMBO golf! A hole-some game for all sizes!,118,12,4,134,645,2427
"Yes, it was a Dutch architect but I thought that was a good thing.",117,14,3,134,645,2869
Our children are ten times more likely to be admitted to Ivy League Universities.,117,14,3,134,645,3843
"Yes, yes the Seller is an avid mini-golfer, but there is an offer in place from a wind energy investor.  As your real estate agent, I must urge you to put in your best offer today.",117,14,3,134,645,4500
"PSST..., Guido wants the vig for the Tulips",115,18,1,134,645,5586
This real estate listing is a hole in one!,100,11,3,114,645,2029
What is this going to cost us in H.O.A. fees?,99,13,2,114,645,2791
Just pretend it’s a bar and you have to pass through the swinging doors ever time you enter or exit.,99,13,2,114,645,3072
"Every time a hipster brings a first date here, a literal 'elephant in the room' materializes to metaphorically trample the pseudo-irony, so we'll need you to sign this waiver.",123,15,3,141,645,3312
"Yes, the HOA fees are standard in these kind of communities.",124,13,4,141,645,3326
"At last we've made golf great again."" 
""You see, honey.This is the real deal, the way our parents used to play.""",124,13,4,141,645,4621
"On the plus side, the casualty rating for the upper floors is pretty much nil.",125,11,5,141,645,6417
Why do you think there’s an elephant behind the house?,104,16,1,121,645,692
I can offer you a non hole-in-one insurance plan,105,14,2,121,645,6262
"Wife to lawyer: “And this toy windmill is all the fortune his favorite aunt left him” ? 
Husband, smiling : “At least we could safely say - she thought she was the wind beneath my mills...?”",111,15,2,128,645,2415
"In case you have any little rug rats, you'll be happy to know your home is fully carpeted and entirely fenced in.",111,15,2,128,645,2914
"En un lugar de la Mancha,de cuyo nombre no quiero acordarme,...",112,13,3,128,645,3443
"I know you are new to Brobdingnag, but this is a real steal, I assure you.",110,17,1,128,645,3454
This one is the most elephant-proof . You'll get used to the hazards over time.,111,15,2,128,645,5534
it's perfect for planting roses...and so close to a place of worship,109,19,0,128,645,7099
"The price is good. A thousand dollars,tops. Nice neighbors,too.",136,15,4,155,645,4789
It's wise not to overextend yourselves.,117,16,2,135,645,497
On the other hand...,116,18,1,135,645,694
"Let’s consider a compromise, this listing is both close to shopping and on a golf course...",93,14,1,108,645,1409
"I know the listing said Dutch Colonial, but what are the odds of them getting through?",117,16,2,135,645,2000
"Now, this house is known to have dents here and there, but its the only one we found in your price range...",118,14,3,135,645,2076
"Another benefit is having direct access to the town's ""FORE!"" crier.",117,16,2,135,645,4007
"Windmills will not do the work for global warming. Too  slow. You can pray, Parson, but no promises prayers would work.  You are better off with a see-saw and a couple of kids.",118,14,3,135,645,5340
"Elephant in the room, no he lives down the street, but it is located  on a miniature golf course.",121,21,0,142,645,195
"And, owners get free access to the community's Skee-Ball facilities!",122,19,1,142,645,1474
Don't let the schools in this area putt you off...,123,17,2,142,645,1707
The woman who wrote that big hit for The Association had it built in '67.,124,15,3,142,645,2022
There's a flood insurance discount.,123,17,2,142,645,3134
"Not to worry elephant are afraid
of windmills",124,15,3,142,645,6374
Large? Of course it's large. It's a miniature golf course for idiots.,98,17,0,115,645,6905
Even at this scale putt-putt tut-tut's the ho-hums.,128,20,1,149,645,4851
It's the new modern!,106,14,2,122,645,589
I advise you to insure the property against irate villagers bearing torches.,106,14,2,122,645,2260
". . . the views, the amenities, location - this property is practically a resort -  living here you'll feel like you're really living large. This place is gonna go fast, so now is not the time to think small!",105,16,1,122,645,5278
And it comes with automatic air conditioning too!,111,17,1,129,645,53
"Imagine feeding back to the grid twenty-four seven!  Just bob and weave.""",110,19,0,129,645,2021
Sure there are some risks. But it's not Detroit...just a Detroit price.,112,15,2,129,645,2347
The elephant ran through here and the builders stopped putting up fences,113,13,3,129,645,2701
"Personally, I wouldn't recommend purchasing this particular house. Not only would you have to live inside a windmill, the property has inexplicably been positioned on some sort of gigantic miniature golf course. Talk about an inconvenience!",113,13,3,129,645,3988
There is concern the Egyptian pyramid hole will obstruct waterfront views.,115,9,5,129,645,7563
"""We'll sue and this windmill turns into your windfall.",119,14,3,136,645,100
I have no idea what to say...did you see the elephant?,119,14,3,136,645,1963
You'll need Dutch edam cheese for the mousetraps.,118,16,2,136,645,1989
You know I just read that this is the windiest part of the Atlantic coast and yet they use fossil fuels for all of their energy.  Go figure!!!,117,18,1,136,645,3572
"Remember the pass code, 'swish-2-3'.",118,16,2,136,645,6588
See the key is to move fast but really you're just puttering around.,123,19,1,143,645,489
"Man, modern architecture sure has advanced.",126,13,4,143,645,5071
Your escrow payment might be in vane. Better wait and see how the wind blows.,123,19,1,143,645,6977
I'd like to add you to my LinkedIn network,131,16,3,150,645,42
Tilt? No of course you needn't tilt.  Why would you ask such a silly question?,100,15,1,116,645,1773
The movie had a very limited theatrical release in the US. And I assure you this windmill is not haunted by an average demon.,101,13,2,116,645,4083
"And on windy days, it'll generate all the electricity you need....",101,13,2,116,645,6415
I recommend hail insurance coverage for everyone in this neighborhood.,106,16,1,123,645,1545
milling about,106,16,1,123,645,1911
A variable rate mortgage would be perfect for you two.,105,18,0,123,645,6192
"So, folks, this is quite a unique property!  The good news is you will save a lot of money by making your own energy.  The bad news is you gotta remember  'Heads Up' as you enter and exit the property!",106,16,1,123,645,7540
...and a steep discount any time you want to join the game.,113,15,2,130,645,224
"Unfortunately, someone shouted ""fore"" in a crowded windmill.",112,17,1,130,645,297
"Never forget to feed The Pit.
Never succumb to the horrors of The Pit.",114,13,3,130,645,926
We call it Giant Golf!,113,15,2,130,645,1698
... and in two minutes pick up briefcase full of cash and make sure no one notices you leaving.,113,15,2,130,645,1904
I disagree.  Knocking out 30 to 40 of these is not an Impossible Dream.,112,17,1,130,645,2305
"Let me introduce myself: Win Miller, Real Frustrate Agent. I'm sure we're gonna have a ball!",113,15,2,130,645,3982
For a little more money we also have the tilting model,114,13,3,130,645,4147
"If that elephant gets any closer, just tell him it's powered by coal.",116,9,5,130,645,6999
Burning Man is terrible this year.,120,14,3,137,645,256
It started life as a bowling challenge.,118,18,1,137,645,745
The elephants are coming!,120,14,3,137,645,1557
The granite sweeps match the kitchen countertops!,119,16,2,137,645,1737
You will have more than enough hot air you’ll ever need for your brand new fully wind-powered home from the preacher in the church across the street,119,16,2,137,645,4145
"On the bright side, between 10pm and 8am you won’t have any golf balls crashing through your living room.",119,16,2,137,645,5467
This home will make your impossible dream come true!,120,14,3,137,645,5636
"Oh, they decided to downsize. They're living in a barn with a weather vane now.",125,17,2,144,645,719
It'l take you through your ups and downs,124,19,1,144,645,6785
"Yes, like cafeteria Catholics--Protestants too--it moves with the winds.",98,8,4,110,645,7214
"The owners of this charming cottage have two other offers, so if you can overlook those large white boulders rolling through every few minutes, lets sign that bid sheet now, and submit it.",107,16,1,124,645,1188
"And best of all, in this community everyone's from Holland.",107,16,1,124,645,4142
"Sure it's an early attempt at wind power, but you'll never pay a dime to recharge your phone ... as long as it's a flip phone.",110,10,4,124,645,4951
"This is the best deal on the market, and I'm not just blowing wind.",108,14,2,124,645,7105
"There is an HOA fee, but look at the amenities.",112,19,0,131,645,332
"If you don’t like this house, I got a clown’s nose you’re gonna love.",116,11,4,131,645,2761
"Sorry, but this is strictly a child-free community.",115,13,3,131,645,4812
This would be a Par 4 on our Mammoth Golf Course.,114,15,2,131,645,5360
"Frankly, I think this one will bowl you over.",113,17,1,131,645,6792
Just put it in neutral when you get back from shopping...,114,15,2,131,645,6825
"I'm sorry to tell you, but we're going to have to close. This was a terrible business idea.",112,19,0,131,645,6892
"""yeah sad, was a breezy day and forgot he'd had this window put in""",121,14,3,138,645,1924
Shh.... There's an elephant in the room,121,14,3,138,645,5437
"It's a great neighborhood, and you won't get hit with high taxes.",128,13,4,145,645,1741
"SHOULD WE DISCUSS THE HUMAN IN THE ROOM?""
- elephant",127,15,3,145,645,2703
"Don Quixote is on his after-lunch siesta and will return in
three hours.""

Suresh Mehta, Mississauga, Canada",127,15,3,145,645,7064
"Oh sure, an elephant-shaped cloud behind the church?! Well, have I got a windmill to sell you in Holland!",132,18,2,152,645,5598
"Obstacles do not block the path, they are the path . . . to your new home.",96,14,1,111,645,1156
I’m sorry to say your insurance doesnt cover HUGE BALLS,104,11,3,118,645,3050
"And it's conveniently located near the water hazardAnd it's conveniently located near the water hazard; er, the lake.",102,15,1,118,645,3790
What did I tell you...No more hiding from the elephant in the room you two.,104,11,3,118,645,4270
The former owners complained about mice.,109,14,2,125,645,432
Did you see “ the tunnel” ?  Just trust your luck and walk in front of the hole.,108,16,1,125,645,799
Its the latest in air conditioning,110,12,3,125,645,895
Cross ventilation r us!,108,16,1,125,645,2684
We're standing beside a large windmill.,111,10,4,125,645,3583
It’s true that your view of frustrated mini golfers may be compromised.,108,16,1,125,645,4150
"Some call it a white elephant, but I'd like to sell it for a fair market price.",109,14,2,125,645,5668
I hope you'll be happy with a rolling mortgage.,108,16,1,125,645,5901
"This  was miniature golf, until you both fell down the hole!",115,15,2,132,645,785
"Miniature Golf is the latest craze in Real Estate Development these days... This Windmill model will probably be snapped up quickly!__J. Scott Petersen, Ladue, MO",114,17,1,132,645,3236
In this market the chances of that are highly unlikely.,121,16,2,139,645,1282
"When the wind gets up, sounds like a herd of stampeding elephants.",121,16,2,139,645,3329
All your green friends will be purple with envy!,121,16,2,139,645,4680
"Yes, it powers itself. No, there are no windows.",127,17,2,146,645,4719
"I’m sorry, the trains are not included.",126,19,1,146,645,6996
Bye-bye Con Ed  and hello babysitter.”,133,18,2,153,645,805
If both of you take a hit you’ll never have to work again!,102,17,0,119,645,220
Sales have really taken off after our White House installation. We now call it the Ultimate Comb Over.,103,15,1,119,645,271
"You see, the rent is payed in baby pencils.",109,16,1,126,645,307
"The hole is a bit of an eyesore, but if you have a great sense of timing it's still a wonderful place to live.",97,14,1,112,645,621
"I understand there are historic and wind energy production tax credits available, but if this property isn’t in an opportunity zone I’m not interested, thank you.",114,19,0,133,645,1184
You said you wanted a doggie door. Well ....,104,13,2,119,645,1823
And for a few dollars more we'll provide system an alarm,115,17,1,133,645,2466
It comes with a drone in case there’s no wind.,103,15,1,119,645,2715
"And we call this one our money pit.”

Eloy Nava, New York, N",122,16,2,140,645,2730
What better use for your 200 acres?,97,14,1,112,645,3349
It was originally designed for giants.,110,14,2,126,645,4191
"The HOA can be a bear, but at least it’s carbon neutral.",103,15,1,119,645,4627
With this house you get free everything.,117,13,3,133,645,5258
It’s priced right and you get to designate your own enemies.,118,11,4,133,645,5869
"Just to be clear, the faux nonfunctioning windmill look, is optional!",103,15,1,119,645,5979
"Yeah, but remember, free air conditioning!",121,18,1,140,645,6115
This would be a great place for a water hazard.,102,17,0,119,645,6283
"Golf village retirement. 
Welcome to our giant movie set home. The windmill is off after midnight.",116,15,2,133,645,6545
It comes with a pair of Air Jordans for each of you.,104,13,2,119,645,7398
I thought you said your dog didn't chase golfballs,116,15,2,133,645,7558
Cloth earns an energy credit.,144,13,5,162,645,3135
Not a problem!  During our peak tourism months we've booked you a quiet place in the nearby Bird House Boutique.,128,19,1,148,645,7202
My wife wants to know if the house comes with a windmill or if that costs extra.,122,18,1,141,645,5686
"Imagine.... a perfect Tiny House with a spectacular view, centrally located and walking distance to all the amenities",116,17,1,134,645,327
"As you can see, it's a steal, and with the expanded cup, it doesn't take long for the kids to putt out. As for quiet evenings, the course closes at 9:30.",112,12,3,127,645,309
The point of the game was to get the golf ball past the moving windmill blades and down the hole.,110,16,1,127,645,1018
"Location, Location, Hole-in-One!",112,12,3,127,645,1415
"Welcome to the Mini-Golf Course Subdivision, where the greens are groomed and the upkeep is free...",109,18,0,127,645,2291
"If the ball makes it into the windmill, that's your cue to grab it and make sure it never comes out. Hole in none, that's our motto.",111,14,2,127,645,3018
Have you had any experience dodging gigantic snowballs?,111,14,2,127,645,3243
Here’s an insider tip: The winning bidder will need to get a hole in THIS one,111,14,2,127,645,3900
"With your budget, you’re lucky not to be in the glow in the dark neighborhood.",110,16,1,127,645,4937
Happy to say your birdiefront property is now in escrow.,111,14,2,127,645,7329
Yield.,105,13,2,120,645,2818
And the blades are guaranteed not to block the front door!,104,15,1,120,645,4795
"Do you remember the Giant in the Princess Bride movie? Well, he has passed on and his estate finally decided to sell his private golf course as 18 individual homes. This one is the Dutch Colonial model.",106,11,3,120,645,6877
"We  are  looking for a home
that includes electric without
a  windmill!",131,15,3,149,645,7451
a ballsy choice to put put some roots down,123,18,1,142,645,328
"It’s creaky, but it’ll waft away your farts in nothing flat.",125,14,3,142,645,3408
"Nothing to worry about, folks—that’s just a miniature sinkhole.",124,16,2,142,645,4901
"Well if this house's design doesn't blow you away, you can blow me""",123,18,1,142,645,6693
The cookies come free!,116,19,0,135,645,506
For an extra 10k the owner is willing to throw in an out of place Gorilla statue,117,17,1,135,645,2963
Good windmill fences make good neighbors.,117,17,1,135,645,6655
Sometimes it can be tilting.,111,16,1,128,645,1078
I bet you‘re going to kick yourself when I say there is an elephant in the back.,113,12,3,128,645,6817
We call it Maximum Mini-Golf,111,16,1,128,645,7126
The self-contained energy conversion system is a real bonus.,105,15,1,121,645,3257
"It’s my dream, and I will include in it anything that my heart desires.”",106,13,2,121,645,3983
You'll be the Talk of the Polder.,106,13,2,121,645,4844
"You may think it’s a white elephant, but think how much you’ll save on bread.",105,15,1,121,645,5330
Do you like miniature golf? How about elephant ghosts?,100,12,2,114,645,784
"Not only is it eco- friendly, it’s gluten free.",101,10,3,114,645,1089
The perfect home for the Windy City.... and you can moon the power company goodbye.,100,12,2,114,645,1606
"Zero net energy, and doubles as a death-penalty device. So, whichever way the wind blows. . .",102,8,4,114,645,4198
"No, it’s not made of LEGOs, it’s made of wood. Perhaps you remember wood?",126,14,3,143,645,1500
"And, you can get putt putt rental income.",125,16,2,143,645,2452
Earth ball mini-putt.,124,18,1,143,645,2616
"I give you my word, there are no bears around here!",118,17,1,136,645,2831
"The late Jim, 'Bite Size' Anderson built this Estate with pride.",118,17,1,136,645,5718
"Trust me, you won’t find a better deal for that kind of cheddar.",114,12,3,129,645,577
"It's called ""miniature golf hunt."" And you're the prey.",113,14,2,129,645,767
This is the best we can offer with your budget,113,14,2,129,645,1700
It's great for entertaining: You can be the Belle of the Ball,113,14,2,129,645,1941
Don't try it on a wendy day. Just stay in or out,114,12,3,129,645,2277
"Now, I'm going to demonstrate artificial intelligence.",114,12,3,129,645,3952
"It’s a three bedroom, 2 bath with a fabulous view of the tulip fields.  And a real steal at only two seven.",107,13,2,122,645,2762
"I'm not questioning my faith, Reverend. But the number of mini-golfers is gonna' be ridiculous.",106,15,1,122,645,3767
It provides a delightful breeze.,106,15,1,122,645,5416
Affordable housing in this town is a big game that you can play.,106,15,1,122,645,5988
Be sure not to miss the retro fight climate change touches>,102,10,3,115,645,5472
"So then I thought, “Hey, why not try _full-size_ golf?”",124,20,0,144,645,787
Sharing Dutch-I presume ?,95,11,2,108,645,5336
How about if I throw in a free clown nose?,119,17,1,137,645,424
"We call it ""The Anything But Miniature Golf Course"".",120,15,2,137,645,6152
"It doesn't have stairs. On the bright side, catching the blades will help trim that body fat!",119,17,1,137,645,7251
"You know of course, these were originally meant to be curtain panels",113,16,1,130,645,839
Wealthy people have a chance for close access to President Trump as a result of membership payments that enrich him personally.,114,14,2,130,645,1091
It's all yours now. Just don't forget to avoid the main floor during 'Giant Putt Putt' business hours and you'll be fine.,113,16,1,130,645,1920
my advice to you....don't fight it!!,113,16,1,130,645,4384
Didn’t you say there are updated bathrooms and a gourmet kitchen?,114,14,2,130,645,4854
"It's not going to work with three bedrooms, two baths and half a hole!",113,16,1,130,645,5558
It has many underground tunnel entrances in case of attack.,114,14,2,130,645,6868
"The good news or the bad news.
Mortgage or golf’
Your both sub par.",132,19,1,152,645,5342
"The former owner was hooked on miniature golf!""",127,16,2,145,645,3915
Such misgivings are just in your mind!,125,20,0,145,645,4507
It’s a turn key deal,102,12,2,116,645,5421
We're marketing this as 'Miniature Geoff',100,16,0,116,645,7210
I know...but The Caravsn IS Coming....,121,15,2,138,645,2301
You'll be the proud owners of one of the finest beach ball mini-golf courses in the world.,120,17,1,138,645,3381
Al would be very proud of you.,121,15,2,138,645,5504
It'll appreciate twice as fast as one that I sold at Pebble Beach.,123,11,4,138,645,7530
"It takes a certain type of person to live 
in this house and you two fit the bill perfectly",116,12,3,131,645,2140
Drained the swamp.,115,14,2,131,645,3609
"The good news is that your homeowner's insurance policy covers all forms of peril. However, I'm afraid it just doesn't cover sinkholes.",113,18,0,131,645,3779
"""Our Gouda and Edam service is 24/7.
The once-a-week service is next door.""",114,16,1,131,645,4714
This house is going to be a knockout!,115,14,2,131,645,6325
It's a great deal because its one room is too small for an elephant.,134,17,2,153,645,3074
"This is our border wall to avoid big elephants and their family entering America.
Please let me see your documents.",110,11,3,124,645,3909
It may be time to visit your neighbor with the steeple.,109,13,2,124,645,4022
The Browns have to navigate the wishing well to stow their station wagon. You really must ‘be the ball.’,101,16,0,117,645,3188
I don't know. The last house looked  a little wobbly when the ball came through.,102,14,1,117,645,5371
If  you’re into breadmaking this is the place.,123,13,3,139,645,2654
"If you're interested, you better act now, or the ball will get blocked.",115,16,1,132,645,509
No windows?  For the natural air-conditioning.,116,14,2,132,645,2450
"Great views, always a breeze, and with your own planks business from the clergy...",97,11,2,110,645,2533
It's actually a trap to catch elephants.,116,14,2,132,645,3878
It's a compromise between the Koch brothers and the environmentalist,116,14,2,132,645,6815
Last Available. Resale Formerly Gulliver’s Miniture Golf  9th,129,16,2,147,645,5215
"Sir, we asked for a house with a child safe door not one that will knock them out!!!",109,15,1,125,645,1510
"Yeah, I live in fantasy land. What's your excuse?",111,11,3,125,645,2683
Our favorite control app is Windmill See-Saw Ladder (Free from La Mancha).”,110,13,2,125,645,4010
It’s gonna be a great deal. You are buying from Toys “R” Us!,109,15,1,125,645,6549
"We get an occasional golf ball in these parts. No windmill, no insurance.",122,17,1,140,645,1385
You know that scene from Raiders of the Lost Ark?,123,15,2,140,645,2551
"The elephant is out of the room, roaming the neighborhood, and will most likely be haunting your dreams.",135,19,1,155,645,7501
It's great for kids who also can Double Dutch.,116,16,1,133,645,2532
"Yes, this is a perfect location for your putt  putt golf.  The church is all for it !",130,16,2,148,645,2529
"Okay, the previous owner had a thing going on with ""Mini - Putt""; but look Lady, I don't build them, I just sell them!",97,13,1,111,645,2740
It comes with a lifetime supply of salt-water taffy.,100,7,4,111,645,7438
"That's right.  Just cut a hole out, then slice it sideways.  Did you remember the lox?""

Oh, no, this was the caption for the pulling the sword out cartoon.
I should have won",113,9,4,126,645,3634
"When clouds look more like a jet,this thing gets...well...let's just say, don't walk around the corner.",111,13,2,126,645,4209
"This sequence starts with a slide down the trunk of the white elephant, then through the church and out the door, over the wall and dash toward the dark spot. Time it right and you get a ride on the sail which deposits you at the door.",110,15,1,126,645,7016
And it provides all the cardio-vascular exercise any adult needs!,123,17,1,141,645,927
"I mean, OF COURSE giants hate mini-golf, but Krazy Karl's loss is your gain!",103,16,0,119,645,343
After the Zuiderzee was pumped out this little gem became available but you need to act fast. A mini golf  corp is after it,104,14,1,119,645,925
"Yah, so, definitely time your strolls on the lawn in a consistent fashion.  These suckers can leave quite a bruise, I tell ya!",105,12,2,119,645,1815
The previous owners (seller's?) inherited a lovely Classic 6 in a shoe.,105,12,2,119,645,5779
"...and this neighbourhood, has a giant-ball-nuisance-ordinance in place...",116,18,0,134,645,1640
Let's face facts. You 'll never get a better hole with a low fatality chance like this!,117,16,1,134,645,2244
I chose this neighborhood because I know you like dodgeball.,117,16,1,134,645,3837
It might be giant,119,12,3,134,645,4308
"Sorry, you will have to get the gas lines separately.",117,16,1,134,645,5475
It's a mini golf course community - the most bang for your buck!,118,14,2,134,645,6668
"It's two-part security, the wheel and the ball!",86,9,2,97,645,1827
I'm sorry Mr. and Mrs. Robinson this is all you can afford. After the film version of 'Downsizing' was released the tiny housing market became extremely competitive.,99,11,2,112,645,6379
"Look at the bright side.  When the previous owner'was killed by a misguided golf ball, the asking price came down and is now well within your budget.",111,15,1,127,645,2153
... and an elephant is very friendly,111,15,1,127,645,2210
The prior owner was a big shot in the miniature golf course industry.,110,17,0,127,645,2648
"No, no problem with Spanish Knights so far. And the Elephant, I am told, is harmless.",110,17,0,127,645,2696
"Mr Happy Gilmore, here is your happy place.  It comes with a retractable death trap, a Bob Barker dog potty spot and remote controlled windmill thingy to block out unwanted guests.",112,13,2,127,645,4212
"Revend, our marriage has been like a windmill.""",112,13,2,127,645,4301
We’ve taken the elephant out of the living room,112,13,2,127,645,4874
I just checked. There's no big elephant in the room... and even in this eco-friendly town!,113,11,3,127,645,5068
I have a reasonable dung remediation guy.,113,11,3,127,645,5833
The minor loss of one panel makes this unique home a steal!,112,13,2,127,645,6106
The Beanstalk League has all its tournaments here!,112,13,2,127,645,6153
"Wall to ceiling windows,
no central air, heating optional.",111,15,1,127,645,6932
"OK, the drawback is that it is drafty; but the big plus is having  
wi fi.",124,17,1,142,645,4174
"The elephant in the room""",104,16,0,120,645,317
"Loving here is a lot of fun, but just don't talk about the elephant in the room.",105,14,1,120,645,528
They ran out of cookie dough.,106,12,2,120,645,2163
"Our neighborhood has the hottest golf course around, especially with that elephant in the backround.",107,10,3,120,645,3591
Storm windows will be extra.,105,14,1,120,645,4387
"'I assure you, only our prices are crazy'",120,12,3,135,645,4932
Either we've shrunk or it's life-size.,117,18,0,135,645,6100
"Good news is, windows and doors arrive Friday""",105,14,1,120,645,6240
I promise - the elephant cloud in the distance is NOT the spirit of Don Quixote....,105,14,1,120,645,6378
I'm sorry. We decided that tourists just don't tilt well enough.,120,12,3,135,645,7246
"It may be a bit small, but it's in perfect condition.",125,17,1,143,645,4057
"I know you are religious, so I picked one with a hole-y yard",98,15,0,113,645,4641
Hairdresser services are complimentary during windy days!,118,18,0,136,645,6089
Oh it's perfectly safe. Don't believe those silly rumors aab,106,14,1,121,645,1208
It’s prime real estate.,107,12,2,121,645,3510
Duck! It’s going to hit your head!,114,13,2,129,645,2161
It's a giant cheese grater. You have to take care not to get in the way of the blades..,113,15,1,129,645,6745
"Yes, it's gingerbread but I thought the picket fence would blow you away.",114,13,2,129,645,7436
Its a church elephant.,100,13,1,114,645,1446
"so it's a 0 bathroom but there are a bunch of holes in the ground.... rustic, am i right?",100,13,1,114,645,6191
This new downsizing is really expanding the available market.,120,16,1,137,645,196
"Yes, this is the place where Bart was born.",120,16,1,137,645,2281
God has a big hashtag.,121,14,2,137,645,4982
Beware of the windmills on my mind.,123,10,4,137,645,5761
Doors no!,108,12,2,122,645,4195
Does it come with earplugs,108,12,2,122,645,4954
"Unfortunately, you're only allowed to plant a garden in a neighboring yard.",113,17,0,130,645,32
This one is putt-friendly.,114,15,1,130,645,291
"Other than the nonstop golf ball traffic throughout the day, this place is a steal!",116,11,3,130,645,2186
It's literally a white elephant sale.,115,13,2,130,645,3905
I bet not every mill you've looked at comes with such a prominent hole.,122,14,2,138,645,1907
This house is a hard hit!,121,16,1,138,645,3054
"Truly unique, and the landlords concession is last month rent free!",101,13,1,115,645,5583
"After his Divorce, Tiger Woods had to downsize but following his comeback, he has put=put  this property on the market",108,14,1,123,645,619
It’s as distasteful as the Christopher Buckley ‘Shouts and Murmurs’  piece found earlier in this edition of The New Yorker.  There’s cute and then there’s sick.  Writers should be sober when they submit their work; so should editors.,111,8,4,123,645,1164
Get ready to duck.  Donald's in a bad mood.,108,14,1,123,645,1239
The plus-sized model comes out next month.,109,12,2,123,645,1786
Can’t you just imagine the infinity pool with a beautiful view of the Ant Hill?”,109,12,2,123,645,2387
It’s the fence mill house and it is energy efficient!,108,14,1,123,645,3514
Billy Baroo used to live here.,109,12,2,123,645,6551
So what do you say? I can set you folks up with a five-year plan.,115,15,1,131,645,3724
"You’ve addressed the elephant in the room, but what about the one outside?",117,11,3,131,645,5119
The elephant sometimes uses it for golf,114,17,0,131,645,5361
"Ballpark, $2k a month, but it's hole in one in this neighborhood.",114,17,0,131,645,6708
You won't believe the views.,98,6,4,108,645,5136
"The building is so secure, only a magician could pass thru.",124,12,3,139,645,5453
we think it was his index finger.,102,13,1,116,645,1048
Just your average house. Looking to buy?,101,15,0,116,645,3027
And I'm sure you'll love the neighborhood.  Any questions?,130,15,2,147,645,7238
"Really, all the neighbors say the balls rolling about are a great source of inspiration and respite. Never had anyone with even a scratch.  99% are holes in one. I swear.",110,12,2,124,645,2738
And it's a beautiful house with retro picket fences!,109,14,1,124,645,4832
Now you can see your expectations are unreasonable.,108,16,0,124,645,4970
"Thank you for agreeing to meet me here, now I'll tell you the information I promised to divulge, we do not live on a spinning ball.",108,16,0,124,645,6042
"No sir, property insurance does not come with the house",115,17,0,132,645,590
"This is the “Mariah” model, and the tax credit incentives are fantastic!",116,15,1,132,645,4410
"You've kept your nose to the grindstone,eh?",116,15,1,132,645,6452
Shhhhh…Be quiet！We must be able to catch this foggy elephant and lock it under the windmill！,126,10,4,140,645,314
It was previously own by a Holland old lady who never let shoes be worn inside.,130,17,1,148,645,3266
"So you are a myspace-influencer,  your wife draws imaginary elephants in backyards and your budget is two million dollars?""",102,15,0,117,645,107
"Sorry ma'am, we are not liable for death by golf ball",102,15,0,117,645,1498
Doors and windows are extra.,110,14,1,125,645,3476
I call it big-ature golf!,111,12,2,125,645,7044
Did they tell you that our miniature golf course is much more exciting because we shrink you to the size of the course?,125,14,2,141,645,795
I also have corn holes available.,124,16,1,141,645,5664
"If we play this one right, we can score a hole-in-one price for this pre-war charmer.",105,11,2,118,645,250
It's free real estate.,106,9,3,118,645,303
"Most people spend their retirement playing mini golf, so might as well make a retirement home here, am I right?",103,15,0,118,645,1096
You’re a two-time National Putt-Putt champ.  This is a piece of cake,112,12,2,126,645,1881
The odds are in your favor if you bid now.,110,16,0,126,645,2484
"Since you wanted a golf course and a house, we decided to put e’m together 

Don’t worry, only about 1000 people have gotten injured. BUT this house comes with insurance.",113,10,3,126,645,3683
...and you’re in the catchment area for Krazy Putt High,112,12,2,126,645,5488
You have nothing to worry about. No drives here.,111,14,1,126,645,6729
...what's really ironic is that the elephant is still invisible.,114,8,4,126,645,6950
An elephant in the room is the elephant in the backyard.,119,13,2,134,645,2241
...and the elephant will simply *change your life*!,120,11,3,134,645,2475
"....and this is where we make the ""Elephant Oatmeal.""",119,13,2,134,645,2504
"Dolores, what’s your relationship to carrots?",119,13,2,134,645,4327
I think your golf Club isn't big enought for our hole.,119,13,2,134,645,7405
"This one will go fast - it's in a good school district and the 
hole is in front of the door.",91,11,1,103,645,2907
Is there an option to check in and never leave?,105,13,1,119,645,21
"And this is what makes the location - Location, Location!",112,14,1,127,645,403
It's true a few swings will cure it!,113,12,2,127,645,7249
110010 11111001001010101001 010101,121,11,3,135,645,949
"We like it, but is there any chance we can put green over that hole?",120,13,2,135,645,3882
"The owner? Apparently, he was some crazy guy fighting imaginary enemies, morphing into an alienated creature, terrified of seeing the letter “A” in red, and stuck in some rabbit hole seeking advice from a cat in another land.",119,15,1,135,645,4797
"The seller is an avid miniature golf enthusiast.                                     
  Frank Buckley Andover, MA",126,16,1,143,645,166
That's a lovely purse. Is it able to hold everything you need?,130,8,5,143,645,6702
We like to make sure our visitors have a positive experience.,133,17,1,151,645,4234
"Property value has been circular, but I've got a good feeling about this one.",106,13,1,120,645,3055
And you can’t get hit by an errant drive. It’s a wonderful location!,106,13,1,120,645,4227
"It can get a little drafty, but in this neighborhood you sometimes need  unusual protection.",121,13,2,136,645,5042
"Getting hit by the windmill and jumping over the balls aside, it's a prime piece of NYC real estate.",91,13,0,104,645,5325
"Yes, it's expensive, but what do you expect it's the windmill lot.",120,15,1,136,645,5943
"It's a two-for-one, a place to stay and to practice your putting.",112,16,0,128,645,6123
"At 2/3rd scale, you get more house for your money.",107,11,2,120,645,6807
"Well, if you adopt a Republican bastard, the elephant in the room will be yours. It is all Trompt by a revolving picket fence. If you think outside the plot, you can have a snake in every pot. When you're under wHatter, jump down the obit hole.""",114,12,2,128,645,6983
"I assure you, nobody will ever find the bodies here.",121,13,2,136,645,7311
It's a great neighborhood if you can handle periodic earthquakes.,131,10,4,145,645,247
"And if you retire here, you can literally on the golf course!",121,15,1,137,645,6284
Listen you putz. I brought you here because it suits you.,114,14,1,129,645,2474
"The elephant hologram distracts them and they fall into the hole ... horse, armor, lance and all.",115,12,2,129,645,5076
Look at this you will be sweeper off your feet,115,12,2,129,645,5096
"And during the slow season, the hole out front doubles as your garbage disposal...",115,12,2,129,645,6870
"Giant putter delivered upon sale.""",108,11,2,121,645,1213
...and its right by the golf course and your timing's perfect.,108,11,2,121,645,6054
"Forgive me, but didn’t you say you wanted to see a small-sized golf club?",101,10,2,113,645,3585
"...also, Chip and  Joanna Gaines have agreed to do the renovation!",102,8,3,113,645,4651
"That hole by your front door makes it a fixer upper, but I can get you a heckuva deal if you're a little short!",92,13,0,105,645,3110
My critics say that I’m my father’s daughter and my husband’s wife.,130,14,2,146,645,7088
"Once we realized that the technology didn't work, we changed it to a church.",123,13,2,138,645,1866
"You won""t have a problem with noise, it only runs if 
it""s windy...",122,15,1,138,645,5823
you have to understand that the interior has been completely renovated and has all the latest amenities,122,15,1,138,645,7124
I know this process can be frustrating.,118,8,4,130,645,3787
"In fact, you can go balls to the walls puttering around with this one.",115,14,1,130,645,4181
"And of course, it has a sump pump.",116,12,2,130,645,7183
Don’t think “elephant.”,109,11,2,122,645,4691
"Power salesman, couple and house",94,11,1,106,645,7400
"And you can keep any ball that doesn't get through. Be careful, though --they had to hire a plumber to get Gibson out.",125,11,3,139,645,4
There's no elephant in the room.  You can run into the house every five seconds and think of the exercise and the savings in electricity.,119,8,4,131,645,5780
And Starbucks is just around the corner.,118,10,3,131,645,5876
"Well, Scott, you said your dream was to live on the eighteenth floor.",117,12,2,131,645,6535
"''It's the same technology they used in that 2017 Matt Damon documentary.''

''Downsizing?''

''Yeah, that's the one.''",108,15,0,123,645,467
"Yup, they say this is far more effective than those Insomnia pills you tried",108,15,0,123,645,723
"Elephant, kids, I get it.",108,15,0,123,645,3711
During the day it’s a putting green.,109,13,1,123,645,6400
This is what we meant when we said your house would arrive in a box.,104,8,3,115,645,3784
We at PGA Investment Bank always seal the deal on the 18th green before the celebbratory drink at the 19th hole,124,15,1,140,645,5783
"Oh my!!!!
This would be a perfect place for our baby boy Frankie to play. Absolutely no playing with matches aloud.",123,17,0,140,645,7562
It's not quite a koi pond. Remember Indiana Jones...?,116,16,0,132,645,4416
Welcome to BROBDIGNAG C.C. Hope you brought your clubs!,118,12,2,132,645,4966
The current owner guarantees you a dry basement.,118,12,2,132,645,5374
"Not only will it scare any elephant away, it'll generate electricity",119,10,3,132,645,7527
"I'm telling you folks, Putt-Putt is big here.",112,9,3,124,645,1379
You'll be perfect for our new reality show.,111,11,2,124,645,4860
Boy a botch job,133,14,2,149,645,190
What kind of balls do elephants use for mini putt putt?,133,14,2,149,645,4452
"Please correct the spelling of ""stollen"" in the ""final three"" contest - it's ""stolen"" - thank you",104,10,2,116,645,879
Political shadows fenced clean energy loopholes,103,12,1,116,645,1622
Locke and Amour security shields you from the tiger in the woods,126,13,2,141,645,4999
Comes with all 3000 square feet of real estate!,120,10,3,133,645,473
I  wonder how Dutch make their windmills appear festive enough for Christmas!,117,16,0,133,645,3049
You expressed an interest in flour-power?,121,8,4,133,645,4131
I'm seeing a slight break in the foundation.,117,16,0,133,645,4751
"Yep, this will be a slam dunk, or a touchdown if that’s more your sport.",118,14,1,133,645,5839
We will make a line of these and call it a wall,118,14,1,133,645,6385
"Living on a putt-putt course has some downsides; you'll need to watch your step to avoid the cup and watch for dimpled, flying  projectiles.",111,13,1,125,645,791
"And to further entice you, we’ll throw in an extra blade.",111,13,1,125,645,3809
Hans Brinker's father built this home here to get fresh water from the damned lake!,135,12,3,150,645,4460
The previous owners were Chinese...,110,15,0,125,645,4601
"Well, yes, it does happen occasionally, 
but a ball out of bounds on this course is enormously rare thing.",112,11,2,125,645,5438
You think he’s still in the sand trap?,104,12,1,117,645,1001
It has gas forced heating and AC. But I think that can be easily updated,105,10,2,117,645,1426
Look left before you step out and you will never get sliced up like an egg.,119,14,1,134,645,6346
There wasn't room to store them in the garage,119,14,1,134,645,7401
A side benefit of this property is its amazing capacity to disperse  the hot air emerging from your news feeds.,97,11,1,109,645,1231
Maxi-golf is included but we don't talk about a time-share exit plan.,97,11,1,109,645,5240
Believe it or not it sleeps 12,135,14,2,151,645,3614
its a vane,136,12,3,151,645,4972
"Before you sink a lot of money into this, consider putting down a smaller deposit.",111,15,0,126,645,684
"On the bright side, it's half off the closing cost.",111,15,0,126,645,1800
We built these quaint wind-farm homes to last until we can bring in electricity in a few years.  You really can't go wrong.,112,13,1,126,645,2894
Just wait for it to be over - the chance to enter the property market will be back in a few.,111,15,0,126,645,3115
"If you would like, I can ask the current tenants to move out a bit earlier.",113,11,2,126,645,4667
"Not to worry, it's a ghost. The original owner was a big game hunter.",126,17,0,143,645,4919
Thirty year mortgage with a dike thumb ten year commitment.,127,15,1,143,645,5434
"If your gluten-free, this might not be your place",120,14,1,135,645,2789
"all the people that comes here are fans of the church""",113,13,1,127,645,4249
It comes with a can of   3 in 1 oil._,115,9,3,127,645,6354
"In the postmodern era, these windmills briefly returned to an inanimate state...",114,11,2,127,645,6574
"Welcome to MIGO!
Live, Work, and be Played",114,11,2,127,645,7338
It really is THE new state-of-the-art rustic wind turbine that will complement the new RH catalogue.,121,14,1,136,645,755
I think you'll get a real kick out of this place.,91,10,1,102,645,770
"Disney, shmisney, Brexitland  means the Dutch and other eurosynics will flock to our UK Playland",122,12,2,136,645,2199
This house is a cut above the rest.,122,12,2,136,645,3139
Your elephant trap is not big enough,121,14,1,136,645,7117
This house lets you finally figure out how to make a million dollars in the real estate business. You start out with two million.,116,9,3,128,645,419
"So, are you interested in becoming the world's first human golf balls?",113,15,0,128,645,3080
'It's called Windmill Lite.',113,15,0,128,645,3390
...and if you act fast Mr. Bunyan says he will throw in his golf balls and clubs.,113,15,0,128,645,4959
So glad you could make it! The elephant got too big for this place... just be careful when going in. It's windy.,115,11,2,128,645,5154
This is the opposite of a miniature golf course!,122,14,1,137,645,2046
- The previous owner was a hockey enthusiast.,124,10,3,137,645,6281
Destiny called.,106,14,0,120,645,4907
Its energy you don't have to fight!,116,11,2,129,645,218
"Sure, it's a bit pricey, but you could sell tour tickets to tourists.",114,15,0,129,645,4547
"It's the perfect house for swingers.  -Stephen Rock Raphaelson West, Laurel, Maryland",117,9,3,129,645,7355
"This property is a little above your price range, but I think the view is worth the extra $30k.",124,12,2,138,645,5530
site of season #11 America's Next Top Model photoshoot,122,16,0,138,645,7498
At this price you expected a Jacuzzi?,108,12,1,121,645,743
We generate our own power for BINGO Nite!,107,14,0,121,645,6599
The gates are extra,134,9,4,147,645,7097
It's the home of your dreams. Without the 'Naked on stage' bit,138,18,0,156,645,1353
Veg-o-magic was already used.,117,11,2,130,645,2822
Y<o8 can grind your own wheat and keep any golfballs that stay inside the house.,124,14,1,139,645,1699
"I won’t lie, this mini golf windmill is the home of our dreams but I checked the neighborhood demographics so... gonna have to withdraw the offer.",133,13,2,148,645,6124
After the stock market crashed I got par.,110,10,2,122,645,1708
We are waiting to canvas the result.,109,12,1,122,645,4276
"This next piece is called, “Eine Kleine Knockout Musik.”",108,14,0,122,645,4600
Adult version,111,8,3,122,645,5343
"Maybe you own the air rights, but NO naming rights -- especially ""Satine's Hole-in-One,"" much less in neon.",110,10,2,122,645,6391
"Sure, there are lots of kids, but with these fences, imagine the neighbors!",116,15,0,131,645,1450
"I know you think this new church will be sanctified,but not until you figure out how to make a crucifix look right",119,9,3,131,645,2270
In this neighborhood home is always in your mind.,117,13,1,131,645,2803
"Now remember... If you give them what they're asking for, don't expect to ever get it back.",125,14,1,140,645,5976
The latest trend...contemporary windmill picket fence.,133,15,1,149,645,6748
"I know it looks old-fashioned, but it really works. And for an extra $500 we can install a golf hole!",101,13,0,114,645,294
They dont make 'em like they used to.,101,13,0,114,645,667
That is a very long climb to get grass.,102,11,1,114,645,733
Plus it makes elephant clouds to order,142,14,2,158,645,6629
"Wood and wind are forever...well, wind will be around for a while.  Gets stronger, day by day...",110,12,1,123,645,579
Let’s Ro-Sham-Bo,111,10,2,123,645,4827
I'm not a fan of the elephant in the room.,110,12,1,123,645,6230
No putting allowed on the property,117,15,0,132,645,5781
And if you’re seri,119,11,2,132,645,6295
Ever seen Indiana Jones? kind of like that. Just make sure it doesn,102,13,0,115,645,6527
You should consider installing a pair of reinforced doors.,110,14,0,124,645,2287
You've got to get in on the ground floor with our newest time-share offering.,111,12,1,124,645,3249
Living here will definitely improve your golf game.,112,10,2,124,645,4251
You're looking a golf ball?,118,15,0,133,645,4554
I'm sorry to inform you that your son has been expelled. He's just spinning out of control.,121,9,3,133,645,7139
Price has just been reduced to half off.,113,10,2,125,645,5242
"I love mini-putt,but perhaps that's small on my part?",112,12,1,125,645,5324
"It's Southampton sized, but fun for the average family.",112,12,1,125,645,7136
"This windmill house is top-notch real estate!""
""Oh, yes. I love plastic grass, a giant hole in the front yard, and the occasional giant florescent-colored golf ball in my living room. We'll take it.",120,13,1,134,645,4594
But didn’t you say you wanted to mend fences with the mean neighbors?,128,14,1,143,645,6258
This house is free of charge!,113,12,1,126,645,198
The town might grant a tunneling permit.,120,15,0,135,645,4024
"And if you're ever feeling adventurous, you can Indiana Jones it in your own front foyer during business hours.",114,10,2,126,645,4877
I suggest you stop waffling and put in an offer.,90,7,2,99,645,5310
It's the same house but without the view from the anthill,113,12,1,126,645,6816
"For the ball never to be out of bounds at the church for tithers is a gimme, not a handicap.",122,13,1,136,645,3303
Beware the silent ricochet.,105,13,0,118,645,4396
MAM THIS IS LATEST DESIGN GUD VENTILATION AND SAFE FROM THIEVES,124,11,2,137,645,3717
And your dreams will be absolutely prismatic!,122,15,0,137,645,5784
Insurance pays triple in case of a dreidel.,115,12,1,128,645,2112
The elephant will be here shortly to turn the turn the blades.,115,12,1,128,645,2428
IT'S PERFECT FOR BACKERY AND ALSO  NO AC NEEDED,114,14,0,128,645,5644
whose ladder is this?,114,14,0,128,645,5998
Your uncle left this property to you. Now the IRS owns you! Dutch treat!,107,11,1,119,645,2255
This used to belong to nazis but we managed to disguise it quite well,106,13,0,119,645,7336
You want WHAT!???,123,15,0,138,645,2114
It's our home in one fixer upper!,123,15,0,138,645,5213
"It doesn’t come with the pool you wanted, but it is haunted by Van Gogh’s severed left ear so perhaps worth a look.",123,15,0,138,645,6174
"Now remember, it is ""Fore!"" and not ""Four!""",115,14,0,129,645,1870
Hopefully the house doesn’t fall down the hole,117,10,2,129,645,4495
Only we guides know about such things. It's called a wind mill.,115,14,0,129,645,5619
They will take your offer of $8 million.,116,12,1,129,645,6967
"""Previous buyers have said the blades are the elephant in the room"".",108,11,1,120,645,7289
I think it's out of gas.,134,12,2,148,645,1833
This new house I’m about to show you is in the themed section of the amusement park neighborhood.,133,14,1,148,645,7067
"many would love this  Dutch home ""wooden shoe"" ?",127,9,3,139,645,3212
"So, where's your putter?",125,13,1,139,645,6847
get the elephant off your back and start living again.,117,12,1,130,645,2816
"Most homeowners are passive, gimme types. Here, you put your life on the line and tell your house, 'I'd die for you.' It's romantic.",110,9,2,121,645,5168
Once you get past the hole in the ground and the outline of an elephant in the right hand corner it's actually par for the course,100,12,0,112,645,2486
"YES, THIS IS WHERE DR. FRANKENSTEIN AND HIS MONSTER PERISHED, BUT WE'D RATHER NOT MENTION IT---",100,12,0,112,645,3664
Welcome to Reverse Pee Wee Golf,119,10,2,131,645,2111
From the second floor you,117,14,0,131,645,7004
"And thats how I found her hole, in one. Now if you’d step this way to the kitchen.",118,12,1,131,645,7239
"One thausend sben in a day gust to give you , The wavel you ask for",119,10,2,131,645,7294
Couple to Realtor - “This house is put put perfect for us! We want to make an offer!”,110,11,1,122,645,2016
London bridges sure fell down.,109,13,0,122,645,3449
"Whereas, if you get married in a windmill, the electricity in your relationship will last well into your eighties and beyond.",110,11,1,122,645,6709
There’s 3 offers on the place. 2 FHA and 1 all cash.,103,8,2,113,645,3440
"As I understand it, the previous owner had a timing issue
Ok on my count of 3 we make dash in to see the renovations.
Entertainment in this back yard? I don’t you’ll have a ball!",103,8,2,113,645,4021
Your bungalow at Trump Putt-Putt comes with free NDA!,119,12,1,132,645,3730
"Unfortunately, your lottery winnings of one million do not cover the purchase of homes with inappropriately fitting shutters",93,11,0,104,645,4505
...and the yard has a deep hot tub.,110,13,0,123,645,3029
The previous owner was a linebacker.,111,11,1,123,645,3251
"hey listen, if we dont jump in that hole that giant elephan will murder us all",113,7,3,123,645,3720
"Don, why did you bring us here?  No, selling windmills is really not an improvement on fighting them.  And no, this one is not giant on the inside.",122,8,3,133,645,3036
"The HVAC may need some updating, but if he was a tremendous",120,12,1,133,645,3824
Windmills b turnin,112,11,1,124,645,977
"And as an extra bonus, if you buy today, one year free oil will keep the squeaks to a minimum.",113,9,2,124,645,1127
Before they invented screens,112,11,1,124,645,4953
The 8th hole is in Miami. The 9th hole is in Dallas. The 19th hole is in Toronto. They have great drinks.,121,12,1,134,645,381
The DWP takes full responsibility. Your bill will reflect these changes.,120,14,0,134,645,5116
He’s having trouble weaning!!,122,10,2,134,645,5548
"This house is a hole-in-one! Haha... Anyway, you’ll be living next to a sex offender.",121,12,1,134,645,6050
The architect was having a bad day.,133,7,4,144,645,3480
It's the latest spin on a home protection border wall that allows you quick access between migrant caravans.,129,15,0,144,645,3667
And there is no cost for electricity when the elephant disappears.,114,9,2,125,645,1283
You'll also have your very own elephant mouse.,112,13,0,125,645,2670
It's more efficient than saying 'You're fired!',113,11,1,125,645,2784
"And here we have, “Tom Sawyer enlists a Dutch boy”.",130,15,0,145,645,4316
"This is the best house on the course, not the first - so, no amateurs - not the last - so, not frustrated husbands!",105,10,1,116,645,6697
Don’t quit the church....Wind mill you realize we are spending your tithe wisely?,132,11,2,145,645,7106
Join us. We believe God's blowin' in the wind.,113,13,0,126,645,1454
Buy now. It is more than worthy later.,113,13,0,126,645,2081
We frown on pets but maybe if we can throw him through that black hole.,124,10,2,136,645,4847
Congratulations. Please check the doppler report for move-in information.,107,8,2,117,645,1794
Windmill blades? Not at all. You're imagining them - like you did that elephant in the bathtub.,105,12,0,117,645,4952
"I always advise newlyweds starting life's journey: ""A well-timed prayer will get you through the rough patches.""",114,13,0,127,645,2249
"Relatively private. Only if they have a platinum pass do they get to come in.""",115,11,1,127,645,6575
You should both get checked.,125,10,2,137,645,1253
You need your passport to enter the house.,123,14,0,137,645,4888
It's not too disturbing.  It only works in a hurricane.,124,12,1,137,645,6367
"Frank, timing is everything during this hot buyers market...lead me to the front door and I'll give you a visual!",97,11,0,108,645,3404
Its called the Grandparents Special,107,10,1,118,645,498
"I know it sounds strange, but the prior owners complained of being visited by a smoke elephant so they put the place up for sale.",107,10,1,118,645,3451
Includes all your adult inhibitions at no extra cost.,108,8,2,118,645,4967
"Don't worry, the giant windmill attached to the front of your home should protect you.",108,8,2,118,645,6211
"Where the elephant passes, one knows.",117,9,2,128,645,1625
Think of it this way. You can open a mini-golf  range for extra money.,115,13,0,128,645,3156
"If you do decide to make the move up the property ladder, you’ll be able to ride the property helter-skelter afterwards.",115,13,0,128,645,4080
Thanks for meeting me back here. Cum is a great alternative fuel source if you consider my mouth a vehicle.,127,8,3,138,645,52
"Rest assure, this windmill is not a monster.",124,14,0,138,645,2144
This is our ivory model.’,134,13,1,148,645,4067
And we’re calling this section....GIGANTIC golf.,109,8,2,119,645,841
J,117,11,1,129,645,470
"When I said I wanted to live in a place where I can practice getting it in the hole daily, this is not what I meant.",119,7,3,129,645,2854
"He is the top windmill shutter architect


Linda Goldman",127,12,1,140,645,2248
You told me you were looking to downside.,118,11,1,130,645,2585
I have a proposition for you that involves your wife.,120,7,3,130,645,4106
I can get you a discount on the runof plug!,126,14,0,140,645,5043
The underwriters said you must get rid of that hole in your lawn.,129,10,2,141,645,6876
Or you can just spring for the in-app purchase.,119,11,1,131,645,3000
"Functional is the rage. Here's a functional penthouse. And if you act quickly, it could be yours.",100,11,0,111,645,2193
"And, of course, you don't have to floss.",129,12,1,142,645,5999
"Are you too good for this home?""-Happy Gilmore, Real Estate Agen",129,12,1,142,645,6256
"So we agree, I got a birdie and you've got dyslexia?",129,12,1,142,645,6539
"Nice house in the green, but be careful of strokes.",120,11,1,132,645,3925
And... you can see the Rhine if you tilt~,121,9,2,132,645,7345
The only downside is that you have to watch out for erratic golf balls,111,10,1,122,645,1889
"No really, go ahead. So what if you're not as fly as Snoop Dog? You're timing's impeccable.",122,9,2,133,645,2952
But it breaks even after two years!,111,12,0,123,645,2806
Do air conditioners go with the deal?,104,7,2,113,645,4996
"This is fine, the solar panels will be here shortly. Ekkkkkk",130,14,0,144,645,6750
"For $20, I'll let you whitewash my picket fence.",121,13,0,134,645,882
He’s 6 months.,122,11,1,134,645,2280
"Ah, I see. You have it set to M for mini when you should have it set to W for wombo.",123,9,2,134,645,2497
Lake George is noisy,121,13,0,134,645,6182
I misunderstood - it's Sales you want people to see how high up you are in.,114,8,2,124,645,6224
Just playing Some Put Put...,123,11,1,135,645,3261
You can queef for days in a place like this.,116,6,3,125,645,1263
A house divided against itself cannot stand,124,11,1,136,645,3538
"Scientist:"" We’ve discovered a gravitational swirl near the black hole in your front yard. It is elephant times more powerful than anything we know.""",115,10,1,126,645,5864
Fee-Fi-Fo-Fum.  It's the new Fore!,125,11,1,137,645,3301
The last homeowner pooped to death,124,13,0,137,645,4226
Let me punch out a tune for you all.,107,7,2,116,645,1196
"I'm sorry, but zero emmissions and rescue animals make good PR.",106,9,1,116,645,1728
"I know there are moles, but you can expect a Eighteen course meal from 9-7.",109,9,1,119,645,155
"Don’t look now, but there’s an elephant in town.",118,12,0,130,645,1250
And a beautiful view of The Donald's birdie from Mar-a-Lago!,121,8,2,131,645,58
"One bedroom, one bath, two-year lease.",119,12,0,131,645,6478
Goliath the Architect is a big fan of miniature golf!,112,7,2,121,645,2282
It’s guaranteed “Tilt-Proof “!,100,10,0,110,645,2747
Armchairs or at a push a small a two seater,131,13,0,144,645,4003
It's God's way to say touché and that he will never fence you in.,121,12,0,133,645,1336
"This particular property was designed by Mr. Wood's older brother, Puma.",112,9,1,122,645,1084
We used to have an HOA. Now we have a giant elephant.,132,13,0,145,645,6496
"Succ my dick, you dumb: cunt!",126,4,4,134,645,4480
Shit. Golf was always a white mans sport but I was never very good at it.,112,11,0,123,645,1787
And this house is available to you as a short sale.,114,7,2,123,645,2943
It's Christmas Morning. My girlfriend's in the kitchen doing stuff before we leave for her parents. I got some really good presents this year. An artist I like dropped an album and I'm listening to the start of it. I'm doing okay. Hope you are too.,104,6,2,112,645,5523
We encourage tourists to visit the windmills before the coffeeshops.,113,11,0,124,645,1106
"It sounds like we're paying you to own our property."" ""Correction. To SHARE our property.",114,9,1,124,645,1681
"I know your faith has been tested, but why don't you take another wack at it?",103,10,0,113,645,826
This prime piece of real estate comes with its very own ‘The Sunken Place’ for all those late night tee sessions.,104,8,1,113,645,1105
Fore!,135,11,1,147,645,3815
"Does the elephant come with it.
Patrick McGuire Waldorf MD",136,9,2,147,645,3957
shhh! if the manager sees us here he'll be pissed,115,9,1,125,645,2148
"Why yes!  --it does come with ""Rocinante"".  Except this one eats peanuts by the bushel.",116,7,2,125,645,2774
"The motion-activated windmill not only backs up the pheromone-scented hole, it bucks up the curb appeal.",115,9,1,125,645,4871
We can't offer you insurance on that kite.,105,8,1,114,645,1967
Tiny hands golf course.,126,10,1,137,645,6067
Boxing clusters.,116,9,1,126,645,898
You’d have to wait 20 minutes to get on the rollercoaster,115,11,0,126,645,1207
Fe Fi Fo Fum Golf opens in Palm Beach.,118,9,1,128,645,1807
The entrance is up through the ladder. Restrooms are down below.,118,9,1,128,645,3203
How dare you turn a zoo into a windmill?,117,11,0,128,645,7087
White power.,107,10,0,117,645,33
"Is he still out there?
That elephant killed my family and now he's after me!",108,8,1,117,645,4612
ultragolf rewards cocksure players above miniature,107,10,0,117,645,5125
"You don't say! Your son is in a Japanese diaper band? Right in this condo, he could mill his own vegan sprouted Manchurian tea mushrooms and share some artisanal jar Kombucha with his guests.",119,9,1,129,645,4517
Sure it has a whole in the wall  kitchen but the HOA fees are paid by others.,130,10,1,141,645,5639
Your energy bill will be charged monthly.,130,10,1,141,645,6534
"Sorry, sir but there may be a confusion. We asked for jumbo shrimp.",119,11,0,130,645,6669
"You had drained the shot, until some little boy plugged the hole with his finger.",120,11,0,131,645,203
We’re taking Jamaica off the grid.,110,10,0,120,645,493
"It's for rubber bowling balls, so it won't keep you up.",99,9,0,108,645,1793
We have a putt-putt special only for today that includes shipping. BUY ONE GET ONE FREE. They are endorsed by the President.,124,5,3,132,645,4379
It comes with a gum drop allowance so you can make it your own.,121,11,0,132,645,6800
"Maybe if we hide our business meeting here, behind this giant golf windmill, the rude ghost elephant won’t interrupt us this time.",100,7,1,108,645,7003
"As you know, the weather did tip-toe thru the tulips....the market is down.",132,12,0,144,645,7549
The previous owners were from China.,134,12,0,146,645,7343
You'll get used to the kids' tantrums.,123,11,0,134,645,2317
"Falling attendance on Sunday inspired this. After all, we're competing directly against the NFL.",124,9,1,134,645,2665
"Well, yeah, the people from the church next door DO keep climbing the wall and jumping into that hole. That's why we put the lower-case 'bob' there-- to try and trip a few.",113,10,0,123,645,0
Do you really  ...?,114,8,1,123,645,3570
It was a bargain at twenty trillion dollars,114,8,1,123,645,5249
"In addition to wind power, this house also has the capacity to generate snow power with this unique snow fence design.",127,7,2,136,645,6350
When you said this place was the whole package....,116,6,2,124,645,5696
The market has moved to just selling the its hazards.,127,9,1,137,645,6131
The feed-in tariffs make it a very attractive investment opportunity.,115,10,0,125,645,6572
"Honestly Mr. Brush, it sound a little far fetched.",128,9,1,138,645,2041
You want to go get him? I say we get him.,129,9,1,139,645,971
"The owner of this rental will maintain at all times one hole ready to ""resolve"" any accidents that might happen.",118,8,1,127,645,6881
Are you Big Ballers?,130,9,1,140,645,593
No Winds and Fouled Gears or Kiss Your Ass Goodbye!,119,8,1,128,645,980
"If that’s what you think, wait’ll you see 
my mini-me!",119,8,1,128,645,5887
"yes, we do, but not reception please",119,10,0,129,645,88
"It can be rented to basketball players for putt putt golf, and also provide power for your home.",120,8,1,129,645,4904
"This place would be great, but there are so many giants trying to hit balls at this place.",110,5,2,117,645,9
The owner kindly offers to include the two coveralls that hang next to the basement tunnel entrance.,108,9,0,117,645,4504
Where is the shmoo?,145,12,0,157,645,4846
"...but on the plus side, we have very strict zoning laws, and the home comes with a lifetime warranty.",133,11,0,144,645,5271
What kind of church is this? I hope that it’s under renovation cause otherwise we’re in trouble.,110,9,0,119,645,4069
"Price at one million but come with 5 Semper Augustus
Yayo Chinea Antioch Calif.",110,9,0,119,645,4544
"Remember, when you meet Mr. Panza, ask him for the appraisal",99,6,1,106,645,2252
"In Holland, elephants are too big to fit in a room.",123,10,0,133,645,5409
We have this well with a big white ball.. I think you're gonna like this house. Mr big hole with a white ball in it,112,7,1,120,645,1900
You couldn't want a better location.,111,9,0,120,645,7315
Not to worry. It's gone by FRIDAY! Homeland Security sees some promise.,126,6,2,134,645,6649
"''No,there aren't refunds for my concert.''",101,8,0,109,645,614
Congratulations!  You are now OFFICIALLY,116,5,2,123,645,4759
"In our downsized community, you can watch miniature golf if you avoid the putter hacks.""",127,10,0,137,645,2394
You didn't say we were buying a windmill. We thought we were buying a normal house.,116,7,1,124,645,146
We're running a bit early for this next showing.,117,5,2,124,645,3985
"It's a tough world out there.  Kids like ""bob"" over there just don't have what it takes.  Survival of the fittest you might say.",129,10,0,139,645,6587
"You can't just stand there, waiting for the elephant in the room to blow over!",118,9,0,127,645,780
"And for my next piece, Requiem for a heavyweight.

This is for the Dec. 17th issue.",123,7,1,131,645,368
"And, Dr. Frankenstein promised to stop by later.",110,6,1,117,645,6292
"What your husband and wife were doing right,   when the elephant attacked you could say ?",124,9,0,133,645,5996
"of course it's haunted. you want a three-story, two-bath windmill on the coast that ISN't haunted?? yeah, and i wanna be elvis freakin presley!

my mom died in this windmill, ya know. it's her ghost. never even thought to ask, huh? about my lonely ma",100,5,1,106,645,972
Have you seen my brother? We come from a descendant of golf balls.,115,6,1,122,645,1986
"We are weight watchers, the sails go round to max a fight-to-fright response.",116,4,2,122,645,2138
It'll be missed.,130,7,1,138,645,462
"Disregard the oil stain, all you need to know that Richard Colton created ' I Love New York'--yet milton glaser mere;y added the heart",129,9,0,138,645,3190
“The window unit conveys.”,117,8,0,125,645,184
A small loan of a million dollars will suffice.,120,6,1,127,645,471
Watch out for the giant gol balls.,135,7,1,143,645,3527
"We're so confident of our global warming creditials, Mr Noah, you could build a boat with our wood.",107,5,1,113,645,1694
pretend your on the worlds largest mini-put course,109,5,1,115,645,871
This is not a lot of hat air.,110,5,1,116,645,5274
"My client wishes to express his sincerest apologies. But you must admit, the baby does look a bit like a giant golf ball.",126,6,1,133,645,7377
"And any problems with elephant clouds wandering into the yard, the switch for the outside fan is in the cupboard under the stairs...",127,8,0,135,645,4202
"When we signed up for the “Foreign Correspondent” re-enactment, we thought Joel McCrea was leading the tour.",129,8,0,137,645,6392
I have a plugging proposition for you.,132,8,0,140,645,1669
g around.,117,7,0,124,645,1308
You ever notice reposado tequila smells better than it tastes?,119,7,0,126,645,6419
"Well, before you can go “Dutch”, you have to rob the Number 3 train going past Christopher.",122,7,0,129,645,1342
"Sorry for the delay, it took longer to clean up after the last Titlus squash the Adams.",122,7,0,129,645,2604
On the count of three step forward and you will be talking with the winds!,123,7,0,130,645,2232
"...Used to be a well. No incidence yet. Goes by Donta, she hates doors. Pretty Quiet Actually. No, I take this very seriously.",129,5,1,135,645,6490
"C’mon, you guys aren’t feelin’ this? One two three FOUR FIVE six seven eight NINE TEN eleven twelve! Doo-Doo do-do-do Doo-Doo do do-do-do do-do do DOO! Do do-do DOO! No? Daaaamn!",130,5,1,136,645,4064
Are you going to work to madame?,116,6,0,122,645,2724
So now we know  ...  miniature golf and midget housing are not compatible.,101,5,0,106,645,3422
You sure you want to joust this marriage thing when so many others have failed?,106,5,0,111,645,1088
The antique trunks department is in the back.,129,6,0,135,645,5188
Join our church for eclectic ideals . The red church around the corner is full of hot air.,127,5,0,132,645,216
If you don't sicced the first time?,119,4,0,123,645,6590
