caption,unfunny,somewhat_funny,funny,count,contest,target_id
This is the exact moment Susan realized she may be an accomplice and not a magician's assistant...,90,42,39,171,648,3368
"When I did this trick at my old accounting firm, they called it a felony.",88,50,34,172,648,3182
It's not magic. It's a Georgia ballot box.,98,40,37,175,648,3372
Here's a trick I learned from my lawyer.,95,53,29,177,648,1172
You folks may have seen this trick in the last Florida election.,92,44,30,166,648,2363
"And now, ladies and gentleman, I will turn my assistant into an accomplice.",90,39,28,157,648,2074
It's not obstruction if a magician does it.,87,50,22,159,648,3103
Watch as I transform this ordinary magician's assistant into an accomplice to a federal crime.,93,39,27,159,648,3108
I will now demonstrate the new Florida ballot box,102,52,26,180,648,110
And now for a trick I learned at the White House.,93,36,27,156,648,1612
And voila - a paper shredder has been transformed into perfectly functioning ballot box.,98,36,29,163,648,3972
"Relax, it's not obstruction if it's magic.",97,54,23,174,648,881
Now I'll try paper; I apologize about the rabbit.,115,39,33,187,648,1616
The monthly ritual at the New Yorker after receiving my caption contest submission.,98,32,29,159,648,3357
Watch while I attempt to assemble the IKEA furniture without the instructions!,80,41,19,140,648,800
Watch closely as I turn collusion into an illusion.,88,29,25,142,648,2132
The President says there’s not a ‘shred of evidence’ and yet ladies and gentlemen ‘here we are.’,97,40,25,162,648,64
"Ladies & Gentlemen, I call this one the ""Florida Ballot Box""",80,35,20,135,648,1652
I call this trick President Trump's suggestion box.,104,41,27,172,648,4049
"In DC, they call this trick the shred of decency.",94,35,25,154,648,105
And for my next trick I will provide a shred of evidence!,100,39,26,165,648,2865
"And now, I put my ballot in the Florida ballot box ...",101,46,24,171,648,3127
I learned this trick from a congressman in North Carolina,93,34,24,151,648,1408
"Ladies and gentlemen, here’s a little trick I learned while attending Trump University...",114,43,29,186,648,3119
"And now . . . due to new rules and regulations put forth by PETA . . . I will write the word ""rabbit"" on this piece of paper and make it disappear!!",110,35,30,175,648,3128
Well there goes the last shred of truth.,98,46,22,166,648,3175
And here's a little trick i learned from my accountant.,104,38,26,168,648,4203
"You know it's still in the cloud, right?",101,34,26,161,648,1297
"And last, your mother's string bean casserole recipe.",97,45,21,163,648,1885
People complained when I used rabbits.,85,34,18,137,648,1922
Next ballot please.,100,35,25,160,648,3988
This is how we vote in Georgia!,109,42,26,177,648,3499
It's jammed.  Must've been the rabbit.,116,39,29,184,648,2297
"Oh, a North Carolina ballot box.",116,42,26,184,648,3197
I don't get it. This trick kills at corporate events.,110,41,26,177,648,2239
See? The wand makes it feel less criminal.,102,50,20,172,648,2425
"It's magic: you put your ballot in here, and Republicans show up in Washington.",107,30,28,165,648,1723
And now for a trick I perfected while working in the White House.,91,37,20,148,648,1302
He better be good. Those are our Hamilton tickets.,113,33,29,175,648,310
My lawyer said if I shred it on stage we can call it artistic expression.,97,34,23,154,648,3864
Ask yourself--does this document spark joy?,94,23,25,142,648,4243
This shredder's been jamming since you made that cole slaw.,97,32,23,152,648,1635
We switched to paper after PETA called about the rabbits,106,39,21,166,648,4017
This is a classic trick that dates back to Watergate.,104,43,21,168,648,2632
Here's a classic trick I learned when I worked for the Trump administration.,105,47,20,172,648,1882
Of course your vote counts!,111,38,25,174,648,2183
I learned this trick when I was working at Enron.,123,46,25,194,648,3309
"It's a popular trick I learned in The White House... It's called,  'Permanent Redaction'",105,34,22,161,648,1543
Voila!  A shred of truth.,105,40,22,167,648,1771
"After I shred this subpoena, I'm going to pull a pardon out of my hat.",106,44,21,171,648,501
Allow me to demonstrate our new voting machines ~ just arrived from Moscow!,106,44,21,171,648,1979
Here's a little trick I learned at Trump Tower.,110,42,21,173,648,3009
And now... a little trick I learned at Trump University!,109,44,22,175,648,298
"And now, ladies and gentlemen, the translator's notes.",111,48,21,180,648,82
Ladies and gentlemen: how magic is used to count votes in North Carolina.”,102,33,23,158,648,210
"You're right,Sally. The magic is gone.",112,45,22,179,648,4129
Alabama voting booth,112,39,24,175,648,107
There's not a shred of evidence of collusion.,102,39,20,161,648,3383
Here's a trick I recently preformed at the White House..,101,31,23,155,648,2487
"Watch closely as I fix a North Carolina election, using only this common office appliance.",116,39,25,180,648,1632
Now you see it; Now it didn't happen.,106,42,20,168,648,3663
"This illusion was recently performed in Washington, D.C.",99,31,22,152,648,37
The real trick is going paperless,106,52,15,173,648,338
Now watch in amazement as I escape criminal liability!,106,43,20,169,648,3148
"And now, I'm going to amaze you with a little trick I learned when I was working at the Georgia Department of Voter Registration.",102,36,21,159,648,3527
I'm also available for birthday parties and cabinet meetings.,128,49,25,202,648,452
"It's called the Magic Southern States voting machine""",109,39,22,170,648,3023
Now I just say the magic words: Plausible deniability.,106,42,20,168,648,1798
And here goes my last shred of dignity.,112,44,21,177,648,4212
"Ta da!  And just like that, I've transformed Olga from assistant to accomplice!",110,36,23,169,648,3997
The White House Magician’s work is never done....,112,23,28,163,648,115
See what small hands can do: Constitution? What Constitution?,107,34,22,163,648,3492
The real magic is getting this thing not to jam.,97,50,12,159,648,3226
Anyone can make a live rabbit disappear. It's making the paper trail vanish that separates the amateurs from the pros.,95,45,15,155,648,479
"Now watch carefully, as before your very eyes I, The Sensational Trumpo, take this perfectly ordinary copy of the US Constitution ...",111,45,20,176,648,2076
Florida officially adopts the Banksy Ballot.,116,29,27,172,648,2448
I learned this trick while working for the Archdiocese of Boston.,108,36,22,166,648,2686
"I understand the shredder. But why the hat and wand, Mr. President?",104,32,22,158,648,1862
I learned this next trick while working at Enron...,95,44,15,154,648,86
At least this went down easier than the rabbit did.,118,36,25,179,648,258
For my next trick I'll need a volunteer and some scotch tape.,114,41,22,177,648,4076
This next trick I first saw performed as a government intern.,110,46,17,173,648,4177
"For this next trick, I will need a lawyer from the audience.",111,38,22,171,648,3853
We should probably just use the hat for the bunny.,124,47,23,194,648,3968
These are the facts. Now they aren't.,108,38,21,167,648,2328
"For my next trick, I'm going to demonstrate how the average American voting machine works.",106,30,23,159,648,1890
Another summons from a woman sawed in half.,111,37,22,170,648,3983
I learned this trick at the White House.,127,37,27,191,648,1087
"I’m pretty sure he said “shred the evidence,” but it could have been “there’s not a shred of evidence.”",110,36,22,168,648,1537
"It's what we accountants like to call ""magic"".",115,46,20,181,648,3078
Florida electronic voting machine.,107,24,25,156,648,623
"No, it's not tax fraud, it's magic.",114,39,22,175,648,101
"I saw the President do this trick once, with his tax returns.",97,38,17,152,648,2997
There goes the last shred of decency.,113,32,22,167,648,1905
"Yes, dear, I know. A real magician wouldn't have to plug this thing in.",100,37,18,155,648,1974
And now for the magic words: “HOCUS POTUS!”,113,37,22,172,648,3030
And let’s see what happens when we shred all sense of decency and compromise.,116,31,25,172,648,4151
And that's how we make votes disappear in Florida.,111,38,21,170,648,3080
Voting in Florida explained.,96,39,16,151,648,2215
Do not try this with a rabbit.,110,34,22,166,648,1577
"Now before I slice my lovely assistant Tiffany in half, I will do something really daring and shred her liability waiver.",116,42,21,179,648,4115
I would have never thought that our disappearing act would get us a gig at the White House.,115,44,20,179,648,4244
And now - the Trump defense.,108,29,23,160,648,2910
I learned this one when I was with the Trump Organization.,117,34,24,175,648,1539
"I tried this trick with a rabbit, but just once.",115,35,23,173,648,802
Abra cadabra... and the transcript of the meeting with Putin is gone.,101,37,18,156,648,426
It's my $1.4 Million check to Banksy,113,39,19,171,648,2666
No one charges Santini for drinks.,111,37,21,169,648,1348
Slightly less messy than with the rabbit.,108,43,18,169,648,4191
Due to the government shut down this cartoon has no caption.,109,35,21,165,648,565
"And now, I will magically double the value of this original work of art.",118,32,24,174,648,124
"Presto, the Florida vote is now counted!",115,37,22,174,648,3689
"But Mr. President, that's The Constitution.",120,35,24,179,648,775
"And for my next trick, a new election result!",105,39,18,162,648,1976
The real trick is making you wonder about the shredder instead of why Sheila isn’t wearing pants.,103,44,15,162,648,4245
"To honor our President, I will now shred the U.S. Constitution.""",119,33,23,175,648,167
"And for my next trick, I’ll unjam the copier.",110,43,18,171,648,1807
It's an old trick I learned from Richard Nixon.,120,45,19,184,648,1658
"Just slide your ballot into the machine and Presto!, Republicans win again!",98,28,17,143,648,2489
"And for my next trick, I will need some tape.",114,46,18,178,648,4089
"Ladies and Gentlemen! Now you see it, now you don't. The last shred of decency in the world.",101,32,19,152,648,2515
Due to  PETA protests I will now only make this picture of a rabbit disappear,104,41,16,161,648,149
Voila.  No collusion!,118,26,24,168,648,2732
"...and now, for my next trick, I will process the absentee ballots for North Carolina's 9th before your very eyes.",118,40,21,179,648,1274
I also work political parties.,113,47,17,177,648,3257
"Ah yes, I now realize my mistake with the rabbit.",111,30,21,162,648,327
I place the prenup into an ordinary Georgia ballot box . . .,111,25,24,160,648,2266
And now the magic words--PLAUSIBLE DENIABILITY!,110,44,17,171,648,157
"Before this job, I worked in voter registration.",113,40,18,171,648,3927
"And for my next trick, I will make all of these Florida ballots disappear.",117,47,18,182,648,2511
My next act I call Voter Suppression.,112,37,20,169,648,1191
"Not only will I restore this document to its original condition, it will also be heavily redacted.",109,44,16,169,648,2791
Abracadabra - and another absentee ballot is magically processed.,110,35,20,165,648,677
Tell the Rabbit Union this is what I think of their demands.,113,34,21,168,648,1582
And Presto! In three minutes I'm going to find I really needed this.,110,40,18,168,648,3830
"You're sure this is where I submit my absentee ballot?""",114,23,25,162,648,3034
And now I will turn a felony into a misdemeanor,115,52,15,182,648,1110
Georgia Democratic Voters! Step this way to cast your ballots in the midterm elections,117,48,17,182,648,3762
There’s nothing magical about it.  It’s the Republican recommendation for new ballot boxes in blue states.,122,35,23,180,648,1271
My lawyers hate this trick.,105,39,16,160,648,1684
Behold as I consider your request for Friday off.,106,50,13,169,648,914
Presto!  No collusion!,114,34,21,169,648,2348
"But, you'll need to be a real magician to get rid of the actual emails.",113,38,18,169,648,4097
"I am The Amazing Trumpini. First, I will shred the constitution. Then ... well, that's it.",121,34,23,178,648,227
Any now I will attempt to shred what's left of my dignity,116,45,17,178,648,901
This next trick is sponsored by Staples.,112,52,14,178,648,1564
When I used a rabbit kids were disturbed.,111,40,16,167,648,3730
"And for my next trick, observe how I can make democracy disappear with our new populist ballot box.",101,37,16,154,648,2922
"This isn't part of the show, I just needed this shredder to be a business expense.",106,41,16,163,648,2378
"Please do not attempt this at home, I am a highly trained White House note taker.",127,41,22,190,648,1370
"""Our new ballot box for blue precincts.",119,40,20,179,648,190
"I call this trick ""Avoiding Indictment""",112,45,16,173,648,1978
"As Joan watched Bert shred his Viagra prescription, she knew the magic was gone.",123,31,24,178,648,2175
The real trick is to empty it without getting little scraps all over the floor!,111,41,17,169,648,2537
"And just like that, I don't remember.",113,31,21,165,648,1983
I will now turn this piece of paper into many smaller pieces of paper.,104,35,17,156,648,3867
It's my no-collusion illusion.,101,30,16,147,648,1143
"And now, by order of President Trump, I make the Constitution disappear!",116,36,20,172,648,1747
And out comes Donald trump's tax return!,112,44,16,172,648,2296
"I must say it's an honor to join your legal team, Mr President",117,32,21,170,648,2480
And we would like to thank President Trump for volunteering the use of the Constitution.,111,29,21,161,648,2836
"For my next trick, I will jam the office shredder using a single sheet of paper!",114,36,18,168,648,857
And here's one of the many letters Carol and I received after last week's tragic performance with a rabbit!,115,43,17,175,648,1716
"Now you see their votes... 
Now you don't...",128,41,20,189,648,1377
One less tweet for mankind,105,46,13,164,648,4000
And for my next crime...,122,38,20,180,648,3667
"Now that I have written ‘Cheese’ on this piece of paper, I will, right before your eyes, turn it into shredded cheese.",101,37,15,153,648,2911
We put the Constitution in here...and voilà!,122,31,23,176,648,1743
The  Constitution: Now you see it; now you don't.,120,35,21,176,648,3723
So much for those translator´s notes.,112,37,18,167,648,2261
"And now Ladies and Gentlemen, a copy of the Mueller report should magically appear under your seat.",107,33,18,158,648,807
This can't go any worse than the bunny...,103,41,14,158,648,4160
"I call this next trick ""the Electoral College.""",104,36,16,156,648,3557
I learned this trick from interning at the White House.,108,40,15,163,648,3928
I usually handle workplace complaints with my magic wand... but I’ve found the shredder to be less finicky.,113,37,18,168,648,4186
I'm pretty sure it's not destroying evidence if you use magic.,118,38,19,175,648,2607
Now watch as I magically escape from liability.,113,48,14,175,648,4211
"And presto, there was no collusion.",101,36,15,152,648,1702
A ballot box that also shreds... what a brilliant idea!,123,39,20,182,648,2156
"For my next trick, I begin with this ordinary, everyday  United States Constitution...",109,31,19,159,648,25
"And now, the famous GOP trick, the disappearing absentee ballots!",110,29,20,159,648,2540
There's not a shred of magic in this trick.,123,50,16,189,648,2665
I came up with this routine when I was in the bookkeeping department at Enron.,110,40,16,166,648,2677
And voila! The truth has disappeared.,117,37,19,173,648,641
"This next illusion is called ""how to win an election in Florida"".",124,35,21,180,648,2057
I learned this trick in the government.,104,38,15,157,648,1673
"It's not destroying evidence.  The evidence is still all there, just in tiny pieces.",106,45,13,164,648,3363
Watch as I turn this single sheet of paper into forty-four slightly more narrow sheets of paper.,112,42,15,169,648,2021
Abracadabra! It's a Florida vote!,116,35,19,170,648,1848
After I shred this unwanted junk-mail watch in amazement as it magically reappears in my mailbox about every 3 days!,115,37,18,170,648,3441
This is actually how information gets into the cloud.,112,29,20,161,648,1569
Ta-Da! Another caption contest entry vanishes.,119,36,18,173,648,3584
"A good magician never reveals his taxes.""",108,42,14,164,648,698
"...And with a little “presto” , we now have 10,000 absentee ballots!...",92,32,12,136,648,3248
"Now, one final wave, and all the campaign promises disappear.",109,37,16,162,648,3586
"Now I say the magic words, “votus interruptus”",131,45,19,195,648,674
"And just like that, Bush is president.",117,32,18,167,648,141
"And if these reappear, I'm going away for a long time.",116,33,18,167,648,475
"And just like that, most of the caption contest entries are... gone.",104,33,16,153,648,161
I perfected this one during the Watergate era.,104,33,16,153,648,2024
"And now with the help of my lovely assistant - I shall shred this paper, wave my wand, and distract you from the three human toes in my chest pocket.",126,41,19,186,648,2341
And just like that 2018 never happened,116,39,17,172,648,165
"If this trick works, Carla, we'll get you that pair of pants.",108,33,17,158,648,3156
"For  my next  trick , I  am  going to make a small yellow paper  stick to the  wall .",128,34,22,184,648,2345
"Abracadabra, Hocus Hootin;
Unshread Trump's notes 
from his meeting with Putin.",146,39,25,210,648,830
Presto Obstructo!,109,36,16,161,648,528
And now we magically reduce the number of caption contest entries.,107,40,14,161,648,566
The GOP Voting Rights Act,109,36,16,161,648,1487
"Illusion, my dear. Illusion. Not COLLUSION.",120,41,17,178,648,3227
Vote counting in some American states has been made even easier.,120,41,15,176,648,1940
"And for my final act of evidence tampering, I shall saw the witness in half.",112,40,15,167,648,2972
Hocus Potus!,113,27,20,160,648,240
The year of magical voting.,112,30,18,160,648,2206
I learned this from the great ‘DickCheney’,122,36,19,177,648,774
And- poof!- plausible deniability.,97,37,12,146,648,3572
I now deliver the Mueller report.,103,33,15,151,648,1843
And for my final act at the White House....,111,44,13,168,648,257
"For my next trick, Wendy and I shall go completely paperless!",103,41,12,156,648,2959
"This is where the Republican poll watchers said I should put my ballot, right?",107,33,16,156,648,3603
The White House Magician.,122,30,21,173,648,3922
"After disbarment, there was only one job for one so skilled at making things disappear.",112,39,15,166,648,3529
"Thank you very much, ladies and gentlemen. 
Next up... my parents' hopes and dreams!",125,40,18,183,648,3111
"As the beautiful Marlene holds the shredder, I'll  tap it 3 times and Presto! She's now a subcontractor with no benefits!",135,55,15,205,648,560
And presto! No collusion.,110,40,14,164,648,1268
This trick didn't work with the rabbit.,126,35,20,181,648,1434
I specialize in Wall Street magic.,112,44,13,169,648,1186
"And for my next trick, I shall not leave any shred of evidence",108,41,13,162,648,2235
"I just put the check in the box, and presto, you never slept with the president.",105,36,14,155,648,608
"And now, ladies and gentleman, the Popular Vote!",110,26,19,155,648,1950
"In goes the constitution, and abracadabra, out comes...",128,44,17,189,648,3609
"Relax, it’s cleaner than shredding the rabbit!",123,35,19,177,648,3621
"You were right, Susan.  This fits much better than the rabbit did.",120,41,16,177,648,3940
And presto. No proof of collusion!,115,32,18,165,648,3303
The paper works much better than the rabbit.,116,38,16,170,648,235
"And that, ladies and gentlemen, is how you stay part of the 1%.",106,31,16,153,648,1141
This trick is for White House staffers,130,37,20,187,648,3758
"Now watch closely as I turn this blue district red.""",131,37,19,187,648,3985
The trick that horrified audiences everywhere.  The document UNshredder.,122,34,19,175,648,3549
Abra Covfefe!,116,27,20,163,648,2524
Watch closely... There is no collusion.,114,31,18,163,648,3024
I know what you're thinking...I'm recycling an old trick,100,34,12,146,648,2022
"For my next trick, I will create a $1.4 million dollar piece of art!",132,38,20,190,648,4101
"Magician? No, I’m the cartoon caption judge.",114,47,12,173,648,790
For my next trick I will saw this lady in half - WITHOUT THE INSTRUCTIONS!,96,29,14,139,648,3497
Notice at no time do my fingers leave my hand.,101,35,13,149,648,3599
"For my next act, I'll need $10,000 and a fake passport.",92,34,11,137,648,1559
And for my next trick as new attorney general ...,111,39,14,164,648,2619
This next trick I picked up while briefly serving as a top lawyer to the President of the United States.,125,35,19,179,648,3402
"And now, before your very eyes, I, the Amazing Donald, will shred the Constitution!",125,35,19,179,648,3993
"And now, a little 'magic' for the accountants in the audience",102,46,9,157,648,332
For my next trick; I’ll make these absentee ballots disappear...,114,33,15,162,648,3420
"Now, with my assistant, I will attempt to make the 2016 presidential election results disappear!",114,38,15,167,648,3895
I learned this trick the very first day I worked for Trump.,120,34,18,172,648,3493
The magic of a voting machine in South Carolina”,122,38,17,177,648,3041
A Magician never reveals his secret tax debts,109,29,17,155,648,2173
That one no longer sparked joy.,111,33,16,160,648,1870
"I place the absentee ballot in the voter’s box, and hocus, pocus...",109,45,9,163,648,29
"Good news, Barbara - you've been promoted to magician's accessory after the fact.",119,46,13,178,648,266
"And, abracadabra, your vote has been counted!",121,42,15,178,648,864
"Together, my assistant and I are performing a co-illusion, which is not a crime",99,35,12,146,648,2479
A horrified Ms. Williams looks on as Richard The Amazing unknowingly shreds the REAL Apple stock certificate...,111,25,18,154,648,3787
"And...Presto, the will of the people disappears!",121,20,23,164,648,1710
We interrupt our regular act for this special request from the White House!,110,42,12,164,648,2379
"I say the magic word 'Trump', and Abracadabra ... not a shred of evidence remains.",119,40,15,174,648,3283
The critics are not the only ones to mince their words.,121,36,17,174,648,3987
I wish to thank President Trump for donating his tax returns.,112,35,15,162,648,892
"And for my final act, the Florida ballots.",117,33,17,167,648,3563
Next I will pull a rabbit out of a 3D printer!,124,44,14,182,648,1919
Uh oh. The magic words were on that piece of paper.,125,41,16,182,648,3884
Trump submitting his tax return,107,34,14,155,648,265
Abra Redactra,104,32,14,150,648,1036
Prepared to be amazed as I shred this document without it immediately jamming! Next up the impossible...printing on first try!,130,28,22,180,648,1884
"But before we saw you in half, let's make your life insurance policy disappear.",126,36,18,180,648,2614
"And abracadabra, the President never had that conversation with Putin.",121,31,18,170,648,3238
"I keep telling him that he needs a lawyer, not a magician.",117,30,18,165,648,3580
"""It is is not illegal; it is an illusion.",118,41,14,173,648,351
Are you sure this ballot will be counted?,119,31,18,168,648,721
"And if we all close our eyes real tight and wish real hard, I’ll shred the 2016 election results and the past two years will all be forgotten",116,29,18,163,648,3920
Glad we stopped using rabbits.,113,29,16,158,648,900
And for my next trick... I will make a copy of Trump's income tax returns magically appear.,111,31,16,158,648,2781
"Thank you, Mr. President.  Now I just need a volunteer from the audience who can put the Constitution back together.",108,29,16,153,648,4173
And this is a diasappearing trick I learned when I was employed by Enron.,129,48,14,191,648,3926
Is that the new suggestion box?,125,40,16,181,648,3353
Quit crying or the rabbit's next.,104,26,16,146,648,3142
Nothing up my sleeve. Nothing beneath my hat. Nothing they can prove.,131,41,17,189,648,1642
And Presto! The collusion never happened.,125,29,20,174,648,3423
And the Oscar goes to...LaLa Land!,119,33,17,169,648,287
Try to put it out of your mind Miss Capshaw. I admit the version with the rabbit was a mistake.,119,33,17,169,648,1575
"Hey, relax. I could've been sawing you in half.",144,49,17,210,648,3773
"and now, at the command of our President, I am officially submitting his tax returns via my magic box",114,30,17,162,648,3243
"Now watch Mr. President, as I put the notes from your meeting with Vladimir Putin back together again!",131,36,18,185,648,1151
"Alas, there is just a shred of magic in this trick.",103,32,12,147,648,3655
The Presto 2000 can double as a shredder or a voting machine.,116,41,13,170,648,1061
Don't try this in the bathtub,111,35,14,160,648,3831
And out pops Donald Trump's tax returns.,134,37,17,188,648,465
They told me I had to stop using a rabbit.,114,42,12,168,648,2506
"Now for the encore, pulling President Trump's tax return from the shredder!",117,36,15,168,648,2701
"And with a Gerrymander of my wand,  poof, your vote disappears!",114,42,12,168,648,3286
"Oh yes, you're right, much cleaner without the rabbit.",119,33,16,168,648,3356
"This next trick is called the ""Presidential Tax Return""",116,30,17,163,648,2275
The real trick is to watch it disappear from the Cloud.,113,36,14,163,648,2456
These ballot machines are designed for use in elections world-wide.,130,39,17,186,648,2777
Abra Kadabra!  No more Putin meeting notes.,128,27,21,176,648,617
Voila! Another absentee ballot mysteriously disappears!,125,33,18,176,648,1578
"Your caption, as soon as it arrives.",107,26,15,148,648,3826
"When I say the magic word, collusion becomes confetti! COVFEFE!",119,37,15,171,648,2095
"I feed the incriminating evidence into the shredder and say the magic words ""Total Immunity""",118,31,17,166,648,3925
"Don’t worry folks, these tax returns will reappear as part of the Mueller probe!",113,36,12,161,648,318
"Believe me ladies and gentlemen, you don't want to see the rabbit version of this illusion.",127,34,18,179,648,766
I learned this disappearing act from the wizards of Wells Fargo.,121,30,18,169,648,588
"And jut like that, the translation of the Trump-Putin meeting disappeared",117,30,17,164,648,1397
"As the new Broward County Elections Supervisor, I declare this new ballot 'acceptable.'",117,30,17,164,648,1729
"Abracadabra, and just like that... no collusion.",122,33,17,172,648,1205
"I, the Great Muellerini, will now unshred the President’s tax return.",122,33,17,172,648,3535
And now there will be a brief intermission while I testify before the grand jury.,106,28,15,149,648,1488
"For my next trick, I will unjam the paper!",108,25,16,149,648,1704
"Now for our next trick, we will need someone from the government.",117,35,15,167,648,2087
"And now, dear followers, I will shred this constitution, then magically restore it!!... but without all that “freedom of the press” nonsense..",117,35,15,167,648,2579
"Don't cry, Sweetheart, it's only the Constitution.",116,29,17,162,648,3230
Making the voter disappear is more difficult,123,36,16,175,648,4126
"Don’t worry, it’s just the Constitution.",112,32,13,157,648,2390
I call this trick “Jury Summons”,115,44,11,170,648,2308
"And now for my final act. 
I will make Banksy's painting reappear.",121,32,17,170,648,3386
"For my next trick, I will re-open the government.",122,35,16,173,648,727
This next trick I’m working on for the White House.,124,31,18,173,648,1744
Now you are liable. Now you are not.,123,33,17,173,648,2702
"In professional circles, we call this trick the Russian Donald.",111,29,15,155,648,38
"And now, I will pull the President's tax returns magically from the shredder!",115,24,16,155,648,100
And thus my personal details are gone forever.  And yet not so.  Would you please welcome to the stage ... Mr. Mark Zuckerberg.,117,37,14,168,648,1785
"abra cadabra, no collusion",129,34,18,181,648,67
"I think it’s still clogged with
rabbit fur.",125,42,14,181,648,2443
...and Presto! No Russian interference!,131,31,19,181,648,2482
"Been a while since Enron, but it should still work.",104,34,12,150,648,186
I'll just wave my magic wand...and it's as though I never met with any Russians.,116,33,14,163,648,2014
The real trick is that it's not plugged in.,124,36,16,176,648,2812
"And with a wave of my wand, I can make anyone's taxes look just like the President's""",114,30,14,158,648,3971
The Florida government decided magic would be a more accurate vote tallying method.,121,34,16,171,648,1466
See how I carefully shred the credit card numbers you gave me. Yet before long they will magically reappear buying groceries at a Walmart in Iowa.,128,41,15,184,648,3234
Every vote    counts,124,41,14,179,648,104
"Well, that's the last of the lawsuit from last night's show. Now, do we have any volunteers?",126,37,16,179,648,371
"And now, to count the votes we don't like, we are using our new cutting edge ""Tab-U-Later"".",99,33,11,143,648,397
OSHA says this is the closest we can get to cutting someone in half.,116,41,12,169,648,984
Unfortunately my conversations with Mr Putin are unavailable!,128,38,16,182,648,1216
Pulling out the rabbit is much worse.,109,34,13,156,648,3032
And voila! The shredded document will reappear on Wikileaks!,120,33,16,169,648,4051
And now... from out of the shredder... Trump’s tax returns!,137,33,20,190,648,2412
"I place the ballot just so, and abracadabra, into the magic vote-counting machine it goes.",115,35,14,164,648,3446
Watch closely as I shred my assistant's restraining order against me.,122,34,16,172,648,113
"I will now fax this never seen before, confidential information to the NY Times.",117,36,14,167,648,304
This is the very same illusion that I presented to the Florida Election Commission.,108,33,13,154,648,2436
And for my next trick...The Mueller Report.,127,31,17,175,648,1846
And this is why you will NEVER see Donald Trump's tax returns!,120,35,15,170,648,669
After which I shall disappear to a country with no extradition treaty.,99,35,10,144,648,1279
"And now, abrcadabra, there is only a shred of evidence.",114,39,12,165,648,83
This creates the illusion there was evidence.,110,39,11,160,648,359
"I call this trick, The Michael Cohen",133,40,16,189,648,1243
"Alice, your request for pants is denied!",110,31,14,155,648,2835
And they say my statements don't contain a shred of truth.,121,37,13,171,648,3817
The rabbit cancelled!,123,31,17,171,648,3995
And presto! We can now blame Obama.,127,36,16,179,648,707
"A magician never reveals his secrets, especially when they're tax-related.",107,42,9,158,648,2582
"What happens in Florida, stays in Florida!",112,45,9,166,648,3488
You should see what my lawyer can do,115,39,12,166,648,4206
I will now magically make the Electoral Votes disappear.,125,32,17,174,648,883
"Place the notes in the box and repeat the magic words ""No collusion, no collusion"".",115,31,15,161,648,1486
America's Best Magic Trick: Obstruction of Justice,114,33,14,161,648,2758
Now you see the evidence aaaand... now you don't.,127,33,17,177,648,1701
My friend Banksy taught me this one.,127,36,14,177,648,2874
I've had to tailor my act a bit for corporate audiences.,103,34,11,148,648,2019
"It's not exactly magic, but it's good enough for government work",103,26,14,143,648,1661
Now watch the Russian vote trick!,109,27,15,151,648,2437
North Carolina ballot box.......,106,33,12,151,648,2668
Voilà! The notes of Trump's meeting with Putin arise from the shredder!,108,30,13,151,648,3157
"And presto, our transcribed conversation with Putin is history.",121,29,17,167,648,836
Watch carefully as my tiny hand slides my interpreter's notes into this machine...,129,40,14,183,648,1168
"The Russian interpreter's notes ""magically"" disappear.",101,35,10,146,648,1008
They made me stop shredding rabbits.,106,38,10,154,648,1688
This is the test of the new ballot box for 2020,113,26,15,154,648,2119
"Now you subpoena, now you don’t!",113,37,12,162,648,2309
It worked for Banksy.,111,42,9,162,648,2321
Some call it magic. Some call it art.  But really its just identity theft protection.,116,31,15,162,648,3666
"For my next trick, I will remove all evidence of collusion.",120,36,14,170,648,903
"Well, Susan, this would have been better if your pants hadn’t gone through first.",133,36,17,186,648,3832
So much better without the doves.,104,34,11,149,648,2085
"Abracadabra,
Hocus pocus,
On my taxes,
Do not focus.",118,32,15,165,648,1619
"...the trick is NOT getting caught""",125,31,17,173,648,2891
"Don't worry my dear, your paycheck will magically reappear when my loan magically gets granted.",122,37,14,173,648,3590
"And finally, Aunt Erma's fruit cake recipe.",109,29,14,152,648,71
Sometimes sawing it in half just isn't enough.,111,38,11,160,648,182
For my next trick I will shred Donald Trump's tax return while this Fox anchorwoman assists. Then I magically will be named US Attorney for the 9th Circuit.,135,29,20,184,648,365
and now for a little trick I learned from Banksy,135,34,18,187,648,3760
The rabbits just got too messy.,120,38,13,171,648,3025
"What is shredded, shall not be dreaded.",112,29,14,155,648,4165
"And since she refused to be sawn in half, we'll just shred her paycheck instead.",118,34,14,166,648,1173
It seems my wand is jammed.,119,32,15,166,648,2203
I really need to stop doing shows for the mob.,115,40,11,166,648,2299
"The Great Destructo performs at children's parties, audits, and year end closings.",119,32,15,166,648,3428
Another Florida voter exercises his constitutional right.,115,27,16,158,648,1237
"I'm not a magician, I'm just the CFO.",108,28,14,150,648,673
Now you see my paternity test. And now you don't.,132,37,16,185,648,192
Anyone can make it disappear. But the real trick is to keep it from coming back.,129,43,13,185,648,4060
...and this is what I like to call ‘practical magic.’,118,39,12,169,648,1022
Presto!  The new AG presents Mueller's Russia Report to Congress!,123,29,17,169,648,1356
"Abracadabra; with the wave of my wand....""PLAUSIBLE DENIABILITY""!",119,37,13,169,648,1532
I’m shredding my rabbit’s letter of resignation.,121,34,14,169,648,1949
And now for my assistant’s last shred of dignity.,120,35,14,169,648,2007
And presto!  No evidence of collusion!,120,35,14,169,648,2354
"Rabbits are overdone, I'm pulling paper out of a shredder.",122,31,16,169,648,2357
I will now make the truth dissapear!,121,33,15,169,648,2505
and now.... the Mueller report!!,121,35,13,169,648,2557
This clogs up the machine much less often than the rabbits did.,116,30,15,161,648,1050
Now watch as I make these Democratic ballots DISAPPEAR!,130,33,17,180,648,1149
Florida's newest ballot box assures... no more recounts!,117,34,13,164,648,890
The White House is looking forward to our performance. They'll even supply the paper.,115,37,12,164,648,3092
"And for my next trick, ‘plausible deniability.’",116,35,13,164,648,3837
Melania...I had an amazing dream about the Muller report.,123,39,13,175,648,2613
My next trick involves no magic.  My ballot disappears by itself when I insert it into a voting machine from Broward County.,121,31,15,167,648,920
Next we saw my accountant in half.,109,41,9,159,648,1942
I consider this to be an act of magical disappearance rather destroying evidence.,120,37,13,170,648,3225
...and VOILA! Donald the Magnificent makes the Constitution disappear!,116,32,14,162,648,2370
"Trust me, you don't want to see how I make the rabbits disappear.",134,27,20,181,648,2719
And here is how I make the translator's notes disappear.,127,29,17,173,648,651
Watch.....as I magically make your legal problems disappear.,127,30,16,173,648,2690
You can't just throw stuff away anymore. You have to make it disappear.,120,42,11,173,648,4078
It seems we have encountered a clump of rabbit hair.,121,27,17,165,648,885
Environmental regulations.   Now you see them,133,35,16,184,648,546
And now.... for the final trick...the constitution of the United State of America will pass through the oval Office shredder in one piece.   Oops.,137,44,14,195,648,1847
And now...the transcript of the Trump-Putin summit!,122,30,16,168,648,2464
"And now, I will make my conversations with the Russians disappear.",116,29,15,160,648,3109
Tell Mr Trump not to worry about a thing.,134,24,21,179,648,630
I’m glad we stopped using rabbits.,131,35,16,182,648,1570
And that completes my taxes for 2018.,130,37,15,182,648,2858
"For my next trick, I'm going to make some copies.",113,40,10,163,648,2008
Counting the Vote in 21th Century America,116,34,13,163,648,3217
"Well, we don't have much of an act MayBelle, but it takes care of the bills.",118,30,15,163,648,3384
"And now, by the power of congress, let your paycheck disappear!",103,29,12,144,648,2055
And now a little trick I learned from Banksy...,127,31,16,174,648,2899
How about a big hand for my lovely accomplice?!,109,35,11,155,648,1989
Now there is no collusion!,129,44,12,185,648,793
"For only $19.95 you can get this amazing shredder, toaster, compacter purse and, if you call within the next ten minutes, at no extra cost, we’ll throw in this stick I’m holding absolutely free!",117,37,12,166,648,2745
"As you requested, Mr. President, I shall now make your taxes disappear.",108,25,14,147,648,1400
"Behold, I have un-shredded the interpreter notes from Trump's private one-on-one with Putin.",104,32,11,147,648,1475
I tried this with a rabbit and let’s just say it didn’t go very well.,127,35,15,177,648,919
"I call this next trick: ""The accountant.""",125,41,11,177,648,4052
And now I will magically change a presidential speech into tweets.,122,32,15,169,648,2621
Presto-changeo -- I now qualify for a cabinet position.,119,39,11,169,648,3147
"This is a trick I learned from some of our politicians.  It's called, ""Now you see it, soon you won't",128,38,14,180,648,3588
And my lovely assistant will hide the interpreter's notes from my meeting with Putin in a very safe place ...,126,29,17,172,648,1586
"And magically, without even the slightest reference to politics, we will make this document disappear...",124,38,13,175,648,119
And now I will make this ballot disappear!,127,32,16,175,648,1499
Absentee ballots!,129,32,14,175,648,2735
"No magic, just always wanted to do this to my tax return.",125,36,14,175,648,3056
why force your dog to eat your homework when for 29.99 you can order the chewmatic 3000?,123,42,10,175,648,3839
"Again, this is her only copy...",103,31,11,145,648,904
Subpoena? What subpoena?,128,35,15,178,648,369
Ta-da!  No collusion!,127,37,14,178,648,3105
"And by the second act, the annual office talent show hit a new low",136,38,15,189,648,466
And now for the election results!,143,41,16,200,648,2337
NO COLLUSION!,105,32,11,148,648,619
This won't work with rabbits and pigeons.,113,34,12,159,648,352
For my next trick I will make my assistant’s sexual harassment lawsuit disappear.,115,30,14,159,648,2385
"And just like magic, your vote stays secret!",114,32,13,159,648,3316
Some of you may want to look away while I next do this with the  rabbit.,121,36,13,170,648,554
..I  simply place this into the magic suggestion box..,121,36,13,170,648,1533
"Behold, as I shred the Constitution with my tiny hands, everyone's rights will disappear.",123,32,15,170,648,2316
"And, presto! Magician Mueller will reconstruct this into an indictment.",126,45,10,181,648,1513
I work for the White House,123,37,13,173,648,1694
"And voila, no collusion.",136,29,19,184,648,2538
"And Banksy, this is your check for that piece I bought at auction!",144,31,20,195,648,1997
"And now, I'll extract Trump's tax returns from the shredder.",125,20,20,165,648,590
"First, I insert my New Year's resolutions...",128,34,14,176,648,1406
A magician never reveals his bank statements.,100,34,9,143,648,3122
Voila! the next State of the Union Speech made coherent!,114,25,15,154,648,3126
"Magician by night, tax specialist by day. Similar skill sets.",121,46,9,176,648,3526
Watch carefully as I audit the President's tax form.,125,21,19,165,648,3902
"Honestly, we'd do anything to amuse the cat.",124,45,10,179,648,3732
And now I am magically cleared of all liability.,140,37,16,193,648,435
"Well, I don't do this one with the rabbit anymore.",130,38,14,182,648,1335
Watch carefully as I shred the last of my dignity and self respect,121,38,12,171,648,2620
My rabbit is on strike.,124,32,15,171,648,2727
I will now ask my assistant to reach into the shredder to retrieve her liability waiver.,126,34,14,174,648,486
Now watch me make my lovely assistant's sexual harassment claim disappear.,118,31,14,163,648,1787
"And now, ladies and gentlemen of the House of Representatives—out of my MAGIC REVERSE SHREDDER—Donald Trump’s tax returns!",116,35,12,163,648,3692
The inspiration for this next trick came to me during a recent IRS audit ...,125,40,12,177,648,3800
As the President's personal magician I shall now make this subpoena disappear.,127,36,14,177,648,4029
"And for my next trick, my assistant and I will disappear to an offshore tax haven.",114,45,7,166,648,1510
Abracadabra let’s bring back those shredded notes from the Trump-Putin meeting!,114,26,15,155,648,1260
"For my first trick as Attorney General, I'll make Mueller's report disappear!",114,26,15,155,648,2453
And now you know why we don't use a rabbit anymore.,130,35,15,180,648,279
"For my next trick, I will attempt to turn one large piece of paper into many small pieces of paper.",126,46,8,180,648,1395
"By the way, this model is available at the White House gift shop",129,38,13,180,648,3172
The secret to this trick is to never exceed more than 10 sheets.,125,45,10,180,648,4138
The real magic is unjamming it.,111,37,10,158,648,93
You should have seen what happened to the rabbit.,114,33,11,158,648,2116
Am I voting or shredding?,115,29,14,158,648,2364
I perfected this next trick as part of my plea deal.,125,32,15,172,648,2770
"And now, ladies and gentlemen I, The Great Dlanod, will draw your attention away from my tiny hands by placing this Bill of Rights into my magical alternative-facts casket.",119,26,16,161,648,1987
"Ladies and gentlemen, for my next trick I give you the Mueller Report!",136,35,15,186,648,1473
"And for my next trick, I’ll be pulling an alibi out of my hat!",127,34,14,175,648,785
Now you see the Mueller Report; now you don't.,126,35,14,175,648,1697
There. And remember: not a word to Pelosi.,125,37,13,175,648,2747
Redaction is now complete.  Please forward this to the Senate.,128,31,16,175,648,3050
"And now, the Presidential  tax return trick!",126,35,14,175,648,3575
Oooh that’s a strange noise. Do you have the rabbit?,106,39,8,153,648,1165
This is one I learned from Banksy.,122,30,15,167,648,3494
It's very important that all my campaign promises are shredded-- twice.,115,26,15,156,648,2465
"For my next trick, I will turn this original copy of the Constitution into a rabbit.",115,26,15,156,648,4045
"And presto, your vote in the 2016 presidential election never happened.",125,29,16,170,648,1581
Banksy taught me this one.,121,37,12,170,648,2497
A magician never reveals his tricks. Or his tax returns.,103,33,9,145,648,3708
"And now after shredding and deletion, this message will reappear in the inboxes of  all your business contacts.",119,23,17,159,648,3728
Now watch as I make my beautiful assistant's sexual harassment complaint . . . disappear!,109,43,7,159,648,3896
And hocus pocus...What subpoena?,124,37,12,173,648,794
Keep in mind that every vote counts.,120,44,9,173,648,2250
Please tell me you didn't actually plug it in.,104,35,9,148,648,1505
"And now, I will saw Karen's college diploma into two thousand equally useful pieces.",121,24,17,162,648,275
"Shredder, shredder, so efficient, make it look as though I didn’t.",120,26,16,162,648,2288
Now watch as the notes from my pre-election meeting with certain Russian individuals magically becomes a plea bargain agreement.,114,38,10,162,648,3005
And for my next trick: The Bansky!,128,39,12,179,648,3649
"Voila!  Without my knowledge or approval, my assistant will make evidence of my payments to a porn star disappear!",129,39,11,179,648,4077
"Say the magic words with me...'Interpreter notes, become fodder for goats!'",111,32,11,154,648,341
"For my final trick, I will need our marriage license.",136,27,19,182,648,1319
Voila! There’s not a shred of evidence against me!,121,34,13,168,648,1333
"Watch as my translator’s notes vanish into thin air, with no collusion whatsoever.",112,29,13,154,648,2315
"And then we say the magic words, ""North Carolina's Ninth District.""",123,30,15,168,648,3591
"Keep a copy? No no, Mr. Trump assures us no one will ever request his tax returns.",113,27,14,154,648,4144
A magician never reveals his tax returns.,134,36,15,185,648,300
"Don’t worry, Kelly Anne, this is alternative archival of presidential records.",122,37,12,171,648,2106
"And with a flourish, the Great Trumpioso made the meeting notes disappear",129,23,19,171,648,2958
"If this doesn't reappear, then I'm in serious legal trouble.",120,41,10,171,648,3795
"Eh, voilà; the translator’s notes disappear!",124,38,12,174,648,653
And that’s how the votes were counted in 2016.,126,34,14,174,648,3648
And there you have it folks - a paperless office.,127,32,15,174,648,3794
"Now folks, watch carefully as I turn these ordinary translator's notes into a subpoena from the Special Counsel.",116,31,13,160,648,411
"Before I make the rabbit appear, let me just dispose of this meddlesome summons from the ASPCA.",115,33,12,160,648,3379
And in just two seconds the unwanted absentee ballot vanishes!,121,26,16,163,648,632
"For my next trick I'll be disappearing  
--right after this subpoena",119,30,14,163,648,1263
Last nights tweets from the twit.,155,32,21,208,648,3241
Watch closely as this document and your magician's chances for indictment disappear.,109,27,13,149,648,289
"I was advised to dress for the job I want, not the one I have.",122,30,14,166,648,1201
"We do birthdays, bankruptcies and ballots!",120,33,13,166,648,2199
"If you make it disappear on stage, it doesn't count as corporate fraud.",119,35,12,166,648,3585
"So, ladies and gentlemen of the Grand Jury, when it comes to documentary evidence, it depends on what the meaning of ""destroy"" is.",107,36,9,152,648,421
"Now, I shall attempt to recover Trump's tax returns.",122,34,13,169,648,562
I place the words describing a rabbit into the box.,122,34,13,169,648,2589
Watch your mail-in ballot disappear.,110,35,10,155,648,3144
"On my signal, make that annoying whirring noise.",120,43,9,172,648,1213
Not a shred of evidence will remain from this trick.,121,41,10,172,648,2365
Here at Fred's School of Magic we like to start simple and work our way up.,114,32,12,158,648,3719
"So, Anya, I just put the ballot in the ballot box like so, and Voila!",114,37,10,161,648,845
"Next the great Trumpini, with the aid of my lovely assistant Ivanka, will shred the Constitution!",128,37,13,178,648,1888
Watch how deftly I shred ballots cast by likely Democratic voters.,138,22,18,178,648,2343
And that's the last of Trump's tax returns.,132,29,17,178,648,4176
Auditcadbra!,121,28,15,164,648,460
"This worked for Banksy, didn't it?",117,36,11,164,648,3369
"We couldn't afford to make a real rabbit disappear so this is a copy 
of the last page of Watership Down",130,38,13,181,648,664
Hope this works out better than the rabbit.,127,44,10,181,648,2115
See?  I told you it would be less messy using paper instead of a rabbit,120,35,12,167,648,1931
"""The act was much better before PETA nixed the rabbits.""",116,44,7,167,648,2616
"Ballot box, shredder...there's a difference?",120,35,12,167,648,2809
"And, zip-zap, I make the Constitution disappear.",114,27,12,153,648,792
And now the Amazing Giulani will--- presto chango--- turn the evidence into confetti!,118,44,8,170,648,2551
"And for my next trick, I'll make your sexual discrimination  complaint disappear.",120,45,8,173,648,89
Hmmmm. I forget. What’s ‘abracadabra’ in Russian?,121,43,9,173,648,1167
"If this is anything like the rabbit, we’re going to need a mop.",127,31,15,173,648,2318
And this is what happens to your popular vote.,123,39,11,173,648,2927
"Vote here, you say?",123,39,11,173,648,3608
"I can make 300,000 ballots disappear. Just like that!",125,40,11,176,648,205
"The people at the White House loved this trick- ""Disappearing Meeting Notes!""",126,38,12,176,648,1409
"Here it comes, out of the amazing unshredder, Donald Trump's tax returns!",117,28,14,159,648,1337
I hope you backed up everything to the Cloud,145,44,13,202,648,589
A good accountant? No. I am a MAGNIFICENT accountant!,136,34,15,185,648,2031
"As you can see, I am shredding the Constitution.
FYI: This is not a trick.
 I work in the White House.",125,27,16,168,648,894
"Magicians' Rule No. 5: Before attempting to saw your assistant in half and then put her back together, practice with a sheet of paper.",117,43,8,168,648,2231
"Presto! It’s the UNshredder! Politicians, beware!",124,29,15,168,648,2451
...and now I hope this will go better than the pigeon routine.,126,30,15,171,648,56
Now you see the Trump tax return and now you dont,125,32,14,171,648,498
"And now for my next trick,watch me make all the other entries for the New Yorker cartoon caption contest disappear",112,30,12,154,648,2427
I sense it is Trump's translator's notes.,129,29,16,174,648,1139
"Trust me Carol, no one will miss your ""Chicken and Mushroom Soup Casserole....""",130,30,14,174,648,3107
What I'd really like to shred are these ridiculous gender roles.,128,31,15,174,648,3218
Oh No!  There goes the instructions of how to do this trick.,112,35,10,157,648,2474
It’s the President’s favorite routine.,131,30,16,177,648,2470
You should have seen what a mess I made of that rabbit!,116,32,12,160,648,2807
"Again, you really don't need me for this.",129,39,12,180,648,4091
"And now, I will transform this ordinary piece of paper into a magnificent work of art.",117,35,11,163,648,1923
You were right: this trick works so much better without the rabbit!,118,38,10,166,648,181
Presto-change-o... No collusion!,123,28,15,166,648,2762
Now watch as I make this tax return disappear and then become President.,120,34,12,166,648,2818
"This is what you can do with a Harvard diploma in ""magic studies""!",119,36,11,166,648,3828
And with a tap of the wand an ordinary novel becomes...a screenplay!,108,25,13,146,648,1783
And now I will demonstrate the voting system in Venezuela.,122,35,12,169,648,189
Just kidding--- this is not a White House document.,137,43,12,192,648,3690
"Okay, if you’re asked to testify, this was a magic trick.",110,31,11,152,648,921
"I wave my wand and, as we reverse the shredder we see...it looks like... Why, we seem to have a written transcript of the Trump Tower meeting!",128,38,12,178,648,511
Better shred than read.,125,44,9,178,648,1292
You know what? I just realized how small my hands are.,132,30,16,178,648,2634
"Presto, shredded tweet.",117,27,14,158,648,1614
Voila! A paper jam.,133,38,13,184,648,458
Now to shred the Russian interpreter's notes.,117,32,12,161,648,2339
And now the Russia investigation findings will magicially disappear!,135,34,15,184,648,2870
Republican voting ballot instructions.,117,32,12,161,648,3890
"Unshred , unshred",136,38,13,187,648,3295
And voila! One vote becomes many.,118,35,11,164,648,2067
"And now I'd like to show you a little trick I call, ""The Plausible Denial"" ...",113,45,6,164,648,3216
Another letter from feminists complaining about the outfit I make you wear.,119,33,12,164,648,3329
"As I wave the magic wand, my taxable income is reduced by half.",100,33,8,141,648,1411
"Ex uno plures—out of one, many.",122,32,13,167,648,700
You say that this is the Broward County ballot box model?,120,36,11,167,648,1131
Before the government shutdown I was a Russian translator for the president.,122,32,13,167,648,2423
Abracadabra!  And see the Constitution disappear before your very eyes!,122,32,13,167,648,2834
AUDIT-CADABRA! Now be amazed as these extraordinarily incriminating tax returns from 2010-2015 miraculously transform into ordinary hamster cage lining.,120,36,11,167,648,3943
"Ánd now, the President’s tax returns!",140,39,14,193,648,2936
"Pick a shred, any shred.",126,30,14,170,648,2968
"And here it is....completely restored, and back in its original condition.....the president's tax return.",125,31,14,170,648,3118
"For my next trick,  I'll shred my last trick.",127,32,14,173,648,3110
I will now shred this document and come up woth a completely different set of facts.,107,34,9,150,648,407
"Pick a redacted memo, any redacted memo.",127,37,12,176,648,4163
I will now turn this worthless conceptual artwork into a Banksy,138,25,19,182,648,987
And presto! I'm eligible to run for president!,117,29,13,159,648,2165
A real magician never reveals his tax returns.,116,31,12,159,648,2920
"The real trick, and most of the show, is when I put it back together.",117,29,13,159,648,3739
"Subpoena this, Mr. Special Counsel.",138,35,15,188,648,3957
"Watch carefully as I, the Great El Trumpo, shred the Constitution before miraculously turning it into 20% off KFC coupon!",123,22,17,162,648,1320
"and the name of this dandy device is the 'special counsel'""",122,31,12,165,648,57
Now watch while I make your vote magically disappear...,121,31,13,165,648,2447
"And now, the receipt for the Banksy!",124,25,16,165,648,3432
You are furloughed until further notice.  Here is your paycheck.,122,34,12,168,648,1936
You sure rabbits eat shredded paper? He's awfully quiet,123,32,13,168,648,3451
"And voila, the translator's notes are gone.",128,32,14,174,648,2120
"Abracadabra, the Russian Interpreter’s notes have disappeared!",130,28,16,174,648,3861
And yet by printing just one page I have triggered the low ink level warning.,131,31,15,177,648,1345
"No worries, Ivanka. I'm shredding the last bit of our decency before I meet with Mueller.",130,33,14,177,648,1810
"And that, Mrs. Clinton, is how one recovers an email.",132,29,16,177,648,2556
"And now, I will make this subpoena... disappear!",109,27,12,148,648,4106
"Great, a Republican vote polling place!",115,25,14,154,648,2713
"Now ,watch me make this parking ticket disappear.",113,34,10,157,648,154
"To the Federal Worker, "" Abracadabra there goes your pay check""",113,34,10,157,648,760
Please observe that at no time does the shredder leave its cord.,116,33,11,160,648,1280
"I call it ""practical magic.""",123,24,16,163,648,555
Our Secretary of State has just completed processing Absentee and Early Voting ballots.,121,28,14,163,648,1656
"And with this, I thee shred.""",121,28,14,163,648,2209
It's tough developing an impressive current-day magic routine now that sawing you in half is considered offensive.,121,33,12,166,648,2394
"......"" and with a wave of Mario's magic wand .....the President's Christmas Tweet : is transported to its appropriate place in history"".",150,35,16,201,648,2546
The invitation to your sister's third wedding goes in the magic box and...,119,42,8,169,648,1965
I will make Democratic votes disappear in Florida and Georgia.,124,37,11,172,648,1096
"The magic word is ""nondisclosure.""",103,31,9,143,648,1212
"And, after I shred this secret document, my assistant, Ekaterina in Moscow, will read it back to us in its entirety.",108,26,12,146,648,558
For my next trick I shall make the election results disappear.,109,24,13,146,648,3913
"Folks, this is an ordinary absentee ballot, collected from a North Carolina resident by my lovely assistant...watch as I make it disappear!",134,37,13,184,648,2446
"And for my next trick, your links to Russia will disappear",112,23,14,149,648,2329
We feed the interpreter's notes into the magic box... and voila! There is no collusion.,112,28,12,152,648,955
"So that, shareholders, concludes the investigation of my malfeasance.",138,39,13,190,648,3566
"I told you mom, I won’t need this high school diploma if I’m a magician.",111,36,8,155,648,907
Abracadabra! You’re now an accomplice.,109,39,7,155,648,2389
And now I will change a piece of paper into plausible denial.,115,32,11,158,648,1401
The Amazing Mueller will now make the Trump tax returns reappear,116,30,12,158,648,2151
Forget sawing a woman in half. Watch closely as I shred this ordinary sheet of paper and create a million dollar work of art.,111,40,7,158,648,3185
"After a slight mishap, The Great Shredo will no longer be using rabbits in his act.",118,31,12,161,648,414
"The handbook recommends starting with this, before I try sawing you in half.""",120,30,11,161,648,1629
"I learned this trick from my accountant.
First, I file my taxes here.
Then, presto! I pull a refund out of my hat.",115,37,9,161,648,3187
"And now, Giuliani-ini the Great shreds yet another set of Mueller questions...",150,40,15,205,648,1119
"And then, like magic, I will reconstruct President Trump’s tax return.",123,31,13,167,648,1029
Voila! The Mueller Report!,127,30,13,170,648,325
"And now, watch as I saw my assistant's benefit package in half",126,30,14,170,648,1944
Behold!  The Electoral College will now tally the ballot.,125,32,13,170,648,3120
A good magician never does his taxes.,129,34,13,176,648,1273
The real magic will be getting this damn thing unjammed.,134,37,11,182,648,2257
What collusion?,136,31,15,182,648,2714
"It's not really magic, but it will make a few things disappear.",106,27,11,144,648,2276
The magic? It also shreds all digital copies anywhere.,107,30,10,147,648,1815
Voila -- the missing ballot is now intact!,108,28,11,147,648,2068
And now here's one you can try at home,107,30,10,147,648,3254
"... and now, Mr Trump, with just a wave of my wand, your tax returns disappear.",112,30,11,153,648,1715
"Prior to sawing my lovely assistant in half,  I present her with my  personal guarantee for her safety.",108,43,5,156,648,681
"And in a final irony, I shall make the warrant for failure to appear, disappear!",115,34,10,159,648,78
"The real magic comes from being able to let go, Sharon.",117,31,11,159,648,116
"For my next trick, I will make an auditor appear out of thin air.",120,24,15,159,648,2578
A magician never tells his secrets to the I.R.S.,116,37,9,162,648,1363
What do you mean I have to make it reappear?,124,31,13,168,648,253
Magician files his tax returns!,128,28,15,171,648,59
Whitehouse archives.,125,34,12,171,648,2512
But does Mr Trump know that is the Constitution?,134,26,17,177,648,1724
"And now, I'll make the Russian translater's notes disappear,",134,36,13,183,648,1584
And poof! - no more prenup.,107,32,9,148,648,910
"First we shred your Magician's ""Thou-Shall-Do-No Harm"" Contract and then we saw you in half.",112,27,12,151,648,2955
I tried this with a rabbit but it was a little messy.,110,41,6,157,648,392
"At the count of three, this shredded secret government document will magically reappear...in Russia!",118,28,11,157,648,3702
"And for my next trick, I'll make 2018 disappear.",118,30,12,160,648,234
"Presto-Chango: The ""Reverse Shredder"" re-constructs the President's tax return.",116,34,10,160,648,1118
"And for my last trick, I will make truth disappear.",117,32,11,160,648,2549
"It's not magic, but it is better than eating the evidence.",118,30,12,160,648,2923
"If this is not what you were expecting, please direct your grievances toward my wife here who thinks the ""woman cut in half"" is too degrading.",117,32,11,160,648,3889
and the translator’s notes go in just  like this.,118,35,10,163,648,120
Watch me as I cut a critic in sixteenths.,116,39,8,163,648,1893
Would it ruin the trick if I told them there is an electronic copy?,119,33,11,163,648,2491
Shreddicus Evidencia!,122,32,12,166,648,2430
Abraca...dammit!  This is the REAL shredder!,122,32,12,166,648,3193
And now my lovely assistant will subvert democracy.,123,35,11,169,648,98
"And with an assist from Olga, I will now make 50,000 votes disappear.",126,34,12,172,648,4208
The rabbit sent me a letter?,130,31,14,175,648,1640
We insist on the use of paper ballots.,123,45,7,175,648,2535
"Now, we’re going to make your vote disappear!",126,39,10,175,648,2585
"Watch closely, Ivanka, while I make this subpoena disappear!",133,35,13,181,648,459
And the electoral college will now make your vote disappear!,135,31,15,181,648,3284
"For my next trick, the Thirteenth Amendment ...",133,35,13,181,648,3471
Wait until you see what this does to the rabbit.,142,32,16,190,648,1066
And now my assistant will reassemble the document.,113,29,10,152,648,3382
This one weird trick will lower your taxes!,114,30,11,155,648,376
In this trick I transform a banal sketch into a coveted and valuable piece of art. I call it the 'Banksy Illusion'.,111,37,7,155,648,1562
"Now watch this boys and girls....this was the ""magical"" way your grandparents deleted their unwanted messages.",112,34,9,155,648,2286
"And now, this only copy of Donald Trumps taxes may......or may not..... reappear""",112,34,9,155,648,2974
And now for a magic trick I have been perfecting since my 2001 performance at the Enron Christmas Party.,114,35,9,158,648,2703
Watch me make this subpoena disappear,122,24,15,161,648,1420
"And for my next trick, I'll shred this STAPLED document",116,36,9,161,648,2817
"I, The Great Trumpino, will make the constitution disappear!",126,24,14,164,648,1334
I appreciate any technology that obviates the need for a recount.,113,47,4,164,648,1596
"Now for my last trick, I will make Donald Trump’s tax returns reappear.",123,27,14,164,648,4141
I will now shred my credit card bill and reconstitute it as a winning lottery ticket.,123,27,14,164,648,4150
"I will feed the Trump-Putin meeting notes into the shredder, and Presto!  There is no collusion!",125,30,12,167,648,323
"If you like this, wait until I get the rabbit.",123,32,12,167,648,1354
And now i will show you how to change an indictment into a parking ticket.,126,26,15,167,648,1379
"And with that, my taxes are gone. For my next trick, I will disappear for 5-10 years with a chance of parole after 7.",122,34,11,167,648,2500
Pay no attention to the shredder in front of the lady.,122,34,11,167,648,2513
and now.....before your very eyes....watch as the incriminating content of this document becomes.....FAKE NEWS,122,34,11,167,648,3930
Watch as the Great Trumpezi shreds the constitution!,125,33,12,170,648,215
"You doubt me now, but this trick killed for Banksy .",127,29,14,170,648,1047
my next trick involves an absentee ballot,126,31,13,170,648,2459
"With a wave of my magic wand, another mail-in ballot gets shredded!",127,34,12,173,648,2192
And now I'll just pass my interpreter's notes through the magic truth box...,134,25,17,176,648,818
"Most magicians can only cut things in two, but I am eight times better than most magicians.",131,36,12,179,648,239
I agree this is working much better with paper than a dove.,136,26,17,179,648,2224
And for my next trick. Tax Fraud.,135,33,14,182,648,171
"My most popular illusion, collusion disappears.",141,37,13,191,648,3520
"After the unfortunate incident with the rabbit, they decided to tone down their act.",110,30,10,150,648,102
"Ok...let's try this agin: ""Alakazam! you will not jam!""",99,28,8,135,648,388
"And  voilà, we have Brexit",121,38,9,168,648,398
‘“Next we add some bedding to make the rabbit nice and comfortable.”,116,29,11,156,648,685
"Since you refuse to be sawed in half, I will now make your contract disappear.",122,36,10,168,648,762
"And now, a trick I learned at the Justice Department. Watch in amazement as I pull a Trump-Putin conversation transcript from the shredder unscathed!",121,24,14,159,648,863
"This is a little trick I call 'Contract, what contract?'",117,31,11,159,648,1366
Hocus Pocus! Here come chats between Putin and POTUS!,121,33,11,165,648,1371
It's a lot neater than my rabbit-thru-the-shredder trick.,114,27,12,153,648,1472
"Trust me, people loved this trick when Banksy did it.",129,32,13,174,648,1867
Let's hope this works better than it did with that rabbit last week.,126,28,14,168,648,1895
"Harold after finding out he was on the short list for Attorney General, began practicing how he would
make Special Counsel reports and IRS records disappear.",133,39,11,183,648,1951
So far I've only mastered the first part of this trick.,130,51,5,186,648,2010
Is it our Pre-Nup or is it Magic?,132,41,10,183,648,2160
Votes for democracy in here please.,122,30,10,162,648,2349
Now watch closely as I make 2016-18 disappear...,117,31,11,159,648,2603
"And Presto!, the great Giulliani makes collusion disappear.",133,29,15,177,648,3028
"For my next trick, I will make years of tax fraud - disappear!",127,36,11,174,648,3161
"And with one swift wave of my wand, this shredded page of vitriol will become a tweet.",141,33,15,189,648,3306
Because I'm all out of rabbits.,130,35,12,177,648,3457
"Merlin, working for the FBI, pulls intact documents from the paper shredder.",115,35,9,159,648,3669
"Presto chango! And for my next trick, I'll need an unscrupulous CPA from the audience.",142,38,13,193,648,1027
The ballot disappears into this toaster and voila! Donald Trump wins the Presidency.,144,30,16,190,648,2210
"Was it Shred it and then make a Copy, or...?",127,38,10,175,648,3406
Sigh! I miss the Rabbit-and-Guillotine times !!!,130,27,15,172,648,185
If it brings you no joy....,131,25,16,172,648,236
Watch me make this critic's review disappear!,126,37,9,172,648,1792
I will now assemby an IKEA Valhomla Kitchen Island with 48 separate parts,129,29,14,172,648,3215
"Great, but how do we get this thing up your sleeve?",127,33,12,172,648,3229
"I, the Great Shreddini, will now make the President's tax returns disappear.",125,32,12,169,648,710
Now these interpreter's notes from Trump's meeting with Putin will magically reappear!,128,26,15,169,648,2610
"So, now we know that this is much easier with paper than with a rabbit.",122,33,11,166,648,361
Nothing up my sleeve...anymore.,123,31,12,166,648,429
"For my next trick, I’ll fix Theresa May’s brexit plan.",127,26,13,166,648,2030
"And in what sadly will be her last show as his assistant, Alakazam proves to Marie that her contract was just an illusion.",116,42,5,163,648,2853
And now... a preview of 2020.,120,32,11,163,648,4232
A magician never reveals his secrets – or his tax returns.,117,33,10,160,648,109
"And abracadabra, the subpoena disappears!",118,31,11,160,648,213
"Voila! 
With my patented Reverse-Shredder, government documents
are put back into one piece making more sense than the originals!",118,31,11,160,648,1404
This trick has never before been performed in public.,115,29,10,154,648,755
"And as you can see, the collusion disappears.",112,33,9,154,648,1032
Annnnnd abracadabra.... I am NOT the father!,113,31,10,154,648,1911
My first trick involves my marriage license.,111,35,8,154,648,2445
Watch as I make shredding this document appear to be obstruction of justice.,107,33,8,148,648,214
"And presto, my Democratic vote is now in Florida's hands.",110,28,10,148,648,3072
The real magic is that I was able to change careers so late in life.,139,36,13,188,648,364
A magician never reveals his tax return secrets,131,43,8,182,648,801
This trick does work better without the rabbit.,135,29,15,179,648,1311
Abra Subpoena!,134,31,14,179,648,1493
"Nothing up my sleeves, or in this background check.",128,38,10,176,648,306
"Is it a ballot box, a toaster, or a shredder? The voters will never know!",129,31,13,173,648,796
The trick is to feed just one sheet at a time.,127,35,11,173,648,2989
I will now turn this solid piece of paper into confetti.,125,34,11,170,648,245
"Abracadabra! And like that, we’ve made America great again!",127,30,13,170,648,3844
"With a wave of the wand, it is now, jammed.",125,29,13,167,648,217
Now I’m going to ask Congress to join me onstage as we insert the proposal to end the Government Shutdown.,127,25,15,167,648,1929
"And for my next trick, I will make the Emoluments Clause disappear!",124,31,12,167,648,2433
Now watch carefully as I make these grounds for federal indictment disappear!,126,29,12,167,648,3992
Ladies and gentleman I present the POTUS tax returns!,123,28,13,164,648,812
Now watch democracy disappear,123,28,13,164,648,2093
"I adjusted my act, after the saw-box incident.",117,40,7,164,648,2327
Abracadabra -- no collusion!,122,30,12,164,648,3069
"And voila, your depressing Honey Do list becomes my celebratory confetti!",119,31,11,161,648,530
You're right. This is much less messy than rabbits.,117,36,8,161,648,627
"I insert my recent tax return, and out comes a ticket to a country with no extradition treaty to the U.S.",118,33,10,161,648,3016
"And now, I will magically make the President's Russian interpreter's meeting notes disappear",116,33,9,158,648,855
"We're testing a Russian voting machine for 2020 with a disappearing paper trail.""",112,30,10,152,648,3687
"No, we don’t use Mr. Nibbles for this trick anymore",110,29,10,149,648,3677
And gone is the national debt.,109,26,11,146,648,1802
I swear it looked cool when Banksy did it.,107,25,11,143,648,4192
Presto!  The First Amendment vanishes.,142,27,17,186,648,4213
"...And Abracadabra, your Georgia State election ballot is tallied!",137,27,16,180,648,2075
All tha abbra-cadabra's in the world won't prevent this  from jamming!,131,34,12,177,648,2260
And that is how you turn contracts into kitty litter,130,31,13,174,648,273
"Boy, do I miss that rabbit!",127,37,10,174,648,1314
I told President Trump I was a magician with Tax Returns so now I'm handling all his filing.,129,33,12,174,648,2716
Watch me pull the  president's tax returns out of my shredder.,129,29,13,171,648,2013
"For my next trick, I will make Democrat ballots disappear.",128,30,13,171,648,3670
“There - no shreds of evidence that I ever contacted any Russians.”,127,27,14,168,648,160
And now I’ll make Banksy’s payment disappear.,126,29,13,168,648,563
"And as quickly as they appeared, Trump's tax returns shall now disappear from your very eyes, fulfilling yet another campaign promise!",124,33,11,168,648,2216
"Ladies and Gentlemen, watch your vote disappear before your very eyes!",122,37,9,168,648,4083
And Prestoroonie!  I pull a completely intact Florida Republican registered vote out of a paper shredder!,120,26,13,159,648,1105
"Next, I am going to shred my wife’s meatloaf recipe (her only copy).",157,34,17,208,648,2040
"Bear with me, if you've seen this before--how the Bill of Rights can be made to completely disappear.",114,33,9,156,648,3462
"No collusion illusion!
Presto, Shredo!",116,24,13,153,648,2170
And that's the famous Bernie Madoff trick,109,33,8,150,648,769
"And now, a re-enactment of everyone’s favorite disappearing act from 2016–the ballot!",111,29,10,150,648,3665
"If this works, we'll try it with the rabbit.",111,24,12,147,648,1044
"And now my lovely assistant will shred this paternity test.""",137,39,11,187,648,2993
And presto...no more subpoena.,133,37,11,181,648,474
"Meet the Great Obstructio, new Attorney General.",131,36,11,178,648,1368
'Marie said it's the life-changing magic of tidying up.',133,32,13,178,648,1769
"Presto-Chang-o, Redact-o Fact-o!",129,41,8,178,648,2263
"And, Presto, transcripts of all the Trump-Putin meetings!",131,36,11,178,648,2317
Banksy made this look so easy,133,27,15,175,648,1255
For my next trick I need a volunteer from the audience who's an attorney.,132,29,14,175,648,2392
And for my next trick: Collusion Confetti.,129,25,15,169,648,3429
In goes the legislation and out will come a balanced budget.,125,33,11,169,648,4169
"To think, I use to have to saw up voter districts and reassemble them into fanciful shapes.",122,34,10,166,648,294
"For my next trick, I will make the office paper shredder work.",120,38,8,166,648,1644
How your mail ballot goes into the void never to be counted.,124,30,12,166,648,2849
A magician never reveals his receipts.,122,29,12,163,648,221
The IRS didn't believe my magic deductions.,123,27,13,163,648,2281
"And I shall magically make the President's tax returns reappear. Oops. Oh, darn.",115,38,7,160,648,1115
"Heidi, would you please come up to verify that this is the document you shredded.",144,37,13,194,648,518
Now watch closely as I make the prosecution's case disappear before your very eyes!,113,32,9,154,648,3855
Presto change!  Presidential Collusion is now... Russian adoption!,115,25,11,151,648,732
Let's start with paper. But wait 'til you see how fast this sucker makes a rabbit disappear!,115,23,13,151,648,2058
Maybe we need to plug it in?!,112,29,10,151,648,2975
"Now you see proof of tax evasion, now you don't.",135,35,12,182,648,2584
"There ..... now, watch closely as the ballots change from blue to red right before your eyes.",135,35,12,182,648,3046
"Watch your hands!  I'm a magician, not a miracle worker.",102,34,6,142,648,2854
"Now, by the power of electricity...",135,25,16,176,648,820
...and it’s stuck,132,31,13,176,648,3294
You’re right—much smoother than the rabbit.,105,23,11,139,648,1670
I now pronounce us ex-husband and ex-wife.,129,32,12,173,648,2518
My latest trick is called 'the disappearing ballot.',125,40,8,173,648,3769
"If I can perform this trick on Fox News, I might get a job with the WhiteHouse.",127,31,12,170,648,3317
"And now I shall make a rabbit appear out of a shredder.""",129,29,12,170,648,3343
And... voilà! The incriminating evidence is now eco-friendly compost!,121,38,8,167,648,2177
Hold it steady kellyanne!,125,30,12,167,648,2225
"And now, ladies & gentlemen, watch as I magically un-shred  Trumps tax returns!",126,28,13,167,648,2978
"When gerrymandering doesn’t work, this is how Republicans deal with minority voters.",127,27,13,167,648,3263
"And if everything works out, we'll have a brand new budget on the other end.",124,29,11,164,648,3455
"Don't worry Susan, I'll make your contract reappear with a only a few minor changes.",122,33,9,164,648,3463
This is a special trick ordered from the 45th President of the United States; I am to make these tax returns disappear.,114,37,7,158,648,1270
Now I am magically extracting Donald Trumps tax returns from the shredder!,140,32,14,186,648,2226
With one wave of this wand the remaining evidence of my 4 years at Princeton will disappear - and with it the hopes and dreams of my parents.,116,28,11,155,648,3048
I will now make your caption entry magically disappear!,115,25,12,152,648,404
"For my next trick, I'll need a copy machine.",110,35,7,152,648,2377
Now you see collusion and now you don’t!,134,34,12,180,648,3858
"All is well, have no fear, watch the transcript disappear...",131,35,11,177,648,1085
"And now, as I shred my notes from the President's last meeting with Premier Putin, Robert Mueller will suddenly appear.",130,32,12,174,648,1722
"And with that, your taxes are gone!",110,20,13,143,648,3929
"And PRESTO, your credit score has disappeared. For my next trick, I will saw your 401k in half.",128,31,12,171,648,1809
And now watch my Russian translator notes disappear!,130,28,13,171,648,2220
"In tribute to Banksy, we shall turn an ordinary page into a masterpiece!",125,37,9,171,648,2604
Annnnddd Presto! No collusion!,131,25,15,171,648,3212
And the next thing to disappear...our motel receipt from last night.,126,35,10,171,648,3654
The Magic Voting Machine,127,30,11,168,648,1511
"In honor of the shutdown, I'll only recover two thirds of this page.",125,34,9,168,648,2627
Ladies and Gentlemen I will now make this warrant for my arrest disappear.,117,38,7,162,648,2785
Here’s a little trick I learned from Oliver North.,118,36,8,162,648,4171
There's a shred of truth to my magic tricks.,136,42,9,187,648,1536
"Through the magic of voter suppression, here's how your ballot is counted.",117,33,9,159,648,3174
"And voila! The new Vote-o-matic voting machine, brought to you by The Trump Organization, securely records your ballot!",120,27,12,159,648,3503
"And now, to prove there has been absolutely no collusion, my assistant and translator Natasha will completely shred all her notes.",119,29,11,159,648,4214
"After last week's incident, we'll only be separating inanimate objects from now on.",113,31,9,153,648,172
And that is how you un-shred it.,135,29,14,178,648,243
"With the help of my able assistant,Sarah Huckabee Sanders, I will make the results of the mid-term elections disappear!",129,38,8,175,648,1209
"Watch now, see democracy vanish right before your very eyes.",131,27,14,172,648,271
"And so, with a wave of my wand, I pull the interpreter's notes out of the shredder!",129,31,12,172,648,1414
abracadabra watch Trump's interpreters notes disappear!,127,35,10,172,648,4189
"And just like that, your adolescent poetry disappears.",126,32,11,169,648,1448
"Ladies and gentlemen, don’t be alarmed. Through my amazing magical powers, I will defy all natural laws and attempt to restore the constitution to its original condition!",127,30,12,169,648,2548
"And now, these translator notes will disappear before your very eyes.",112,18,14,144,648,1062
"For my next trick, I will make it disappear like an African-American's vote in Georgia.",149,23,19,191,648,3857
"I can put The Constitution back together again, believe me.",124,33,9,166,648,911
Abracadabra. I am going to shred this junk mail and it is going to magically reappear in your mailbox tomorrow morning.,121,32,10,163,648,798
Alakajam!,122,31,10,163,648,2776
Now! Watch closely as my lovely assistant Lucinda aids and abets as I make this damaging piece of evidence disappear!,123,28,12,163,648,3202
My mother was right. Big wand small hands.,120,32,8,160,648,3525
Not everything is magic!,133,40,9,182,648,1291
And now your harassment allegation just goes right in here...,118,29,10,157,648,423
"And, poof!  No proof of collusion!",115,34,8,157,648,625
"I never thought I'd say it, but you're right: this trick really is much better without the rabbits.",120,25,12,157,648,1534
And...Presto! The G.O.P. sweeps the Birmingham elections.,138,26,15,179,648,1677
Now watch me make this bill for The Wall disappear!,139,25,15,179,648,2438
"This is the copy machine, right dear!",151,36,14,201,648,55
I will now perform some legal magic.,116,27,11,154,648,442
"And,with a swish of my wand,l will show you how we count our ballots.",117,25,12,154,648,1219
"They say it can't be done!  But watch as I, Steve the Magnificent, escape from Jury Duty!",128,35,10,173,648,1639
You think shredding your documents protect your privacy?  Watch this!,125,43,5,173,648,2254
"And now, ladies and gentlemen...for my final trick...the Constitution!",132,27,14,173,648,3915
Abracadabra - there goes your government check!,127,34,9,170,648,1399
And for my next trick - I will make these Florida ballots disappear!,125,36,9,170,648,3630
"For the act, is it ok if I call you ""Melania""?",113,23,12,148,648,1300
"..and now, for the last of my dignity.",112,25,11,148,648,2961
And now watch as I instantly get a job with the administration.,111,27,10,148,648,3100
And just like that the notes from the Trump Putin meeting disappear,127,30,10,167,648,344
"Abracadabra, no more collusion.",127,22,15,164,648,1194
Presto magic... what constitution?,121,35,8,164,648,1791
"Siegfried and Roy, I thought you said shred and destroy",123,30,11,164,648,2801
Unfortunately we lost fluffy in the original version of this trick.,120,31,10,161,648,3999
"Presto, change-o! Conversations with Putin disappear!",136,31,13,180,648,2761
Wanksy Tanksy gonna make a Banksy,135,33,12,180,648,3166
The real trick is keeping everyone's mouth shut.,119,28,11,158,648,1321
"What you saw, didn’t happen. 
What you heard, was never said. 
What he wrote, is misspelled.”",117,32,9,158,648,1361
"You know Linda, sometimes abracadbra isn't enough",117,32,9,158,648,1721
"Combining business with pleasure is the real magic, Miss Jones.",117,32,9,158,648,3506
Now I will demonstrate how politicians make things disappear.”,116,34,8,158,648,3729
Shred softly and carry a big stick. (Said Trump about the dossier.),119,28,11,158,648,3958
"And where it goes, no one knows",128,42,7,177,648,2501
"For my next trick, I''m going to make it reappear in a copy machine.",111,39,5,155,648,3208
This is much harder on the rabbit,116,24,12,152,648,355
Now you see these Tax Returns! Now you....,117,22,13,152,648,2118
Wait till you see my disappearing rabbit trick.,124,40,7,171,648,2661
There goes the Constitution folks!,128,33,10,171,648,3710
"I am now going to make the restraining order filed by my lovely assistant, disappear.",126,31,11,168,648,26
Don’t try this one with the rabbit,127,29,12,168,648,2415
"And, abracadabra ... no collusion.",126,31,11,168,648,3026
"And now, we're going to make those allegations against me magically disappear!",114,23,12,149,648,1239
"Well, apparently it's magic for Sotheby's.",112,27,10,149,648,4196
There goes the President's Tax Return for yet another year!,120,38,7,165,648,3
I'll now transform my assistant's harassment suit into a dove.,128,26,11,165,648,3937
"And now, for a trick the IRS hates...",107,32,7,146,648,713
You say there will be a shred of evidence?,110,26,10,146,648,3862
"And just like that, the truth disappears!",135,35,11,181,648,162
"If they ask, tell them I thought it was a postage machine.",134,37,10,181,648,683
"This is a trick I learned during my time spent in Broward County, Florida.",122,29,11,162,648,312
Voila! Notes from a Russian interpreter.,107,27,9,143,648,3725
"There, that should take care of the pesky Putin / Trump Interpreter notes.",135,30,13,178,648,2137
This is called my disappearing votes trick!,133,34,11,178,648,3892
"And with one swish of my wand, our democracy disappears!",121,26,12,159,648,2104
"His assistant thought that he didn't have a shred of decency. 
He did, it was just paper thin.",116,36,7,159,648,3768
"And for my final trick, you’ve been served.",130,35,10,175,648,2382
Voila! A hanging chad.,131,33,11,175,648,3170
"And now, for my next trick, my assistant's toaster will translate your ballot into Russian",118,27,11,156,648,537
"Watch now as my tax returns vanish, only to reappear in congressional testimony months later.",129,32,11,172,648,4137
"I swear, Hilda, this will kill on the corporate circuit.",134,22,16,172,648,4199
Watch closely: The paper...will...not...jam.,115,28,10,153,648,91
The real trick is putting it back together.,112,34,7,153,648,2038
And now for my version of Shredded Tweet..,114,30,9,153,648,2432
Yes honey. It's a scanner.,112,34,7,153,648,2590
Russian Translation by day. The Great Shreddini by night!,114,30,9,153,648,3090
I learnt my craft working on the 2016 Election campaign.,124,37,8,169,648,3392
And out comes a bunny.,100,26,8,134,648,281
"We'll just put your vote in the magic toaster, and voila,
the opponent wins",126,28,12,166,648,1447
It's as if this conversation never happened.,120,40,6,166,648,2134
"I can assure you, that despite what you may think that you see, no evidence is really harmed or destroyed in this trick.",122,36,8,166,648,2896
I believe this is the last transcript of the Helsinki meeting.,123,34,9,166,648,2998
"And for my last trick, I'm going to show you how to make your debt disappear.",123,34,9,166,648,3717
"It would be a great trick, if my vote actually counted",136,35,11,182,648,1899
Subpoenashreddis!,124,27,12,163,648,582
"Before I saw you in half, watch the theater's liability waiver disappear.",124,27,12,163,648,2783
This is my last letter from Mom telling me I wouldn’t make it as a magician.,137,29,13,179,648,3532
Observe how quickly a Russian business contract can disappear!,119,32,9,160,648,9
Watch as evidence vanishes before your very eyes.,145,35,12,192,648,925
...and I've been magically un-served!,142,35,12,189,648,2285
I assure you! This is NOT a trick!,132,31,10,173,648,831
"Ladies and Gentlemen, right before your eyes I will make this subpoena disappear.",128,36,9,173,648,3442
"Ladies and Gentlemen, I will now make all the evidence disappear",117,31,9,157,648,1076
Now watch very carefully as I attempt to restore this prenuptial agreement.,129,29,12,170,648,2697
"And, for my next trick, I will show the Justice Department how to make the Mueller Report disappear.",118,24,12,154,648,3865
"Don’t worry, this isn’t how the rabbit disappeared.",133,43,7,183,648,225
"I place the only copy of my mother-in-law's meatloaf recipe in this magic device,and presto it disappears!",126,30,11,167,648,393
"For my next trick, I will make all evidence of the President's collusion with Russia disappear.",128,26,13,167,648,1215
"I will now make this ballot and 60,000 others disappear before your eyes!",126,30,11,167,648,2903
The magic is that it ends up making more sense than it did going in.,126,30,11,167,648,3453
"And for my next trick, watch the transcript of Trump's Putin meetings disappear​!",124,29,11,164,648,930
The new attorney general makes a show of reading Robert Mueller’s report at a White House party.,114,25,9,148,648,1814
"And now ladies and gentlemen, watch as your vote disappears before your very eyes!",133,33,11,177,648,2509
And for my next trick: The Trump/Putin Meeting Notes Disappearance Act,120,32,9,161,648,230
"Not a rabbit this time. Happy, PETA?",122,28,11,161,648,3155
I am now shredding the insurance policy for my assistant Carol in case of accidental disappearance of disembodiment.,134,21,16,171,648,764
This next trick I learned from G. Gordon Liddy the Great.,126,37,8,171,648,1060
My next trick is President Trump's favorite. I will now make the Mueller Report disappear!,134,21,16,171,648,1221
"Watch carefully, as banking fraud disappears right before your very eyes!",115,32,8,155,648,522
"And, presto, MANY shreds of evidence !",117,28,10,155,648,1664
Undo!,117,28,10,155,648,3882
"And for my next trick, I'll make this non-disclosure agreement disappear.",117,28,10,155,648,3921
"And now we insert your ballot, to create a paper trail",124,36,8,168,648,3994
I call this the Banksy.,138,33,10,181,648,478
"If  Nixon had done this with his tapes, he'd still be president",135,38,8,181,648,3240
And voila! The end of voter fraud!,113,32,7,152,648,866
I still haven't figured out how to make it re-appear.,116,25,11,152,648,918
"Abracadabra is passé, we now just say, Banksy.",126,27,12,165,648,629
"Now, you've all seen the shell game trick, but have you seen the shell company trick?",126,27,12,165,648,1606
"""Now, might anyone in the audience have their own subpoena they'd like me to make disappear?""",124,31,10,165,648,3955
And now to make democracy disappear...,105,20,11,136,648,1558
I will now insert this magic paper and it will come out in shreds.,127,42,6,175,648,956
The real trick is unjamming this piece of paper.,134,28,13,175,648,1342
Say so long to Hillary's last email.,139,41,8,188,648,3613
"For my next trick, I shall require some Scotch tape.  It could take a while.",114,41,4,159,648,4
These notes from President Trump's meeting with Mr. Putin must be shredded before he eats them,123,23,13,159,648,1344
"So now you're thinking, No Congressional committee will ever know the contents of THAT document, right?",118,34,7,159,648,3196
And here’s how we make a ballot DISAPPEAR…,119,31,9,159,648,3505
Not what I expected when you promised to make my debt disappear.,121,28,10,159,648,3781
And presto! Al Gore is no longer president-elect!,129,33,10,172,648,324
And now I will make all evidence of collusion disappear!,135,22,15,172,648,620
Viola! It renders intelligible English from hocus-pocus Potus gibberish.,129,33,10,172,648,744
All is illusion--I shred the paper without jamming the shredder!,130,31,11,172,648,1731
And now watch as Donald Trumps tax records disappear.,132,27,13,172,648,1971
"If you think this is great, just wait and see what is does to a boiled chicken and a head of iceberg lettuce.",131,29,12,172,648,2380
"For my next trick, tax evasion.",132,28,12,172,648,2602
"Thank you, thank you...for my next trick, I will need the help of a credit card in the audience.",137,39,9,185,648,169
And lo!  The Constitution disappears by The Make America Great Trumpinski's command!,141,31,13,185,648,577
Open shredame!,128,30,11,169,648,75
He doesn’t need me to hold this... but it’s better than getting sawed in half.,128,30,11,169,648,1752
Here's a trick I learned from Banksy.,139,25,15,179,648,1622
"And then for $1million, I will make Banksy appear!",136,32,11,179,648,2954
"...and voila, a Banksy....",124,33,9,166,648,799
Ladies and Gentlemen behold the Bill of Rights,130,21,15,166,648,1224
"My mother was right, marry a doctor.",125,32,9,166,648,2005
The new Vote-O-Matic magically turns one vote into one hundred!,127,27,12,166,648,2586
"Do not try this trick at home, unless you also have a shredder.",124,34,8,166,648,3515
"Behold, my assistant’s disappearing health insurance policy! On a related note, I won’t be sawing her in half anymore.",113,33,7,153,648,400
A magician never reveals his secrets- to the IRS.,112,35,6,153,648,1392
This trick looked better on paper.,114,31,8,153,648,2149
"Next, a little something my accountant calls the ""leave no trace"" trick.",117,26,10,153,648,2373
Let's see what The New Yorker does after I shred the list of the remaining 153 captions that have never been submitted.,105,27,8,140,648,1242
"Once again the Russians have interfered , this was supposed to be a rabbit",148,27,14,189,648,594
"Abracadabra! And just like that, all evidence of collusion with the Russians disappears!",143,34,12,189,648,795
Watch now as my assistant's literary ambition disappears!,142,36,11,189,648,3619
And this is how you do disappearing absentee ballots in North Carolina’s 9th district.,133,32,11,176,648,1827
Now watch as I make the evidence of collusion disappear!,126,24,13,163,648,1446
It's a letter from the woman I sawed in two... she's half-hearted about taking me to court.,121,34,8,163,648,3658
"Ladies and gentlemen, it is my sincere pleasure testifying today before Congress...",138,39,9,186,648,2856
Banksey taught me this back when I was an art critic.,141,34,11,186,648,2948
The Amazing Disappearing Ballot,132,29,12,173,648,314
"Abracadabra, a pesky House Oversight Committee subpoena is GONE!",126,19,15,160,648,610
Thanks for making me come all the way down here to deposit my ballot.,118,35,7,160,648,959
Try not to act like we do this four times a day.,136,38,9,183,648,2560
I will now make your New Yorker cartoon caption entry disappear.,130,28,12,170,648,410
My favorite trick- any Florida election.,129,30,11,170,648,1631
I swear this is the only way to get the damn thing to work!,149,29,15,193,648,2848
The constitution wasn't that good anyway.,110,24,10,144,648,1012
And for the final trick... I’ll make these votes disappear!,135,35,10,180,648,3138
Abracadabra! You never graduated from Trump University.,135,35,10,180,648,3716
"If this goes well, we may be moving on from the box and the saw.",122,39,6,167,648,457
"...and ""presto"" my ballott it counted in Florida!",128,27,12,167,648,2033
"Now, with a wave of my wand, this work from Christo will increase in value!",143,36,11,190,648,2001
"The interpreter's notes are being fed into this shredder. Next, I'll pull an indictment out of her ear.",114,33,7,154,648,128
Bills piling up? No problem with the incredible Shred-o-matic!,115,31,8,154,648,730
"Ladies and gentlemen, this is an old trick that I learned from G. Gordon Liddy",104,31,6,141,648,2214
"A magician may never reveal his trick, but he can certainly shred the evidence.",124,30,10,164,648,3700
Who says shredding evidence can’t be fun?,125,28,11,164,648,4190
"Ala Ka Zee - Ala Ka Smaxes ,This is why you will never see Trumps Taxes!",117,22,12,151,648,869
Because of the sawing the lady misfortune I'm back to paper restoring only.,115,26,10,151,648,3827
"And for my next trick, I will make your pension funds disappear. You may remember this classic from our 2007 tour.",135,25,14,174,648,3859
"And Abracadabra, out comes a Banksy!",122,29,10,161,648,1410
And the House thought I would veto it.,125,40,6,171,648,2912
One tap of my wand and this document will become a valuable work of art.,131,28,12,171,648,3013
Anyone know how to fix a paper jam?,128,35,8,171,648,3289
And now the collusion,131,28,12,171,648,4236
"Yes, it's true - it is the Social Contract.",140,27,14,181,648,3906
And voila! Trump’s translstor’s notes from his meeting with Putin magically reappear!,125,18,15,158,648,130
... And the Harassment Clause of my assistant's contract...,146,33,12,191,648,2496
The President doesn't care how I make the Mueller report disappear!,128,30,10,168,648,35
"And, voila, our marriage is dissolved. For my next trick...",126,33,9,168,648,449
This is not part of the act - it's revenge for years of paper cuts.,127,31,10,168,648,1892
Subpoena. subpawna. subpohna.,128,29,11,168,648,2940
"My next impossible feat, Mr. President, is to try to protect you from impeachment the only way I know how ....",128,29,11,168,648,3070
"For my next trick, I'll turn this shredded copy of the Constitution into a border wall and then run for President.",129,27,12,168,648,3304
"Watch carefully, I will bring back the Trump-Putin
Meetings Notes.",114,20,11,145,648,2462
"And now, ladies and gentlemen, my Rosemary Woods impression.",110,26,9,145,648,4074
Behold as the Great and Powerful  Giuliani makes collusion disappear before your very eyes!,116,31,8,155,648,3062
I will now place my ballot in this Russian shredder and see who gets elected!,129,22,14,165,648,779
"For my next trick, I will make an official ballot disappear.",123,35,7,165,648,935
Now you see the wall proposal. And now you don’t.,127,26,12,165,648,3900
The real magic comes when we recycle this.,133,31,11,175,648,658
"When I wave this Wand of Privilege, my lovely assistant's allegations against me will disappear! I'll be performing this trick with a new assistant tomorrow.",104,33,5,142,648,784
I place the collusion evidence in the magic shredder and WALLAH!,117,24,11,152,648,471
"Behold! This is the new ballot box/shredder combo machine. If the voter votes for another dumbass, the ballot will be shredded.",118,22,12,152,648,2249
I call this my Banksy trick.,119,37,6,162,648,150
Lieutenant Colonel Oliver North and Fawn Hall take their magic show on the road.,122,31,9,162,648,763
"This isn’t working, do you know how to dance.",127,19,15,162,648,1841
And now I will...oops! Wrong one.,123,29,10,162,648,2733
And this is how we feed the rabbit.,130,32,10,172,648,991
"Excuse me, Ms. Snipes, is this the voting box for absentee ballots?",130,32,10,172,648,1183
And now I place this secret document into the Paul Manafort Signature Model Shredder ...,129,34,9,172,648,1313
Watch me make this Mueller report disappear!,129,34,9,172,648,1835
"And just like that, the minority vote DISAPPEARS!",117,19,13,149,648,72
"Now, Ladies and Gentlemen, let's watch Ms. Giggle's contract disappear as we find out she shared all my tricks on the internet.",113,27,9,149,648,84
"And for my next trick,one that actually works.",121,28,10,159,648,825
The rabbit made an awful mess.,120,30,9,159,648,2081
"If you think about it, it's still a trick.",127,33,9,169,648,729
"And with one tap of my wand, I will make all Russian collusion disappear!",136,32,11,179,648,241
"And for my next act, I'll do my taxes without receipts.",113,23,10,146,648,4070
"Abracadabra, Trump's tax returns.""",119,27,10,156,648,1426
This will shred any doubt that I'm a true magician.,122,23,11,156,648,1693
"Presto-chango, and...not guilty!",118,29,9,156,648,2970
And the Banksy is now magically reassembled!,139,22,15,176,648,358
":...and this trick I like to call...the Oliver North.""",142,32,12,186,648,2588
He is such a bad magician he has to use a shredder to make a piece of paper disappear.,109,25,9,143,648,1627
Bet thisn’t what you thought I meant by “stripper?”,115,30,8,153,648,950
"As you can see ladies and gentlemen, there is no collusion.",120,20,13,153,648,3478
Behold! The Un-shredder!,115,30,8,153,648,3490
"And now, ladies and gentlemen...I will make my heretofore unsubstantiated relationship with Russia disappear. Oh, and my tax records!",119,22,12,153,648,4108
"You're right, this works a lot better than a dove.""",131,32,10,173,648,31
Don't try this with a live rabbit.,131,32,10,173,648,285
This ballot will reappear in a very different form!,130,34,9,173,648,1262
"I used to hide the coin behind my ear,but the IRS caught on.",136,22,15,173,648,3058
And now I shall make this subpoena from Robert Mueller disappear..like magic!,146,36,11,193,648,1133
"And now, my subpoena into confetti trick.",121,30,9,160,648,533
And now you will witness my vote magically disappear.,126,37,7,170,648,548
Does he really think hiring magicians is going to make the whole Russia thing disappear?,131,27,12,170,648,995
"And for this trick, I will amend my tax return.",144,35,11,190,648,1265
"They'll never suspect, if I just make it part of the act!",121,30,9,160,648,2082
For all my past and current assistants claiming abuse and wishing for a mere shred of evidence- wish granted!,114,27,9,150,648,2405
"If it's not a rabbit that comes out of the bottom, run like hell.",109,20,11,140,648,3310
"Thank you, Miss Jones. This is the perfect cover for obstruction of justice!",137,44,6,187,648,2640
"Ipso Facto, Shreddo",137,27,13,177,648,1181
"For my next trick, I will make a shredder not jam.",129,26,12,167,648,194
And now watch as I magically make this evidence disappear.,124,36,7,167,648,1159
"You haven't been replaced, okay. I'll saw you in half later.",128,28,11,167,648,4003
Observe how I make this ballot magically disappear!,117,33,7,157,648,494
"And on the third tap, this shredded document will mysteriously reappear in the Cayman Islands!",113,41,3,157,648,1430
"'Abraconomics!'  I wave my corporate wand, and now there is no pension.",120,27,10,157,648,2516
"And for my next trick, I'll show you the simple art of taking back the district",119,29,9,157,648,2574
I learned this next trick from legendary illusionist Arthur Andersen.,112,26,9,147,648,2330
And shazam! There goes the evidence.,103,29,5,137,648,523
Presto! I will no longer go to prison for fraud!,121,37,6,164,648,781
... and there goes your vote.,127,27,10,164,648,884
Even I can't make Trump's words disappear.,128,23,13,164,648,1545
"And, abracadabra, to the special counsel's delight, shredded documents magically reappear.",125,29,10,164,648,2494
SEE I FIXED IT,127,25,12,164,648,2932
What is it about a shredder that makes me feel like a magician?,125,30,9,164,648,4012
"When I say the magic words, the IRS will have no memory of your tax return.",125,29,10,164,648,4117
"O' K' Ivanka, tell your dad not to worry about a thing.",116,30,8,154,648,908
"Gina, trust me. America’s Got Talent will eat this up.",116,30,8,154,648,2469
Abra Ca Dabra:  There goes the Mueller report!,110,25,9,144,648,2077
And now I will make this ordinary piece of evidence disappear.,138,32,11,181,648,598
"""For my next trick... Donna, where are your pants?""",136,36,9,181,648,2051
For my next trick I'm going to find an assistant who knows how to work a printer.,137,34,10,181,648,3223
And now--we shall make fraud and misrepresentation litigation disappear.,128,35,8,171,648,665
And now the final step in assuring that this can never be traced back to individual # 1!,132,27,12,171,648,706
"And now, with a wave of my wand, I will now make a work of art by Banksy.",133,25,13,171,648,927
It's our new voting system. The outcome is a miracle.,132,27,12,171,648,1394
And then you just shred your dignity like so...,130,31,10,171,648,2052
Now watch as my Yelp reviews disappear,127,20,14,161,648,455
This new voting machine is real sharp.  It even recycles.,124,26,11,161,648,2662
"Now, before we shred my lovely assistant Susan, I'll just prove that it's a real, working paper shredder . . .",123,30,8,161,648,2705
Now watch as the IRS makes my debt reappear,127,20,14,161,648,3250
And for my next trick - I make a felony disappear.,111,18,12,141,648,142
Voilà...presidential tax returns!,125,36,7,168,648,2973
Crank it up a notch. I gotta get rid of this warrant before intermission ends.,129,28,11,168,648,4218
And I say the magic word - BANKSY!!!!!!!!,120,29,9,158,648,3319
"Ta da! First my novel, next my confidence.",120,31,7,158,648,3335
For my next trick I will make my collusions with Russia Disappear!!,113,26,9,148,648,648
Voila!  What once was shredded is now...evidence.,113,26,9,148,648,2636
"And that, my friends, is how you make evidence disappear.",111,30,7,148,648,3501
"This may not produce a rabbit, but it could make our legal problems disappear....",132,34,9,175,648,3268
"Yes, the rabbit does live in there and this is how he gets fresh bedding.",134,30,11,175,648,3302
My next trick is debt-defying.,133,32,10,175,648,4047
"Ladies and Gentlemen, this ""tax evasion"" number is literally cutting-edge",105,25,8,138,648,2994
No! Banksy stole this trick from me!,127,27,11,165,648,377
I learned this ballot box trick from comrade Putin.,126,29,10,165,648,1390
"Giuliani defends Trump: ""...and abracadabra, not a shred of evidence here!""",124,33,8,165,648,2319
"And at the count of three, no more incriminating evidence.",124,34,7,165,648,3836
Watch very closely as I make the President’s tax return disappear.,118,28,9,155,648,2908
"okay, this time will try it with paper and if it works, we'll use the rabbit again",121,22,12,155,648,3885
And the Federal debt seems to disappear...,137,36,9,182,648,639
"For my next trick, I will make whole the shredded IRS returns of the President.",112,23,10,145,648,2772
"Ladies and gentlemen, the power of magic is about to reveal the President's complete tax return.",130,33,9,172,648,218
I will now make this cartoon caption entry disappear.,127,39,6,172,648,569
"Now, I chant the magic word Vladimir three times and presto, change, those notes are from a meeting that never even happened.",133,27,12,172,648,2514
...and now for my final act... an original Banksy,124,28,10,162,648,868
Now watch as I make this piece of damning evidence magically disappear!,124,28,10,162,648,934
A magician never reveals his secrets... or his sensitive account information.,122,32,8,162,648,946
"For my next trick, I will plead the fifth before Congress.",125,26,11,162,648,1385
And now for my impersonation of a southern voter . . . .,124,30,8,162,648,1445
AbracaBansky,122,32,8,162,648,2368
I learned this trick from Banksy.,119,21,12,152,648,667
"I take these confidential papers, say the magic words, ‘reductio ad absurdum’, and it’s like nothing ever happened.",132,24,13,169,648,944
I will now make my tax liabilities disappear...,128,32,9,169,648,960
Voila! Coleslaw.,128,32,9,169,648,3977
And that ladies and gentleman is how you make tax returns disappear.,122,27,10,159,648,343
Now watch as I make the photos that my wife had of you and me disappear!,131,39,6,176,648,302
"Going, going Banksy.",134,32,10,176,648,1494
I will now make Russian Collusion disappear.,138,24,14,176,648,3091
And now I will magically shred this evidence for Mr. Trump.,151,27,15,193,648,1512
Jeff your not a magician and we still have to pay the bill!,118,18,13,149,648,1286
For my next trick I will make your job disappear.,116,23,10,149,648,4079
Oi vey! It's whole again!,124,35,7,166,648,417
"Taxes done, now to run for President",126,31,9,166,648,877
Thank you madam for your federal-employment contract; let's put it through this and we'll see what happens...,126,31,9,166,648,1489
"And Voila, the indictment goes away!",126,31,9,166,648,1556
Prototype Magic Ballot Box (TM) for 2020 Trump supporters.,138,36,9,183,648,1918
"If this works, the original Bill of Rights should come out of my hat.",139,34,10,183,648,3536
Presto-Chango....Now...into the Electoral College counter....,121,24,11,156,648,348
"And just like that the interpreter’s notes disappear. For the interpreter, we’ll need a wood chipper.",135,25,13,173,648,3143
"... And after our vote gets processed by the E-Voter2016 machine,it gets sent to the electoral college.",126,26,11,163,648,1099
No deductions up my sleeve.,122,34,7,163,648,1795
"And for my next trick, Mr. President, I'll turn proof of collusion into pretty confetti!",123,32,8,163,648,1875
It’s magic!  Hillary’s missing emails have reappeared!,124,30,9,163,648,3338
....then....from this shredded tax return...voila! A presidency!,127,24,12,163,648,3779
I used a white rabbit before PETA got wind of it.,126,26,11,163,648,3822
And now I will feed this ordinary page of translater’s notes into the shredder.....,136,35,9,180,648,3628
Notice my hand never leaves the mail fraud evidence.,135,37,8,180,648,4233
The real magic is making your student loan debt disappear!,139,41,7,187,648,295
"And with a waiver of my wand, your vote disappears!",129,32,9,170,648,1611
Presidential interpreter,115,31,7,153,648,2463
"Yes, it's your resume.  
Or did you change your mind about the sword box?",129,32,9,170,648,2504
Do you remember the trick to unjamming these?,112,37,4,153,648,2797
"And now I present to you, the results of the presidential election.",107,18,11,136,648,3104
"And now, for my old ""Shred of Evidence Trick""!",137,28,12,177,648,580
"Yes, this is how 50 Shades of Grey ends.  For good.",135,33,9,177,648,3973
"President Trump's brand new Attorney General, making his very first appearance, along with the U.S. Constitution -- its very last.",111,23,9,143,648,758
Abraca - PAPER JAM!,128,30,9,167,648,2536
Now presenting... How to Cut Your Bills in Half!,130,25,12,167,648,3991
And the Oscar goes too...,135,27,12,174,648,2680
Now watch closely as I make my student loans disappear.,116,36,5,157,648,1956
"I’ll keep the return here, for safe keeping",124,21,12,157,648,3401
"For my next trick, I will make the Russian Interpreter's notes disappear!",136,37,8,181,648,1104
and NOW.......The missing POTUS  Tax Return!!,141,27,13,181,648,1332
Presto! Chango! Subpoena Disappearo!,137,35,9,181,648,3019
"Buck up, Lisa. We're performing for the President this weekend.",137,35,9,181,648,3644
"And that, Mr Trump, is why I, the Magnificent Magoo, should be your lawyer!",127,26,11,164,648,1011
"As I toast to a crisp this amorous note from my beautiful assistant here,  please some applause for my lovely wife, who couldn't be here tonight.",127,29,8,164,648,1507
"I will put my ballot into the ballot box, wave my magic wand, and undo the results of the last presidential election.",123,34,7,164,648,2311
I now invite Mr. Mueller to come to the stage.,143,35,10,188,648,723
"Behold, ladies and gentlemen, as I make this vote miraculously disappear.",131,30,10,171,648,1567
"Watch carefully, Ladies and Gentlemen.  Later in the show I shall use my magic wand to reconstitute this absentee ballot.",130,32,9,171,648,3657
"I am a magician, not a freaking accountant.",118,27,9,154,648,635
For my next act I will be getting the IRS off my back,116,31,7,154,648,1964
This is the Constitution.  Wish me luck...,134,36,8,178,648,3251
Watch the paper disappear and then reappear as a shredded rabbit.,125,25,11,161,648,1252
No matter. It was mostly in Russian anyway.,125,25,11,161,648,1506
"As promised in my confirmation hearing, here is the Meuller Report.",123,29,9,161,648,3907
"I don’t think magic will work dear...
It has to be a Banksy for it to double in value when you shred.",140,36,9,185,648,986
I call my next trick The Amazing Bladen County Ballot Box.,132,23,13,168,648,445
"Watch, as I make my assistant's sexual harassment 
complaint magically disappear!",131,25,12,168,648,1067
The spirit of Houdini tells me the rabbit is in dire need of new bedding,131,37,7,175,648,118
Ev'ry vote Counts!,136,28,11,175,648,2825
And my next trick is to make this document reappear as a fully assembled skirt for you.,136,28,11,175,648,2969
"Trust me, it's a lot more impressive with a rabbit.",135,29,11,175,648,3903
And now please observe me destroying the contract in which it states that I will appear to saw Lydia’s body in half in a way that is objectifying and demeaning.,116,26,9,151,648,448
"And presto, the fraud case against me disappears!",113,32,6,151,648,4147
I do not think inserting a piece of paper in a shredder is the warm-up I want you doing before you saw me in half.,121,28,9,158,648,1403
"I thought for the trial run, we'd just use paper.",121,28,9,158,648,2180
"Now I reverse the shredder, and, presto, out comes a perfect copy of President Trump's translator's notes from his Helsinki meeting with Vladimir Putin!",122,26,10,158,648,2734
"Here is the ""disappearing Mueller Report"" trick that the Republican members of my audience love.",143,37,9,189,648,3834
And now I will demonstrate how to make a ballot disappear!,127,28,10,165,648,1861
The real illusion will be convincing the board that we didn't actually do this.,126,30,9,165,648,2078
"And this is one I like to call the ""Enron""",125,33,7,165,648,2460
and now I will make the evidence disappear!,125,32,8,165,648,2544
"Thank you, translator.  That's all I need.",129,24,12,165,648,2916
This trick seems to work much better with paper than it does with birds.,127,28,10,165,648,3495
"And for my next collusion, watch as I make the allegations disappear",111,19,11,141,648,1854
The executives at the corporate retreat were both frightened and amazed at the magician's ability to unshred the Q4 earnings report,110,22,9,141,648,3624
My last trick requires a little bit of presidential inspiration...,131,34,7,172,648,476
...and here we will shred the interpreter's notes from Helsinki,134,26,12,172,648,743
"And for all you youngins out there, before the delete button, we had something more reliable.”",132,30,10,172,648,957
"As Attorney General, my next trick is to make these translator's notes disappear.",134,26,12,172,648,1435
Presto ! A full text of the translator's notes from the reverse shredder!,135,26,11,172,648,2195
"And with a swish of my wand, I will clear the jam!",114,25,9,148,648,1246
"For my final act, 
I will make my prenuptial agreement disappear.",135,36,8,179,648,48
The shredder ate my homework!!,139,32,8,179,648,155
This trick worked for Banksy!,136,34,9,179,648,1541
Abraca....dagnabit! I actually needed that.,115,35,5,155,648,45
"Miss McGyver, I believe your thumb has jammed the mechanism.",120,25,10,155,648,322
Folks this thing is not even plugged in!,117,31,7,155,648,1309
Insert here and voila! No more Constitution.,118,29,8,155,648,3232
And our next president is...,147,38,8,193,648,1098
"...for my next trick, these teeny, tiny hands will pull a great big beautiful wall out of my hat!",108,20,10,138,648,3456
And this ladies and gentlemen is the magic of the KonMari method.,135,31,10,176,648,222
Watch as I make the president's tax returns disappear.,135,31,10,176,648,363
"And now, I will make your vote disappear.",133,35,8,176,648,539
I hear there is an even better magician named Bob Mueller who will make the evidence reappear.,132,37,7,176,648,1161
That was the death certificate for the other girl.,137,27,12,176,648,3002
"And now, ladies and gentlemen, watch as Trump’s tax returns disappear right before your very eyes!",112,25,8,145,648,1433
My genius “ magician “ believes there’s only one copy of our prenup .,112,24,9,145,648,1828
Presto!  And the Mueller report disappears.,113,34,5,152,648,2422
Now observe as I magically transform this restraining order into harmless confetti!,124,24,11,159,648,3825
Let's warm it up before we bring on the rabbit.,127,32,7,166,648,200
Muller will never find it here,127,30,9,166,648,483
"Watch closely folks, here's a trick that blew their minds in the Oval Office!",127,30,9,166,648,2667
"Before your very eyes, a presidential address becomes an anthology of tweets.",125,34,7,166,648,3741
Hopefully this trick will turn out better than the time I tried it with a dove.,127,31,8,166,648,4217
"This isn’t a trick, I’m just celebrating my PHD loans being paid off.",133,31,9,173,648,362
"And now, Ladies and Gentlemen, performing for the first time in public, I give you The Great Banksy...!!!",134,28,11,173,648,559
This is your ballot; this is a ballot box.,131,34,8,173,648,1367
"For my next trick, watch me make President Trump's subpoena disappear.",129,38,6,173,648,3102
"And with this trick, I reveal the magic at the heart of the Enron scandal.",135,39,6,180,648,432
Data!,105,21,9,135,648,2384
Voter suppression magic,123,22,11,156,648,1672
Voila! The president’s Putin notes disappear!,123,33,7,163,648,2063
"And, the Trump Tax Returns look like ...",130,31,9,170,648,1531
"As my mother always said, why hire an accountant when you’ve got MAGIC!",130,31,9,170,648,2347
And presto! All your hopes and dreams are gone.,129,33,8,170,648,3684
With a quick 'abracadabra' the U.S. Constitution is 'Trumped'.,141,33,10,184,648,506
And my next trick will be avoiding an indictment.,137,41,6,184,648,2563
And here's the  page that keeps Social Security running for another 150 years.,112,26,8,146,648,833
A magician never reveals his secrets.,125,24,11,160,648,626
A true magician always shreds his secrets.,124,29,7,160,648,2651
"There! Magically, one vote is now thirty minority votes.",131,24,12,167,648,1055
Miss Shimansky was beginning to have doubts about the interview process for administrative assistant.,131,24,12,167,648,2234
"I call this trick ""the subpoena solution"".",128,30,9,167,648,2554
Watch in wonder as I make a letter from my ex-wife’s attorneys disappear.,125,36,6,167,648,4161
I learned this banking trick during the Great Recession.,140,30,11,181,648,1858
Who really reads instructions?,138,34,9,181,648,2185
Watch as I attempt to cut the evidence against me in half.,144,22,15,181,648,3344
"And for my next trick, watch me unshread wheat!",116,25,9,150,648,3270
The magic part is when I make this credit score disappear from Google.,122,25,10,157,648,1609
"Uh oh, we may have found Trump’s long lost tax return!",120,29,8,157,648,3776
"Fleer-o, schmeer-o, criminal record disappear-o!",122,37,5,164,648,482
And now let's see what news the toaster of fate will bring us.,129,35,7,171,648,173
"Shut down or no shut down, we still have to shred.",131,31,9,171,648,1786
"I don't understand, it worked great for Banksy...",137,33,8,178,648,2398
"Et voila, hanging chads!",136,33,9,178,648,2564
Now watch carefully as the incriminating document miraculously disappears!,135,35,8,178,648,3327
Now watch as I file my tax return.,140,25,13,178,648,4222
And voilà — my embarrassing high school poetry disappears.,115,34,5,154,648,21
Watch as this environmental regulation disappears!,146,32,11,189,648,252
Watch as I make my assistant's sexual harassment claim disappear right before her eyes!,125,26,10,161,648,391
And it will re-appear as Trump’s tax turns!,132,24,12,168,648,813
"Only 32,999 left to go.",130,28,10,168,648,1469
Alice will now take this backstage to Mueller the Magical Mender.,112,28,7,147,648,1845
"For my next trick I will
make this Cartoon Caption Contest submission DISAPPEAR!",125,26,10,161,648,2083
For my next trick I'll need an omelet.,127,22,12,161,648,3071
My attorney tells me it will take some real magic for these charges not to stick.,131,27,10,168,648,3939
My next trick will be how you change the results of an election.,144,31,11,186,648,3311
"After I say a few magic words, President Trump's complete IRS 1040 Tax Return will appear.",137,33,9,179,648,3727
"My final trick: tax evasion. Now the IRS sees it, now they don't.",132,31,9,172,648,1325
"A simple wave of the wand, slight of hand and PRESTO...  No collusion!",132,31,9,172,648,1554
And now for the famous Banksy trick.,139,17,16,172,648,2056
"Get the smile back, smile, smile!  We need them to think the jam is part of the act.",131,34,7,172,648,3555
"On the count of three, your credit rating will emerge intact!",126,31,8,165,648,372
"At the request of audience volunteer Mr. Bezos, I will make this prenup disappear.”",125,36,4,165,648,401
"Pay attention, folks.
This is a Florida ballot box...watch my vote disappear.",129,25,11,165,648,2841
"And when this is reassembled, my assistant will read the winning caption.",130,23,12,165,648,3040
And now for the greatest trick of all...I call it the Banksy...,123,25,10,158,648,997
"And now, Ladies and Gentlemen, my final act! Watch closely as I turn Robert Mueller’s report on Russian collusion into thousands of tiny bunnies!",126,19,13,158,648,2880
"Abra Cadabra, the President's unshredded tax return!",122,27,9,158,648,4010
"And that, Ladies and Gentlemen, is the magic behind Shredded Tweet.",141,32,10,183,648,757
Banksy's shocking side hustle,141,20,15,176,648,679
This trick used to be better but I couldn't afford the doves.,132,26,11,169,648,446
A rabbit out of a hat is so last millennium.,128,34,7,169,648,958
And now I distract my wife with meaningless patter as I slip our Pre-nup into this Magic Box...,125,40,4,169,648,1748
"And now,for my next trick,I shall pull an unemployment check out of a printer.",135,23,11,169,648,2847
And now we will make the government shutdown appear as if the workers are happy to work without pay.,127,24,11,162,648,969
Auditions for a new White House Russian translator were surprisingly competitive.,127,25,10,162,648,3219
Pulling a rabbit out of the hat just wasn’t cutting it anymore,119,29,7,155,648,924
And with a tap of my wand the Rabbit's vet bill will disappear!,120,26,9,155,648,3486
Anyone else have a bill you want to see disappear?,118,30,7,155,648,3849
"First, I shall shred my assistant’s contract.  Then I will use hypnosis to convince her she’s a volunteer.",142,25,13,180,648,1917
"Just put the speech in like so, and, Hey Presto! Out comes Donald's words!",147,16,17,180,648,4058
"And now, with a little wave of my wand and the assistance of lovely Myrna, I make your lawsuit disappear!",134,29,10,173,648,856
"And yes here it is, we are reversing the President's tax returns from the shreds we found earlier.",133,31,9,173,648,2181
"Hold on, that looks like the pre-nup....",135,27,11,173,648,3998
"Voila`, the notes from Trump's in interpreter.",132,23,11,166,648,2737
We will magically make this vote disappear.,126,21,12,159,648,2369
"...and viola! Kellyanne, your worries have disappeared!",121,32,6,159,648,2532
Presto!!!  Pasta!!!,124,25,10,159,648,2894
Voila! Here is the disappearance of Donald Trump's tax return.,123,27,9,159,648,3829
You're next Debbie. Feet or headfirst?,124,25,10,159,648,4215
And another 'vote' for Stacey Abrams,117,27,8,152,648,1768
"My assistant is holding an ordinary box, just an ordinary box.",114,33,5,152,648,3085
"For my next trick, I'm going to make this Banksy painting worth millions, oh, I forgot to sell it first",119,23,10,152,648,3403
Who wants to aid and abet the next trick.,141,46,4,191,648,4110
So much for your much-vaunted Constitution!,140,36,8,184,648,1521
Behold -missing ballots from the election.,138,28,11,177,648,643
‘And this is how we make your vote disappear’,136,32,9,177,648,3057
The vote is now toast.,138,28,11,177,648,3843
Waldo the Great performs at the Home for the Technically Challenged....where paper shredding is considered one of the Black Arts.,130,32,8,170,648,3579
Perfect! Now there's barely a shred of evidence I cut your sister in half.,133,26,11,170,648,3635
Every vote counts. Except those for the other candidate.,129,34,7,170,648,3898
"For this next trick, I’ll need a racketeer.",128,24,11,163,648,251
Abracadabra--now I never said that!  I wasn't even there!,131,23,9,163,648,2133
And just like that my subpoena disappears.”,127,26,10,163,648,4021
We Trumps understand the magic of making our tax returns disappear for good!,159,31,12,202,648,990
We can't use my hat because there is a rabbit in it.,117,34,5,156,648,267
This will prove that there is not a shred of evidence this wand actually works .,120,28,8,156,648,330
"I assure you, your petition is transmitted directly to the base station in the Oval Office",155,25,15,195,648,1857
"Remember: if  the SEC asks, I can never reveal my tricks.""",149,37,9,195,648,1992
And the Democratic nominee is........,118,32,6,156,648,3611
"Observe, your last check following the government shutdown!",115,26,8,149,648,2601
The effect is better with a toaster.,113,30,6,149,648,2715
"And now, behold, Article I, Section 9, Clause 8 of the United States Constitution, will disappear before your very eyes...",116,24,9,149,648,3556
I may need a new rabbit...and a new shredder.,115,27,7,149,648,3909
Evidence disappears — like magic!,134,31,9,174,648,631
Trump asked me to make his tax returns disappear.,139,21,14,174,648,2091
"And for my last trick, I will make paper filing irrelevant.",136,27,11,174,648,3177
Maybe old school with a rabbit and hat was actually better.,130,39,5,174,648,3279
"And now, I will make the pre-nup dissappear!",134,31,9,174,648,3659
"DACA: Now you see it, Now you don't!",133,33,8,174,648,3735
Magically sawing ladies in two is so 20th century.,131,25,11,167,648,1082
Watch as I make this letter from my father questioning my career choices disappear.,126,35,6,167,648,2599
Into the shredder goes bipartisan compromise.,130,29,8,167,648,3473
"And before your very eyes, I'll make it reappear from the cloud.",123,29,8,160,648,2188
"Hold on, ladies and gentlemen. I have here a subpoena for someone in Row 2, Seat No. 356.",117,27,8,153,648,2204
"Behold the Captionator! In goes a brutal cartoon caption and out comes a hilar—, no, still brutal.",119,25,9,153,648,2688
"For my next trick, I'll need an email server...",121,21,11,153,648,3027
I will now transform this authentic tax document into an audit.,120,24,9,153,648,3731
"And magically, your non-disclosure agreement appears whole from the shredder.  Is this your signature?",136,34,8,178,648,1389
Next we put the Interpreter's notes right in here....,114,23,9,146,648,889
For my next trick I'm going to need someone from IT.,115,22,9,146,648,2967
And watch as the subpoena magically goes away.,134,26,11,171,648,3342
An identity thief never reveals his secrets,130,37,4,171,648,4065
"For my next trick, I’ll be making the president’s tax returns disappear! Don’t look so so scared, Ivanka! Michael Cohen told me to do it!",125,32,7,164,648,3980
And now watch as I convert lovely Linda's full time employment into contract labor.,123,36,5,164,648,4069
Need help winning an election?  This magic voting machine shreds ballots you oppose and counts your favorites!,129,24,11,164,648,4121
The office can be a magical place.,145,36,8,189,648,405
"And the Oscar for best picture goes to, “oops daisy” !",121,28,8,157,648,1819
The real magic: a working printer!,120,30,7,157,648,1998
And now we present—the cheapest alternative to divorce lawyers.,122,26,9,157,648,3433
Voilà! The presidential documents are restored unshredded.,138,25,12,175,648,489
Now I will make this lawsuit from the family of my last assistant disappear.,114,30,6,150,648,3887
I shall now shred the directions for sawing my partner in half and do the trick from memory!,126,37,5,168,648,1171
Enron The Magnificent!,130,31,7,168,648,2336
Watch me pull an email out of a shredder!,130,29,9,168,648,3036
This is the GOP's new ONE STOP voting trick.,131,27,10,168,648,3350
"And when it comes out the other side, Mueller's report will miraculously say every shred of evidence points to collusion!",146,29,11,186,648,966
The rabbits have called in sick. Apparently they're not convinced by your new disappearing trick.,144,33,9,186,648,2026
Its all in the wand,144,32,10,186,648,3081
Watch as I make my carbon footprint disappear!,138,32,9,179,648,842
"For my next illusion, I will make confetti out of this paper....",120,25,9,154,648,1994
"And with a wave of my magical wand—the greatest magical wand in the history of the world, I will attempt to make my conversations with Putin disappear with No Collusion!!!",118,29,7,154,648,2725
And this is how you make an investigation disappear.,141,15,16,172,648,735
"I really don’t think it’s going to come back out again, Doug”",131,34,7,172,648,1851
They should know better. Magicians cannot be subpoenaed.,134,28,10,172,648,2805
"And for my next trick, watch me make this tax return disappear.",130,36,6,172,648,2995
Observe. Collusion. No collusion.,132,32,8,172,648,3410
"And now, the transcripts of my conversation with Putin will disappear.",114,25,8,147,648,454
I will now make my tax return disappear just like magic!,124,36,5,165,648,1492
I did this trick with the government some time ago.,127,30,8,165,648,2402
"The obvious question is why I just don’t make it disappear, right?",127,30,8,165,648,3959
I am taking a thousand pieces of shredded paper and turning it back into a—what do you mean there’s no reverse button!”,140,35,8,183,648,2708
"Keep your eyes on the marriage certificate, and...presto estrange-o!",125,22,11,158,648,183
And now presenting the Great Redacto,119,34,5,158,648,823
Why campaign? It's easier to get elected this way.,128,17,13,158,648,2830
"As our President might say, this memo is toast.",138,27,11,176,648,1429
I will now attempt to make the president disappear.,138,27,11,176,648,1678
"Now, watch me turn this Shredded Tweet into a bowl of Special Kounsel",136,31,9,176,648,2919
It isn’t a magic trick. It’s the transcript of Trump’s Helsinki meeting with Putin!,131,31,7,169,648,187
"Behold my dignity: now you see it, now you don't.",131,30,8,169,648,1188
"Oh darn 
That was my grocery list!",132,27,10,169,648,1706
Watch me make this incriminating evidence disappear!!!,125,29,8,162,648,712
"Now, get the blender.",123,33,6,162,648,1591
"And, now, for my next trick as your new attorney general, watch as I make these records disappear.",126,28,8,162,648,2142
Hmmm and now I make disappear my Putin notes.,128,23,11,162,648,2167
Now I'll place my campaign pledges in here...,125,29,8,162,648,2289
And now I file the notes from the translator.,129,21,12,162,648,2495
My attorney insisted I not rely on abracadabra.,123,33,6,162,648,3833
"Abracadabra is so eighties, ma'am; it's 
'Brexit, Smexit' nowadays.",130,38,5,173,648,1691
"For those of you loudly demanding refunds, yes, I used to ‘saw the lady in half,’ but thanks to the #MeToo movement, well ... let’s just say I’m a little more ‘woke’ than I was.",133,34,6,173,648,1775
"And suddenly, Ladies and Gentlemen, right be fore your very eyes, everything Mr. Rudy Giuliani has been saying for the last two years comes true: there is no proof of collusion!",130,38,5,173,648,3852
Trump thought he had shredded his instructions from Putin--but voila!,123,21,11,155,648,4071
Voila! No jam!,142,33,9,184,648,1184
It's for the rabbit coop.,146,25,13,184,648,4219
Told you I could make your paycheck disappear.,131,24,11,166,648,270
Now watch as I make this subpoena disappear,128,30,8,166,648,350
"Behold, as I pull from my magic reverse shredder the tax returns of…of…oh my goodness would you look at that?",130,26,10,166,648,453
Abracadabra! Your transcripts from the Trump/Putin meeting will now vanish forever,130,26,10,166,648,2186
Now watch our Democracy disappear.,132,22,12,166,648,2218
"This time, we'll skip the rabbit",128,30,8,166,648,3819
When the wrong people vote---that's when the magic starts!,116,23,9,148,648,650
Lady’s & Gentleman; At No time will you see this Sexual harassment complaint leave my hand,150,36,9,195,648,4050
"And poof! It’s disappeared. Now for my next act I will pull out a clean set of tax returns out of a hat. Caroline, will you help me please?",137,32,8,177,648,1070
"And voilà! By shredding this last document, I've completely deleted my Facebook account!",138,29,10,177,648,1663
"And now, I’ll make that complaint you made against me to HR disappear.",134,37,6,177,648,1698
This is how you make voting rights disappear!,127,20,12,159,648,948
Abracadabra shred this presidency!,113,17,11,141,648,947
Observe how the paper is restored as I pull it out of the machine!,132,29,9,170,648,424
"The paper shreds and presto, a three-toed sloth rises from my jacket pocket.",134,25,11,170,648,3941
I learned this from the Clintons.,119,24,9,152,648,765
Thank you Mrs. Clinton!,119,24,9,152,648,1508
"And with a tap of his wand, the subpoena disappeared.",119,25,8,152,648,2921
"For our next trick w shall repair this jammed shredder, without benefit of pliers which my lovely wife Joanne, here, made disappear from our tool kit, last month, when attempting to repair a brassiere",145,24,12,181,648,296
"For this next act, I’d like to introduce my lovely assistant and part-time paralegal, Diane.",133,46,2,181,648,3204
Leave it to James to make a big show of the divorce. This is precisely why she had left him in the first place. The rabbits in the bath tub were also part of it.,130,21,12,163,648,13
"And for my next trick, I will protect my personal data.",127,27,9,163,648,2442
"Abracadabra, there goes my art history degree ...",125,31,7,163,648,3798
"And for our next trick: how to vanish a failed safety inspection! On an unrelated note, Fluffy the rabbit will not make an appearance in today’s show.",139,22,13,174,648,574
"Finally, I’ll wave my wand... and presto! The dinner invitation from the Johnson’s has magically disappeared!",133,34,7,174,648,761
"No, I can't use this trick on your student loans.",112,26,7,145,648,859
"Newly retired, Shirley and Oscar explore ways to spend their time.",149,21,15,185,648,1705
Banksy tells me this trick could make me a millionaire.,120,32,4,156,648,2862
Behold as I will now turn myself into a Presidential candidate!,129,30,8,167,648,3358
And now I will magically turn campaign promises into reality.,131,26,10,167,648,3618
I know I know -but it’s my first gig after losing my job as an auditor!,135,37,6,178,648,254
"Well, I was thinking of a rabbit but I guess our marriage license works too...",141,25,12,178,648,709
Plausible Deniability!,117,26,6,149,648,3139
The translator's notes from Helsinki.... Presto! All gone! Never existed!,144,38,7,189,648,1125
I learned this technique from Banksy.,148,33,8,189,648,1889
"And with a wave of my wand, The Great Splendini makes my lovely assistant’s sexual harassment claim disappear.",125,26,9,160,648,219
and ... PRESTO! Our taxes are done for 2018!,124,28,8,160,648,495
Watch and see Mr. Bezos's prenup disappear and miraculously end up in my hat...,126,24,10,160,648,2123
The real trick is how I manage to stay ahead of the IRS.,124,29,7,160,648,3115
...and voila! All my legal problems disappear.,129,37,5,171,648,1449
Once a Brexit Plan...,133,29,9,171,648,2569
"And here we have the 'Donald' © brand Make-A-Wish machine, and Voila!, problem solved, budget balanced, wall built, and America is great again!",136,23,12,171,648,2925
"How do you say ""abracadabra"" in Russian?",139,36,7,182,648,1424
Pay attention as my last shred of dignity disappears.,143,29,10,182,648,1587
"I call this ""The Disappearing Banksy"".",108,29,5,142,648,2987
"You should have made these disappear two years ago, Hillary.",116,32,5,153,648,409
"Now you see it, now you don't",119,26,8,153,648,607
"Think it's a magic act??? No, it's just Trump ""sorting his paper trail.""",120,24,9,153,648,3629
I can't believe people pay me to draw this shit.,133,17,14,164,648,61
"Pitney Bowes, the early years.",128,27,9,164,648,503
And first I will shred the pretty assistant's life insurance contract.,130,23,11,164,648,1465
"And just like that, there go his tax returns.",128,27,9,164,648,1737
Now this parking ticket will become a priceless work of art.,128,27,9,164,648,1872
"There goes your employment contract, my dear... and POOF! You're a freelancer!",127,29,8,164,648,2332
"Miss May and I will now insert the European Union Agreement here, and wave this magic wand, and . . . .",123,25,9,157,648,2413
The president and his translator after hours,125,21,11,157,648,2421
"And presto--my lovely assistant's pre-nup disappears!""",121,29,7,157,648,2575
"They only disappear if you say the magic words:  ""IRS audit"".",131,28,9,168,648,787
And with no hesitation whatever I consign my IRS audit to the firm hand of my sorceror's apprentice.,129,32,7,168,648,1650
"Now, we make Mrs. Marvin the Magnificent's prenup disappear.",130,30,8,168,648,2128
"And then presto, a whole piece of paper becomes eight pieces of paper!",140,29,10,179,648,1464
I will now make the translator’s notes disappear.,143,23,13,179,648,1754
Watch while my opponent's votes disappear,136,37,6,179,648,1824
"I know it's not much, Pam, but at least with this trick I don't risk pulling out a dead rabbit in front of a bunch of six-year-olds again.",136,37,6,179,648,3035
Abracadabra we are now divorced!,157,33,11,201,648,1538
Watch as I make this incriminating evidence of my ongoing tax fraud disappear!,123,33,5,161,648,422
"The Federal Budget, in the style of Banksy",124,30,7,161,648,719
The real magic is in Cayman,126,27,8,161,648,2545
"In preparation for my next saw trick, here is my assistant's liability release form; I call this bit ""beyond a shred of a doubt"".",125,31,5,161,648,3001
The bunny has mixed feeling about this trick,127,24,10,161,648,3905
"I shall now make the instructions for the ""cut-the-lady-in-half"" trick, which didn't work out so well last time, disappear.",127,25,9,161,648,3976
"The good thing about this honey, is that the bills will disappear. magic school paid off!",136,26,10,172,648,899
I will now make the evidence... disappear!,133,31,8,172,648,1418
And voila!  The KGB puts it back together.,132,33,7,172,648,1589
It seemed so easy when Banksy did it.,137,23,12,172,648,2361
"Virginia, your letter to Santa will arrive electronically!",136,27,9,172,648,3704
If the president can do it...,143,32,8,183,648,3063
"And now i will make a five year old document, not just relevant but crucial.",139,27,10,176,648,197
And now to make all allegations of sexually harassing my lovely assistant disappear.,117,32,5,154,648,232
"This is the famous ""Nixon Trick"" soon to be renamed the ""Trump Trick!""",121,24,9,154,648,264
Watch as I transform this budding novelist into a magician's assistant!,129,27,9,165,648,1163
...and Presto!  No more prenuptial!,136,34,6,176,648,1355
"[under his breath] Don't worry, Diane. A magician always files his secrets in triplicate.",145,33,9,187,648,2641
"Voila madame, your prenup has disappeared!",135,34,7,176,648,4180
"Now, watch me make the translator's notes disappear!",141,29,10,180,648,891
A magician never reveals his secrets...or his gluten free muffin recipe.,139,33,8,180,648,1633
This should work better than the rabbit.,140,31,9,180,648,3934
"Disappearius, last-yearius, Tax-returnius",137,37,6,180,648,4057
Now just watch as I make your stock earnings from 2018 disappear.,133,27,9,169,648,905
...I tap the ballot box three times...,130,32,7,169,648,3425
"And now, presto chango, the first of Hillary’s missing e-mails.",131,30,8,169,648,3671
"And voilà, your tax return is on its way to the IRS!",126,21,11,158,648,2533
...and now I will make the evidence magically disappear! ....I said MAGICALLY DISAPPEAR darnit!,115,25,7,147,648,2109
"Remember, ladies and gentlemen, as I shred my only copy of my W2, the blank 1040EZ remains locked in a steel case on the other side of the stage!",113,28,6,147,648,3414
The rabbit's on furlough. Pulling his contract out instead.,107,21,8,136,648,2143
"At the count of three, I will turn this single sheet of paper into dozens of little sheets.",106,23,7,136,648,2698
"Now you see my assistant's non-disclosure agreement—wait a minute!""",141,36,7,184,648,4239
I want to be known for really tearing it up on stage.,134,31,8,173,648,2043
The real magic will be the massive corporate bonus I earn for disappearing the evidence.,138,23,12,173,648,2362
"If shredding evidence isn't Magic, I don't know what is.",132,35,6,173,648,3519
Abracadabra! I will now make the notes from Trump's meeting with Putin disappear.,125,30,7,162,648,937
No subpoena can bring this document back.  I am sworn to secrecy by the magician's code.,128,25,9,162,648,1825
"For my next trick, I will disappear all record of my contact with the Russians.",128,24,10,162,648,2682
"And, for our finale, we’ll scrub a computer hard drive.",126,28,8,162,648,2752
For my final disappearing act: the Constitution.,117,27,7,151,648,1668
Sorry that I forgot the table.,109,24,7,140,648,2573
Watch as I make Trump's returns disappear!,138,30,9,177,648,998
"And now, for our Bansky fans...",141,24,12,177,648,1760
"It is, of course, a standard cross-cutting shredder, producing the confetti from which I will make a bill acceptable to the House, Senate, and Mr Trump",128,31,7,166,648,605
"We put the vote tally in the shredder and the President becomes dis-elected, Abra...",130,29,7,166,648,1912
And for my final illusion I will shred the constitution and reassemble it in perfect Russian. I call it the Trump Triumph,131,28,7,166,648,2251
"Yes, that's my only copy of the Saw-The -Lady-In-Half Trick instructions.",119,30,6,155,648,244
Watch me carefully: for every ballot voted for me we will have three.,123,24,8,155,648,2960
"The lesser known brother, Binksy the Magician, never had a very big following.",123,22,10,155,648,3359
"The Great Giuliani is unsurprised to see,“Tell them anything but the truth, Michael!” reconstitute from shreds.",126,16,13,155,648,3982
"Before the shutdown, I made the big bucks doing this",122,24,9,155,648,4072
And now......Right before your very eyes.....AG  William Barr will make the Muller report DISAPPEAR!,112,25,7,144,648,3325
And voila! That incriminating letter shredded by your cheating husband is now in perfect condition.,115,19,10,144,648,3376
A Trumpian tax audit. The magic is that he hasn't been caught!,142,29,10,181,648,202
Banksy is to art as I am to magic!,134,26,10,170,648,1908
"Well, this trick worked for Banksy, so here goes!",128,38,4,170,648,2006
And the disappearing student loan winner is...,131,32,7,170,648,2240
Another vote for Mitt Romney!,132,30,8,170,648,2434
See my Congressional Subpoena disappear!,132,30,8,170,648,2440
"I'm glad you agreed to shred the prenup, it was ruining the magic between us.",134,26,10,170,648,3037
"What happens in Vegas, stays in Vegas.",129,36,5,170,648,3841
Abracadabra! It's a Banksy.,122,31,6,159,648,809
"Next, I will attempt to join not two, not three, but four sheets of paper together with a stapler!",116,24,8,148,648,159
"As I shred this birth certificate, watch our volunteer from the audience vanish.",113,30,5,148,648,2291
I call this trick my reverse Banksy.,146,28,11,185,648,3330
Behold the magic of corporate law !,139,23,12,174,648,95
And now to make the Mueller investigation disappear.,147,33,9,189,648,2353
Abracadabra Banksy!  It's now worth over $2 million!,119,26,7,152,648,3612
For my next deduction . . .,140,28,10,178,648,3673
Watch carefully as I make your vote disappear,139,30,9,178,648,4022
Here I have the original copy of the United States Constitution.  Good night folks - you all have been great!,110,24,7,141,648,1547
"Et voila, I will transform this ordinary document into festive confetti.",109,27,5,141,648,3984
This is how I made a rabbit disappear before the PETA complaint.,109,26,6,141,648,4198
Toaster or shredder. You be the judge.,128,33,6,167,648,2414
"I know it's no longer politically correct, but this just doesn't have the pizzazz of the old days with the saw.",129,31,7,167,648,2877
"Behold, as my assistant's benefits disappear before your very eyes!",131,27,9,167,648,4073
"Helsinki notes? Absolutely, Mr. President, this baby'll shred even when recharging.",122,26,8,156,648,642
"And for my next trick, I’ll make the President’s tax returns disappear.",145,25,12,182,648,1179
"Well is February now,time to destroy this years resolutions.",141,33,8,182,648,1474
I hope you cleaned it after the dove bit the dust.,140,35,7,182,648,1602
'I will now make the constitution disappear. ',124,23,9,156,648,1948
"You know, I wouldn't have to be shredding our marriage license if you just supported my hobbies.",124,24,8,156,648,1968
"Notice my dear, at this point it will take magic to reclaim shredded liberties.",125,20,11,156,648,2201
"For my next trick, I will suborn perjury!",144,27,11,182,648,3293
"And now from the shredder of the newly appointed  Attorney General, the Mueller Report!",135,26,10,171,648,3262
And this is the prenuptial agreement with my previous assistant.,137,22,12,171,648,3267
"Abracadabra!  The Never Before Seen, Amazing, Disappearing Presidential  Tax Return Trick!!",135,26,10,171,648,3975
"Carol had once been sawn in half, but even she began to tremble when she mistakenly heard the next trick as, ""The shred-her.""",111,29,5,145,648,2930
"And viola! Just like that, I shall make my taxes disapear.",124,29,7,160,648,897
"Of course, it wouldn't be magic without the tireless work done by my beautiful and undocumented assistant.",120,37,3,160,648,3096
with the flick of my stick and swish of my wand my income statement shall forever be gone,124,29,7,160,648,3744
If we can hide the electrical cord. this trick goes up a whole level !,135,33,7,175,648,1657
... and Abra-ca-Banksy!,130,24,10,164,648,2695
This bill eliminator eliminates any size bill. I am now eliminating the National Debt.,129,26,9,164,648,2826
Do you think they'll be able to tell how I did it?,129,26,9,164,648,3806
"Before modern technology, I used to say: ‘Now you see it, now you don’t!’",143,25,11,179,648,1495
I don't know why I keep putting all of my evil schemes in writing.,142,26,11,179,648,2530
Isn't this the voting machine?,140,30,9,179,648,3614
This is what happens to republican ballots in Chicago.,121,23,9,153,648,832
"And now, here's the missing tax report, magically unshredded.",121,23,9,153,648,1308
"For my next trick, not a shred of evidence shall be left behind!",116,33,4,153,648,2931
"For the final act of this administration, we will make the tax returns of Donald Trump disappear.",121,23,9,153,648,3578
"I shall now make my fraudulent tax returns, disappear!",133,25,10,168,648,1757
"Bada bing, bada boom and this is how you disappear the president tax files",134,24,10,168,648,1928
With my magic de-shredder I will reveal the notes of the translator of the Helsinki meeting between Trump and Putin.,136,19,13,168,648,2140
"Honestly, I didn't rig the ballot box! There was no voter fraud!",133,25,10,168,648,2806
#metoocadabra,131,29,8,168,648,2810
And I’ve called this one: Robert Mueller’s Dream Trick!,131,29,8,168,648,4090
"For my next trick, I will make the Trump/Russian agreements miraculously disappear.",144,31,8,183,648,3133
Your ballot is toast.,122,28,7,157,648,1225
Now watch as I make my New Year's resolutions disappear.,122,28,7,157,648,1746
And this one is for the IRS,124,24,9,157,648,2650
"Abracadabra, let it be November 8, 2016",126,20,11,157,648,2699
I wonder if this will work with the bunny.,126,21,10,157,648,2700
"Now, I will make all of my credit card debt- disappear!",121,30,6,157,648,3740
"By the way, the President said if I can make the notes from his meeting with Putin disappear, he would guarantee me a spot in the America's Got Talent finals.",135,28,9,172,648,2294
"And “presto”, your harassment complaint has vanished!",137,26,9,172,648,2687
"This document will now...honey, this is our marriage license.",146,32,9,187,648,1692
"And Presto, watch as my subpoenaed financial records disappear!",145,34,8,187,648,2346
Trust me.  Stuffing the ballot box always yields magical results.,114,25,7,146,648,1157
"Abracadabra, I thus increase the value of this Banksy signed letter by 1 million dollars",115,23,8,146,648,2674
And-- Presto!-- royalties appear in Banksy's account!,132,15,14,161,648,4181
Abracadabra tax evasion!,134,37,5,176,648,4209
"Magically, the election results are unexpected.",152,27,12,191,648,2282
Watch closely as I make these incriminating political records disappear before your very eyes!,127,32,6,165,648,68
"And now, my lovely assistant will bring the shreds home with her and over the weekend painstakingly reassemble her paycheck.",143,26,11,180,648,575
And the bi-partisan amount that Congress will allocate for the Wall is . . .,115,30,5,150,648,1734
"Abracadabra…Shred Faster, the feds will be here any second.",117,26,7,150,648,2131
"And for my last trick, I will make your student debt disappear!",138,36,6,180,648,2381
"When we say ""a magician never reveals his secrets,"" we're not messing around.",140,32,8,180,648,2562
"Ladies and gentlemen, prepare yourselves to be astounded as the talented and indefatigable Mrs May demonstrates how her magical Brexit plan can separate the UK from the EU!",130,26,9,165,648,4183
"Melania, hold still.  It's just the Mueller report""",142,35,7,184,648,3255
We interrupt this episode of The Apprentice to bring you the long awaited release of the Mueller Report.,147,25,12,184,648,4158
"And now, my lovely assistant and I, will demonstrate the best way to dispose of all those bothersome bills.",133,27,9,169,648,328
"And now, before your very eyes, I, as new head of the IRS will make President Trump's tax returns disappear. Viola!",132,29,8,169,648,852
"And that, is how you file taxes.",133,28,8,169,648,1144
"Now, Sheila will reproduce the same copy of our prenuptial agreement.",134,25,10,169,648,4179
"You can take it to the banksy, folks!",123,25,6,154,648,3541
Watch as the facts disappear Miss Demeanor,147,32,9,188,648,2587
"When it comes out, the sensitive information will be blacked out.",139,24,10,173,648,418
A young Houdini performs his most important trick of all: making his pre-nup disappear.,121,32,5,158,648,480
Now watch as I turn your government pay stub into a tasty meal full of fibber.....er...fiber.,125,24,9,158,648,1740
Abracadabra!  Banksy does it again!,123,28,7,158,648,2102
"See Judy, I told you I could make our bills disappear",124,26,8,158,648,3412
And you really think  that Muller’s team  won’t be able to piece it back together?,126,22,10,158,648,3513
"As the president's new ""Secretary of Redaction"", we felt that simply ""blacking-out"" certain sentences left some ambiguity about our position",140,29,8,177,648,3543
Eureka! Here is Donald trump's tax returns!,128,25,9,162,648,2950
This one's a special request from Bart O'Kavanaugh in the audience: Abracadabra let's make Roe v. Wade disappear.,126,29,7,162,648,4149
Don't try this with a rabbit.  And let me know if you've seen Babette.,113,29,5,147,648,3017
It's a balanced Congressional budget.,142,31,8,181,648,1600
You can shred it but it’s still on your email !,145,24,12,181,648,2292
"And with my next trick, I'll make your vote disapear!",129,30,7,166,648,2387
"We can try, but I'm not sure this will make the subpoena disappear.",118,26,7,151,648,2861
This trick killed at Ollie North's soirees.,142,37,6,185,648,696
A/b/b/a/c/a/d/a/b/r/a!,135,26,9,170,648,315
a tap of my wand and ballots disappear,133,29,8,170,648,2622
"And now, for my next trick, I'll make the evidence disappear!",132,31,7,170,648,4014
Behold! As I make this ballot disappear!,147,34,8,189,648,1229
"And when it's shredded, it will turn into his tax returns!",145,38,6,189,648,4197
"See, it doesn't jam. Magic!",123,23,9,155,648,2522
"Now, I will make this piece of paper disappear!",121,27,7,155,648,2774
And now...The Great Redacto will reveal what's in those Mueller reports!,121,27,7,155,648,3385
Hocus pocus and the incriminating evidence is gone!,120,29,6,155,648,3449
And for my final act-Mueller subpoenas!,138,26,10,174,648,1883
And this trick is called 'Making my Russian transcripts disappear'.,124,28,7,159,648,444
"For my next trick, I’ll file my taxes.",124,28,7,159,648,4124
"Watch carefully as I partially shred this Banksy printout, thus increasing its value considerably.",138,33,7,178,648,3073
"Lady's an gentlemen, watch before your very eye's as I make this Muller report disappear!!",154,34,9,197,648,2681
I shall now make the subpoena disappear.,142,32,8,182,648,699
"And just like that, we can make Trump's financial statements disappear!",142,32,8,182,648,1527
Now to saw the witness in half.,118,21,9,148,648,378
"Click of a switch, a wave of the wand, jury summons be gone!",130,31,6,167,648,804
And for my next collusion trick....,133,24,10,167,648,1421
"And now, before your very eyes, watch the jury duty summons disappear!",132,26,9,167,648,2182
Voila! Gone without a shred of evidence.,133,24,10,167,648,2230
"Cross cut is the real magic, am I right, folks?",132,26,9,167,648,2753
"I can’t take anymore, just saw me in half already",129,32,6,167,648,3626
Curse these Trump hands!,148,27,11,186,648,1081
TA-DA! Tax returns? What tax returns?,148,27,11,186,648,3336
"And say the magic word...presto, all our legal problems disappear!",150,32,8,190,648,553
And now for my final act as precinct captain ...,137,23,11,171,648,945
"...and now I will shred my rabbit's last will and testament"".",149,32,9,190,648,1294
The magic trick is that I turn the toaster into a shredder.,119,29,4,152,648,2302
"I think I'm done practicing on paper and feel ready to try my new version of the ""cut a person in half"" trick.  Are you ready?",131,36,4,171,648,2706
...and Viola... No voter fraud here!,118,28,6,152,648,3298
"No, you're right Murielle. He's a great showman, but this new voting system still seems flawed.",136,32,7,175,648,1017
I have a recycling business on the side.,138,28,9,175,648,4229
"Now, “before the audience ‘s eyes I will make this opponent ‘s ballot disappear.",122,27,7,156,648,112
And now...the disappearing Mueller Report. Zzzzzz....,123,26,7,156,648,333
Watch me turn this paper into a Banksy!,124,23,9,156,648,368
"And if you do this with Muller's report, Kelly Ann, you'll have another two years.",120,31,5,156,648,716
And now my assistant and I will make our completely worthless college degrees magically disappear.,108,22,7,137,648,1902
"And for my next trick, we'll disappear from your very eyes, then reappear overseas with different names and hairstyles.",143,25,11,179,648,198
Abracadabra and viola!  Tiny Hands the Magnificent has made the Mueller Files disappear!,142,27,10,179,648,1552
My liability for cutting that last women in half will now vanish.,139,33,7,179,648,2846
I shall now shred the Florida ballot...,137,37,5,179,648,2977
"And presto change-o, no more incriminating evidence.",127,24,9,160,648,1272
"And now, my famous “Disappearing Tax Records” trick, which I learned from The Great Trumpini.",129,21,10,160,648,1707
"I, the new Attorney General, will now make the Mueller report disappear.",126,33,5,164,648,447
"You won't regret hiring Magyar, the magical tax accountant.",129,27,8,164,648,599
I hope you've got that copy tucked in your cleavage!,129,27,8,164,648,1138
"And for my next trick, I'll run the president's entire cabinet through the shredder.",130,25,9,164,648,2630
"To shred or not to shred, that is the question.",128,29,7,164,648,3782
"And now, for my next trick, I'll make another Russia collusion document disappear.",129,27,8,164,648,3814
Keep your eye on the wand and not the paper shredder.,132,28,8,168,648,906
"Because, Doris, just throwing out my list of dreams and aspirations lacks the dramatic flair appropriate for a would-be professional magician.",136,20,12,168,648,2452
"Dad specifically said, ""Eric, be sure to put it in the Mueller file.""",132,28,8,168,648,3269
"And that, Mr. Mueller, is what a magician can do for your team.",151,30,10,191,648,2003
And voila!  It never happened!,115,29,5,149,648,152
This is how every magician worth his salt files his taxes.,117,25,7,149,648,360
Now watch carefully as I make this subpoena disappear...,120,19,10,149,648,2105
Now we know what happened to Hillary's emails.,138,25,9,172,648,342
"In this trick, my assistant will make evidence disappear.",136,27,9,172,648,2202
And voila! Your legal troubles have disappeared!,133,34,5,172,648,3367
This one's from Banksy so I'm going to grab it fast.,123,21,9,153,648,603
"For my next trick, I'm going to make my 2018 tax returns disappear.",138,30,8,176,648,1756
I will now cast my ballot for an honest president.,141,24,11,176,648,3750
"Poof, we're a cash business again.",140,26,10,176,648,3838
Unlike the rabbit this will never see the light of day.,122,29,6,157,648,1868
"I don't need the divorce papers anymore, my husband won the lottery",129,17,11,157,648,4107
"And for his next trick, Mr. Trump will make his taxes disappear.",141,31,8,180,648,3576
A magician never reveals his secrets...or his credit card statements.,138,38,4,180,648,3860
I learned the paper works better than the rabbit did.,130,20,11,161,648,203
Observe.  This document will disappear before your very eyes and reappear as . . . toast.,126,28,7,161,648,824
"Ipso, Factso, Fakeso, ... 
the shredded translator notes 
from Helsinki!",147,26,11,184,648,1079
Abracadabra. The amazing disappearing prenup trick.,123,34,4,161,648,1329
You're getting sleepy,128,24,9,161,648,1460
"And now, my tax returns will disappear",148,24,12,184,648,2660
"I don't explain my tricks, but I call this one ""the disappearing vote.""",125,30,6,161,648,2904
"Voilà, the illusion of our marriage disappears.",129,29,7,165,648,143
"Next I, the Amazing Subpoeni, will make this document appear in court.",127,33,5,165,648,292
Had to shred my old act. Women I was chopping in half were demanding two salaries.,133,21,11,165,648,1158
I perfected this slight of hand with my first wife's pre-nup.,113,21,8,142,648,2108
This trick most likely will not work.,133,28,8,169,648,1112
"Go forth, increase and multiply.",133,28,8,169,648,2144
I’m shredding the contract for “The Wall”... abracadabra.... oh shit! It’s the Cheque for the wall! Oh noooo....,135,25,9,169,648,2269
Boy...voting can be a brutal business...,130,34,5,169,648,4159
"This is a seasonal magic trick, I call it income tax intervention.",113,28,5,146,648,3897
Did you plug it in?,154,33,9,196,648,939
"And presto, with a tap of the wand my personal tax returns for the years 1992-2018 disappear.",137,27,9,173,648,293
This is were the magic happens…,138,25,10,173,648,3627
"Now say the magic words, “Sarbanes Oxley!”",117,28,5,150,648,316
For my next trick watch how I make Donald Trump's tax returns disappear.,138,32,7,177,648,1266
The real trick was getting my hand in there to pull it out.,140,28,9,177,648,2113
And for my next trick I shall free myself from the bonds of marriage to my assistant.,140,28,9,177,648,2350
"Aaaandd, ....wait....yes, here it is: the Steele dossier!",139,30,8,177,648,3679
Now watch as I make your tax return return.,140,28,9,177,648,4195
Watch the shredder! This simple marriage contract will come out as a complete set of divorce papers.,118,32,4,154,648,3458
"And now, for my next act, I shall make your vote disappear!",141,33,7,181,648,1056
"Ladies and gentleman, please watch closely as I seem to make my assistant's union contract disappear.",141,33,7,181,648,2739
Abra Cadabra Russian notes disappear!,127,21,10,158,648,208
"And voila, as a part-time financial planner, I've solved your budget problems!",127,21,10,158,648,2534
"Martha, I promise I’ll get your paycheck back this time",128,26,8,162,648,1738
"And for my next trick, I will make the U.S. Constitution disappear.",128,27,7,162,648,2229
Hocus Pocus Habeas Corpus.,127,28,7,162,648,3052
"You’re next, lady",129,24,9,162,648,3487
Abracadabra! Problem solved!,132,25,9,166,648,2658
"…and when I tap my wand, watch as my off-shore banking discrepancies disappear.",132,25,9,166,648,3551
And now I'll make these #MeToo allegations DISAPPEAR!,128,33,5,166,648,3617
"Once I pull the paper out of the shredder, we will have the election results.",132,32,6,170,648,1187
"Behold, as this résumé for an educated, qualified, unattractive assistant disappears!",136,24,10,170,648,2461
Please!  No help from the audience!,137,22,11,170,648,4187
I told you this would be faster than a divorce Janet.,138,27,9,174,648,567
Presto! Whole again.,137,30,7,174,648,3924
"Trump conspired with Putin to commit treason.  Now, presto!  He NEVER conspired to commit treason!",143,24,11,178,648,851
It appears that even magical shredders get jammed.,139,32,7,178,648,1267
Right before your very eyes... I can make Trump’s tax returns vanish.,142,26,10,178,648,2023
"We put the court order in the magic box and presto, my problems disappear.",142,26,10,178,648,3694
Bye Bye Constitution,119,25,7,151,648,932
Obama’s achievements shall disappear before your very eyes.,142,33,7,182,648,999
No paper has been harmed in this trick.,143,32,7,182,648,1844
"Of Course I'll win.  This isn't a third world country, it's New Jersey",123,24,8,155,648,806
"Now I'm inserting this page, which contains the word 'rabbit' two hundred times,...",148,28,10,186,648,3152
"And now, I'm going to make Donald Trump's tax return disappear!",120,31,4,155,648,3176
And voila! The ballot disappears!,121,28,6,155,648,3242
"Watch now as it emerges as new.  I call this trick ""My accountant's nightmare""",120,32,3,155,648,3387
"That's right, eight pages in a shredder that can only do five!",125,27,7,159,648,97
And now I shall make the tax returns reappear!,123,31,5,159,648,384
And for my next trick.....the federal budget!,129,20,10,159,648,1416
Now watch me make these votes disappear,127,25,7,159,648,1427
It says that I am a non essential magician.,125,27,7,159,648,2278
"And now, with a tap of my wand, I will make the interpreter's notes disappear.",130,24,9,163,648,1204
NC-9 Polling Station,131,22,10,163,648,3562
"For my next trick, I shall now let all my hopes and dreams disappear.",102,26,4,132,648,2110
I ran out of pigeons.,133,25,9,167,648,1659
Any friend will help shred a document. But only a true friend will you help cut a body in half.,134,23,10,167,648,1700
"Saw me in half, okay.  But a shredder?  
This was NOT what we rehearsed!",130,31,6,167,648,2080
Watch as I make this restraining order disappear!,134,23,10,167,648,2964
"Trying to make your prenup disappear again, dear?",137,25,9,171,648,1496
"And, for our final trick, we will turn an ordinary piece of toast into a terrifying todo list!",133,32,6,171,648,2951
Watch my unreported earnings disappear!,136,26,9,171,648,3123
And viola...a tree simultaneously sprouts in Thailand!,138,23,10,171,648,4193
Honest.  Fake news.,135,28,8,171,648,4234
"No meeting notes means I never met with Putin. In fact, better yet, I don't even know the man.",138,30,7,175,648,288
"For $29.95 you get the presidential tweet shredder and, for the first 100 callers today only, a VP bobble-head for your dashboard.",139,27,9,175,648,2723
"Next, I will make the rabbit disappear",141,30,8,179,648,1101
...and just like that your marriage is annulled.,140,32,7,179,648,3438
Now I’ll make my assistant disappear simply by shredding her contract.,145,29,9,183,648,858
Now watch as The Great Gerrymandro makes your voter registration disappear.,147,25,11,183,648,2248
"Take that, Zuckerberg.",143,33,7,183,648,2374
"And now, with the help of my assistant, I will make all evidence of the meeting with Mr. Putin disappear!",121,16,11,148,648,1440
"In this trick, I will fix this shredder without calling the IT department!",117,24,7,148,648,3910
Fig. 2. Constitutional law and stagecraft do not mix.,123,22,7,152,648,3209
"Pelosi leviosa.""",121,23,8,152,648,3489
"At the sound of the magic word “Audit,” Madoff the Marvelous quickly made things disappear.",152,29,10,191,648,2631
"And when I count to three, none of you will remember seeing this.",122,28,6,156,648,1576
I taught Banksy everything he knows,125,22,9,156,648,2298
Now watch me make this State of the Union Address disappear before your very eyes.,126,20,10,156,648,2707
"And now, by means of my lovely assistant, a few magic words, and this handy-dandy Fellowes Powershred 6000, I shall evade federal prosecution!",125,29,6,160,648,676
Abracadabra! I will now make my paper trail disappear!,124,31,5,160,648,1984
"Next, I shall use the mystic box of knives to transport my tax return beyond the ken of man.",127,25,8,160,648,3400
Watch and be amazed my legal troubles disappear before your very eyes.,130,26,8,164,648,499
Presto!  No more constitution!  For my next trick:  what do you think of eighteen justices on the Supreme Court?,129,28,7,164,648,2101
Abracadabra! My taxes are done!,134,18,12,164,648,2647
"With two shakes of his small wand, Manshreddi makes women's rights disappear.",130,26,8,164,648,2827
"And now, I’m casting the magic vote that will decide the election!",131,31,6,168,648,587
My lawyer says it's the only way to make it truly disappear.,137,26,9,172,648,538
"And, ladies and gentlemen, the IRS isn’t working right now, which means I can make my taxes go poof (and you can too!).",133,34,5,172,648,2523
And we simply place this infallible plan to end the shutdown in the magical remote suggestion box....,136,28,8,172,648,3390
"...and with a touch of magic, we'll finally see the President's tax returns!",140,27,9,176,648,896
"According to my divorce lawyer, this IS pulling a rabbit out of my hat.",140,29,7,176,648,1796
Sounds really shredful,137,33,6,176,648,2084
"By the power vested in me by the New Jersey Magicians Alliance, I now pronounce us divorced.",139,29,8,176,648,2729
And Abracadabra! It’s now a Banksy!,140,27,9,176,648,2929
"Abracadabra!  The votes disappear, right before our very  eyes!!",141,32,7,180,648,1504
Abracadabra!  Let this absentee ballot register itself!,142,30,8,180,648,2754
"For my next trick, I will make my tax return disappear.",141,32,7,180,648,3141
"And just like magic, workers' rights are an illusion",105,29,3,137,648,3084
"For my next trick, I will put this piece of paper into the machine, and it shall come out in tiny bits.",146,29,9,184,648,2844
Wall-a!  There you have it no more constitution!,146,29,9,184,648,3483
I will now make your accumulated paid time off disappear.,153,29,10,192,648,1615
"And for my next trick, I will make my criminal record disappear!",115,30,4,149,648,778
"And the magical unshredder not only puts your documents back together, but edits and improves them as well!",114,32,3,149,648,1836
"So, here I vote for equality between men and women. Let's see what happens...",117,27,5,149,648,3288
"And for my next trick, I shall resolve this printer error.",158,34,8,200,648,686
And for my next trick. I will make my tax returns disappear.,122,23,8,153,648,878
Notice that at no time does deniability leave the realm of the plausible!,122,24,7,153,648,1518
"I promise you darling: This will be the last magic trick in our marriage.""",121,25,7,153,648,2526
Donald asked me to make Muller’s notes disappear.,127,20,10,157,648,3504
A prestidigitator never reveals his tax returns.,125,31,5,161,648,1478
My God!  That is our Marriage license!,130,21,10,161,648,1695
"Say the magic word, Mr. President, and I'll make that interpreter's notes disappear.",127,27,7,161,648,2829
Turbotax.,134,20,11,165,648,1526
"That was the latest work by ""Banksy""",131,26,8,165,648,2771
The rabbit is next!,131,26,8,165,648,3589
And now to make the evidence disappear,129,30,6,165,648,3821
Was THIS your shredded tweet?,131,33,5,169,648,640
"And before I saw my wife in half I will make our prenuptial disappear.""",129,37,3,169,648,2424
"Get ready!  I will retrieve a rabbit, slightly the worse for wear.",131,33,5,169,648,2638
Now watch me pull a Banksy out of my hat.,134,27,8,169,648,3305
Watch as I make this collusion disappear!,141,21,11,173,648,534
And next my lovely assistant will step into the shredder.,140,25,8,173,648,1914
Now watch as I make this Banksy print disappear...,137,28,8,173,648,2032
With a quick wave of the wand - and like that! - your parking ticket has disappeared .,134,34,5,173,648,2065
"Come on, you don't see this piece of paper crying about getting cut in half ?",138,27,8,173,648,2519
I will now make the President 's  tax return disappear.,144,28,9,181,648,1037
"And, voilà, evidence has disappeared!",144,28,9,181,648,3477
"For my next trick, I'll make my insider trading charges disappear!",150,30,9,189,648,1374
"Now, Ladies and Gentleman, with only a standard shredder, Abracadabra!! my opponents’ write in votes magically disappear!
(NC 9 humor)",149,32,8,189,648,3514
"As they say, any sufficiently advanced technology is indistinguishable from magic",102,23,5,130,648,1932
"No, Karen, when I said that I wanted to shred on stage when I grew up I pictured a guitar not this.",112,24,6,142,648,2280
"...and in a few short moments, my assistant will cough up this document, fully reconstituted.",116,23,7,146,648,1467
"OK, so I said let’s make the act more high tech. Is this really the best we can do?",116,23,7,146,648,2060
"For my next trick, I will reverse-Banksy this document.",118,26,6,150,648,1817
"As a magician, I can even make government paychecks disappear.",116,30,4,150,648,2568
"...and just like that, the evidence has VANISHED. For my next trick, I will miraculously ESCAPE from my assistant's lawsuit...",120,22,8,150,648,3149
"It says, ""This act is toast"".",122,25,7,154,648,550
"Soon the secret of my shredding magic trick, written on this piece of paper, will be shredded, thus forever ending my shredding magic trick.",122,25,7,154,648,1840
"And next, the rabbit please.",123,23,8,154,648,3394
I hope the IRS and FBI do not make this reappear.,129,18,11,158,648,1113
"Yes, I blew it on the Magna Carta and Dead Sea Scroll fragment, but third times a charm.",125,26,7,158,648,1856
And now with my magic words this sheet will turn into confetti,130,23,9,162,648,277
"Presto, some 2018 income has disappeared... next I'll pull an expense from my hat.",126,31,5,162,648,1988
Now only an intern could restore it!,127,29,6,162,648,2015
"And now I will read your mind.
 You're thinking, that's just a paper shredder!",132,26,8,166,648,1821
Would you prefer a rabbit?,130,30,6,166,648,4085
Come on out of there little rabbit.,135,27,8,170,648,79
Presto-chango and the summons is magically converted into confetti.,134,30,6,170,648,262
I will then reassemble the shredded page into a genuine Banksy worth millions.,132,33,5,170,648,2129
"...and  Abracadabra, all the evidence disappears.",143,27,8,178,648,1328
And abracadabra just like that your tax problems are gone!,139,33,6,178,648,2648
Henry demonstrates to the court how his Redact-o-matic saves a bundle on toner.,137,37,4,178,648,3307
"Meet my lovely assistant, Miss Aida Ann Abettor.",143,32,7,182,648,1837
"We need confetti for the act, I happen to have an impending indictment. Two birds, one stone.",147,24,11,182,648,3422
"And just like that, your student debt is gone, madam.",143,39,4,186,648,3200
Let's see you return your birthday present now.,151,30,9,190,648,3685
"Now, I will pull this full sheet of paper out of a shredder.",163,27,12,202,648,1180
Watch as I make this subpoena disappear!,105,26,4,135,648,4172
"And now watch, as I make this ballot disappear.",109,25,5,139,648,441
We magicians never reveal our secrets.”,114,22,7,143,648,3160
And for my next trick I’ll make make that pesky U.S. Constitution disappear for good.,113,24,6,143,648,3247
"Next... ah, the translator's notes... Bye, Bye...",119,19,9,147,648,1129
"No, Banksy is not part of this illusion.",116,25,6,147,648,1662
And the winning lotto ticket is,121,29,5,155,648,1626
"And when I place the magic ballot in the box, presto, Hillary will be the president.",122,27,6,155,648,2985
Abracadabra! Just like that I can make Trump's tax returns disappear.,128,22,9,159,648,250
I will now retrieve your secret information from Equifax.,133,19,11,163,648,2718
Watch closely as my taxable income disappears!,133,27,7,167,648,387
"And for my next trick, I'll shred my mail without jamming the shredder",130,32,5,167,648,1217
And with a wave of my wand... abracadabra! No more health insurance for Carol.,132,28,7,167,648,1269
"Right before your very eyes, I will destroy all evidence of what really happened to the bunny in the hat.",133,26,8,167,648,3883
"And magically, by the end of my act, I'll have enough bedding for my rabbit cage!",131,30,6,167,648,4061
"Er voilà, 2020 election victory!",132,35,4,171,648,827
"If this works, ballot boxes are next.",136,27,8,171,648,2089
Now watch closely as the shredder speeds up when it detects the name Clinton.,136,27,8,171,648,3280
e Presto! - linguini ala carta!,137,32,6,175,648,1610
And viola! This will make your credit card bills disappear.,142,23,10,175,648,2371
This way we don't have to buy the confetti,138,31,6,175,648,3296
"And, now for my last trick, I will make my graduate school loan paperwork disappear.",146,28,9,183,648,1669
"Behold! as I, the Amazing Banksy, using only this ordinary shredder, turn this paper into one-point-five million dollars!",146,28,9,183,648,2396
"And VOILA!, the paper vanishes...in about 1-2 minutes",146,36,5,187,648,403
We the people,149,29,9,187,648,1074
"And just like that, you ex-husband never existed!",147,33,7,187,648,1192
"It's magic, but not as you know it.",150,34,7,191,648,4011
"President's aren't the only ones who can make their 
dirty tricks disappear!",127,27,6,160,648,174
And for my next trick ... I will make my debt disappear,138,32,6,176,648,268
"...And, as you can plainly see, the printer has NOT run out of ink!",128,24,8,160,648,346
"And now, the great Manzini will show you how to make an FBI investigation disappear...",120,26,6,152,648,396
And not even I will be able to put it together again!,146,31,7,184,648,436
And as if by magic...that incriminating document disappeared.,134,26,8,168,648,572
"And with that, all of your problems go away",122,29,5,156,648,613
And here's the REAL magic...you'll recall Mandy was wearing a full skirt when she first came onstage...,111,23,6,140,648,829
"For my next trick, using nothing but a paper shredder, I will confess to no collusion with Russia.",113,26,5,144,648,850
"Viola, the PETA approved rabbit!",151,28,9,188,648,931
Expelliarmus Trumpus Translationus!,131,25,8,164,648,1054
"Listen Honey, I'm happy to help but if you really want to make your jury duty disappear then just wear that outfit down to the court...",121,19,8,148,648,1254
Just be thankful there wasn’t a rabbit under my hat today.,126,28,6,160,648,1516
Can Banksy do this?,133,28,7,168,648,1790
"And now, the disappearing pre-nup!",116,27,5,148,648,1887
And VOILA! The Mueller report has disappeared!,120,19,9,148,648,2054
And now...we present the Mueller report!  Drumroll please.,142,25,9,176,648,2147
"No prenuptial agreement, no marriage.",136,23,9,168,648,2193
"And now, watch my vote disappear",127,26,7,160,648,2576
"This sheet is my heart, Gloria. You're the shredder. Get it?",136,36,4,176,648,2594
"Yes a moment ago I was fired,but now magically I’m still here.",134,33,5,172,648,2769
"Hmmm, No federal paycheck... no federal income tax filing!",129,29,6,164,648,2869
I haven't fully worked it out but I'm pretty sure you will come out in one piece.,130,34,4,168,648,3094
Is anyone in the audience of Russian extraction?,133,28,7,168,648,3205
And now - my audit letter from the IRS.,125,23,8,156,648,3881
"And for my next trick, I’ll make a priceless Banksy appear!",134,26,8,168,648,3948
Don't . . . shred . . . on . . . me.,125,23,8,156,648,4153
Next I will perform this trick with a rabbit.,154,23,12,189,648,1288
... and now the prenup...,152,28,9,189,648,2435
Essential government employees have been recalled to the White House.,152,27,10,189,648,2653
The Amazing Mueller makes Buzzfeed disappear.,148,35,6,189,648,3448
I am now adding artistic value to junk mail,150,27,8,185,648,2326
Trump tax returns magically revealed!,146,32,7,185,648,3431
"And for my next trick, the slow magic of 20th century technology.",143,31,7,181,648,1128
"The Great Putini shows off his best illusion: The old ""the ballot is cast or is it?"" trick.",143,24,10,177,648,1154
"This is why we needed a rehearsal, Stacey!",138,34,5,177,648,1339
Banksy tried this and failed.,141,28,8,177,648,3672
"Your pre-nup, as requested",135,33,5,173,648,3643
"First I made my beautiful assistant's dignity disappear, and now I'm going to remove any evidence that it existed in the first place.",140,23,10,173,648,4092
I will now make my meeting with Putin disappear.,134,28,7,169,648,2247
"Relax my dear , it's not your paycheck.",134,28,7,169,648,2258
This trick is called: ADMINISTRATION,135,26,8,169,648,4048
"Abracadabra, audit away.",132,26,7,165,648,370
"Delores, we've been booked for Brexit!",133,23,9,165,648,1284
"Ok, wands almost set up. Just need to read the terms of service.",132,25,8,165,648,1776
"And after the Cohen files, our Piece de Resistance!  I shall un-Bansky!!",131,27,7,165,648,3192
We re-cycle even the darkest deceptions.,129,24,8,161,648,1150
I’ve had plenty of practice. It’s just another bill.,129,24,8,161,648,2245
And let's have a round of applause to Señor Sanchez for volunteering his immigration application for my next illusion.,129,25,7,161,648,2572
All we need to call this magic is a fake audience.,128,26,7,161,648,3468
"...and now, for my next trick, I will make this federal indictment disappear.",128,26,7,161,648,3474
Our first gig was the U.S. Embassy in Iran forty years ago.,124,27,6,157,648,456
Presto! There goes the prenup!,126,24,7,157,648,2012
"And presto, my debt has disappeared!",128,19,10,157,648,2565
'Thanks Svetlana for being my interpreter.',125,26,6,157,648,2843
It'd be a better disappearing act if it were quieter.,122,24,7,153,648,583
And for my next trick I give you 'The Michael Cohen Fever Dream',123,25,5,153,648,701
"And for my next trick, I will make all your tax-season worries disappear.",119,30,4,153,648,2517
"Unfortunately,  the Constitution is no longer worth the paper it's written on.",120,23,6,149,648,3260
Now watch closely as I make these tax records.... Disappear!,163,35,8,206,648,331
"Abracadabra, the combination shredder / ballot box!",150,26,10,186,648,3393
"For this trick, i will magically make all the evidence of Russian interference disappear!",147,32,7,186,648,3419
For my next trick-- How to disappear one hour of colusion with Russia...,147,27,8,182,648,1766
"I will now make 30,000 printed emails disappear!",148,23,11,182,648,3747
Try harder! Turn these lies into facts.,142,35,5,182,648,4156
"And, wait, wait, YES, IT'S THE PRESIDENT'S UNSHREDDED TAX RETURNS!",141,30,7,178,648,3989
"Now, let me see if I've correctly guessed what's on this Toast-It note",144,25,9,178,648,4225
"For my next trick, I'll make these lawsuits disappear!",137,31,6,174,648,2559
Here's a nifty trick to make a bad review disappear.,133,39,2,174,648,3965
For my next trick...tax bill,134,30,6,170,648,34
All this fuss over a parking ticket.,136,26,8,170,648,263
Abracadabra! The evidence has disappeared.,140,18,12,170,648,517
And now...watch as Mr. Interpreter puts the meeting notes into the box,138,22,10,170,648,1089
Behold! I will now make Robert Meuller's report disappear​!,136,26,8,170,648,1482
"Watch these Putin meeting notes magically 
recycle into fast food wrappers !!",138,22,10,170,648,3000
"Behold as I, the Great Donald T. Rumpio, make this fake news disappear before your very eyes!",131,29,6,166,648,848
"And, voila! Our pre-nup!",133,25,8,166,648,2581
This would be so much better if we could get rid of the cord.,130,31,5,166,648,3459
"And ab bra-cadabra, your vote disappears.",131,29,6,166,648,4042
Abra-cadabra!  I can make this vote disappear!,128,28,6,162,648,1095
Now we wait for the rabbit to come out.,132,21,9,162,648,1116
And for my next trick I shall make your rights disappear,128,28,6,162,648,2372
R U Kidding me??!@#$  A Paper Jam !  ABRACADABRA ABRACADABRA...... Start dancing Wanda !,130,24,8,162,648,2659
"Before we attempt to saw my new assistant in half, we will make her birth certificate disappear.",127,30,5,162,648,4184
At $1.2 million. Going once,125,28,5,158,648,871
"Preserving confidentiality takes work, not magic.",125,27,6,158,648,2503
"What is this, you ask? Well, I like to think of it as a new-fangled debt balance eater.",128,21,9,158,648,3751
Cohen agreed to pay me 150k to make the Constitution disappear.,125,27,6,158,648,3783
"Don't worry, in a few moments this will be worth double.",124,22,8,154,648,1200
"And for my next trick, I will make my legal culpability disappear!",122,26,6,154,648,2555
I will now make this past due notice reappear in my mailbox next month.,116,25,5,146,648,2485
On second thought I'll let the IRS piece it back together.,112,32,2,146,648,2915
This trick is toast!,117,22,7,146,648,3970
and now watch as i pull out a paper from a old printer without getting the paper ripped,111,20,7,138,648,3460
"And when I reassemble the pieces, 
Tiffany will be once again,
be reunited, 
with her pants.",159,31,9,199,648,3051
"In a few seconds,this will magically be worth more",152,31,8,191,648,1823
Watch carefully as I make my lovely assistant's contract disappear.,149,37,5,191,648,4125
I call this trick The Internet.,148,32,7,187,648,1803
"And, voila! Our tax issues are gone!",151,26,10,187,648,3625
"...and when the special counsel's report has been completely shredded, all evidence of Russian interference in the 2016 presidential election will have magically disappeared.",142,37,4,183,648,1251
It has been challenging to find consistent work ever since Watergate.,145,31,7,183,648,3820
"And magically, my assistant’s mini bar receipts reappear from the shredder.",139,29,7,175,648,472
And now watch my tax returns from 7 years ago disappear!,137,33,5,175,648,1007
The real trick is not getting your tie caught in the machine,138,31,6,175,648,1045
My To Do list disappears like magic!,143,25,7,175,648,2800
"Uh-oh, the notes from the Trump-Putin meeting.",135,30,6,171,648,1234
"For my next trick, I will turn this shredded piece of paper into Banksy.",135,30,6,171,648,1921
Prepare to be amazed! Until then I have some work to do.,134,25,8,167,648,437
And on the count of three I will cast my vote for Trump.,136,21,10,167,648,1026
"And now, for my final act of super-edgy street art, I will make Banky’s tax returns disappear!",132,29,6,167,648,1728
"Let's take a moment to acknowledge Diane's professionalism, as I remind you all that this document is our actual prenuptial agreement.",128,30,5,163,648,2466
I told you this bill was toast!,129,28,6,163,648,3485
"What they don't know, it gets scanned before it is shredded",127,25,7,159,648,725
"Now, unless I am paid a sizable fee, I will magically restore the entirely undamaged tax returns.",130,19,10,159,648,2161
Abracadabra! And now for the election results...,125,22,8,155,648,819
"Okay, now bring in the bunny.",124,24,7,155,648,1714
I will now preform the famous cut and restore of a government leaked document!,123,26,6,155,648,3082
"Close your eyes during this part, Dorothy.",123,26,6,155,648,3249
Disappeared...Shredded...I didn't finish magic school.,124,25,6,155,648,3297
"I call this one, the shredded Chad.",119,27,5,151,648,3715
And...voila! The last copy of The U.S. Constitution! Come back to Trumpworld soon!,116,26,5,147,648,596
Presto! The paper is shredded.,123,12,12,147,648,1086
"For my next trick, I will make this subpoena disappear.",145,33,6,184,648,237
"And like magic, there goes the pre-nup!",145,26,9,180,648,94
Geoffry always took things too far... especially when it came to keeping toes in his breast pocket.,147,22,11,180,648,3786
Wait! These are Trump-Putin notes!,144,24,8,176,648,43
I can make anybody’s tax returns disappear!,139,32,5,176,648,634
And the only record of the meeting of these two great men...,139,31,6,176,648,1860
I'm feeding the rabbit,138,33,5,176,648,1945
And viola! Your democracy is gone!,143,23,10,176,648,2561
"Using my subpoena, the shredder will digitize the paper to Wikileaks.",136,30,6,172,648,849
"For my next trick, I make my assistant’s suggestion disappear.",136,30,6,172,648,1030
And presto! We turn it into a subpoena.,137,28,7,172,648,1402
And NOW––it's a jam.,140,23,9,172,648,2444
"Hold it still now, Hillary",140,22,10,172,648,2980
And now I will make my unpaid tax problem disappear before your very eyes......,133,29,6,168,648,33
This next trick eliminates wordiness in a flash.,136,26,6,168,648,122
"Repeat after me: this trick is for paper, not bunnies.",135,25,8,168,648,385
And now I am going to make your paycheck disappear...,134,27,7,168,648,488
For my next trick I will make the audience disappear.,133,29,6,168,648,1107
"And just like that, we never married oooooo.",130,28,6,164,648,1383
I will start by shredding our wedding certificate”,131,26,7,164,648,2644
"If you thought that was great, wait until I saw you in half.",126,29,5,160,648,912
You democrats know this trick from the general election. You put your ballot into the ballot box – and vanished it is!,123,35,2,160,648,1238
Abra Cadabra - Watch as I make these translation notes disappear. For my next trick I will turn money laundering into adoption.,129,23,8,160,648,2689
"Voila,the indictment disappears!",125,31,4,160,648,3239
"Enron , The Magician .",127,20,9,156,648,1028
Your vote in russia,126,22,8,156,648,1597
"As the new White House magician, I disappear a lot more than the rabbit.",124,26,6,156,648,3899
"Ladies & gentlemen, wait until you see what we do to the rabbit!",122,23,7,152,648,259
Observe as all my tax records and any proof of my collusion with Russia magically vanish!,119,29,4,152,648,2375
Hocus Potus and...no Mueller report!”,123,21,8,152,648,2751
"I will now partially shred my tricks of the trade 
to auction at Sothebys.",120,27,5,152,648,3259
"And for my next trick, I will be annulling our marriage",121,25,6,152,648,3332
"And just like that, the evidence has disappeared!",148,36,5,189,648,1182
"And for my next trick, I will get Donald Trump elected!",152,28,9,189,648,1880
Paul Manafort's chief lawyer attempting to destroy incriminating PDFs.,119,22,7,148,648,3045
"You know Susan, I used to do this trick with a rabbit....",117,26,5,148,648,3502
"Abra-cadabra: Incriminating memo, DISAPPEAR!",142,34,5,181,648,962
"And now for my next trick, I'll make gluten-free papier mache.",147,24,10,181,648,1540
Abracadabra.  Put this in and out comes a Banksy!,149,20,12,181,648,3287
Just watch this subpoena disappear!,140,31,6,177,648,1897
"That's not your normal suit, is it Banksy?",111,24,5,140,648,821
"Actually, I bet they're raiding my house right now...",135,34,4,173,648,704
"And now, I will reverse shred the $100,000 check I shredded along with the Target ad.",140,24,9,173,648,1431
I am Banksy.,139,26,8,173,648,1990
3-D printing a rabbit seemed like a good idea,141,22,10,173,648,2498
"The name's Cohen, Michael Cohen.",140,24,9,173,648,3095
Magic made me do it!,133,31,5,169,648,54
"And for my next trick, I will show you how to make evidence from a hard drive disappear.",132,33,4,169,648,645
"The real trick will be cleaning this out
without getting confetti all over the floor.",135,27,7,169,648,655
Presto; our prenuptial agreement!,134,29,6,169,648,1195
"And, just like that, our constiutional rights are ripped up. Its a trick, not magic.",135,27,7,169,648,2401
The true magic is in its Cross-Cutting capabilities.,160,35,7,202,648,3509
Watch carefully as I turn this subpoena into confetti fit for a hero.,130,30,5,165,648,1196
"Abrakadabra your turbo tax is not free,free,free,liar,liar,liar",131,28,6,165,648,1413
Behold! As I turn this ordinary piece of paper into festive confetti!,132,27,6,165,648,2111
If it worked for Banksy it can work for me!,126,31,4,161,648,229
"Watch closely as I make this restraining order from 
the magician assistants’ union disappear.",128,27,6,161,648,520
Abra-kannulment!,129,25,7,161,648,776
we cast the final ballots under the careful eye of the voters magician committee,131,21,9,161,648,1646
"And on the count of three, your identity will vanish, and pop up instantaneously in Moscow!",154,26,10,190,648,1551
Out of all the dangerous stunts Misty was the assistant for she never dreamed this would be the one that took her life.,126,24,7,157,648,256
Oh ye of little faith!,126,24,7,157,648,2086
Shredding it halfway doesn't make it a Banksy knockoff.,124,28,5,157,648,2232
"You may ask yourself , How can 20 years of tax returns disappear into one shredder?",127,22,8,157,648,3583
"For my next trick, watch as I make my tax records disappear!",123,30,4,157,648,4031
"Ladies and gentlemen, welcome to the illusion of no collusion.  I promise to shred every shred of evidence which the Special Counsel has obtained right before your very eyes!",125,26,6,157,648,4100
"No, my dear, this is tax 'illusion'.",122,25,6,153,648,1789
"Ladies and gentlemen, wouldn't you know it?  Just when the show was going so well, we appear to have developed a paper jam.",120,29,4,153,648,4094
And against my lawyer's advice-let's make this paper trail-disappear,144,32,6,182,648,3554
"Let's try our marriage certificate. It's a win, either way.",147,29,6,182,648,3801
"And for my next trick, I will make our bills disappear.",140,33,5,178,648,2404
"Abracadbra, Mr. President. Your tax forms are gone!",115,25,5,145,648,3397
Voila! It’s Art.,137,25,8,170,648,2941
And I will make the TPS report...disappear!,110,28,3,141,648,759
My assistant will open the shredder in 30 seconds and find  the inserted page shredded and 10 copies of it completely intact!,134,25,7,166,648,8
Voila! It’s a Banksy.,132,28,6,166,648,58
My assistant will take this ungainly proposed legislation - and reassemble it into a coherent document.,134,25,7,166,648,597
"evidence, schmedivence",131,31,4,166,648,1069
"And for my next trick, I’m going to make my summons for jury duty  DISAPPEAR!",130,32,4,166,648,2704
"Your applause is deafening. Thank you, Steve.",131,23,8,162,648,145
"The Trump Reality Show, Season 3 Finale: 
Who Shredded the Putin Meeting Transcripts?",129,27,6,162,648,841
We'll play it backward in the filmed version.,131,23,8,162,648,2784
And after making this tax return disappear we will saw Death in half.,129,27,6,162,648,3709
"Doris, get your thumb out of the way or else this won’t work.",150,31,6,187,648,703
When you reverse the feed this paper better magically reassemble itself or you're gonna look really stupid.,148,33,6,187,648,2811
"Presto chango! When you misplace the key to my leg manacles, your contract disappears!",130,18,10,158,648,1935
"And just like that, my taxes magically disappear.",128,22,8,158,648,2592
And now watch as I make these interpreter's notes.. Disappear!,126,26,6,158,648,2684
"Never fear, my dear...the President will come up with a new reality in the morning.",122,27,5,154,648,954
"The real magic, ladies and gentlemen, took place earlier today when my accountant prepared this tax return which, on reflection, could land both of us in the slammer.",125,21,8,154,648,3068
"And with a wave of my magic wand, that previously shredded document has emerged intact!",125,21,8,154,648,3851
"Abracadabra.  Sorry,your vote doesn't count this time.",122,27,5,154,648,4026
"To retrieve this, will be a miracle, not a magic trick.",143,22,10,175,648,147
One wave of the wand and all the ballots will reflect my vote!,140,28,7,175,648,291
I will attempt to let go before my hand enters the shredder.,140,28,7,175,648,313
"Abracadabra....and the winner is,Vladamir Putin.",138,33,4,175,648,1100
Voila! And now for the rabbit.,141,26,8,175,648,3767
How did Banksy do it again?,141,26,8,175,648,3810
Voter fraud???,136,29,6,171,648,1618
My chances of ever getting a date again.,138,26,7,171,648,2255
"And now, for my final trick, I will make my taxes disappear!",155,28,9,192,648,1160
The tricky part is putting the pieces back together again.,135,25,7,167,648,20
Voila! My Banksy moment!,133,28,6,167,648,581
I shall now make high crimes and misdemeanors disappear.,133,28,6,167,648,2135
No taxation with magicianation,133,28,6,167,648,2293
This is a new version of Russian roulette.,137,20,10,167,648,2411
And now the evidence will disappear.,151,29,8,188,648,2366
And that's how the government watchdog report on migrant children separation 'disappeared'.,150,31,7,188,648,3569
The great Shredini shall now make the entire incriminating document simply disappear,132,23,8,163,648,3824
Pay no attention to the buzzing,150,24,10,184,648,2963
And now for my incredible Banksy trick!,132,16,11,159,648,606
"I shred, therefore I am.",126,28,5,159,648,2450
It's just doesn't have the same pizzazz as using the rabbit.,126,28,5,159,648,3061
Affidavit-cadabra,128,24,7,159,648,3682
"And this, ladies and gents, will turn the Trump-Putin 
translator's notes into TP, before our very eyes.",144,29,7,180,648,1571
"If this doesn't work, I'm toast.",143,32,5,180,648,3320
We've finally got a voting rights act that will make America great again!,124,25,6,155,648,584
"Well if this doesn't throw Mueller off our trail, I don't know what will.",126,22,7,155,648,791
And this shredder works on reputations as well as names!,124,26,5,155,648,2542
"First, I shred my marriage license; then, behold, as I make half my belongings disappear.",124,25,6,155,648,2804
"Now, into the ballot box it goes and shreddo",125,23,7,155,648,3388
And ta-dah! Your mortgage application has been rejected! Thank you for choosing Copperfield and Henning for your banking needs.,141,28,7,176,648,248
Et voila! My corporate tax bill instantly disappears!,139,32,5,176,648,611
"Sorry folks, but apparently the IRS is on its way, and I’m afraid ‘abra cadabra’ just won’t cut it.”",143,24,9,176,648,1696
Now watch closely as I turn this shredded paper into a legitimate candidate...,143,24,9,176,648,3047
"And now, to make the tax return of Individual 1 disappear ...",122,23,6,151,648,750
Watch as I change this simple piece of paper into a million dollar Bansky for you.,120,26,5,151,648,2035
"Heh, Trump thought this really worked on his tax returns.",148,37,4,189,648,591
"With a wave of the wand, I insert the paper into the magic box and, voila, the national debt has disappeared. Thank you -- I'll be appearing on Capital Hill all week!",134,28,6,168,648,633
"Trust me, Hillary, this should do the trick.",135,26,7,168,648,1046
And watch the tax returns- DISAPPEAR!,151,31,7,189,648,1331
"And now, observe as I turn this into a cloud.",154,26,9,189,648,2991
There goes the United States Constitution.,135,26,7,168,648,3413
You're toast.,119,21,7,147,648,3581
I now give you... the president's tax returns!,135,26,7,168,648,3615
Houdini didn’t have to worry about hackers and identity theft.,133,31,4,168,648,3646
"And, presto, the paper un-shreds right into my hand!",137,22,9,168,648,3803
"And voila! Along with my interpreter's notes, evidence of treason disappears!",149,28,8,185,648,1980
"So I shred the 'fake news,' like so, wave my wand and say ""Nostrovia"" for our Russian friends listening in and then...Tada! The paper comes back out as favorable news!",135,19,10,164,648,972
"Next, we will try to analyze a phone bill.",134,22,8,164,648,1726
"And before your very eyes, watch as I make these sensitive documents disappear!",128,33,3,164,648,3381
"Nothing to worry to worry about folks, I moonlight as the President’s tax attorney. And a magician never reveals his secrets, unless it’s to the special counsel. So here we go. Abracadabra!",132,25,7,164,648,4007
Ta da.....and next I will disappear the rabbit,134,21,9,164,648,4240
I wave my magic wand and Presto! Out comes a Banksy!,148,23,10,181,648,2837
Watch as my assistant's restraining order magically disappears!,129,24,7,160,648,1594
We're gonna recycle your vote.,125,32,3,160,648,1818
I call this trick is the Banksy.,131,20,9,160,648,2850
"Don't worry,Helen.  It worked on YouTube.",131,20,9,160,648,3258
And out comes a new prenuptial agreement.,131,20,9,160,648,4008
"The magic may be gone from our marriage, but who says you can’t bring a little magic to divorce?",128,27,5,160,648,4122
"VOILA, President Trump's 2016 tax return.",114,17,8,139,648,3594
My god! That's my only copy of the Gettysburg Address!,160,29,9,198,648,915
"There are options to gerrymandering, Sylvia.",141,30,6,177,648,2130
For my next act  I will shred a Banksy.,146,20,11,177,648,3675
Presto! This simple shredded paper will now transmogrify into Donald Trump's complete 2018 Federal tax return.,131,13,12,156,648,3546
"Not as dramatic, but sure beats the last guy sawing me in half.",138,29,6,173,648,329
"Don't worry, we should have this wand in working order when it's time to saw you in half.",137,31,5,173,648,4064
"Magic, it can help you avoid both death and taxes!",153,30,7,190,648,2178
"Voila! As Mr. Trump says, ""your subpoena is shreded so you are free to go!""",122,24,6,152,648,3233
"And just like that, Miss Adams.....Viola! Your contract with me is up!",149,31,6,186,648,212
"Now, who wants coleslaw?",149,30,7,186,648,936
"And now, for my final trick, I'll make his tax returns....DISAPPEAR!",118,25,5,148,648,1117
"For my next act, I will make Trump’s tax returns disappear",134,23,8,165,648,1121
And Presto! The judge will not be able to find a shred of evidence to convict you!,130,31,4,165,648,2166
Abra-ca-electoral college.,132,28,5,165,648,2472
"Now as I promised, you can see that all your social security numbers are being completely shredded.",132,27,6,165,648,2508
"It's magical, the votes vanish and the hares appear tomorrow.",131,30,4,165,648,4134
I started using paper for this trick after 1 unfortunate loss of a rabbit.,117,20,7,144,648,1033
"Secretary of Magic ""And for my next trick the Robert Mueller Investigation""",115,24,5,144,648,2499
"In goes the marriage certificate, and viola! We're no longer man and wife!",117,20,7,144,648,2724
"Much like the scandal, the lesser-known 'Iran-Contra' trick, continues to leave audiences shocked and astounded.",125,34,2,161,648,2924
Wordsmithing!,142,30,6,178,648,17
"Sawing a beautiful woman in half has become
too costly and time consuming.",142,30,6,178,648,87
"We say the magic words, “Collusion's Illusion” and – Hey Presto! – the evidence disappears!",140,34,4,178,648,1906
"Now I’ll wave my magic wand, and watch the evidence disappear!",144,26,8,178,648,2303
"...and so, to make this transition to the paperless office, we’ll be distributing magic wands to all company associates.”",142,30,6,178,648,2419
"Donald the Great: ""You see a State of the Union address, Nancy? Covfefe! Now you don't.""",144,26,8,178,648,2683
"For my next trick I’ll turn my assistant’s and my 
marriage license into a divorce decree!",156,32,7,195,648,4062
Another illusion on the cutting edge!,126,25,6,157,648,0
"Aren't you taking a bit too far,with this whole dress-for-the-job-you-want-thing,Ben?",127,23,7,157,648,42
It will reappear in the cloud at the moment I attain my Go Fund Me target.,126,25,6,157,648,1189
"and when this reappears, it will be a perfectly toasted piece of artisan bread!",126,25,6,157,648,2072
"If I can't read the bad news, then it disappears",126,25,6,157,648,2570
"Nothing is lost, nothing is added.",125,27,5,157,648,3012
And the magic word is FAKE NEWS,126,25,6,157,648,3291
And next I will make a rabbit disappear!,139,29,6,174,648,840
I will now place this ordinary subpoena into the box without reading the amount I owe my ex-wife.,140,27,7,174,648,940
I'm gonna ask my lovely assistant to watch herself please.  Making this document reappear is one thing.  Her thumb is another story.,136,35,3,174,648,1528
"Why yes, my cousin is Banksy - why do you ask?",143,22,9,174,648,2507
"Yes! It looks like a shredder, sounds and acts like a shredder.  But Ladies and Gentlemen:  Have no doubt.  I assure you my vote will still count!",141,20,9,170,648,557
Behold as the corporate hocus pocus of Theranos turns this once valuable stock certificate into hamster litter.,136,28,6,170,648,1718
!arbadacarbA,136,28,6,170,648,2163
"And now I, the Great-Outstanding-Phillip, will make this mail-in ballot disappear!",122,27,4,153,648,3573
"and presto, we have shredded your old birth certificate and you are now 21.",135,30,5,170,648,3582
''Abra Cadabra we're divorced.'',163,27,10,200,648,88
I can make it disappear but it would take a real magician to make it reappear.,134,25,7,166,648,1647
Hmmm making that rabbit disappear was a lot messier.,133,27,6,166,648,1961
And abracadabra your ballet has been tampered!,135,23,8,166,648,3759
Watch my latest trick: unshredding evidence!,136,23,7,166,648,4140
Where does it say you can't claim rabbits as dependents?,120,23,6,149,648,1742
You'll find out why magician assistants have such a high turnover rate when we switch to the rabbit.,119,25,5,149,648,4025
Now watch closely as this piece of paper will be recycled into a wall.,159,29,8,196,648,3792
They say you can’t make taxes disappear.,142,32,5,179,648,131
And with a tap of my wand this harrasment claim against me will disappear.,145,27,7,179,648,1299
"Once we upgraded the operating system, the dove flew off and took the hat.",145,26,8,179,648,1904
"In case you were wondering, Oliver North taught me this trick.",143,30,6,179,648,4221
And this is how we get rid of toxic masculinity.,130,27,5,162,648,2098
"Not part of the act, ladies and gentlemen... I just love to shred.",130,27,5,162,648,2905
"A ""50 percent off"" coupon toward a rabbit of your choice.",131,24,7,162,648,3198
Now I pull a perfect copy out of my Reverse Shredder.,132,22,8,162,648,4178
Why should I saw you in half my dear when I can just shred our license.,141,27,7,175,648,469
"Now, please watch carefully as I escape from taxes.",143,24,8,175,648,2902
"Picasso,
""The urge to destroy is a creative urge.""",141,27,7,175,648,4006
The real magic is me getting the paper I am shredding. Everyone has been trying to get these tax returns.,128,23,7,158,648,753
"Due to the delay in my federal magician's subsidy, I will be performing presto-change-O Lite.",129,21,8,158,648,1148
And again in 2020 the winner is... !,130,21,7,158,648,1730
Now watch this!  Old boring stuff becomes hot news!,130,19,9,158,648,2583
Here goes my assistant’s contract.,125,29,4,158,648,3129
"And now, I'll turn this everyday office memo into glorious confetti!",113,23,5,141,648,1877
It's called the Enron vanish.,137,28,6,171,648,996
And then we shred the shredder.,136,31,4,171,648,1484
For my next trick I will make the US constitution disappear!,127,18,9,154,648,2277
Abracadabra my ass!,128,17,9,154,648,2520
Abracataxfraud!,124,24,6,154,648,2886
... and – Hey Presto! – the bad reviews become ticker-tape!,123,27,4,154,648,3125
Where's the rabbit?,123,26,5,154,648,3966
This is much nicer...the rabbit doesn't fit well in the shredder!,134,27,6,167,648,839
"With my wife's help, I'll just slip this little pre-nup right in here and give it the old abrakadabra.",138,22,7,167,648,2992
"As the election judge, I can do what I want with any ballot.",143,32,5,180,648,941
Now I'll make you're vote disappear.,142,34,4,180,648,2100
Flip the switch while I distract them with my wand.,122,21,7,150,648,3207
"‘Boring’, I hear you say.  Well, next is the Bunny in my hat.",146,26,8,180,648,3507
And voila! You pay no tax!,133,22,8,163,648,1689
And Now for a Masterpiece,135,18,10,163,648,2906
I really don't understand how Banksy did it,129,30,4,163,648,3724
"Hocus POTUS, Alakasham, say them with me folks, Abracallusion, Vladiflimflam.",147,17,12,176,648,1177
"Abracadabra, the secret to this trick is now unshredded..alacazam, it's the rabbit's resignation letter!",144,23,9,176,648,1765
I'm starting to question this whole New Year's shred plan.,148,18,10,176,648,2064
"Don't worry, I'm only going to shred you in half.",138,35,3,176,648,2866
The Great  Bandoni mistakenly shreds priceless historical document while hiding a worthless copy up his sleeve,143,25,8,176,648,3135
"Abracadabra Alakazam
Shred these tax papers
Hiding the scam",145,21,10,176,648,4201
"Ladies and gentlemen, my probation officer gave me this idea after I sawed my last assistant in half.",130,21,8,159,648,1651
This was a great trick for me until Banksy hid the shredder in a picture frame.,131,21,7,159,648,2099
Technology has really put a damper on the vanishing act.,128,25,6,159,648,3876
"And with a wave of my wand, I will make your vote... disappear!"" - GO",142,21,9,172,648,3660
"WaLa,it disappears just like during the 2000 election",138,28,6,172,648,3681
I'm sending an encrypted message that will now appear in plain text on your smartphones.,138,28,6,172,648,3962
"An for my next trick, I’ll make my debts disappear!",149,29,7,185,648,1483
"When my attorney said he could make my student debt disappear, I had envisioned something a little more legitimate",116,19,7,142,648,184
"Next time listen more closely - I asked for the shredder, not the toaster.",126,22,7,155,648,644
"Watch closely as I shred my assistant's contract, and then we will see if she can reassemble it in 30 seconds.  There are no copies.",127,20,8,155,648,652
Thank God the rabbit actually disappeared.,125,25,5,155,648,1250
Abracadabra...watch my impeachment disappear!,123,28,4,155,648,1966
"Before going into real estate, Fred used to be a magician.",137,23,8,168,648,226
And what have we here? An unshredding 'dear john' letter?,135,27,6,168,648,1305
"For my next trick, I shall make my surprisingly litigious assistant’s lawsuit disappear.",136,25,7,168,648,1480
Screw you Mueller,138,21,9,168,648,2750
...with help from my trusty assistant Hillary.,138,21,9,168,648,3228
"And now, I make the evidence of collusion disappear!",120,27,4,151,648,1585
And with that I will make this lawsuit disappear.,142,29,6,177,648,1349
"No, this isn't a trick. This is for security purposes.",143,27,7,177,648,2728
They sure don’t make magic wands like they used to.,141,31,5,177,648,3775
"If I can nail this, I’ve got a big gig over at Facebook lined up after this.",142,29,6,177,648,3954
Can we plug this in?,142,29,6,177,648,4242
"And now, watch all my bills disappear. Tadaaa!!!",154,29,7,190,648,2552
I guess Donald just likes the aesthetic of a magician making his tax returns disappear...,128,27,5,160,648,1041
"And for my last trick, I will make your tax returns disappear!",127,29,4,160,648,3797
"Can’t speak for democracy, but voter suppression has been a boon for us magicians.",141,24,8,173,648,1084
... and watch as I shred my New Year's resolution list,138,30,5,173,648,1323
"Abracadabra
Only shreds of evidence left.",140,26,7,173,648,3606
A magician never reveals his vote.,146,30,6,182,648,7
"And now, I will make our marriage...disappear!",126,24,6,156,648,854
"...and, finally, the only signed copy of that codicil to the Bezos' pre-nup.",125,26,5,156,648,1049
The rubber chicken told me to shred everything.,137,25,7,169,648,1185
And Presto a Banksy Original,136,27,6,169,648,1588
Ta da!  And those critics thought I couldn't make anything disappear.,128,20,8,156,648,1853
I'm going to make our marriage licence disappear... and tada... I'm single again!,128,21,7,156,648,1878
Now you've all seen Trump's tax return.,137,25,7,169,648,2242
And the document now will vanish...subpoena-cadabra.,136,27,6,169,648,2741
And now my assistant will help me shred the evidence.,128,20,8,156,648,3645
Magician BANKSY!,144,34,4,182,648,4038
And just like that all of your bills will disappear,146,23,9,178,648,3942
"If i were in politics, my tax cuts would be spectacular",133,26,6,165,648,77
No need for magic when you can make things disappear this way.,133,26,6,165,648,386
"As I wave my magic wand and insert the ballot, I utter that magic word abra-electoral-cadabra",133,26,6,165,648,656
"An audience member has given me the only copy of  his tax returns in existence.  He is a VIP who holds one of the most powerful positions in the world, but I am not at liberty to use his real name.",135,23,7,165,648,697
Banksky: His Pre-Artist Phase.,134,24,7,165,648,2550
"And when I say Banksy, put your tongue in it.",135,22,8,165,648,3340
May this caption deserve a short life at the bottom of a hampster cage”.,133,26,6,165,648,3558
I wish Ted would drop it with these silly outfits — as if wearing them somehow magically makes this legal.,131,30,4,165,648,4044
"...and make it reappear, ladies and gentlemen, still as a divorce 
decree, but now with me getting custody of Mr. Floppy Bun.""",135,22,8,165,648,4113
And voila...I have saved his resume on file.,124,21,7,152,648,490
And now I will make all fiduciary liability disappear.,124,21,7,152,648,1386
"Please, ladies and gentlemen, do not attempt this trick at home, . . . at least for seven years after you file.",120,29,3,152,648,1501
The real wonder is why we still print things in the first place?,111,24,4,139,648,952
"Full Disclosure, One page at a time.",110,26,3,139,648,3891
"If you keep holding on to that document, your hand is going to be REALLY small.",153,25,9,187,648,768
"And now, with this simple act, I will make my career disappear.",141,26,7,174,648,893
It's magic how we can make these tax records disappear.,142,25,7,174,648,916
"The rabbit has died, we should have stayed with the hat.""",140,28,6,174,648,1398
Maybe this time the damm rabbit will come out instead of that orange haired thing!,141,26,7,174,648,1733
Behold as I make my IRS tax forms- disappear!,142,24,8,174,648,1784
"I hope you’ve enjoyed the Trump magic show! For my grand finale: Into the shredder with the U.S. Constitution! Aaaaaand… Presto! Out it com…. Uh, oh… ehhhh… Presto! Uh…  Something’s gone… Hmmmmmmmmm….",141,26,7,174,648,3516
And shazzam! The last piece of evidence magically disappears.,128,29,4,161,648,27
Now they'll never read what I did to that rabbit!,129,27,5,161,648,1593
The Attorney General assured me that this trick would work.  Even gave me the paper.,133,19,9,161,648,1711
I will now make jury duty disappear!,128,30,3,161,648,2678
This illusion was a lot more exciting before I ran out of rabbits.”,135,15,11,161,648,3633
"I shall now shred this document, along with the thumb of my assistant........",120,22,6,148,648,2429
‘Well here goes Donald’s billet doux to Stormy’,152,20,11,183,648,672
Watch this restraining order magically disappear.,149,26,8,183,648,693
This lovely volunteer from the audience has agreed to let me make her ballot disappear.,150,24,9,183,648,702
The magic of progressiveism meet the shredder of politics.,148,28,7,183,648,3029
"Tis I, the Magical Michael Cohen.",150,24,9,183,648,3079
For a nominal fee I will make all your bills irretrievably disappear.,140,22,8,170,648,692
And now. I'll make my lovely assistant's identity disappear.,137,27,6,170,648,2018
And for my next trick I’ll make his tax returns appear.,138,25,7,170,648,3785
"And for this next trick, I will make my student loans disappear.",134,33,3,170,648,3788
Now pretend this is paper is my assistant and I'm sawing her in half.,127,24,6,157,648,1753
And my biggest trick of 2019... your tax refund before 2020!,130,21,6,157,648,1794
"As I told Trump, with the touch of a wand and the help of shredder, I could make the Mueller report disappear.",155,30,7,192,648,2637
"I will now make the translator's notes of the meeting with Putin disappear. No, I'm not a expert magician, but I did sleep at a White House last night.",146,25,8,179,648,1000
"And now , Ladies and Gentleman, you will see how this antique ink-jet printer from 2002 prints its fifth page in a row without a cartridge change.",147,24,8,179,648,1293
Phew. Last time I pulled out a rabbit.,143,31,5,179,648,1859
"This was the form that said I can't turn anyone into a frog,right?",144,29,6,179,648,3565
Watch me make Trump's tax returns disappear.,133,28,5,166,648,223
What I  shred here will turn into a Banksy mural elsewhere.,137,22,7,166,648,1960
Banksy has nothing on me.,133,28,5,166,648,2691
It's a coll-u-u-u-sion.,139,16,11,166,648,4202
"Now watch carefully as I make these song lyrics disappear........wait, OH NO, they are JAMMING.",143,24,8,175,648,663
you can catch my next trick at the Governor Mansion in Georgia,144,22,9,175,648,1296
"One, two, three...Abracabanksy !",160,29,8,197,648,2124
"For my next trick, I’ll make my tax returns disappear!",161,27,9,197,648,3159
"Wearing Lincoln's hat doesn't give you the right to shred the Constitution, Mr. Trump! And what's with the bowtie?",133,21,8,162,648,3055
Magician unaware of Manufacturer's Warning: This is an Oval office limited edition model. Documents are made whole after appearing to be shredded.,123,19,7,149,648,1955
Ok. Not what I saw myself doing at this point in my life but my high school leotard still fits.,118,28,3,149,648,2213
"But first, I'll make this cease-and-desist order disappear.",138,27,6,171,648,158
I can make the information on this page reappear on computers everywhere,139,25,7,171,648,622
"I wave my magic wand, and the shredder casts ballots, early and often, for the right candidates.",140,25,6,171,648,1613
And in my next act I will show how one makes an email disappear!,139,25,7,171,648,2158
"Abracadabra, it's now great art",142,19,10,171,648,2730
And another woman who had an affair with Donald Trump confesses!,139,26,6,171,648,3201
"And for my next trick, I will attempt to make this jury summons disappear...",140,23,8,171,648,3245
...one can come up with most any excuse to meet a half naked blond!,158,27,8,193,648,2222
And now I will make the Constitional Republic reappear,110,21,5,136,648,771
Next we cut the translator in half.,126,28,4,158,648,148
"And now, watch me make this subpoena disappear!",127,26,5,158,648,612
I shall now make this state dept. translator's notes disappear.,128,24,6,158,648,1235
I like to start the show with easier tricks.,128,24,6,158,648,1982
Don't cry.  Now we can both be president.,130,20,8,158,648,3346
"For my next trick, I'm going to make the Mueller Report disappear",145,29,6,180,648,838
"And now using my magic anti-Mueller box, I will make this event disappear!",147,25,8,180,648,2979
"Ladies and Gentlemen, for your delectation: All The News That's Fit to Shred.",147,26,7,180,648,3466
And now I will shred my tax returns. Back to magic in a minute.,144,31,5,180,648,3713
Presto! No more hassle from the ASPCA!,117,23,5,145,648,2493
"And with the wave of my wand, your affidavit will disappear!",114,29,2,145,648,3006
"I call this one, Preventus Identity Theftus",119,22,4,145,648,4009
I'd like to add you to my LinkedIn network,137,22,8,167,648,724
"Before your very eyes, your paycheck shall disappear""",137,22,8,167,648,938
"Yes, a President did show me how to shred ballots...",136,24,7,167,648,1901
"And now ... I'll put my traffic ticket into the shredder, and later, you'll see, as by miracle, ... I'll get a brand-new new ticket!",138,20,9,167,648,2121
and now I will save Trump's tax return,136,24,7,167,648,2307
"And just like that, you owe thousands in back taxes!",136,25,6,167,648,2331
My final curtain call is to pull a shred of human decency from these Panama Papers.,143,26,7,176,648,1630
And Presto! Evidence of collusion has vanished!,127,19,8,154,648,2939
I shall now magically change this summons for Jury Duty into a plate of delicious scrambled eggs.,142,28,6,176,648,3539
Abracadabra there goes another Republican vote.,123,27,4,154,648,3688
"Relax. Just put on your best, “This is how we vote now,” smile.",141,30,5,176,648,4224
"It's just as amazing, but much easier than sawing you in half.",151,26,8,185,648,3639
I will now saw this paper in half and half again and half again and half again and half again and half again and half again and half again and half again and half again and half again and half again.,152,24,9,185,648,3811
"Decompose, Ye, my tax returns.",150,29,6,185,648,3845
And now I'll make my tax problems disappear!,131,27,5,163,648,238
"And when I am done, ladies and gentleman, it will be confetti!",133,24,6,163,648,680
"Presto!  Don't forget kids, it works for chore lists, report cards, AND tax returns!  Now that's real magic.",132,25,6,163,648,3189
"Behold! 'Auditing' in progress.""",132,26,5,163,648,3314
See? I can make IRS audits disappear too.,141,23,8,172,648,28
"And for my next trick, I will make this cease and desist notice disappear",139,27,6,172,648,461
"'And now, I will make my taxes disappear.'",137,31,4,172,648,3559
I will now shred all the records of tonight's ticket sales.,137,31,4,172,648,4130
"And here we have our prenup back again, as good as new.",120,26,4,150,648,144
"We've got to bury the evidence first, then the rabbit.",121,24,5,150,648,2400
I will now make our marriage license magically disappear.,146,30,5,181,648,1120
Presto Change-o fraud indictment Disappear-o!,130,22,7,159,648,439
The last paper we  will ever read,129,24,6,159,648,493
"And for my next trick, I'll make this prenuptial contract disappear before Soon-to-Be-Ex-Mrs.-The-Great-Zambini's eyes...",128,26,5,159,648,1667
The sex therapist said to try new things.,131,20,8,159,648,2228
I am holding our national audience as witnesses that I have delivered President Trump's tax returns directly to Congress.,132,18,9,159,648,2738
I will now make my attorneys' fees disappear!,128,26,5,159,648,2824
"After working thirty years as a magician, I can finally make my mortgage disappear.",131,20,8,159,648,3188
"And once the contract is shredded, I will totally disappear from this miserable venue!",137,24,7,168,648,865
"And now, the Magic Words: Abra-CaBanksy, Wanksy No Thanksy!",140,19,9,168,648,1034
I will now change the translator notes from English to Cyrillic.,137,24,7,168,648,3039
"Abracadabra.
Watch me make those ballots disappear!",144,26,7,177,648,879
It’s magic!  The printer works!,145,24,8,177,648,1457
I'm testing this before I make my lovely assistant disappear.,141,32,4,177,648,4168
"And for our next trick, Janice and I will fight over custody of our son.",151,28,7,186,648,168
Very clever how the toaster exposes the secret ink!,150,30,6,186,648,992
Hocus pocus marriage license toasta,131,29,4,164,648,2909
"And now, with assistance from my girlfriend Gayle, I will make my child-support payments disappear.",137,17,10,164,648,3038
"I'm hoping that by shredding this contract bid for a border wall, the President will magically become Mr. Rogers.",135,21,8,164,648,3154
I think that noise means the bin's full,134,23,7,164,648,3181
I may need someone from the IRS for the next part of this trick,133,25,6,164,648,4235
"Oh, the magic of tax time!",103,30,0,133,648,60
Your document can disappear just like this subpoena for a one hundred dollar donation.,143,21,9,173,648,1739
"Abracadabra, alakazam. Disappear my assistant's contract and sonogram.""",140,27,6,173,648,3022
"Mister President, imagine these are Articles of Impeachment...",140,27,6,173,648,3213
"Abracadabra, terms and conditions now apply!",143,22,8,173,648,3481
Watch my assistant put these shreds together and pull out a rabbit,138,31,4,173,648,3482
And now to make this bill disappear.,139,29,5,173,648,4099
"Now that we know the machine works, I shall make Jaylene disappear.",139,29,5,173,648,4174
"Now I'll restore the paper, and a doctor in the house will do the same to my assistant's thumb.",148,27,7,182,648,22
"And now my greatest trick, making Trump's tax returns disappear",146,31,5,182,648,1094
Some Democrats have cast doubts on congressional Republicans’ new plan to help federal employees manage their bills during the government shutdown.,150,23,9,182,648,1388
"Hold ‘er steady, Karen. We’re only chapter two.",148,27,7,182,648,3191
Presto chango shredo.,132,20,8,160,648,5
Thanks! My wand is broken.,128,28,4,160,648,3533
And bibbiddi-bobbiddi-boom! My financial struggles have mysteriously disappeared. For my next trick I shall fly.....To the Cayman Islands.,129,26,5,160,648,3804
Lets hope magic works this time.,139,22,8,169,648,438
"Yes, I am with the government, and I am here to help you.",137,26,6,169,648,2205
"Nothing up the sleeves, and, Ta-Dum! Look, no redaction needed!",137,26,6,169,648,2580
"Like they say, fake it till you make it.",138,24,7,169,648,4096
Watch as I make this jury duty summons disappear.,143,32,3,178,648,1898
"This new trick is called  ""The Presidential Tax Return"" and if I do it right, it ends up in David Blaine's stomach.",146,24,8,178,648,2164
"I guess they're right, this electronic age is shear magic.",144,28,6,178,648,4216
Abraca...Deborah...could ya give it a little shake...,163,22,11,196,648,1939
"Except for the blood, this was much better trick when I used a rabbit.",119,23,5,147,648,3809
"Dispatching with a hocus-pocus, this presidential Twitter opus.",126,25,5,156,648,1750
"Take that, Toastmasters Club.",127,23,6,156,648,3042
"Viola, the interpreter's notes: COLLUSION",128,21,7,156,648,3300
I never really believed in this Democracy nonsense anyway.,132,29,4,165,648,2756
I've demonstrated that sawing a woman in half isn't criminal while holding this wand. Now for my next trick...,134,25,6,165,648,3908
"And for my next act, I shall make my taxes disappear.",141,27,6,174,648,146
I learned from Enron. Start with magic tricks and then expeditiously shred.,144,22,8,174,648,2867
Now I will make my criminal record disappear.,139,31,4,174,648,3276
The real magic is in step two: avoiding the IRS,142,25,7,174,648,3465
Now you see it... Soon you won’t. As featured on America’s Not Talent.,141,27,6,174,648,3568
And now to make Trump’s tax return disappear...ta-da,147,32,4,183,648,3290
"For my next trick, I will make our loans.. disappear!",120,31,1,152,648,3361
"Before my next trick, I will shred our pre-nuptual agreement...",125,23,4,152,648,3437
This is how I made Trump think we were shredding the Mueller report.,124,22,6,152,648,4237
"Betsy, I know you think this trick is stupid, but act surprised! Marie Kondo would!",131,25,5,161,648,2897
"Presto, chango. My Trump ballot is automatically shredded",139,25,6,170,648,2196
Tax return? There is no tax return!,138,26,6,170,648,2712
Abra-dabra -papershacabra,138,26,6,170,648,2778
"And now, before your very eyes, I'll make our pre nup disappear...",136,30,4,170,648,2966
"Presto Change-O,  from pre-nup agreement to post-nup agreement""",138,27,5,170,648,3577
"This is no illusion folks, this is Enron at it's finest!",140,22,8,170,648,3661
"The rabbit disappears, his contract disappears.",141,22,7,170,648,4204
"And for my final act, I'll make our marriage license disappear",143,32,4,179,648,913
How one man prepares to imitate Donald Trump speaking.,148,22,9,179,648,2034
"Now I'll say the magic words: ""Abra-Ca-Bansky""",143,33,3,179,648,3840
"Tell Abe to vote ballet""  (palindrome!",151,32,5,188,648,4034
Now I’m going to demonstrate how I make my credit card bill disappear...,121,22,5,148,648,1197
"Mueller’s report, vanished!",119,25,4,148,648,3664
"For the first time ever,I will assemble a rabbit from the shreds.",121,22,5,148,648,3742
"And, as I said to the auditor, '""Presto!'",129,21,7,157,648,689
"Damned PETA, the rabbit/shredder could have been a classic.",131,18,8,157,648,1458
"In this trick, I will evade my taxes.",134,28,4,166,648,783
And now I will make your prenup magically disappear,132,31,3,166,648,3869
"Can't take the kids if the papers are destroyed, Sharon!",145,22,8,175,648,3140
Now all I need is to say the magic word - abrrrcrrrddrrbbrrrrr,142,27,6,175,648,4120
"Now for my next trick, watch your paycheck shred right before your eyes.",155,33,5,193,648,1869
This trick's a lot more complicated than the one where we saw a woman into just two parts.,156,31,6,193,648,2913
...as I make a work of art emerge from the shredder.,123,26,4,153,648,85
... and here is my final trick: Making confetti out of  paper!,118,20,6,144,648,321
Now watch as I make your resume disappear!,142,23,6,171,648,726
This is another way to make that subpoena disappear.,125,22,6,153,648,788
"Since this is a banking convention, I will shred my handkerchief, and all of you will receive a picture of a rabbit via email.",119,18,7,144,648,963
"Carl, did you make the rabbit disapear too?",117,22,5,144,648,1014
And now I'm going to turn this marriage certificate into divorce papers.,123,26,4,153,648,1249
"At Magic Shred, I feel valued for the skill set I bring to the job of document disappearance.",157,38,3,198,648,1295
"Audience, you are now watching my divorce summons disappear.",133,22,7,162,648,1322
"For my next trick, my expense report fiction vanishes forever!",132,24,6,162,648,1560
Watch as I turn my taxes into government policy.,140,24,7,171,648,1822
"And while my lovely assistant holds the shredder, I will insert the transcripts of my conversation with President Putin and say the magic words...""No Collusion!""",144,17,10,171,648,1871
"And now, ladies and gentlemen, the subpoena about the incident in Orlando will disappear.",139,26,6,171,648,2323
"This way, Kellyanne, nobody will ask for my dad’s tax return anymore!",134,20,8,162,648,2845
I will now turn this damning evidence into FOIA-exempt evidence.,138,28,5,171,648,3146
Critics agreed that The Great Torzinni had the first half of his tricks down cold.,131,26,5,162,648,3265
And now my tax evasion charges will disappear!,130,28,4,162,648,3308
I'm not as sure about death as I am about taxes.,130,28,4,162,648,3322
"So sorry folks, the lady I sawed in half was from IT!",158,29,7,194,648,242
You want a trick? Shazam! Trump becomes president.,162,21,11,194,648,2860
And presto chango! I will make the evidence disappear!,159,29,6,194,648,2956
"Thank you for lifting that for me, if I bent down I may have dropped the cake off my head.",150,29,6,185,648,3405
"If this won't work, I'll just make the damn thing disappear",148,33,4,185,648,3686
"And for my next trick, I'll need a piece of paper from the audience...",143,27,6,176,648,1608
..and now the great Putin-ski will create a shredded salad with Russian dressing using just my tax returns,143,27,6,176,648,2217
For only $5 you too can watch your tax bill disappear.,144,25,7,176,648,2290
Watch carefully while I make my pre-nup disappear.,142,29,5,176,648,2822
"It's not magic, my paycheck vanished due to the government shutdown.",139,20,8,167,648,1816
Shredracadebra!,136,25,6,167,648,2820
And now for my next trick: I will make our president's tax return disappear,137,24,6,167,648,3888
"Contest #647  |  January 21, 2019

Please relax. They enjoy the tax form trick more if it goes wrong anyway.",137,24,6,167,648,4095
"And now, ladies and gentlemen... to our final trick, ""reverse shredding""",130,22,6,158,648,2310
"Tell the rabbit's agent, 'no deal!'""

-Jim McRae, Montreal, Q",129,23,6,158,648,3967
"...And with the wave of my wand, I will make this restraining order DISAPPEAR!",124,20,5,149,648,2928
And for my next trick I'll make tax returns disappear.,120,25,4,149,648,3418
And to think I believed magic would keep me out of a corporate office job.,122,22,5,149,648,3461
"And now, for my final trick, I will make the divorce papers disappear!",154,30,6,190,648,3757
The shredder is quicker than the eye. Watch this tax lien disappear.,146,30,5,181,648,2868
"A wave of the wand and, PRESTO!, the subpoena disappears.",141,24,7,172,648,602
"- Don't you worry honey, this trick will make your student debt disappear into thin air!",141,24,7,172,648,4039
"Now for my next trick, watch my tax records disappear. Ala kazam!!",131,28,4,163,648,688
Don't shred a tear for me.,132,26,5,163,648,2760
"Abra-cadabra, special prosecutor be gone!",130,31,2,163,648,3472
"And the outcome of the 2020 presidential election, via The Trump Channel, is...",138,14,11,163,648,4004
I am going to make Trump's tax returns disappear,125,24,5,154,648,11
You are Trumps kind of Magican.,129,17,8,154,648,2162
"Mr. Georgie Porgie of puddin’ and pie fame:
“Abracadabra...begone my list of girls I kissed and made to cry.”",125,24,5,154,648,2333
Simply reverse the polarity of the shredder’s plug and Abracadabra! Your message returns...,122,30,2,154,648,2395
"1, 2, 3, IRS DISAPPEAR",124,26,4,154,648,3963
"With this trick, we dissolve our marriage paperwork! Presto! Instant divorce.",115,28,2,145,648,303
Concentrate on the shredder and this piece of paper - out will pop a big beautiful wall.,153,25,8,186,648,1491
"And with the wave of my wand, watch the incriminating evidence DISAPPEAR.",151,29,6,186,648,2360
"If Al Capone can make his taxes disappear, why can't I?",143,29,5,177,648,2305
Who controls the past controls the future: who controls the present controls the past,145,25,7,177,648,3064
"... and the lovely Sandy with my new assistant, the AutoMax PowerShred X1200.",141,19,8,168,648,336
I shall now make a piece of useless technology disappear.,137,25,6,168,648,552
I will now shred the instructions for how to do this trick. Uh-oh.,138,23,7,168,648,756
Those of you thinking bunny - you disgust me.,139,22,7,168,648,1343
...and POOF! Your debt is gone!,135,29,4,168,648,1957
Let's pray to Banksy that I can get $1.37 million for this after it is shredded,130,23,6,159,648,1634
"In goes a Gillum ballot and abracadabra, out comes another DeSantis winner",129,25,5,159,648,1725
So much for your me-too allegations!,127,29,3,159,648,3326
"For my next escape trick, my assistant here will destroy the instructions for opening the air-tight shipping container.",157,26,8,191,648,3632
After defeating You-Know-Who Harry Potter's career quickly went downhill.,150,24,8,182,648,44
"I will never reveal the secrets of my magic! Seriously, I won’t.",146,32,4,182,648,2755
At the count of three I will turn this piece of paper into tiny strips. 1...2...3..,150,25,7,182,648,3421
Now watch as I make this restraining order...disappear!,140,28,5,173,648,614
I am putting the Mueller Report in the fax machine.  It will be sent to all the major media outlets and members of congress.”  Said Barr the great.,142,24,7,173,648,2273
And now my next trick... making my divorce papers disappear.,134,24,6,164,648,516
For my next trick I will move my right eyeball to the right of my nose.,136,20,8,164,648,1015
Presto-Redacto.,134,27,3,164,648,1852
I'm using folks at the CIA to put these back together.,133,26,5,164,648,1864
"Abra-cadabra, your New Years Resolutions will soon be toast.",133,26,5,164,648,3246
"For my next trick, I shall make my credit card bill disappear!",124,28,3,155,648,1006
"And now, as I stop the shredder halfway, this $49 Groupon for Duct Cleaning will become a $10,000 bathroom remodel.",127,22,6,155,648,3007
Your ballet will disappear before your eyes.,120,20,6,146,648,1995
"I will now transform these translator notes into a Moscow Mule""",116,28,2,146,648,2900
"And for this trick, I'll make my legal troubles disappear!",119,22,5,146,648,3638
Voila! The shredded ballot is whole again!,116,28,2,146,648,4087
"In one terrifying suspenseful moment, with the wave of my wand I will reconstitute this notice of the winner of  ""The Publisher""s Clearing house""
 contes",112,21,4,137,648,3870
The last show of the night.,137,27,5,169,648,136
Abraconfetti,140,21,8,169,648,811
"Ladies and gentlemen, watch as I make our prenup agreement disappear.",137,27,5,169,648,2428
abra kazam! Mister Rabbit isn't done disappearing until all evidence is destroyed.,138,25,6,169,648,4054
"Don't forget to hit ""reverse"" before we're on stage.",139,23,7,169,648,4241
I'd like to see Houdini try this one!,133,19,8,160,648,1103
"And just like that, the tax return disappears!",130,25,5,160,648,1127
"...Miss Fawn Hall, ladies and gentlemen!",132,22,6,160,648,2267
"And now, with a wave of my magic wand, toast!",132,22,6,160,648,2417
"For my last act, I shred my assistant’s contract and make her disappear.",133,19,8,160,648,3607
Now for my next trick Mr. President - I'll make your taxes disappear,130,25,5,160,648,3696
For my next trick I will save your identity.,149,28,6,183,648,3848
"And for my next trick, I am going to make these negative audience reviews disappear.",122,25,4,151,648,568
"And just like that, your application for my assistant position disappears!",139,32,3,174,648,1838
"And, voila! This suggestion about not perpetuating stereotypical gender roles has disappeared!",142,26,6,174,648,2606
"Prenuptous agreementus, be-gone-us!",142,26,6,174,648,3793
Abra-memoranda! I've made Parliamentary procedure disappear.,133,28,4,165,648,201
Abracadabra...... Facts from the fax,135,24,6,165,648,247
"Here in New York, another Republican ballot.",133,28,4,165,648,2176
"To save the act, I’m shredding your contract, making you magically disappear, and then replacing you with a drag queen.",134,26,5,165,648,2241
And now we make all evidence of Russia interference in the 2016 elections disappear,147,25,7,179,648,1391
I knew I should have been better prepared when Mueller Called,145,29,5,179,648,1423
"Hocus Pocus 
Sears
K-Mart
1..2..3! 
Retail!!",148,26,5,179,648,1503
Damn I 'd much rather be cutting HER in half.,149,21,9,179,648,2888
"Now, before your very eyes. Watch a paternity test...disappear!",141,21,8,170,648,1947
"""next I will make the prenuptial  agreement whole again""",134,20,7,161,648,592
Marsha and Fred audition for a consulting gig at the Annual RNC Strategy Job Fair.,152,24,8,184,648,1031
And now I will magically delete an email.,151,26,7,184,648,1530
"And for my final trick, I will make my taxes...disappear.",133,21,7,161,648,3011
"Presto!  The cable bill has disappeared.  And now, ladies and gentlemen, boys and girls, Netflix's prices will levitate.",149,30,5,184,648,4082
"To my wife’s attorney ——- Watch, as I make this subpoena disappear before your very eyes.",162,29,7,198,648,3237
"'And for my next trick, my assistant, Hillary, and I will shred the election results""",144,24,7,175,648,96
Now watch as I make this harassment claim disappear.,145,22,8,175,648,1655
"Ladies and gents, my administrative assistant!",142,28,5,175,648,1699
And you thought your accountant worked magic!,142,28,5,175,648,2639
And it looks like The Electoral collage is about to cast its last vote,146,20,9,175,648,3362
"Trumps interpreters notes from Hamburg .  Now you see them, now you don’t.",124,23,5,152,648,1020
"The Trump Organization's Records Department:
""The real magic trick will be avoiding jail time.""",126,19,7,152,648,1106
Banksy's Magician Brother,126,19,7,152,648,1419
And that’s my rejection letter from MIT. Poof!,125,21,6,152,648,3360
"And now, for my final act, I will transform this half shredded rejection letter into a half shredded original Banksy.",125,21,6,152,648,4086
"That’s the last of the Constitution. And now, I will make it the President’s fault.",135,26,5,166,648,123
Ta-daa! The W-2 is..... gone!,133,30,3,166,648,3749
"As you can see, magically, the paper is intact again as I extract it from the shredder.",149,24,7,180,648,2780
Et voila! The president's tax return has magically disappeared.,129,22,6,157,648,278
"I just said to myself: "" Oh, just stuff it!""",130,21,6,157,648,867
"Harry, this modern technology really makes the magic disappear",127,27,3,157,648,2872
"And just like that, all of the Amazing Lenardo’s Student loans bills vanished!",129,22,6,157,648,3348
"...for my next magical trick, watch closely...all notes and documents will be shredded and never seen again.",126,28,3,157,648,3365
"Your ex's demands, expectations and criticisms, gone forever.",128,24,5,157,648,4185
"For my next trick, I will make a bunny disappear!",142,22,7,171,648,1001
. . . . . and this is how it looked before I shred it.,139,27,5,171,648,1350
I wish that we could afford a shredder rather that this toaster.,144,17,10,171,648,1565
With the wave of my wand I shall make all my legal troubles disappear!,142,21,8,171,648,1686
You must admit it’s a fantastic trick as long as long you ignore the shredder,149,32,4,185,648,983
"Abracadabra. First the English, then the muffin.",135,20,7,162,648,3574
"Judy, we call our cure to a delusional, Twittering world, 'hypnosis by fax'.",143,28,5,176,648,4027
"Before my next trick, watch this cease and desist letter disappear!",127,20,6,153,648,1083
"Voila! It's done. I know being a diplomatic translator pays better, but we have to disappear now. You'll feel better in Vegas.",126,21,6,153,648,1515
What tax returns?,135,28,4,167,648,284
"Abra cadabra...November 8, 2016 went the other way.",138,22,7,167,648,2172
"Now watch, as my student loans vanish!",136,26,5,167,648,2803
"Hurry, the price is rising as I shred! Do I hear 55,000?",136,26,5,167,648,2859
"You, too, can be a magician.
Call 1-800-shrdsht.”",138,22,7,167,648,3059
"When you forget the cloak, Darlene, our careers become the illusion.",138,22,7,167,648,3901
Now you see it. In a moment you won’t.,146,31,4,181,648,103
"It's magic, my dear, as if your notes never existed...and no one can ever prove otherwise.",117,23,4,144,648,2740
And PRESTO! Haha see? What lawsuit?,121,15,8,144,648,3364
"And now, we'll magically reassemble this ballot.",118,21,5,144,648,3587
And with a wave of this wand I will turn your boring document into a Banksy.,131,21,6,158,648,3244
"I insert the pre-nup thusly, Unfaithful Assistant...",142,23,7,172,648,357
...and then 16 identical pieces of paper!!,144,19,9,172,648,3124
"I call this my survival trick, making my 1099s disappear.",143,21,8,172,648,3552
"Wadda ya know, the rabbit turned into a Cease and Desist statement.",133,25,5,163,648,375
This act is inspired by our new corporate directive to mainstream disruptive technologies.,135,21,7,163,648,1623
"Don't cry, if your resume makes it through you're hired.",134,23,6,163,648,2782
"...and with a flick of my wand, I will make your debt disappear.",137,18,8,163,648,4118
Before your very eyes ... Your very own million-dollar Banksy!,146,24,7,177,648,782
Who else wants to make their bills disappear?,144,28,5,177,648,1059
Abracadabra! And my pending IRS charges disappear...,146,24,7,177,648,2048
"... and Abra-kadabra , we're now divorced.",150,16,11,177,648,2071
I bet Banksy’s assistant doesn’t have to wear a leotard and pearls.,137,26,5,168,648,47
"And now, I will make my tax forms disappear!",124,27,3,154,648,335
"‘Look carefully! 
Now you see it .... now you don’t!",151,23,8,182,648,532
"See the Amazing Shreddinski perform 
the incredible Vanishing Subpoena!",141,18,9,168,648,646
This was not in the job description when I was hired as Enron's resident magician.,128,20,6,154,648,1123
Alakazam! And now I can once again be within 500 feet of Tom Hanks.,138,24,6,168,648,1412
"And...abracadabra, any record of my embezzlement​ scheme disappears.",138,24,6,168,648,1924
And now watch my assistant pull the paper out of my ear.,137,26,5,168,648,2407
I never had to wear this goofy outfit at Aruthur Anderson...,148,29,5,182,648,2420
The wand chooses the shredder.,148,29,5,182,648,3331
"Now, with a little twist of this magic wand, we'll transform these poll results into better numbers for The Donald!",136,28,4,168,648,3733
"...And for this next trick, I’ll make my jury summons disappear!",152,30,5,187,648,23
Watch closely as I make my credit card bill disappear before your eyes!,155,25,7,187,648,290
"I will shred this list, and transfer it to all your cell phones as a text.",153,28,6,187,648,1450
"Alakazam, our marriage is a sham.",157,21,9,187,648,1973
"For my next amazing feat, I’ll update my social media profile.  But first, I shred my list of passwords.",140,29,4,173,648,1779
"And for my next trick, I'll make the record of our conversation disappear.",118,23,4,145,648,1362
"Behold, as the script becomes even more unreadable.",149,20,9,178,648,514
Any volunteers?,143,32,3,178,648,715
"I'm fine with being sawed in half 
but don't even think about shredding me.",145,28,5,178,648,777
"Now ladies and gentlemen, I will make my government check disappear.",145,28,5,178,648,1579
"I'm sorry, Lyla.  I can't make our mortgage disappear, but I can turn it into confetti",147,24,7,178,648,3736
Abracadabra! Your notarized pre-nup disappears.,133,27,4,164,648,1874
Now where were we?,135,23,6,164,648,2525
Voilà ! I make the interpreter's notes reappear!,136,21,7,164,648,2527
Hmmm . . .pretty sure that one should be going to the IRS!,134,25,5,164,648,2821
May I have another partner in crime from the audience?,133,28,3,164,648,2876
and there magically goes trump’s tax returns!,133,27,4,164,648,3282
Abrcad-Enron!,134,26,4,164,648,3439
Now watch as I make all of the incriminating evidence disappear.,135,23,6,164,648,3911
The KonMari method is intense.,123,22,5,150,648,1805
...And now for my next act...re-constituting Hilary's e-mails from the shredder....,122,24,4,150,648,3416
Presto Change-o -Hillary won.,125,18,7,150,648,3961
Prepare to be amazed as I utilize my magical gifts to restore the Mueller report after shredding,151,25,7,183,648,3278
Watch as I shred your proof of purchase...,137,28,4,169,648,473
The magic of recycling.,139,25,5,169,648,1396
watch the evidence disappear with a wave of my magic wand,157,23,8,188,648,3131
It's definitely a paper shredder and hopefully also a ballot counter.,131,24,5,160,648,754
What?! A hanging chad!,133,20,7,160,648,1092
Now watch this IRS audit miraculously disappear.,130,26,4,160,648,3445
"HOCUS POCUS , SEND THIS TO RUSSIA
and BACK QUICKLY!",156,33,4,193,648,2152
And yet another piece of junk mail magically disappears.,120,21,5,146,648,4105
"Don't worry, Julia, all your personal documents will be transformed into a delightful fruit basket momentarily.",145,30,4,179,648,2996
"Don't expect me to do the""disappearing rabbit"" trick this way.",136,23,6,165,648,1236
"For this next trick, I will make my assistant’s taxes disappear and she will magically reappear in jail.",136,23,6,165,648,1573
It's not a bunny. It's not a border wall. It's the elimination of any government shutdown ever.,135,26,4,165,648,1759
"For my next trick I will pull Trump's tax return out of a hat!
Oops!",163,28,7,198,648,1777
"For my next trick, I'll make my life's work disappear.",135,25,5,165,648,1850
"For my next trick, I'm going to make this paper disappear.",137,21,7,165,648,2027
"She and I used to do rabbit out of a hat.   Then along came electric appliances.""",136,23,6,165,648,2138
"The U.S. Constitution. Presto, what U.S. Constitution? Ladies and Gentlemen, it really isn't a trick.",150,29,5,184,648,3106
I’m not sure this makes the job any more interesting.,150,29,5,184,648,4055
"And now, an unprecedented public performance of my paper jam contingency plan.""",137,30,3,170,648,1024
...and for my next trick watch as I make culpability...Disappear!,141,22,7,170,648,1603
"For my next trick, I will make fools of the art world and shred a handwritten page from Breakfast At Tiffany's.",143,19,8,170,648,2300
"Sweetie, you promise not to tell the IRS, right?",138,28,4,170,648,2471
"It’s called distraction, Karen.",139,26,5,170,648,2917
I absolutely can NOT let Merlin get his hands on this.,140,24,6,170,648,3003
"For my first trick, I'll make your waiver disappear.",138,28,4,170,648,3163
And Presto! The shredding of Trump's Executive Orders ordered by our new Democratic President.,157,25,7,189,648,1071
"And for my last trick... I'll make our free refund policy... disappear!""",129,21,6,156,648,1375
"It;s magic, we no longer have any bills to pay.",131,17,8,156,648,1452
But before my next trick I really need to take care of this redacted statement.,127,25,4,156,648,2593
"“And for my last shred of the evening, my ex-wife’s latest book Human Decency!”",128,23,5,156,648,2743
Hey presto unshreddo!!!,131,17,8,156,648,3206
"All eletrically-powered machines are magic, really.",143,27,5,175,648,1134
"As you can see, my career is disappearing before your very eyes.",143,27,5,175,648,1574
"All the lies are now confetti, more easily scattered by his base.",147,20,8,175,648,1909
"You see, Hillary...I told you we'd find a use for our talents after we lost our jobs.""",144,25,6,175,648,3231
And for my next trick—I’ll make my assistant disappear!,143,27,5,175,648,3592
"Tears of happiness my dear?...Watch closely as Senator Mystic magically discards all 45 delusions, fantasies and bad dreams...",148,26,6,180,648,1438
And presto! Rabbit litter à la Enron.,147,28,5,180,648,4231
Watch closely as I make my wife's divorce papers disappear.,121,21,5,147,648,561
And now we'll pretend that the document no longer exists.,119,25,3,147,648,3763
... and Voila.  My 2019 tax liability has disappeared.,137,23,6,166,648,211
"And now, Banksy the Magnificent will make it disappear!",138,21,7,166,648,531
"And for my next trick, I'm gonna make Trumps tax returns disappear.",138,21,7,166,648,541
I can put this back together but I can't promise the same for you.,137,23,6,166,648,1340
"This won’t hurt Dolores, as long as you keep your thumbs out of the way.",138,21,7,166,648,1741
And presto!!  My last job was as a interpreter for the White House.,138,21,7,166,648,1999
"Have no fear, it will magically unshred in January, 2021!",134,29,3,166,648,2197
"And for my next trick, I’ll make this parking ticket disappear.",134,29,3,166,648,3818
Abracadabra  I hope I don't reach out and grab her.,139,19,8,166,648,4024
"For my next trick, I will pull a credit report out of the fax machine.",157,27,6,190,648,2
Now watch- as I make this marriage certificate DISAPPEAR!,124,24,4,152,648,684
Guess I won't be needing these hard copies of Dick Cheney erotic fan fiction now that I've moved my personal files to the cloud.,140,26,5,171,648,1282
Our treaty with the Cheyenne-Arapaho tribe.,126,20,6,152,648,2189
"Theresa May and Jeremy Corbyn headline: 
“Now you see it, Now you Brex-it”",140,26,5,171,648,2356
I will now make my job offer from Google disappear.,141,26,4,171,648,2409
Hocus pocus. Doing my taxes.,124,24,4,152,648,2458
"Watch closely as I make this letter threatening to disclose the  secrets behind my tricks completely disappear, never to be seen again.",138,31,2,171,648,2933
"Behold Zelda, watch as I make your salary disappear.",163,24,8,195,648,1514
"And this, my dear, is the receipt for that leotard.",144,27,5,176,648,2831
And then I take the very critical letter from my mother and— presto! It disappears!,128,25,4,157,648,1058
No hanging chads here!,129,24,4,157,648,2070
Pass your papers along; the corporate rate includes a three hour ‘the magic and mystique of plausible deniability’ special.,130,21,6,157,648,2652
I call this one the disappearing marriage vows.,162,34,4,200,648,1590
"Once I shred these Enron financial statements, an entire accounting firm will disappear...",149,26,6,181,648,3098
And now we will magically make the pile of paper that has been sitting next to the shredder for the past 10 months  disappear.,131,28,3,162,648,163
It's no Bansky!,134,22,6,162,648,2795
Expelliarmus Arthur-Anderus,155,24,7,186,648,509
"""For my next trick I'll need a volunteer",152,29,5,186,648,988
And there goes the doctor's bill.,134,31,2,167,648,649
"And just like that, I’ve put your parents’ letter in which they express uncertainty about my magic and fit as a husband, back together again. Ironically removing any shred of doubt.",138,25,4,167,648,1043
Carpe dossier!” (“Seize the documents!”,139,22,6,167,648,2253
And now... I will make all of my tax audits... DISAPPEAR!,137,25,5,167,648,2863
And just like that the voting machines in FL...work and no shads!,139,21,7,167,648,2984
"Damn it. Paper jam.... Sorry folks, I don't do PRACTICAL magic",134,31,2,167,648,4056
"And now, for my final trick, I will make your employment contract disappear.",121,23,4,148,648,3756
The first and last day Banksy had a real job.,157,28,6,191,648,2901
"now, we will take this evidence and make it disappear right in time!",140,28,4,172,648,2988
"And now ladies and gentlemen, watch as I make my tax return disappear.",143,23,6,172,648,3450
Damn it...get your right thumb out of the shredder.,126,22,5,153,648,1004
With the help of my lovely assistant i will now make my mortgage...disappear!!,124,26,3,153,648,2788
"Hocus, pocus slamo, whamo-through the power of my mind and my vote shredder I will make Donald Trump president!",126,22,5,153,648,3324
"I call this next trick, The Money Launderer's Recycling Bin.",128,18,7,153,648,3964
Who will disappear tonight?,145,27,5,177,648,2833
"Despite the government shutdown,I was hired by someone I can't name to make the Mueller report disappear.  Abracadabra!",148,22,7,177,648,2879
Oh dear -- is there a woman in the audience with two D batteries?,149,19,9,177,648,3874
"Now watch as I, the Great Depressiono, make your 401(k) disappear!",132,19,7,158,648,1130
And now the sexist patter of my past will disappear before your very eyes.,130,23,5,158,648,2455
"Yes Mr. Jones, this is definitely better than feeding it to your dog.",132,19,7,158,648,3273
"In our new electronic voting machine, insert your ballot, wait 20 seconds, and out will pop....toast!",149,28,5,182,648,1002
Ledgerdemain!,149,28,5,182,648,1952
Damn this old wand--I said 'rabbit' not 'pamphlet'.,148,30,4,182,648,3960
Abracadon'tjam!,134,24,5,163,648,1091
"And presto, your tax problems vanish!",133,26,4,163,648,1524
Et voila!  Hot fake news!,133,26,4,163,648,1797
I’ve taken your company morale recommendation under advisement and addressed my thoughts of it accordingly.,135,22,6,163,648,2136
"Once this last scrap is gone, I will magically recreate the Constitution just the way it was. I've never done this before, sure hope it works!",133,26,4,163,648,2155
Be amazed when I magically reassemble these divorce papers into an apology note from my lovely assistant and wife.,136,20,7,163,648,3033
Ladies and gentlemen! Before your very eyes! I will make the constitution disappear!,134,24,5,163,648,3766
"And now , Ms. M. , observe the waving of this wand, affirming that none of us on staff ever had illicit checks with you.",161,25,6,192,648,949
You know it’s not a toaster.,136,29,3,168,648,2828
"Instead of performing my old trick of cutting my assistant in half, I will now have her step into this shredder.",138,25,5,168,648,2947
"On behalf of all of us on the Robert Mueller team, we appreciate the filing system provided by you White House staffers. We hope our one copy of the report will fit in your file.",137,27,4,168,648,3190
"And now, I will show you that our Constitution can be shredded and restored.",137,27,4,168,648,3868
So we're not getting the divorce?,142,26,5,173,648,1080
And now - I will make my tax returns disappear..,141,28,4,173,648,3807
Abrakadabra BANKSY!,123,21,5,149,648,1481
"Uh, is the cord plugged in?",126,15,8,149,648,2306
"Are there documents in your life giving you heartburn? Turn them into a digestible treat with this new, handy kitchen helper.",122,23,4,149,648,3560
My trick is printing out the Mueller report.,124,19,6,149,648,3676
Hey presto! There goes my weekend jobs list.,145,29,4,178,648,1090
"And now, with the help of the magic box, I will transform these unsigned divorce papers into a huge fight right before your very eyes!",151,17,10,178,648,2767
It was funnier when they took rabbits out of a hat!,150,19,9,178,648,4013
"And, now my marriage license will be torn asunder.",150,20,8,178,648,4166
"Presto, my taxes are filed for life.",129,18,7,154,648,431
Voila!... Reversed surpressed voting rights,127,22,5,154,648,549
"For my second act, I will make the stapler reappear!",126,24,4,154,648,3173
"Yes, sir.  I set it to 'Candidate Becomes Toast'.",135,15,9,159,648,246
Honey.....for our next disappearing trick we’ll need the rabbit.,128,29,2,159,648,2717
"Her tears are all an act, folks!",132,21,6,159,648,2982
"With a wave of my media magic wand, what was said is now unsaid.",134,17,8,159,648,4066
"Before we go onto our next trick with the saw, Doris, imagine you are this piece of ordinary paper.",156,26,6,188,648,507
"And now, the great Mingini will turn this Brodsky into a Banksy!",154,29,5,188,648,923
I now commit this original copy of the US Constitution to a Banksy Moment.,132,30,2,164,648,90
So much for the FBI coup.,134,26,4,164,648,1230
And with my wand and your computer skills we’ll also make the hard drive disappear.,135,24,5,164,648,3508
"On the count of three our marriage paperwork will disappear. One-""

""Hurry up, Tom",140,23,6,169,648,1812
This is your plan to eliminate our debts?,137,29,3,169,648,2819
I swear the current president wasn't my one of my tricks.,143,17,9,169,648,3292
"I do this because it’s you, Hillary. But I tell you, that’s not the way you make emails disappear.",139,25,5,169,648,3816
Oh  how I wish I lived in Australia where there is compulsory voting,145,24,5,174,648,382
Et voila! The words disappear.,142,28,4,174,648,2112
Abracabra-- behold everywhere--the paperless office!,167,30,6,203,648,3158
And for my latest trick--I've turned a toaster into a fax machine!,139,34,1,174,648,3180
"Next, in my new animal welfare inspired act...I call this my 'rabbit bedding' trick!",147,27,5,179,648,367
For my next trick his tax return will disappear!,144,33,2,179,648,2426
"Et voila, Tiffany! Your dad's taxes are now for everyone to see!",146,29,4,179,648,2749
And now for my Disappearing Debt trick,145,31,3,179,648,3823
Abracadabra--turn a prenup into confetti!,126,17,7,150,648,1745
I hope we are going to have one of those Banksy moments.,125,19,6,150,648,3718
I will now make our marriage officially disappear.,157,25,7,189,648,4084
The illusion is in believing I would ever try to put this bill back together.,130,27,3,160,648,2126
"Banksy Incognito!
Marriage e finito!",135,17,8,160,648,2736
"And now, magically, it is worth as much as a Banksy.",132,23,5,160,648,3274
"After I shred these divorce papers, you marriage should magically reappear.",138,20,7,165,648,477
"Tada! I made this employee insurance form disappear! And now, Linda, please climb into this box next to the saw...",136,24,5,165,648,1727
"Now, I will make my contract disappear!",132,32,1,165,648,2383
You're not seeing this.,137,23,5,165,648,2483
"Mr. Banksy, perhaps you shouldn't give up on art quite yet.",135,26,4,165,648,2945
"Giselle, I told you this shredder is magic. My bills are disappearing into thin air!",139,27,4,170,648,41
"And for my next trick, I will run for President of the United States.",139,27,4,170,648,2946
"Russia, Russia, Russia!",139,27,4,170,648,3652
I know Banksy ma’am and I’m no Banksy.,145,24,6,175,648,2816
"Voila, your bar tab has disappeared!",145,33,2,180,648,675
"...and presto, I absolve you all of your fiduciary responsibilities.",146,31,3,180,648,1214
"Abraca - wait, have you seen my instructions?",119,24,3,146,648,2893
. . . and voila! the fake news becomes toast!,121,20,5,146,648,4033
My wife’s alimony papers will automatically disappear,126,20,5,151,648,3703
"Bad Credit, High interests rates, Taxes...Poof, their Gone!",158,25,7,190,648,2943
Watch carefully as I make the evidence... disappear!,128,24,4,156,648,299
And now I will make Donald Trump's tax return disappear.,128,24,4,156,648,536
Watch as I feed this paper into my magic confetti machine...,129,22,5,156,648,993
And voila -rye toast!,132,18,6,156,648,2646
"Don't worry. If the Court invalidates our voter ID law, this special ballot box can still make those pesky new votes magically disappear.",128,24,4,156,648,3678
This med school acceptance needs to disappear before my parents find out.,128,24,4,156,648,4040
"Thank you,Hillary.",168,23,9,200,648,682
"""Abracadabra Cadabra,  make these  PETA court papers disappear like my last 3 rabbits did!",132,25,4,161,648,661
Abracadabra! President Trump's tax returns disappear!,132,25,4,161,648,1111
Abra Ca Banksy!,134,21,6,161,648,1137
Abracadabra shazam taxman...,134,21,6,161,648,1879
Due to the government shutdown I will now make your IRS return disappear.,133,23,5,161,648,2313
And poof go the tax returns! Our next trick we will wipe a server clean ... like with a cloth or something.,132,26,3,161,648,3067
"And for my next act, I'm going to make this bad review disappear!",133,23,5,161,648,4018
"You see, Blanche, the magic wand is not obsolete nor superfluous with today's technology.",136,26,4,166,648,1535
Act II always reminded Britany that she still has to file her taxes.,138,22,6,166,648,1886
"And voila. Between your disguise and my trick, nobody will find the translator's meeting notes now, Donald.",137,24,5,166,648,2598
Cheer up. You get a balloon dog after the audit.,138,22,6,166,648,3281
And now...I will make my bar tab disappear!,135,29,2,166,648,3377
"The trick is turning the shredder into a ballot box.














































The trick is turning the shredder into a ballot box.",141,16,9,166,648,3391
"Give it up for my lovely assistant, Fawn Hall!",135,28,3,166,648,3454
"Presto, change-o . . . the restraining order has disappeared!",139,29,3,171,648,933
"And, PRESTO, the sexual harrasment lawsuit disappears!""",141,25,5,171,648,1315
"Remember, ladies and gentlemen: Vote early, and vote often!",138,31,2,171,648,3748
"And now, we'll see what happens to your federal check.",144,28,4,176,648,1720
"Abracadabr, your IRS tax audit is gone!",108,21,3,132,648,2624
"It jammed...
I knew I should have put a rabbit in my hat.",147,22,7,176,648,3815
Now I will make this paper disappear!,152,21,8,181,648,888
"No it's not my bar tab,it's my summons for jury duty.",152,21,8,181,648,1381
"..then I say the magic words ‘be gone’, and poof..it’s gone!”
(whispering: we suck at this moonlighting gig-when is the government shutdown gonna end!?",149,27,5,181,648,3693
...And voila! Marriage dissolved!,127,20,5,152,648,406
"Presto, Shreddo!",125,23,4,152,648,844
I am now going to make the instructions to this trick disappear.,129,24,4,157,648,30
"With a wave of my wand, these divorce papers will magically disappear.",131,20,6,157,648,502
Abracadabra! From shreds emerges the Trump/Putin dialogues.,131,22,4,157,648,1009
"For my first trick, I'll make my marriage license disappear!",129,24,4,157,648,3114
"We may have some trouble doing tho bunny thing,",129,24,4,157,648,3169
The Great Taxfraudini!,129,24,4,157,648,3347
"abracadabra,the evidence of our affair is magically gone",130,22,5,157,648,3952
And the correct answer is:,134,23,5,162,648,1991
I command you to shred not spread the word,131,29,2,162,648,2154
"First, I shred my unsigned pre-nup; then, behold, as I make half my belongings disappear.",135,21,6,162,648,3178
"And Now...
I will make this young lady's 
pre-nuptial...disappear!",140,20,7,167,648,965
How to magically get rid of the evidence!,137,26,4,167,648,1470
Among the practitioners of legerdemain I alone insist on total transparency.,139,22,6,167,648,2062
"For my next trick, I will turn this single piece of paper into many pieces with a simple touch of my wand.",141,18,8,167,648,3312
"Up next, my lovely assistant will also disappear!",142,25,5,172,648,153
"We shred the ballot, tap twice and ""WAH-LAH"", no vote!",142,25,5,172,648,624
"And for my last trick I am going to make this love letter that my beautiful assistant wrote to me when we first met before I found out that she was playing ""hide the rabbit"" with David Copperfield, Carrot Top, Sigfried, and Roy...disappear.",143,23,6,172,648,2441
"Careful honey, these tiny hands cost a fortune.",145,19,8,172,648,2884
"When you next wash your clothes, one of you will find this in your lint trap!",144,22,6,172,648,3567
You might want to do a little magic as this is a voting machine!,145,28,4,177,648,2352
And now...I'll make the marriage license disappear!,148,22,7,177,648,2851
HOUDINI LAW; making pre-nups disappear for more than twenty years.,148,31,3,182,648,1561
"And, Ladies and Gentlemen, you will soon see the ""Mona Lisa""!",157,24,6,187,648,2386
"And now, for my famous 'vanishing e-mails' trick.",126,23,4,153,648,1648
"For my next trick, I will change shredded  paper into toast.",125,25,3,153,648,1800
And presto! Your contract now requires you to wear that.,126,23,4,153,648,1834
"It says ""5 sheets maximum"" for a reason, Phyllis.",125,25,3,153,648,3171
"And just like that, my jury duty has disappeared!",134,16,8,158,648,929
See how the translator’s notes become wonderful little strips of papee.,130,24,4,158,648,2663
"As if by magic, this invoice will soon reappear.",130,24,4,158,648,3337
I hope my vote is being toasted not shredded!,133,27,3,163,648,846
"Voila! and now you see that  when I pull here, the paper is whole again.",135,23,5,163,648,1607
"And now, watch our economy disappear.",134,25,4,163,648,1653
"Abracadabra!!  Poof, the prenuptial has disappeared!",136,21,6,163,648,3918
"This marriage license was a hoax, Susan",138,26,4,168,648,1223
"And now, the disappearing alimony agreement",136,30,2,168,648,1604
"And for my next trick, I’ll submit my TPS reports.",141,20,7,168,648,2898
'My job is to help the president maintain his image'.,139,24,5,168,648,4075
"Now remember, this multifunction printer-copier-scanner device has no fax capabilities.",144,23,6,173,648,1140
I now show you the magic of not having your identity stolen.,143,25,5,173,648,1156
...and presto! All evidence gone.,142,27,4,173,648,1353
A Visual Representation Of The Government Taking Away Your Money Through Magic (Taxes).,145,21,7,173,648,2340
"And now, with a wave of my wand and the magic words, the restraining order disappears...",142,27,4,173,648,3447
Presto! Your tax returns have disappeared!,144,33,1,178,648,434
Thank you for shredding my vote!,148,24,6,178,648,711
"Steve, shredding your parking tickets won’t make your fines ‘disappear’.",146,28,4,178,648,922
Damn that fine print!,148,24,6,178,648,2813
The Great Shredini,148,24,6,178,648,3333
My next act is a fan favorite downtown.,152,25,6,183,648,1108
"And now, having committed it to memory,
I will attempt to destroy 
my families secret pepperoni recipe.",150,29,4,183,648,3203
"Behold, as I take a wild guess on how long I should keep my past tax returns.",120,19,5,144,648,380
Shred. Burn. Flush. That works every time.,122,15,7,144,648,1152
"And tonight, the virtual rabbit is . . .  .",119,21,4,144,648,1636
My next trick is called The Oliver North way.,121,17,6,144,648,3411
May I present a balanced budget!,119,21,4,144,648,3711
"Help, my wand is jammed.",120,19,5,144,648,3871
Presto shred-o! Your contract is now confetti-o!,120,19,5,144,648,4119
And now all the paperwork connecting the Trump Foundation to Putin goes into this magic box where VIOLA it turns into... shreds! MAGIC!,124,21,4,149,648,2981
"And now, with the help of my lovely assistant, I will make this incrimination document disappear!",130,17,7,154,648,2237
Shredding is one thing but making it disappear is foolproof.,127,23,4,154,648,2543
"That cane's not going to help you, 
 this isn't Sotheby's and you're no Banksy.",127,23,4,154,648,3945
And a little shreddy-shreddy and we're done!,133,21,5,159,648,1477
"And now, presto! Your bill has disappeared!",131,24,4,159,648,3524
I'm worried that the long cord will compromise the misdirection.,136,23,5,164,648,1324
The president's memory magic,137,21,6,164,648,1498
"And just like magic, Trump's shredded IOU's to some oligarch will reassemble themselves under my hat where they will be eaten by a rabbit!  And I will pull that rabbit out of my hat and give it a stern talking to!",135,25,4,164,648,1666
"Abracadabra, no tax report!",136,23,5,164,648,2953
Brian Kemp unavailing Georgia’s new ballot boxes,137,21,6,164,648,3210
Only this magic will end the shutdown.,136,23,5,164,648,3352
"And now, Ladies and Gentlemen, I will restore 'Girl with Red Balloon'.",136,23,5,164,648,3854
"That may as well be my GED,”  she thought.",142,20,7,169,648,1735
"For my finale, I will magically bring back Hillary's erased emails.",138,28,3,169,648,1808
Magic un-shredder Hillary/Dillery e-mail produce-illry.,141,23,5,169,648,2198
A twelve-year-old kid with 20 years of practice can do this trick…,145,32,2,179,648,2406
Your tax refund this year will be...,150,22,7,179,648,2566
I will now make my substancial college debt disappear.,149,24,6,179,648,3634
"And with a wave of my magic wand, these sexual harassment charges disappear!",153,25,6,184,648,835
Voila! The only printer in the world that magically works every. single. time.,153,25,6,184,648,2117
And the date of Trump becoming toast is ....,131,17,7,155,648,50
"Don't be upset,it's only his tax return.",128,23,4,155,648,177
And your 1040 is gone forever.,146,23,6,175,648,320
"""Now, our magic spell: Bibbidi-Bobbidi-Boo, Banksy-Banksy too""....",139,29,2,170,648,529
"Hocus, pocus, banksy!",129,21,5,155,648,545
I have procured a copy of the President’s elusive tax returns. Now watch carefully...,127,16,7,150,648,659
"Alacadabra, alacazam!
The Constitution is
just a sham!  I'll build a wall, 
I am, I AM (dammit).",132,24,4,160,648,767
"Now for my last feat of magic, shredding the final e-mail.",130,19,6,155,648,1549
"Tampering with evidence is one thing, Chloe. The law says nothing about hexes.",137,23,5,165,648,1770
Everybody wants a piece of my will.,146,23,6,175,648,1927
I will now make this subpoena disappear with the wave of a  Molotov wand.  A gift from the Kremlin.,125,20,5,150,648,2148
I can make everything disappear... except for my humiliation.,149,26,5,180,648,2171
And now... shredded toast!,132,24,4,160,648,2233
And Presto! My lovely assistant will take this to the bunny hutch while we clean things up..,129,21,5,155,648,2765
Abra Cadabra. Now I can legally see other people.,165,30,5,200,648,3132
"If this works, we'll try the human shredder next.",158,27,5,190,648,3222
"And when I tap my wand three times all of Hillary's emails will appear.""

Harris Fogel, Springfield,P",131,26,3,160,648,3253
"For my next trick, I'm going to make my contract at this run-down, rat-infested theater disappear.",140,26,4,170,648,4170
So there!  With my magic wand I hereby unshred your prenup,125,20,5,150,648,4200
Didn't you read about Whimsical Wednesday in the Employee Handbook?,154,27,5,186,648,3021
My rabbit went on strike.,149,28,4,181,648,1226
And then we feed it into the automatic AI speech editing system.,144,29,3,176,648,1405
My magic shredder will shred your marriage license and you will be set free my little chickadee.,146,25,5,176,648,1417
"Presto, Melania! Your tax records disappeared!",146,25,5,176,648,1811
And with magic I’ve made my retirement savings disappear.,145,27,4,176,648,3602
It appears the rabbit may have been a bit too much.,143,31,2,176,648,3875
"Why look, it says the rabbit may be in the hat.",142,26,3,171,648,3345
"Yes, all your debts will be Toast!",137,28,1,166,648,1304
"We are seriously shredding it, Shirley.",137,25,4,166,648,2502
"No, I don't think hitting will fix it.",137,25,4,166,648,3722
I am now magically de-voted.,135,20,6,161,648,1422
"Damn, that was the Wheat contract!",134,22,5,161,648,1542
"And now, direct from Sotheby’s...",134,22,5,161,648,1799
good luck stealing my identity motherfuckers,137,16,8,161,648,1926
"And then, voila!  I make Mr. Trump’s tax returns forever disappear.",133,24,4,161,648,2541
This won't hurt a bit!,134,22,5,161,648,2726
"Well Barbara because this is your first day on the job, I think you should know that this is how all magicians handle there unpaid bills.",129,23,4,156,648,1793
"In keeping with the latest in industry safety standards, if not our sexual harrassment policy, we now give you the saw trick.",130,22,4,156,648,2088
"Watch in Amazement as I 
make this evidence disappear.",131,20,5,156,648,2268
And now you'll never know how I do it!,125,22,4,151,648,4136
"Begone you worthless werds, er, wurds.",119,25,2,146,648,191
"Ladies and gentlemen,  watch as I shred the instructions for this wand.",117,20,4,141,648,2212
"And now I'm going to make my marriage license, along with the court-ordered alimony agreement vanish before your very eyes...PRESTO!",117,20,4,141,648,3179
For my next trick I will obliterate my fingerprints.,172,29,6,207,648,1781
Abracadabra unjama!,153,22,7,182,648,283
Watch me shred your pay raise,150,29,3,182,648,1938
I will now produce my actual tax returns,143,24,5,172,648,3754
The internet is above my paygrade.,144,23,5,172,648,3761
Watch closely as I make my clutter disappear.,145,22,5,172,648,3923
"Now I'm going to show you why it's a called a tax return, emphasis on return.",143,24,5,172,648,4109
I learned this trick when I worked on Hillary Clinton's staff.,135,22,5,162,648,2211
And now I'll make the memo suggesting you wear that outfit disappear.,135,22,5,162,648,2475
Abracadabra- I will make my tax returns disappear!,135,22,5,162,648,3299
My next trick is to make an audit magically appear.,136,20,6,162,648,3318
"And with a simple wave of my magic wand, my marriage to the lovely Gina will...disappear!",136,24,2,162,648,3370
and now we will make these tax returns disappear,135,23,4,162,648,3780
"Janet, if you wanted a divorce you could have just told me.",129,25,3,157,648,126
Abracadabra! Surefire gerrymandering! Step right up to shred votes right here!,129,26,2,157,648,1016
"A simple shredding of the paper and, voila, my tax problems have disappeared.",130,23,4,157,648,4036
"And now, ladies and gentlemen, I -'Fred the Shred' will make this voting ballot disappear into cyberspace.",132,20,5,157,648,4148
This next trick will be performed without an antidote,125,24,3,152,648,1257
Now if this illusion could only make the payment disappear too.,125,24,3,152,648,4188
"Now, watch as I make Watership Down magically appear on my Kindle.",122,22,3,147,648,383
"Finally, I will make my tax returns disappear.",118,21,3,142,648,1490
"Watch your fingers, Tammy.",167,23,8,198,648,1456
"Though Mr. Presto's city council campaign fell through, his penchant for making money disappear did come in handy.",158,23,7,188,648,1679
And this is our pre-nup. Hope this works.,156,27,5,188,648,2669
And I also told an animal rights advocacy group that I have used the same rabbit for the past twenty years.,159,22,7,188,648,2962
"I will now shred this document proving I have colluded with Russians...and NO I will not make it reappear, and THAT Ladies and Gentlemen is a real magic trick!",153,24,6,183,648,1341
Any more tax prep documents to send to your husband in heaven?,148,25,5,178,648,1316
Abracadabra! Make this vote disappear!,150,21,7,178,648,3195
"Shred the ballots, Abracadabra, and now an Ass will appear.",154,13,11,178,648,3510
Banksy gets the idea to shred his painting at auction.,141,21,6,168,648,3518
"If you happen to get a traffic ticket, let me know.",139,25,4,168,648,3771
I will now rewrite a Trump tweet.,139,25,4,168,648,3956
"We may have a slight complication here. Is what you secretly wrote, ""Shredder User's Guide""?",136,22,5,163,648,3598
"With a tap of my wand, my tax returns will disappear forever!
For three payments of $999.99, yours can too!",131,24,3,158,648,216
Fake News Preparation Illustrated.,133,22,3,158,648,571
"Voila, the Helsinki notes are magically unshredded!""",130,25,3,158,648,1767
"I'll now make the Quackenbush's dinner bill disappear without a--well, maybe with just a shred of evidence . . .",129,27,2,158,648,3339
Big shout out to audience member Donald T...,132,21,5,158,648,4164
Finally! Shreds of proof this is real magic.,127,22,4,153,648,737
"'For my next trick, I'm gonna make a quick fifty bucks by making these Putin notes disappear'",126,24,3,153,648,1162
"And VIOLA!
The new terms of your employment Ms. Birdstall.",169,30,5,204,648,3475
Please observe as I demonstrate for your wonder and amazement the  illusion originally created by Lieutenant Colonel  Oliver North and Fawn Hall.,120,18,5,143,648,977
"You are going to lose your rights, I'm just shredding the Constitution for affect and to dazzle my audience.",161,19,9,189,648,4157
I hope I know what you are doing!,151,30,3,184,648,3714
"and with a flick of the wrist, his dignity vanished into thin air...",148,27,4,179,648,2857
"Et Voila, vraie magie, les ""tax return"" de Trump!",141,32,1,174,648,111
Abracadabra - Unshredder!,143,28,3,174,648,249
"And just like that, all evidence of Watergate magically disappeared.",143,28,3,174,648,274
And now I'll make these divorce papers disappear!,148,18,8,174,648,1451
Let's just hope I have this wand working when it's time to saw the woman in half.,146,22,6,174,648,2284
"Okay... Presto CHANGE-O didn't work, so... now I make the Mueller report disappear...",144,26,4,174,648,2611
"And next, we’ll amazingly restore this rare document to its 
original condition, safely locked inside the shredder...
Abra-ca-DAB-rah!",139,27,3,169,648,670
"And the magic word is: ""Fake Contract!""",142,21,6,169,648,2612
This worthless Trump Tweet will now be worth millions!,138,20,6,164,648,1881
"And now for a cheap trick, I will make my tax refund disappear.",134,20,5,159,648,261
I need machine help for disappearances due to my teensy-weensy Trump-fingers.,133,23,3,159,648,1437
"Sazsam, I take one person's cast vote and turn it into someone else's .",134,19,6,159,648,1894
"'Once again fine working-class pepople are replaced by machines.""",131,25,3,159,648,3117
"For my next trick, I will get rid of your mortgage payment, walla!",132,23,4,159,648,3778
Classified ? What classified ?,127,24,3,154,648,1761
"Cutting her in half is too much for some audience these days, so...",123,23,3,149,648,1147
"It helps keep the magic alive, if they don't know I buy rabbits in bulk",125,20,4,149,648,1758
If only I could do this with just a handkerchief.,125,19,5,149,648,2141
Aaaand your job has disappeared!,120,20,4,144,648,46
Banksy the Magnificent.,152,22,6,180,648,638
Watch IRS magic make your refund disappear.,121,18,5,144,648,2873
And that . . . takes care . . . of . . . that!,144,28,3,175,648,36
Watch closely as my assistant loses the ballot box.,146,26,3,175,648,2159
Abracashredder,146,27,2,175,648,2944
"Just like that, I've made my New Year's Resolutions disappear.",146,24,5,175,648,3008
Say 'Alaca-taxfraud!',147,23,5,175,648,3349
"And just like that, our accounting fraud promptly dissappears",145,26,4,175,648,3399
You’re fired and this was your contract.,146,24,5,175,648,4041
"And for my next trick, my assistant Miss Georgia will make my ballot disappear!",141,25,4,170,648,3622
And abracdabra... the evidence is ... gone!,140,18,7,165,648,917
"And now, I shall make your bitcoin wallet's private key disappear.",136,26,3,165,648,1253
"Abracadabra, make the translator's notes reappear.",138,22,5,165,648,1462
"Hocus pocus, make those tax returns disappear.",141,17,7,165,648,2039
"And for my next magic trick, watch while I pull a Putin/Trump meeting memo out of my hat!!",137,24,4,165,648,2221
Turn the magic shredder to reverse and before your eyes strips of paper are combined into the original document!!!,137,25,3,165,648,2855
Ballot in; Rabbit out; Abracadabra... Democracy solved!,135,28,2,165,648,3014
... and this is where to submit our W-2 form.,137,24,4,165,648,3933
"Pay no attention to my assistant, Dagmar's, right thumb.",134,22,4,160,648,1276
And presto! I turn this prenup into a much better divorce settlement for me!,131,27,2,160,648,2125
"For my next trick, I'll make the Mueller Report disappear",162,21,8,191,648,2157
"Arthur,this whole hiding your income ceremony is getting tiring.",131,18,6,155,648,80
There goes my contract!,128,25,2,155,648,573
Ta-da! The mysterious box has produced a piece of paper!,158,23,5,186,648,1941
"No illusion here,folks. Just making credit report disappear.",129,23,3,155,648,3256
"For my next trick, I will make this parking ticket disappear.",126,22,2,150,648,1202
Told Morty no more tax attorney conventions.,124,23,3,150,648,2312
...and Voila! My tax return is in early-,145,28,3,176,648,2238
"I promise Mabel,I will saw you in half again when we leave D.C.",146,27,3,176,648,2852
"By all means, let’s talk some trash.",147,24,5,176,648,3547
"If this doesn't un-jam on the count of three, you might have to take it to Teller.",121,21,3,145,648,3593
Now watch as I turn this shredder into a magician's best friend.,143,23,5,171,648,53
"I TOLD you in the interview that stripping was part of the act""",143,24,4,171,648,1178
I'm telling you they'd like a rabbit OR a hat a lot more.,143,23,5,171,648,2059
"For our next act, we'll saw through a live prenuptial agreement.",141,27,3,171,648,3089
"You know, President Nixon could'a saved himself a lot of trouble if he'd just contacted Cadabra Magicians.",142,26,3,171,648,3981
The mandatory Trump Re-Election Ballot reader demonstration.,116,21,3,140,648,895
You said you wanted the wage gap to disappear.,137,26,3,166,648,1146
"For my next trick, I'm going to make my marriage disappear.",136,28,2,166,648,1778
Typical! Betcha Banksy didn’t have to fiddle with shredder oil or press Reverse twenty times to get it to work right!,139,22,5,166,648,4093
"And for my next trick, I shall use this fancy new copier""

""Sir, thats a paper shredder""

""Yes yes a fine copier indeed",137,17,7,161,648,1479
"I'm making your wish for a divorce disappear with ""magic""",131,29,1,161,648,1934
"And now… for my second act, I will make the incriminating evidence disappear!",136,20,5,161,648,2020
"I am disappearing, my paper trail is disappearing...
Oh, wait, internet.",135,21,5,161,648,3712
"For my next trick, watch my marriage disappear.",157,24,6,187,648,156
There goes our prenup.,150,29,3,182,648,301
"ABRACADABRA, Reverse shred.",133,16,7,156,648,616
And now my EZ trick.,133,16,7,156,648,1277
Watch me make this traffic ticket disappear.,153,23,6,182,648,4230
Now the most frightening part of the show- I shred this jury summons!,145,30,2,177,648,485
"Shredder the letter, please and thank you.",150,23,4,177,648,1712
"Now, I'm going to disappear.",147,26,4,177,648,4053
Abra Kadabra — now we're divorced.,128,17,6,151,648,419
This is how we make the contract disappear,163,33,2,198,648,4005
"Watch carefully, as this shredded piece of paper transforms into a white rabbit.",146,19,7,172,648,1675
They said I had to make something disappear before they’d admit me into the Magic Castle.,144,24,4,172,648,3935
I don't suppose this works on kids as well.,124,16,6,146,648,4114
Abracadabra!  Alakazam!  Watch these federal documents shred before your eyes!,142,18,7,167,648,1369
"Marlin the Magnificent finds audiences unimpressed with his new ""Magic Box"" routine.",141,20,6,167,648,2481
And for my final copy...,141,22,4,167,648,3137
"It' s magical, my opponent's votes will vanish and a rabbit will appear.""",141,20,6,167,648,4131
For my next illusion I will produce the translator’s notes.,118,19,4,141,648,637
And now I will make disappear all evidence of Trump's collusion with Russia -- presto!,157,26,5,188,648,2625
Watch as I make my assistant's transfer request disappear!,137,20,5,162,648,255
Abracadabra! House bill 2056 has solved the national debt.,136,21,5,162,648,337
Don't Banksy me!,136,21,5,162,648,1068
Abra-Cadabra! My magic wand lets my vote count innumerable  times!,137,20,5,162,648,1114
"Hocus Procus and Presto-chango.  Robert Mueller, eat your heart out.",136,21,5,162,648,2004
"Abracadabra! Those little steel slats are all we need for protection!
 Right?",153,25,5,183,648,3932
The rabbit in my hat is directing me to shred our plans before the blond haired lady finds out about us.,130,24,3,157,648,705
I'm going to turn this piece of paper into the next President of the United Stats.,148,27,3,178,648,736
And voila' your past returns to haunt you.,147,28,3,178,648,2983
Tada!! My insider trading never happened.,127,21,4,152,648,2322
I now conjure up the spirit of Banksy.,145,23,5,173,648,748
The real magic happens when this thing gets stuck.,146,21,6,173,648,1312
950! Do I hear 1 million?,144,25,4,173,648,3088
"Bitch, I been known you was cheating. This our marriage license.",150,13,10,173,648,3452
"See!
You saved the cost of postage!!",184,25,6,215,648,2567
"And now...Wait, I need that for my tax returns!",157,28,4,189,648,515
Now watch as I make my court summons disappear.,142,20,6,168,648,2256
I don't care what my birth certificate says.  My name is Al Mesmer.,140,24,4,168,648,2270
I call this alternative shredding.,141,23,4,168,648,4223
"Now, I will make my taxes disappear.",155,23,6,184,648,129
"And now, I will make my 2017 tax audit DISAPPEAR!",134,27,2,163,648,666
For some reason these divorce papers just wont shred.,137,21,5,163,648,1207
The real trick is preventing identity theft.,137,21,5,163,648,1873
This is too easy. I love it.,119,19,4,142,648,3498
"Last minute she realized it was not my tax return, but rather her paycheck going in the shredder.",148,28,3,179,648,132
I'll put this tweet into the shredder and tell you what he really wrote.,152,20,7,179,648,618
"Well Carl, Enron was good while it lasted. At least the skills are translatable.",149,26,4,179,648,1013
This magic trick ends with pulling this document out of my hat.,152,20,7,179,648,1548
all I want to shred is my signature,134,18,6,158,648,694
new now! the magical ballot shredder/toaster,132,22,4,158,648,3491
I will now make your obstruction-of-justice charge disappear!,134,18,6,158,648,3544
"Cross your fingers, Miss Stevens.",130,26,2,158,648,4088
For this trick I will make my bill disappear,147,21,6,174,648,1073
"And for my next trick, I'll make my tax fraud disappear!",146,23,5,174,648,1132
"Magician or not, you know it won’t count, right!",145,25,4,174,648,2335
Voila! The makings of my dissonant poetry revealed!,144,27,3,174,648,3738
... and voila!  My parking ticket has disappeared!,129,19,5,153,648,427
Presto chango! Evidence is now confetti.,127,23,3,153,648,1774
"And now I will perform an act of fraud and manipulation for sexual favors from my assistant, Ms. Tinsel.",141,24,4,169,648,81
"Presto Changeo ,prenuptial will now vanish before your very eyes.",139,28,2,169,648,668
And now to make my prenup disappear.,141,24,4,169,648,3321
"Siri,  make the election results reappear.",141,24,4,169,648,3651
The Pentagon papers shredded at last!,156,23,6,185,648,2191
"And presto, the evidence disappears!",123,22,3,148,648,3031
"Let me see . . . ah, yes, this strikes the right note of middle aged whimsy.",136,25,3,164,648,1625
"Next, I shall make this sexual harassment lawsuit disappear, pretending as if it never happened!",136,25,3,164,648,2477
"And now for my next trick, I'll make my bills disappear.",151,24,5,180,648,433
Hocus pocus Panama paper ghostist.,151,24,5,180,648,593
"And for my next trick, I will make my W-2 disappear!",150,26,4,180,648,728
Quote me and I'll deny I shred it.,150,26,4,180,648,2720
"And now to continue my disappearing paper trick, I will accept your parking tickets, jury summons, subpoenas, divorce papers...",121,19,3,143,648,3395
A good magician must never let others see his spell check results.,118,23,2,143,648,3842
Back in my day we shred by hand......and with no super models dang it!,161,33,2,196,648,874
"If he gets one more report card like this, one of us is going to need to empty the bin.",132,24,3,159,648,834
Watch as I make our divorce papers disappear!,131,26,2,159,648,1638
The trick was pretty boring... until the magician revealed that the papers he made disappear were the Mueller Report.,132,24,3,159,648,1959
Presto -- Shreddo!_. . .And my paper trail vanishes!,136,16,7,159,648,3424
"As I told you, dear, there's no need for these pesky HR forms!",131,26,2,159,648,3668
And now I will make this evidence of tax fraud disappear.,147,23,5,175,648,526
Is this your annuity settlement?,146,25,4,175,648,1384
...abracabanksydabra..,150,17,8,175,648,2200
"Message-my wife submitted a caption which said Call 1-800-shrdsht. Do not accept that.  It’s a real number!  SORRY!  After submitting it, we realized...",152,13,10,175,648,3116
"Aha, an alimony request from my 2nd ex wife.",160,26,5,191,648,2971
I can make Michael Cohen disappear but not the paper trail,144,20,6,170,648,76
Now watch as your tax refund disappears!,143,22,5,170,648,2274
"Boy, do I need a new brand of disappearing ink or what?!",154,29,3,186,648,733
"Even though it's in 100 pieces, I still think it worked better when I sawed you in two",127,16,6,149,648,2096
...and presto change-o! Your mortgage has disappeared!,136,27,2,165,648,628
And now I shall make my next trick disappear.,138,23,4,165,648,2799
"No magic necessary, m'dear. Plug her in and let her rip.",150,28,3,181,648,1624
"Nothing up my shredder, presto!",150,28,3,181,648,2815
Presti-non-digitation!,153,22,6,181,648,4019
There is no magic I'm destroying my 2006 tax return.,134,22,4,160,648,70
"And, like magic, I make those divorce papers disappear.",121,19,4,144,648,519
The FBI is going to some lengths to get those translator transcripts back!,136,19,5,160,648,1170
"Watch Susan, I can make my taxe report disappear before I run for office. Abracadabra!",135,20,5,160,648,1439
Abracadabra! My ex-wifes restraining order is gone.,137,16,7,160,648,1459
And absolutely magically it appears behind the Great Wall!,133,24,3,160,648,2746
"Better than crossing items off your to-do list, you make them disappear.",135,20,5,160,648,2938
I will now make this arrest warrant disappear.,133,24,3,160,648,2957
"Magic, using technology, is not so impressive.",134,22,4,160,648,3264
Nothing up my sleeve. Except this.,134,22,4,160,648,3323
And now I'll make your employment contract disappear into this magic electric box.,145,29,2,176,648,3743
"The shredder is safer. Moreover, burning paper is not magic.",140,30,1,171,648,654
Now we make this tax liability go poof!,133,15,7,155,648,106
And now I'm shredding the President's tax returns so no one will ever see them.,166,27,5,198,648,3097
The paper:  A piece of cake.  This wand:  Not so much.,139,23,4,166,648,286
"A little wave of the wand and the shredder takes the whole sheet of pap..,Dammit, it worked in rehearsal !",138,25,3,166,648,657
Here's Putin magician toasting USA ballots.,139,23,4,166,648,808
Hokity-pokity aaaand.... your felony has disappeared!,140,21,5,166,648,1972
"It's not my usual style, but I could work you into my act.",139,23,4,166,648,3835
"Abba dabba o. Shred Trump""s income taxes.",142,19,5,166,648,3866
And the winner is....,126,20,4,150,648,797
Presdient Trump gets creative for new hires for his legal team.,162,26,5,193,648,6
That is how we make a bill disappear.,148,25,4,177,648,510
This trick is an illustration of the latest technology in voter fraud prevention.,151,19,7,177,648,3917
I shall now steal your identity.,136,20,5,161,648,595
Abracadaba!  There are no DJT  tax records ever!,134,24,3,161,648,2885
"And Presidento Change-o, you have a brighter future!",135,22,4,161,648,3408
"There must be an easier way to do the torn and restored paper trick, but I can't figure it out.""",120,23,2,145,648,345
And with a wave of my wand only a shred of my prenup will remain in existence.,143,26,3,172,648,1680
"And as fast as you can say, 'I can't believe there was a time when documents could disappear.', poof, it's gone!",144,24,4,172,648,3199
Oops...forgot to remove the staples first...good thing I got this magic wand.,148,18,6,172,648,3640
"Donald Trump can't rely on the Russians anymore, you know.",132,19,5,156,648,317
...and Presto -- just shredded my final magic trick!,129,25,2,156,648,810
The Magician’s Assistants Union is ruining this business.,130,23,3,156,648,1595
"For my next trick, I will now make my marriage to Vanessa disappear.",130,23,3,156,648,3464
Shreddidi-Shredidi-Soo! Information breach reverse.,132,19,5,156,648,3879
Watch how I make these profits disappear!,153,26,4,183,648,647
And the Houdini for Best Illusion in an Original Cartoon goes to....,154,25,4,183,648,926
Now watch closely while my viability as a candidate magically reappears.,154,24,5,183,648,2069
"This shredrer works automagically, the wand is blue-tooth enabled.",115,24,1,140,648,1232
For my next trick... I will make your tax issues disappear!!!,139,25,3,167,648,974
And now the Great Kondini will make documents that bring no joy disappear!,141,24,2,167,648,1326
I thought a rabbit out of hat was stale so I updated.,140,23,4,167,648,1338
The real trick comes when I attempt to piece back your contract.,141,21,5,167,648,1500
"Hee haw, those ballots really disappear nicely.",138,27,2,167,648,1520
And Voila! Confetti to celebrate my amazing feat!,139,25,3,167,648,4063
Banksy will smile.,128,18,5,151,648,3996
"For my next magic trick, I will do what no one has done before...shred the entire copy of my tax return all at once.",136,22,4,162,648,751
"Harvey Weinstein’s first career - “If you tell anyone I stuffed this in your box, you’re fired”.",135,24,3,162,648,1773
Just imagine a giant poof of smoke.,112,21,2,135,648,2473
"Ah 











Ah.I've been accepted to toast masters international!",159,25,5,189,648,3636
"And now my Assistant's sporty attire shall disappear, along with her marriage certificate.",148,18,7,173,648,1357
Another profession ruined by technology. Bring back coal!”,144,26,3,173,648,1522
And I will then pull 1000 rabbits out of the hat.,146,22,5,173,648,2763
And now I will make this NDA disappear!,131,23,3,157,648,199
"And now, watch me make evidence of that botched sword basket act disappear.",129,27,1,157,648,1943
And now I will make my homework disappear!,140,26,2,168,648,138
"Next time, let's just use my toaster.",142,21,5,168,648,556
Hillary’s new work reveals the answer to the missing ballots.,142,21,5,168,648,862
"And viola, this toaster will make your paper disappear.",141,23,4,168,648,1443
I shall now appear to make toast of this document.,139,27,2,168,648,2779
And now I will make this letter from the IRS disappear,142,21,5,168,648,3595
"Eh, voila!  My contract re-emerges intact!",141,24,3,168,648,3642
VOTING 20200,153,19,7,179,648,1228
"“ My side gig is creative accounting.” 
Jen Hynes
Brooklyn, NY",150,25,4,179,648,2122
"Abra Cadabra, make the curtain a wall.",153,19,7,179,648,2892
We'll need to renew our marriage vows.,149,27,3,179,648,3211
"Unfortunately, the rabbit has been found.",163,19,8,190,648,1025
And now for my final act.....I will make this paper shred to pieces!,127,23,2,152,648,2244
I will put the shredded documents together as exact transcripts of the president's meetings with Putin.,128,20,4,152,648,2787
"For my next trick as the president's CPA, I will make his tax return disappear.",137,22,4,163,648,828
To be followed by my beautiful assistant.,138,20,5,163,648,1428
".esrever ni ,won dnA",139,19,5,163,648,1580
Unlike  Trump. I am on a low paper diet.,140,16,7,163,648,2092
... and our prenup will magically reappear tomorrow with some small changes.,138,20,5,163,648,2486
"Now, pick a number between 1 and 639,764.",137,22,4,163,648,4205
"That’s a surprise!
I thought I paid it!",147,22,5,174,648,1145
"Abra ka dabra, leggo my memo .",145,26,3,174,648,2011
"There goes our marriage! Now I'll see half of what's mine also, disappear.",145,26,3,174,648,3113
"Ta-da, it’s Theresa May’s Chequers white paper.",158,20,7,185,648,339
"And now, for my greatest act: the Banksy. Oh shoot, it's Trump's tax returns!",158,20,7,185,648,882
"And now, to make this evidence of tax evasion disappear",123,21,3,147,648,3236
"And now, for my next act, watch as I make your tax returns disappear!",126,15,6,147,648,3285
"Brenda Snipes, this ballot box has a strong resemblance to the shredder in my Boca Raton office?",133,21,4,158,648,564
"No it's not part of the act, and my vanishing won't be either. FBI is waiting in the wings.",133,21,4,158,648,2439
The birthday party contract specifically stated to shred any evidence of illusion.,134,20,4,158,648,2605
That's one way of making evidence disappear!,143,21,5,169,648,2654
"And now, watch me make my prenup agreement with my assistant disappear!",143,22,4,169,648,4226
"Now, I'll say the magic word and the rabbit will be good as new.",152,23,5,180,648,2236
"Abracadabra, all the company evidence disappears.",150,27,3,180,648,2403
You are amazed! Surely I can't be shredding the restraining order from my former lovely assistant!,159,29,3,191,648,994
"Begone, 3 hole letter size paper. Begone.",129,20,4,153,648,193
...and TA-DA!! No evidence of shred.,126,26,1,153,648,1193
"And with just a wave of my wand, Janet's decrepit list of the men left in her life who may still be willing to marry her and give her a child, has been unshredded!",128,22,3,153,648,2709
"Now for my next trick, I will make my wife disappear.",138,22,4,164,648,1264
Abra Cadabra. You tax returns have now disappeared.,138,22,4,164,648,1849
"Russian Election Protection Services: 
Magically your vote will disappear.",139,20,5,164,648,1900
Trump’s White House Plumbers,141,19,4,164,648,2710
"And now, 'The Amazing Lame-O', will turn this piece of ordinary paper into confetti!",140,18,6,164,648,3523
"When I say ""abra kadabra,"" slip me the copy...",144,30,1,175,648,803
"You call it Peaches, I call it impeachment.",146,27,2,175,648,1176
"TurboTaxMan says, 'Hasta la vista, 1040.' Punk done stole a trick from me/So he gets the penalty. Poetic justice.",147,24,4,175,648,4067
"Why are you so uncertain, my dear?",156,27,3,186,648,976
And so ladies and gentlemen - this is how you unshred a document!,122,25,1,148,648,1546
I will now attempt to reapply for a totally new insurance plan!,125,19,4,148,648,1953
Presto change-o! My court summons will disappear!,133,23,3,159,648,381
I know sawing that lady in half didn't work out too well but let's hope for better with this gentleman's house deed.,136,17,6,159,648,524
"Abba Cadabbra, we no longer married.",135,19,5,159,648,1261
Abracadabra -- and Harold puts an end to her application to attend magician school.,135,19,5,159,648,3553
The turning point when Mary realizes she needs to book an appointment with HR to discuss working conditions at the new FedEx-Kinko’s: Magic,135,19,5,159,648,4175
"And just like that, The Donald’s tax returns were fake shredded.",146,17,7,170,648,1310
GERRYMANDERING REALLY IS MAGICAL!,143,23,4,170,648,1649
"And here, I have unshredded something. And for my next trick, an embarrassing article!",145,20,5,170,648,2393
"And now, for the disappearing document illusion, the Oracle of Obfuscation Oliver North and his lovely assistant Fawn",143,23,4,170,648,2629
"For your amazement, my assistant will now shred my list of tricks.",153,23,5,181,648,2696
"Voila! the paper disappears. And for my next trick, I will make a rabbit disappear.",148,24,4,176,648,416
"Abracadabra, no more monkey! Now I'll make your contract disappear.",147,26,3,176,648,540
This original Bezos prenup restoration is sponsored by Amazon.,130,21,3,154,648,690
"Now just because I’m shredding our marriage certificate, it does not mean my assistant is any less lovely.",140,20,5,165,648,989
"Paper shredder, toaster, ... whatever...",148,24,4,176,648,1454
Watch me make these business records....DISAPPEAR!,157,26,4,187,648,1732
Evidencius Confringo!,143,14,8,165,648,2304
And your employment duties disappear forever Miss Me Too.,140,20,5,165,648,2942
"Geez, and I thought Houdini was meticulous...",148,24,4,176,648,3427
Watch as your I turn your vote into a great ape.,132,16,6,154,648,3434
"Some said it was showmanship, others hubris, that drove The Great Litigato to add the shredding-the-liability-waiver bit to his sawing-the-woman in half act",132,17,5,154,648,3650
You wouldn’t believe it; trump asked me to the  same trick with his financial disclosure report before the election.,132,16,6,154,648,3784
"Honey, just remember that here at the Florida 2020 Presidential Chad voting workshop, practice makes imperfect!",131,18,5,154,648,4046
"As you probably assumed, the shredded document will soon reappear in it’s original form.”",162,27,4,193,648,334
"By shredding this document, I hereby disown my lazy, non-magical son.",152,27,3,182,648,1772
"Voila!  Technically, if it's part of the ""show"" the evidence is considered a prop.",156,19,7,182,648,3847
"Abra-ca-da-bra, now you see it, now you ... Oops",144,24,3,171,648,814
"“The audience will note that, despite the arduousness of this 60-minute trick, my male posture remains neat and professional.”",145,21,5,171,648,1876
A Banksied ballot might be worth more this way.,144,23,4,171,648,2664
And if you’ll look very closely it really does look like our divorce papers are shredding.,143,25,3,171,648,3444
It can make stacks of 3-4 papers disappear!,142,27,2,171,648,3796
"And for my next trick, I'll be avoiding Federal income tax.",144,23,4,171,648,3877
...and with a wave of my wand ...what tax returns?,136,19,5,160,648,206
"Watch as our Constitution is shredded into oblivion by our favorite document destroyer, the Terrible the Ravenous the Ugly the Masterful the Persuasive, well you probably already guessed it.",128,15,6,149,648,3789
"Aha, I've been shut down""",150,22,5,177,648,2832
"OK kids, this next trick I learned from a fella at Burning Man. I call it, ""Tax Evasion""",141,20,5,166,648,1762
To make this feat even more unbelievable I'm shredding the instructions that tell me how to put my assistant here back together and resurrect her after I slice her in two.,139,24,3,166,648,1946
...keeping the IRS and NSA in the dark.,140,22,4,166,648,2399
Ladies and Germs: Now watch your voting ballot magically disappear.,139,24,3,166,648,2618
And so our marriage disappears...,137,28,1,166,648,3409
"When I say ‘abracadabra,’ voter disenfranchisement will magically end",132,18,5,155,648,413
"And, in three days I will make this re-appear as the second IRS notice.",131,20,4,155,648,464
the real magic is getting it to count,133,18,4,155,648,2539
Now imagine this is our prenuptial agreement.,121,20,3,144,648,1303
"For my next feat, I will make my tax bill disappear.",122,20,2,144,648,1831
"And, with a flick of the wand, my tax evasion DISAPPEARS",123,16,5,144,648,3313
and voila! my assistants shredded pants transformed!,153,27,3,183,648,3656
And here’s your NDA,144,25,3,172,648,880
And after Disappearing Liability Form comes the Human Saw.,138,17,6,161,648,1967
"Sir, we booked another gig is Washington.",138,17,6,161,648,2796
I think I might go into street art after this.,170,24,6,200,648,4152
Don't worry. SDNY is waiting backstage to miraculously paste it together in time for the finale.,158,28,3,189,648,108
Taxes...and voila!,150,24,4,178,648,99
Let’s hope it stays together.,150,24,4,178,648,3872
"Then, with a simple flourish of his wand, Maximillian the Magician changed the course of reality as it had always been known, with the introduction of his un-shredder.",151,23,4,178,648,3914
"And the magic box says,""You're standing on the wrong side of the curtain.""",144,16,7,167,648,353
"''Abra Cadaver.""",143,18,6,167,648,2693
After the audit these will magically regenerate themselves.,141,22,4,167,648,3235
"So confident of my amazing accuracy to outline the beautiful Millicent with seven sabers, I shred our prenuptial marriage  certificate.",143,18,6,167,648,3373
With the wave of a wand she shred a tear .,141,22,4,167,648,3430
Be careful not to lean over.,134,16,6,156,648,276
"Before I attempt my death defying escape, can anyone help me get this paper out of the shredder?",131,22,3,156,648,4220
I'm shredding our divorce papers.  The trick is getting me to pay a penny. . .Tra La...!,156,23,5,184,648,980
You have problems doing these sort of things? Just make a nice ritual out of it.,154,27,3,184,648,3469
I shall now Banksy it to oblivion.,148,19,6,173,648,1231
... and abbra kadabra the contract separates but I still have little hands,147,22,4,173,648,1566
"Ladies and gentlemen, I give you the UN-shredded marriage licen- I said, UN-shr- Just a sec... UN-shred- Oh, my dear, I am so sorry!",147,21,5,173,648,1958
"And now, I will make your W2s disappear",147,21,5,173,648,3184
"Ladies and Gentleman, Veronica will flawlessly restore it.",149,20,4,173,648,4111
Magical Mystery Tear,136,23,3,162,648,1174
And now for the possible Democrat candidates . .  including last minute write ins . . ..,161,25,4,190,648,942
This will not come back to haunt us. This will not come back to haunt ussss.,130,15,6,151,648,2676
"For my next trick, my assistant will now pick up my dry-cleaning.",145,17,6,168,648,356
Let’s toast the new immigration bill which is a pure magical fantasy!,140,26,2,168,648,978
"Ms Frz, did you shred your dress again?",143,22,3,168,648,2949
Abra cadabra hallakazoo! Negative for herpes,158,21,6,185,648,2656
"(Damn it, Peggy. I said “rabbit”!)",130,26,1,157,648,2271
"Abracadabra, shred-zam! And just like that, I can make the warrant for my arrest disappear!",133,20,4,157,648,2673
And now for your marriage certificate,150,18,6,174,648,4228
"So, with Ms Sotheby's kind assistance, I will now make this 1m dollar shopping list worth 2m dollars.",161,26,4,191,648,3653
"Once I’ve shredded it, with a wave of my magic wand, ta da, I’ve stolen your identity!",139,19,5,163,648,1830
The magician getup is for destroying the digital copies,150,28,2,180,648,1550
And now for an unusual strip-tease act.,151,26,3,180,648,1749
And Presto!  She is no longer my assistant.,167,25,5,197,648,615
I will proceed to turn the shredded paper into toast!,144,20,5,169,648,1502
Stick my cock in it? Don’t mind if I do!,145,18,6,169,648,1709
Abra cashredshra,160,19,7,186,648,1318
New Year's Resolution...in with the old and ...voila...out with the new,119,19,3,141,648,4182
Hey Mom. Thanks for letting me hide my D&D character sheet in the family toaster.,133,22,3,158,648,1287
"And for my next trick, I'm going to make the auditor disappear!",133,22,3,158,648,1674
Some lawyer must have grabbed my rabbit.,135,18,5,158,648,3165
And finally my latest payslip ... directly from 1989.,135,19,4,158,648,3799
Aaaand...voilá! Your restraining order has vanished! I told you I could win you back by becoming a magician,146,27,2,175,648,964
"I tried to tell him it wasn't magic, but Mr. Trump pays really well so let's just keep up the ruse. Hey, you can't read Cyrillic, right?",148,23,4,175,648,1687
"Abracadabra, I recreate the terms of our divorce decree.",146,27,2,175,648,3301
Watch closely as the wand makes the paper disappear right in front of your eyes,149,21,5,175,648,3894
"""In a subpoena, 'Abracadabra' simply won't do.""",162,26,4,192,648,2194
This is how magically we can make all your debts go away.,126,19,2,147,648,3224
Presto! No more emails.,141,18,5,164,648,307
one needs a magic wand these days to ensure validity,141,17,6,164,648,861
And who needs annoying financial records anyway.,139,21,4,164,648,2615
"Abra Cadabra, here goes the last Non Disclosure Agreement....",139,21,4,164,648,2711
"And now, I will cut my earned income in half--ABRATAXABRA!!!",136,27,1,164,648,3745
I hope it's not too late to change my mind.Dang this wand anyway.,138,23,3,164,648,4037
Well Pam... This is what I think about your costume budget,155,20,6,181,648,3517
I am now shedding my lovely assistant’s car title — and if this trick works I may even shred her home mortgage.,141,28,1,170,648,220
"Yes, it does look like the original of our pre-nup! That’s the magic of shredding the original of our pre-nup!",128,24,1,153,648,1453
"Some slight of hand and a wave of my magic wand, and Presto! our marriage never existed.",129,21,3,153,648,3597
"Abra-cadarbra and disappear, now watch me disappear from the country.",163,26,4,193,648,349
Email has destroyed any resemblance to my first act.,151,19,6,176,648,747
Abracadabra. There goes are prenuptial agreement!,148,25,3,176,648,1682
"Abracadabra, our bar tab's gone.",134,22,3,159,648,39
"Fear not, for I, Paper-Jam Pete, your On-Call Office Magician, have never failed!",134,22,3,159,648,742
"The Great Interpreter, Lost in Translation",137,17,5,159,648,1278
I call my next trick the disappearing Income Tax Form.,137,18,4,159,648,1330
"For my next trick--""abracadabra""-- watch this piece of paper disappear!",136,19,4,159,648,3183
And vola!  That’s how you make Credit card debit disappear.,138,14,7,159,648,3548
Abacadaba! Faster and easier than chewing and swallowing the record.,137,16,6,159,648,3605
"Ladies and gentlemen,instead of sawing my assistant in half tonight, I will attempt something never before performed on stage",134,22,3,159,648,4207
Is this your 1998 bank statement?,121,17,4,142,648,1093
"Now that I have memorized this list of audience members' bank account numbers,my lovely assistant will show you that I have completely dest... wait a minute...",156,20,6,182,648,970
And now for the disappearance of my divorce settlement papers.,153,26,3,182,648,2187
I will now make my bills disappear.,153,26,3,182,648,2759
"I use my pre-nup hoping the restoration part doesn't go well....""",139,23,3,165,648,1281
"Allow me to demonstrate...this piece of paper represents my lovely assistant, Darla...",140,21,4,165,648,1925
Watch carefully. I will make this machine eat this piece of paper!,140,21,4,165,648,4128
"It's the bird's death certificate, best I can do right now.",127,17,4,148,648,3277
I shall make Trump’s tax returns disappear!,143,26,2,171,648,544
"Usually I do this trick with a five dollar bill, but it should work with your marriage certificate",143,26,2,171,648,1780
Where did the bagel go?,146,20,5,171,648,2617
"Enough of his tricks, let’s make that marriage of yours disappear.",131,19,4,154,648,24
Melinda's boss was a control freak.,130,21,3,154,648,1685
Only I can get the government up and running again.,130,21,3,154,648,1736
And now I'm going to make my Schedule A form completely disappear!,131,19,4,154,648,2287
"POOF!!  
Sorry dear, but the pre-nup is back on!",131,19,4,154,648,3969
...and this is how I made Arthur Andersen disappear.,148,27,2,177,648,1198
"Federal offense? Shut that pretty little mouth, Kellyanne.",152,19,6,177,648,4043
"Sawing a woman in half? Bah! With the laws of gravity & politically correctness, I will now shred a non-essential document. Et voila!",136,20,4,160,648,2790
abra--and so on.,120,21,2,143,648,3808
This is what I call “black magic.”,141,22,3,166,648,121
Your Home Loan will now disappear!,141,21,4,166,648,269
"If there's anyone left in the audience after I glue this back together, please don't tell how I did it!",143,17,6,166,648,2476
And now the rabbit’s contract will do a disappearing act.”,142,19,5,166,648,3596
"For my next trick, I’ll triple the value of my work",139,25,2,166,648,3863
And watch as I make your alimony disappear!,160,25,4,189,648,462
"Well, at least a few of  your type are still okay with the destruction of history.",126,20,3,149,648,1078
I told you not to feed the rabbit today!,126,20,3,149,648,2670
"Sure, magic isn't exactly a high salary career but at least I can make my credit card debt disappear",128,16,5,149,648,3407
"This is what I call a marketable skill, Karen.",144,26,2,172,648,843
"And now, I will make Trump's tax returns disappear!",148,19,5,172,648,1190
And I've made your identity disappear!,145,24,3,172,648,1690
"For my next act, I will make my assistant disappear, just like this paper.",146,22,4,172,648,2342
Your ballot paid for compliments from the Donald!,146,22,4,172,648,3355
"And now, with my wireless magic wand, I will make this ordinary piece of paper disappear!",147,20,5,172,648,3755
Watch your fingers!,129,25,1,155,648,3015
"And now, I will make the Panama Papers disappear.",132,19,4,155,648,3570
And with that I will make your debt reappear!,167,33,1,201,648,1387
I like to practice; just hold steady and your fingers should be fine.,152,32,0,184,648,4103
Watch as I make last years Tax Bill disappear!,161,26,3,190,648,773
This is a questionable trick!,163,21,6,190,648,3221
And now the shredder does its magic...science!,143,19,5,167,648,746
My assistant seems to have shredded her thumb.,142,21,4,167,648,1038
Presto IRS Audit- O!,143,19,5,167,648,1317
Abracadabra! The I.R.S. bill disappears!,141,23,3,167,648,1703
"Now for my lovely assistant, Mrs. Loretta the shredda",142,23,2,167,648,2875
The police burst into the room catching Bill in the act.,143,19,5,167,648,2895
Russians...where?,142,21,4,167,648,3087
Clean up is easier when it’s paper you make disappear.,141,23,3,167,648,3540
With any luck I'll be able to perfectly reconstruct your birth certificate from the shreds.,145,15,7,167,648,3701
. . . never to be seen again.,123,17,4,144,648,1432
Now I will make the secrets to my tricks vanish forever.,123,17,4,144,648,2358
It’s a story of a disappearing Rabbit...,123,17,4,144,648,4162
Abraca-prenumpo-disapearo!,167,24,5,196,648,260
"Alacazam, shredded tax returns!",148,20,5,173,648,542
I will place this paper in this shredder and magically turn it into  Twitter message!,147,23,3,173,648,2571
... revealing once and for all whether Oswald acted alone.,146,24,3,173,648,4102
Aba Ca Dabra The shredded tax refund becomes whole again,144,28,1,173,648,4132
My last assistant quit and was not accidentally cut in half.,149,29,1,179,648,16
"And abracadabra, my ageing assistants contract disappears!",153,21,5,179,648,1907
"Uh oh, my magic only works with wireless technology...",150,27,2,179,648,2839
Watch as she goes digital for the 2019 tax year.,132,21,3,156,648,981
"And for my final trick, I will make the lease on my apartment disappear as all my belongings are sitting by the curb.",132,21,3,156,648,2127
Everybody watch me fuck up this piece of paper yo presto!,134,17,5,156,648,3010
"You'll see, ladies and gentlemen, that my lovely assistant's hand will go into a very real shredder.",161,17,7,185,648,374
For my next trick I will eat all the paper now.,160,21,4,185,648,1970
Voila! I shall now make the solution to this trick disappear.,155,29,1,185,648,2053
"Call the Magnificent Melvin for all your Divorce needs!
(also available for birthday parties)",137,22,3,162,648,1605
Honey for our final trick together I will end our relationship with a farewell.,136,24,2,162,648,3043
"""And with a little tap of my wand, this twenty five year old jammed up shredder is once again...almost, semiiii...functional.""",142,23,3,168,648,2655
"Presto Changeo, I now divorce my wife-assistant who is getting too thick through the thigs.",143,21,4,168,648,2808
And now I will make my parking ticket disappear!,126,14,5,145,648,127
"Doris, you’re crying.  Did you get your thumb stuck in the shredder again?",146,26,2,174,648,408
"Abra Cadabra, Hocus Pocus, you better put those tax's in focus.",148,22,4,174,648,1010
Trump's lawyer demonstrates the Carbonaro Effect.,149,20,5,174,648,1259
This summons to Parking Court brings me joy Marie.,150,19,5,174,648,2169
Ladies and Gentlemen...I shall now pull a Banksy Bunny from out of my hat!,123,19,3,145,648,2685
I already told everybody my Tax Return was in Audit and Not Available.,153,23,4,180,648,2243
"As Mueller Fans Might Say, ""Better than pulling a rabbit out of a hat!""",152,25,3,180,648,3086
Little does he know that's the only copy of our pre-nup agreement.,130,16,5,151,648,1683
"Summodium Vanishosa! And like that, watch my jury duty summons disappear!",135,17,5,157,648,366
Presto!  Now I will make our marriage license disappear.,134,19,4,157,648,525
"...and now, I will make my Secrecy Agreement with the International Brotherhood of Magicians disappear.",134,19,4,157,648,3936
abracadabra....she has no pants,134,19,4,157,648,4028
Your contract for the disappearing act. You're fired!,134,19,4,157,648,4145
"... and with the help of our magic words, 'taxo-changeo'...",163,25,4,192,648,1222
I'm afraid I may have used insufficiently advanced technology.,138,22,3,163,648,578
The White House musician and his assistant Olga.,140,18,5,163,648,3777
Presto chango! Accusation  schmackusation! Totally-o innocent-o. Evidence schmidence!,147,17,5,169,648,873
Magic in the age of technology is still not the same.,148,24,3,175,648,1075
Are we ever going to do this for an audience?,149,22,4,175,648,1497
"Presto, my contract will disappear",149,22,4,175,648,1509
"And now, I'll make your contract disappear!",148,24,3,175,648,2642
"Magician unshreds a document and instantly regrets 
making his performance reviews reappear.",147,26,2,175,648,4002
"And just like that, my legal culpability disappears!",156,19,6,181,648,1996
"I say 'Presto' and, just like that, my agent's commission vanishes.",124,19,3,146,648,151
Be sure to shred the machine as well dear.,125,17,4,146,648,1210
With a wave of this wand all your debt will be shredded.,133,23,2,158,648,425
"For my latest trick, I will make our marriage certificate disappear.",135,19,4,158,648,1124
Say it with me! Abraca-Divorced!,134,21,3,158,648,3530
"And just like that, I've made your contract disappear!",139,22,3,164,648,2047
You can use my toaster anytime,174,27,4,205,648,2145
For my last trick I will perform  “the Banksy.”,147,17,6,170,648,2259
"And, poof, your letter of resignation has disappeared! I told you that technology was the future.",142,27,1,170,648,3856
"My greatest feat of magic: If this protest to my mayor, representative, senator and president will actually be read and effect change.",152,18,6,176,648,1051
"...and say the magic words ""Audience of One,"" and...presto!",148,26,2,176,648,2264
Abraca-Bansky am I rich yet?,157,20,5,182,648,1166
"And after this paper goes through, my lovely assistant will herself step into the shredder.",120,18,3,141,648,14
The hand is quicker than the ply.,126,17,4,147,648,3252
And now The Great Retrivo will reassemble Elvis’ original  concept of God’s Plan.,130,20,3,153,648,4059
I see my ex-wife unplugged this shredder.,136,19,4,159,648,815
"Sorry, the receipt gets stuck sometimes",133,25,1,159,648,853
"Alakazam! Alakazoo! I asked you for cash, this bank draft won't do!",137,17,5,159,648,1283
"With one pass of my magic CIA issued wand, I will rip the minutes of Comey's meeting into thousands of pieces.",137,17,5,159,648,1993
Voila! And the Great Banksy re-assembles a girl and her balloon!,135,21,3,159,648,2037
"For my next trick, I will make my bills disappear.",134,23,2,159,648,2320
"Tax fraud, begone!",135,21,3,159,648,2351
"Wow, if this makes my debt disappear let's try the rabbit next.",142,19,4,165,648,12
Watch as I un-shred my lovely assistant's credit report,143,16,6,165,648,1351
And now - I will make my New Years' Resolution disappear!,142,18,5,165,648,1826
Very old school but SHAZAM!  My sins are no more.,141,20,4,165,648,1903
And for my next trick....I'm going to shred this ballot in here...and out it should come out totally intact at the bottom!,138,26,1,165,648,2168
And next I will amaze you with my assistant . . .,142,18,5,165,648,2768
Abra-ka-shreddah!,141,20,4,165,648,3272
"I’m telling you, this trick will bring millions.",147,19,5,171,648,1617
And just like that i have made all my responsibilities as a father... disappear,151,22,4,177,648,1463
"For my next act, I will shred the petition to allow my fetching blonde assistant to dress more warmly. And forget about it.",155,25,3,183,648,3065
"And presto, your tax return has disappeared.",158,19,6,183,648,3680
Now watch as my assistant's resume disappears,167,23,5,195,648,354
And with the power of defense mechanisms - Abracadabra a la Freud!  All your student debt will now disappear.,121,18,3,142,648,2000
Now you see it...,132,18,4,154,648,347
"And just like that, I’ve made this marriage disappear!",131,20,3,154,648,1035
I hope no one figures out this trick,130,22,2,154,648,2547
"Abracadabra! Judy will disappear, as soon as the instructions for bringing her back have been shredded. But do not be alarmed, ladies and gentlemen! I have memorized the spell. Or . . . I thought I had. 
Oh, heck. Nice knowing you, Judy.",130,22,2,154,648,4135
Expecto Lacero!,137,19,4,160,648,311
And now... Abraca-Gerrymander!,138,17,5,160,648,717
"And days from now, the remaining chips will be found behind your sofa pillows., in your purse and your underwear drawer.",142,20,4,166,648,687
"As Trump's financial advisor, I say, ""IRS ...Vanish!""",142,23,1,166,648,961
Fixing a shredder is a magic trick.,144,16,6,166,648,971
You will no longer be interpreting my secrets.,141,22,3,166,648,1713
"Yes, Hillary.  I can use my magic to make these emails disappear, but are you sure the audience will like this trick?",142,20,4,166,648,1833
"Abracadabrax 
TurboTax !",143,18,5,166,648,2468
And for my next trick...the Magnificent Michael Cohen will learn how to shred,148,20,4,172,648,3150
"Now that I've shredded your contract, will you marry me?",151,24,3,178,648,504
And just wait to see my Magic Marker!,151,24,3,178,648,636
. . . and the love letter I wrote to you in Spain . . .,154,18,6,178,648,1896
"Watch, as my lovely Assistant and I attempt to UNshred the paper!",127,19,3,149,648,3404
"With just a wave of my magic wand, you will observe that our letter is no longer hopelessly jammed in the printer.",127,19,3,149,648,4015
"abracadabra, alakazam! if my bitch ex-wife thinks some piece of paper and a process server and the whole weight of the family court system can force me to pay child support, well, she's got another thing coming. she never did respect my craft...",134,16,5,155,648,1407
"Abracadabra, our divorce is final.",133,18,4,155,648,2090
I will next bring up a live rabbit.,134,16,5,155,648,3946
I provide confidential deshredding services,131,22,2,155,648,4123
"We are not in New Hampshire, remember please",137,21,3,161,648,2649
"I wave my wand, and this paper will vanish like my assistant's pants.",143,21,3,167,648,2793
No peeking - no leaking.,144,18,5,167,648,3931
As you can plainly see I can reverse the shredding by tapping here.,148,21,4,173,648,714
I don’t think the bill collector is convinced.,145,27,1,173,648,1378
"Now hold still Marlene.
""Abracadabra, turn into a Banksy!""",154,20,5,179,648,870
"Not bad, but what happened to the rabbit?",151,26,2,179,648,3600
"And  Presto, Chango, watch as our marriage license disappears.",153,22,4,179,648,4081
"If they would print bills on softer paper, we could use them as toilet tissue.",157,16,7,180,648,65
I can make your tax bill disappear.,143,22,3,168,648,326
"You see honey, I just made your copy of The New Yorker disappear one page at a time.",148,23,3,174,648,576
The Un-Banksy!,126,23,1,150,648,621
Are you sure you want to use your birth certificate for this one?,139,19,4,162,648,722
"Ladies and Gentleman, I sure hope this works 'cause I'm placing our marriage certificate in this shredder.",144,20,4,168,648,928
Magic presto! Florida is a no go!,152,26,2,180,648,1063
"Now, just one swipe with the baton, and we'll be right up there with Trump",131,13,6,150,648,1245
"And with a wave of my wand,your fax will vanish into thin air.",146,16,6,168,648,1285
"For my next trick, I will make my lovely assistant, Janie, disappear!

Clyde E. Lehmann
San Antonio, Texas",148,23,3,174,648,2016
And now I’ll unshred your old mobile phone bill.,138,21,3,162,648,2208
Voila! Here's where I store my tricks of the trade!,152,26,2,180,648,2272
"Watch, as bills disappear before your very eyes!",133,20,3,156,648,2990
"This is how Watergate started his career, LOL.",155,20,5,180,648,3186
All your traceable worries will disappear.,142,24,2,168,648,3511
"Observe, as The Great Dr. Reverso reconstructs a shred paper using mind-power alone!""",162,18,6,186,648,3561
And with a wave of my wand I will make my lovely assistant's resignation letter disappear.,123,18,3,144,648,3746
"And now, I’ll make these tax returns disappear!",136,14,6,156,648,4016
"Don't worry - if I can magically tape paper back together, I can do the same with your hand.",136,14,6,156,648,4020
Zap! The Trump government shutdown is hereby ended.,140,17,5,162,648,4112
as you can see I am a a twentieth century magician.,171,25,3,199,648,2757
So much more reliable than the thermal fax machine from the last show.,148,26,1,175,648,125
"Presto,chango!  In an instant his criminal activity will disappear!",147,27,1,175,648,2914
Not a word. Or I'll make YOU disappear.,150,21,4,175,648,2976
"You didn’t forget the doves, did you?",144,22,3,169,648,19
Now watch as I make all your hopes and dreams disappear.,144,22,3,169,648,2722
You're next Miss Feeney,146,18,5,169,648,3436
Does pretending make it legal?,142,15,6,163,648,1645
"Assistant, “This is the only time I can put my college degree to use. Perhaps even get some claps...”",139,21,3,163,648,2246
Jam! These things never do the trick.,140,19,4,163,648,3167
The shred must go on!,136,16,5,157,648,282
Presto-Shreddo.  Divorce settlement be gone!,134,20,3,157,648,2840
"And when I say the magic word, 'Abrasubpoena,' you will see the tax form miraculously reappear",133,22,2,157,648,3512
"Sorry, the hat only works for rabbits....",149,25,2,176,648,770
Behold!  The Presto Change-O Bill Eliminator.,151,21,4,176,648,3637
"Hillary Clinton
-Circa 2014",147,19,4,170,648,195
Originally a restaurant toaster!,146,21,3,170,648,1717
"As you can plainly see, the shredder is plugged in and he woman has upper body strength.",146,20,4,170,648,2626
Why doesn't the damn thing go in?,143,15,6,164,648,2628
Presto shreddo! I took a page out of Jeff Bezos's prenup book.,137,16,5,158,648,114
"Voila, the Mueller Report!

John Thornton, Scio, Oregon",136,18,4,158,648,2764
Slight of hand is so 70s; 1870s. I’m taking the digit out of prestidigitation!,136,18,4,158,648,3978
Marty and Janine Tax Preparers testing our new tax prep hardware,131,17,4,152,648,3214
"Artsy, Banksy, Cranksy.",126,16,4,146,648,570
"There, the last of my ex's love letters",161,25,3,189,648,3534
Who needs instructions when our patented Thigh Blaster speaks for itself.,158,20,5,183,648,4030
"For my next trick, for at least for the next 7 to 10 years, anywhere outside of the U.S., its ME who is going to disappear!",151,24,2,177,648,749
I need to read the fine print,150,14,7,171,648,1203
"And for my next trick, a death defying jump from my office window",142,19,4,165,648,430
Now you see the evidence of me sexually harassing my stage assistant. I say the magic words Presto Chango...and their gone.,143,18,4,165,648,492
"For my next trick, I’d like the entire audience to place their wallets in my hat.",142,19,4,165,648,3812
The disappearing act of woman’s rights,136,20,3,159,648,3790
Abracadabra! That unfair reviews is no more!,129,23,1,153,648,543
"And for my next trick, I'll make your embezzlements disappear!",132,18,3,153,648,1102
Cadabraabra,132,17,4,153,648,1109
And abracadabra! I pull my Dear Jane letter out and it's back in one piece!,130,21,2,153,648,1442
Watch me make these transcripts disappear.,132,17,4,153,648,2484
"My Magic Unshredder revives messages shredded from anywhere!...Is this a bill?...A love note?...The words are re-assembling a bit jiggly - hold the Magic Unshredder steadier, Connie...Steady...Here we go the message says ""This is Page One of 30,000""",127,16,4,147,648,860
This is not a trick.  I'm just celebrating my final divorce decree came through.,166,17,7,190,648,720
"Joe, this isn't going to make our credit card debt disappear.",157,24,3,184,648,3737
This state-of-the-art shredder-printer enables you to retrieve a copy of everything it shreds.,117,14,4,135,648,1077
"For my first trick, making your participant consent form disappear.",147,22,3,172,648,10
"And for my next trick, I will reply to this job application.",148,20,4,172,648,816
You're next.,144,17,5,166,648,188
"For the pièce de résistance, I will now make all traces on the Internet disappear.",142,21,3,166,648,822
"And now for my next illusion, ""The Hillary Escape""!",144,17,5,166,648,1525
Abracadebit!,144,18,4,166,648,2558
"My third vote, is that the charm?",142,21,3,166,648,3315
...And as if by magic my hotel bill disappears!,141,23,2,166,648,3691
Voila! Your mortgage has disappeared.,142,21,3,166,648,3753
Now watch as I make your tax fraud disappear!,136,22,2,160,648,92
Aaah...baah...caah...daah...baah...raahi'm innocent!,138,18,4,160,648,1208
Presto Chango Banski!,127,18,3,148,648,604
You made sure this wasn’t my license right?,161,18,6,185,648,3018
"For my next trick, I will make my taxes... Disappear!",155,19,5,179,648,1065
With a wave of my wand a new Constitution will appear.,153,23,3,179,648,3060
I'm gonna put this politically correct routine into the shredder and make it disappear.,121,19,2,142,648,2478
"Really Comrade?! THIS IS HOW the Proletariat will create a new world order?!

David B. Smith
Miami Beach, Florida",146,26,1,173,648,876
"And PRESTO, the paper disappears!",148,22,3,173,648,1910
Feel the Bern?,149,21,3,173,648,2079
"When the shredder broke, the sales woman knew she was caught with her pants down.",150,19,4,173,648,3893
"Voila!  Gone!  Thank you, Rebecca.  For my next trick, let's bring out that Xerox machine, where I will wow and amaze you with more of my government program analyst abilities.  Tip generously.",145,18,4,167,648,470
I´m sorry I have to break it to you this way honey but I want to divorce,142,23,2,167,648,3699
"This may look like a shredder, but it's actually a toaster.",145,17,5,167,648,3904
Suddenly sawing me in half seems like easy street.,139,18,4,161,648,415
"And now, I will make this horribly written review disappear, while at the same time, torturing all the words by ripping them, letter by letter, with the multiple sharp blades of this machine.",138,20,3,161,648,1275
"Now Ms. Kollins, please be so kind as to demonstrate for the audience that the legislation contains no trap doors of any kind",138,20,3,161,648,1751
"I am a debt relief counselor and I can make your debt disappear ...  Ehem,for this month anyway...",136,24,1,161,648,3151
"Ladies and gentlemen, I will turn your car payment into toast!",138,21,2,161,648,3476
"Watch, as I make your tax worries disappear.",134,17,4,155,648,180
"For my next trick, I will make my liability policy disappear.",131,23,1,155,648,1592
Abrakadabra! Summons be gone!,132,21,2,155,648,3467
"And with just a wave of my wand, I make my marriage MAGICALLY DISAPPEAR!!!",134,17,4,155,648,3662
"Now, ladies and gentlemen, watch my mortgage disappear, just like that.",132,21,2,155,648,3721
"I put the news in the TelePrompTer and, abracadabra!",153,25,2,180,648,609
"For my next trick, with the help of my beautiful assistant, I will turn this document into cross-shredded pieces.",129,16,4,149,648,2553
"And the magic words are...""I divorce you.""",150,21,3,174,648,1372
And now my greatest feat... escape from prison!,150,20,4,174,648,1820
For my next trick I will shred all my tax forms,145,19,4,168,648,209
"This is a page from the scarlet diary of the A list actress here holding The Magic Box. I guarantee it will disappear in seconds or my name isn't Michael Cohen.  And don't forget to catch my act next week at the famous Club Fed.""",145,19,4,168,648,1003
"And now... sim sala bim, the paper won't jam and end up in the bin.",145,19,4,168,648,1248
"Shred away, Mr. Trump....that hat disguises your hair so well, not to mention the girdle, no one will recognize you!",142,25,1,168,648,1813
There is no way we are going to finish this blunt.,138,22,2,162,648,527
Abrashredabra…,142,15,5,162,648,1336
"You, too, can make your bills disappear.",141,16,5,162,648,1519
The magic happens when we intrroduce fiber to her digestive system.,140,19,3,162,648,1829
"And presto, my alimony court order magically goes away.",133,21,2,156,648,967
Abracadabra.  Watch as your pay check disappears.,134,19,3,156,648,2577
Ta Tax !,158,17,6,181,648,1289
"Bibbidi-Bobbidi-Boo! And for my next trick, I'll restore our marriage certificate.",159,16,6,181,648,1563
Sim-Sala-Banksy!,156,22,3,181,648,3145
"This magic machine fixes parking tickets while it shreds them. Just put the ticket in, wave the wand, and poof, the ticket is dismissed.  Honest.",152,18,5,175,648,734
"Yes Lynette it is tragic, yet Wala! like magic....not a shred of evidence.",150,22,3,175,648,1057
Just say abracadabra and you will see shreddar cheese.,151,20,4,175,648,2252
"And now, watch me make our divorce settlement disappear!",150,22,3,175,648,3153
"Don't worry folks, it's safe. Until very recently, my assistant was a chair at U.S. Consumer Product Safety Commission. Sad!",128,20,2,150,648,4238
And as I pull the note out of the shredder it magically reattaches...,166,25,3,194,648,4227
Unshred my heart.,144,23,2,169,648,2107
Hence why they say I'm a real cut up on stage!,139,22,2,163,648,951
I hope this will make my husband's wish list disappear,141,18,4,163,648,1441
And this is winter in a box.,141,18,4,163,648,1517
Abracadabra! Get ready for a delicious shredded cheese pizza.,141,19,3,163,648,1866
I am shredding this 401K and will make it re-appear as a pigeon.,143,15,5,163,648,3542
"Honey, if Beethoven could make it without his hearing, I can make it it without a pre-nup.",157,21,4,182,648,305
Tip included.,150,24,2,176,648,3004
"Lucy and James tried their hardest to renegotiate the terms of their mortgage, but to no avail.",128,22,1,151,648,1863
Damn PETA! Shredding the rabbit's pet license just isn't the same.,131,16,4,151,648,2103
It’s sluggish today. Sometimes a few magic words will speed it up.,130,20,1,151,648,3674
"How Mike the Magician’s
Product Endorsement Contract  
became null and void.",146,21,3,170,648,451
"Manuscripts don't burn, but they could be shredded",147,19,4,170,648,2789
"And...Hey Presto!  I, the Great Shredini, will make the key evidence of a flagrant ‘insider trading’ scam...disappear!”",127,14,4,145,648,3443
"Presto, chango, and I make the national debt disappear!",142,18,4,164,648,1654
Magic sucks. Love Dad.,158,21,4,183,648,1719
"And for my next trick, I will make my marriage disappear.",135,21,2,158,648,51
Abracadabra! I will make my taxes disappear right before your very eyes!,134,23,1,158,648,319
...unless you want me disappear for 2-5 years with good behaviour.,136,19,3,158,648,2153
"I WILL PULL OUT ANY PAPER AND IT IS IN FAVOR
OF TRUMP",152,22,3,177,648,1764
"Hocus Pocus.""   ""Presto Shreado.",149,17,5,171,648,440
"And, Presto!  This is the first time I've performed my ballot shredding trick in public.",131,18,3,152,648,443
She's too pear shaped. Keep shredding evidence and send in the next girl.,147,21,3,171,648,481
"I""m sorry, they ran out of Alexa's. This was all they had left.",134,13,5,152,648,2028
Banksy’s Stage Show,148,19,4,171,648,3752
Why did he insist we do it like this?,149,18,4,171,648,4155
Shredding our marriage certificate means we are divorced.,156,27,1,184,648,741
Hocus Pocus Unshreading The evidence !,142,20,3,165,648,3604
I prefer the bigger one we used for the rabbit,158,13,7,178,648,2283
"Watch as I wave my magic wand and ""poof"" the paper disappears.",153,22,3,178,648,3873
Now watch...I'll shred this tax bill AND pull a rabbit out of my hat.,136,21,2,159,648,1373
"Watch your thumb, young lady.",139,16,4,159,648,1529
Alakazam! Your letter of resignation has disappeared.,136,21,2,159,648,3074
Barring some magic we will finally see this report.,167,18,6,191,648,2643
Don't watch too closely as I make my lovely assistant disappear starting with her left hand.,148,21,3,172,648,1436
"DJT had hired them to make it all go away. Her partner, Dan the Man, remained confident. She knew Stormy and #MeToo had changed everything.",132,18,3,153,648,2965
"We don't cover ""disappearance"" until next semester.",132,18,3,153,648,3990
I might have some interesting applications for your disappearing paper trick.,143,20,3,166,648,1053
"Don't worry Nancy, this is just a copy.",143,20,3,166,648,1382
And now for the final magician's trick . . . the mystical shredder!,142,22,2,166,648,1553
Now for some more pop-up magic.,143,20,3,166,648,2692
Why can’t we rehearse with your birth certificate?,173,19,6,198,648,2952
Please don't burn the toast this time.,156,19,4,179,648,2408
"And presto chango, that bill magically becomes a receipt.",141,13,6,160,648,2838
"THE MORe  you see, the less you understand 
By the time I wave my wand,
There will be no SHRED, of doubt.......",149,21,3,173,648,179
And this is how you make evidence disappear.,149,21,3,173,648,817
Abracadabra ! I can make your bills disappear.,149,22,2,173,648,2672
"Wait- wat the---that's  a very unfair method for serving a subpoena, Miss Kay!",148,23,2,173,648,2918
"And...Voila, we have the Instruction Manual",124,12,5,141,648,3538
"Watch, as the document disappears.",162,19,5,186,648,1468
In a few minutes it will be hot!,162,19,5,186,648,2314
"Yes audience, my assistant Diane may still have a teardrop tattoo but as her probation officer I can make this positive drug test result disappear!",131,22,1,154,648,1327
Presto!  My lovely assistant’s pre-nuptial agreement is reconstituted.,142,24,1,167,648,389
She reconsidered her talking wand ventriloquist act when her puppet made more than she did.,143,22,2,167,648,1557
There is nothing magic about making this year's list of the worst magicians disappear.,157,18,5,180,648,394
And now my assistant's pay check will be shredded into a thousand pieces then with a wave of my wand and the word abracadabra it come back together.,158,16,6,180,648,1023
Alakadabra Alakazam and with the shred of our divorce papers I'm still your man,156,20,4,180,648,1142
2019 disappearing act,154,24,2,180,648,2492
Watch as I make Sheila's photo indiscretions reappear!,140,17,4,161,648,731
"Once I shred this ballot and wave my wand and over its pieces, your vote will actually mean something for once!",149,23,2,174,648,3396
"Edward the Existentialist: ""And for my next act, my 'tax returns' to whence it came.""",162,21,4,187,648,379
"Let’s try it again, this time with a paper. I’m not sensing the Mickey Mantle rookie card under my hat.",163,20,4,187,648,3878
"I, Magnifico, will not be responsible for any debts or wrongdoings other than my own.""",120,22,0,142,648,1393
"..Then we insert the unwanted document in the device my lovely assistant is holding and abracadabra, it disappears!",135,16,4,155,648,1839
This isn't worth taking my pants off. [Sigh].,144,22,2,168,648,1425
"Adult Harry Potter had some trouble with his tax returns. ""Unshred-ulmous!""",164,30,0,194,648,496
Now observe carefully as I make my English degree disappear!,168,22,4,194,648,2190
Banksy’s Toulouse Lautrec impersonation fooled no-one.,130,15,4,149,648,535
And now for the disappearing act.,129,17,3,149,648,3374
"For this trick, life disappears into meaningless emails and forms. *Feel* the metal machine tooth music consume fruits of accumulated effort, your energy disappate, telomeres shorten, death draw near...Poof!",142,15,5,162,648,3620
And now...I shall disappear into thin air!,150,23,2,175,648,513
And now I shred the instructions on,163,21,4,188,648,3950
"And now, the magic words: Enrondium Andersonviosa.",159,18,5,182,648,2207
This is the best way to make something disappear.,145,22,2,169,648,3354
You will find the shredded paper behind your bra straps.,152,21,3,176,648,1018
"Ladies and Gentlemen, watch as I make Trump's tac returns disappear!",153,19,4,176,648,1040
And now this paper will be worth as much as the shredded Banksy,153,19,4,176,648,1088
"And now, presto, my electric bill disappears.""",153,20,3,176,648,1620
"I know it's a lot of trouble, Honey, but this is the only way I can assure that the machine doesn't jam on me.",150,25,1,176,648,2766
What is this witchcraft?!,140,21,2,163,648,133
Alakaz-Enron!,140,21,2,163,648,428
Thank you Esmerelda. For my next act I will shred the fax... with my mind.,142,17,4,163,648,491
"For my next trick, I present you... Non GAP Accounting""",141,19,3,163,648,2114
Now I will make my alimony disappear.,140,21,2,163,648,2881
"Give bad accounts the Razzle Dazzle,
Shred and bury them!",142,17,4,163,648,3380
"With a wave of my magic wand, I shall bring back your recipe for crab canapés!",130,17,3,150,648,1937
"For my last trick, I will shred the Constitution...and my assistant will restore it--while I disappear.",128,21,1,150,648,2454
His stuff just does not play in public,159,21,3,183,648,1977
Jefferson's recipe for chicken noodle soup . . .,146,22,2,170,648,1052
"Behold, as misguidedly attempt to make my show relevant to millennials with this fax machine trick.""",149,18,3,170,648,4068
I need to stop writing down my secrets.,143,20,1,164,648,280
Hey Presto! Your contract is terminated.,142,19,3,164,648,3470
"First, say the magic word.""",131,18,2,151,648,73
And presto-change....the front page of the Times from a box of shredded wheat!,130,19,2,151,648,1048
Trump said we would be able to file our taxes on a postcard...disappear.,132,15,4,151,648,1256
Giggle it a little.,161,18,5,184,648,826
For my final trick I will  shred the only known combination to the family safe. I will say the magic words and it will reappear.,149,18,4,171,648,739
"And now, I will make every shred of evidence disappear forever!!",147,22,2,171,648,2262
"On the internet of things! The paper, the shredder and the wand, all, in communicado!",149,18,4,171,648,3774
"And now, behold!  I will make this document reappear in a nondescript office building in Blawnox, Pennsyvlania!",153,24,1,178,648,272
"For my next trick, watch me pull a 'Hail Mary' out of my a$$.",156,17,5,178,648,1523
NC-09,144,18,3,165,648,505
"For my next trick, I will make my tax returns *disappear* -The Don",132,17,3,152,648,390
What happens when the President who eats paper is unavailable.,131,19,2,152,648,1244
"Ya'll seen that one episode of ""West Wing?"" Dope, dope. You're gonna love this shit then.",138,18,3,159,648,340
Abracadabra papershreddah!,139,16,4,159,648,463
I hope it doesn't come out too brown .,136,22,1,159,648,2591
Abd just like that... Abracadabra... I no longer need to pay alimony.,137,20,2,159,648,3521
"Eventually, it will disappear in time.",127,16,3,146,648,1915
I can make your first draft disappear!,143,21,2,166,648,2999
And for my next trick I'll make voided checks disappear.,143,21,2,166,648,3417
Just plug it in. I skimped on my wand's extended warranty.,144,19,3,166,648,4116
"These darn boobie eyes are making my stick wiggle. Check, please!",135,13,5,153,648,2934
"Magician: I will magically make this paper disappear!
Assistant: Sir, that was your paycheck.",154,12,7,173,648,2223
And...Presto! I pull a description of  rabbit from this paper shredder!,139,18,3,160,648,979
"For my next trick, I will make our marriage disappear.",138,20,2,160,648,1920
"And now, my turn to give a toast.",137,23,0,160,648,3805
For my next trick I will make my debt disappear,144,21,2,167,648,231
Shredding a taxation from the government in front of an audience. Astounding!,144,21,2,167,648,752
Oh Banksy!,146,17,4,167,648,2937
"...and presto, it makes extremely low-cost fiber right in your home! You put it on your cereal and in your recipes to lower your cholesterol and keep your bowels moving!",146,18,3,167,648,3695
You say its magic but I say it's shredding...,146,17,4,167,648,3986
"And for my next trick, I will make my divorce papers magically disappear.",151,20,3,174,648,468
"Every time I do this trick with my assistant's contract, it comes out smaller",151,20,3,174,648,1021
And for my next trick -- I'm going to make your contract disappear!,151,20,3,174,648,1832
"Abracadabrai, make pre-nup go bye-bye!",148,26,0,174,648,2265
Oster!,134,17,3,154,648,3164
Not impressed you say...then next...the disappearing rabbit!,156,23,2,181,648,1365
And now I will make these final notices disappear!,155,25,1,181,648,2748
"And, abracadabra, my marriage disappears.""",139,20,2,161,648,1930
"Ready,Ill make your taxes disappear. One,Two,Three.",141,17,3,161,648,3550
Manic Spell: Abra-shred-abra,163,22,3,188,648,3765
Abra-Kondobra!,146,20,2,168,648,2174
"And for my next trick, I am going to pull a rabbit out of a pregnant rabbit.",145,21,2,168,648,3953
"Viola! Ladies and gentlemen, I present to you the disappearing act of important documents and incriminating files with the swish of my wand and the press of a button!",128,18,2,148,648,1572
A member from the audience will pay me $1.4 million for this,150,24,1,175,648,2050
"And now, get ready for the piece of paper to do an En-Ron around your very eyes...",151,22,2,175,648,2657
"And presto change-o our eviction notice disappears, right honey?",135,17,3,155,648,170
Christopher Columbus! I forgot to sign it!,158,21,3,182,648,2227
"Their marriage in shreds, the magic man turned to his ex and pronounced, “And for my final act I resolve to conjure up a smile for the both of us.”",142,16,4,162,648,3951
"And for my next trick, I'll my marriage disappear",147,19,3,169,648,1169
"Magic magic magic. I put the paper in the box and it shreds itself as my wand moves three times.
1, 2, 3...Oh! Did someone remove the plug from the outlet?",148,17,4,169,648,1660
And now I will make that transcription disappear!,147,19,3,169,648,2798
Might as well combine recycling with magic; that's the only way we'll get anywhere with environmental changes.,146,21,2,169,648,3066
My assistant Banksine will hold the shredder.,158,23,2,183,648,2219
"About as much chance as “the President” putting a sock in it, huh?",163,26,1,190,648,2418
"Next, my dear, I will shred a Bass!",166,20,4,190,648,3099
... And now your debt has dissapeared,141,20,2,163,648,512
How do I tell him that I want to shred his act!,148,19,3,170,648,1
"ABRACADABRA!!""
""Now you see it,
Now you don't",148,19,3,170,648,166
"Don't worry, Ladies and Gentlemen. Mrs. Clinton is here to help me demonstrate her ridiculously innovative voting system.",149,17,4,170,648,1247
Watch how I make your contract disappear.,148,19,3,170,648,1676
"No ma’am, I don’t work for the Miss Universe organization.  I’m just the interpreter.",151,13,6,170,648,1804
I will now magically turn back time on our marriage by turning our decree nisi into confetti,123,19,1,143,648,1376
"I put this sheet into the shredder, watch it carefully
Now you see it now you don’t",124,17,2,143,648,2376
"Just to clarify, this room has no Wifi connection, and the phone that sent this message does not have Android on it.",134,10,6,150,648,3531
Hum,169,17,5,191,648,63
So the tax returns are gone forever?,166,22,3,191,648,3271
"I know you wanted to find your birth mother, darling, but life, like magic, should be indescribable.",136,19,2,157,648,4035
Pay no attention to the sound of a shredder. Within the next second my taxes will have disappeared.,140,24,0,164,648,134
It's a living!,145,14,5,164,648,1298
"As you can see, my assistant is using an everyday shredder.  And in 3, 2, 1 the pre-up is magically annuled",142,21,1,164,648,3623
"Remember, this is only the first part of the trick. If I can avoid signing and read the legalese, that will be the real achievement.",151,16,4,171,648,2049
Presto Chango!,153,24,1,178,648,786
Watch closely while I turn my divorce settlement into toasted buns..,161,21,3,185,648,2623
It will as a $1.4mil Banksy!,139,15,4,158,648,2694
"But Donald, Putin will still recognize you.""",138,17,3,158,648,2802
"And for my next trick, I will recreate it by writing it again.",138,17,3,158,648,3435
"Voila, tax documents disappear... functional magic!",137,20,1,158,648,4104
"I will now try to guess your weight, including the name of your chiropractor!",143,20,2,165,648,2889
Watch me claim a new identity from my neighbor's shredder!,141,24,0,165,648,3375
"And now… the part of the evening when I go a little Banksy on my bank statements. Abracadabra, suckers.",149,21,2,172,648,1241
And now I will make your IRS bill vanish.,157,18,4,179,648,1455
Abra...wait for it...cadabra. An just by magic you got the receipt.,156,20,3,179,648,1555
Abracadabra!  We’ll do it right next time...,156,20,3,179,648,2449
This is one dumb cartoon.  The artist should be fired!,132,18,2,152,648,909
"For my final act, I will make your love letter reappear!... uh oh.",133,16,3,152,648,1307
"Na-na-na-na-na-na-na-na-na, na-na-na-na-na-na-na-na…",140,15,4,159,648,224
Umm: Line?,140,15,4,159,648,2367
"'And for my next trick, I shall wave this wand, shred this letter from the bank, and all your debt shall disappear...'",144,20,2,166,648,1641
Just a tap of the wand and my divorce papers are no more.,147,14,5,166,648,2986
Sorry! Looks like you’re toast,150,21,2,173,648,3093
"And for my penultimate trick, I shall make this object disappear.",153,16,4,173,648,3916
Presto! No more alimony.,133,18,2,153,648,3261
"My bank statement will now magically appear online as soon as I login.  Sadly, the balance will remain as is.",141,16,3,160,648,402
Maestro conducts the player-toaster.,145,20,2,167,648,968
There goes my cut-the-lady-in-half-trick that the world will never see.,150,23,1,174,648,3707
"Be amazed, as I attempt to make confetti out of my ex-wife's request for alimony.",129,15,3,147,648,32
"Next, I shall insert TWO sheets simultaneously and still:
no Combustion!",145,22,1,168,648,412
Shredding is the new Vaudeville,141,17,3,161,648,898
Just say the magic word and the divorce papers will disappear.,134,18,2,154,648,1621
Ironicly it was the receipt for the floor,152,21,2,175,648,1891
"Abra, Kadabra...poof,  now it' s  confetti!",152,21,2,175,648,2596
"ok i may be blasted off mids, but this is not a rabbit",135,17,2,154,648,2633
"You witnessed its destruction but with a flick of the wrist and a couple magic words, we can reach back in and, hey presto: I want a divorce, Mar",147,18,3,168,648,2645
This shredder will do. I couldn't find a wood chipper.,165,22,2,189,648,3121
"Bagel, waffle, toast - poem become a ghost!",155,15,5,175,648,3764
"Ladies and gentlemen, for my next act; please feast your eyes on Mueller’s disappearing surprise!",148,16,4,168,648,3791
"Remember Walter the Great, Tax Preparation.",153,21,2,176,648,74
"Just say the magic words, ""Abracadabra...""
Was this your contract?",153,21,2,176,648,2864
"Good-bye Ernie, we knew thee well!",149,16,4,169,648,601
"Once we disappear this last bit of evidence, Mrs. C, you will be absolves of all wrongdoing.""
""Thank you o Great Comey""",137,14,4,155,648,2431
Abracadabra I have I unshredded your message!,130,15,3,148,648,3706
This is my secret meeting note filing system. I use this wonderful long stick to divert everyone from reading the notes as it is filed.,123,16,2,141,648,3440
It’s as close as I can get to making hum disappear.,160,22,2,184,648,902
"This is my application rejection from Penn and Teller's show. Abracadabra, it never happened.",154,21,2,177,648,373
Watch!  My Magic Wand will make this list of my worst tricks disappear!,153,23,1,177,648,837
Personally I blame global warming,151,14,5,170,648,3522
"Ladies and Gentlemen,my lovely assistant Amber will be retiring after this show.We performed this trick together for the first time when she was just 6 years old""",143,17,3,163,648,1290
"Ladies and gentlemen,thin toast melba  at the wave of the wand",143,17,3,163,648,1913
"And for my next trick, I'll make all my old report cards disappear",142,19,2,163,648,2883
"Voila, and with a wave of my magical wand, 'Girl with a Balloon""' has been restored!""",135,20,1,156,648,1364
Cynics might be thinking ballot? political statement? metaphor? But it’s actually just a trick I learned on my international tour.,135,20,1,156,648,4210
dedderhs,129,19,1,149,648,3415
Behold as I unshred the bottom of this paper!”,132,14,3,149,648,3912
"I know you're thinking but this trick was not
inspired by Banksy",158,15,5,178,648,4001
"And before my spouse can see them, the credit card charges for pearl jewellery are magically...GONE!",150,18,3,171,648,309
Curse that pRESIDENT tRUMP! Now he'll never know my magic formula to make government work!,150,18,3,171,648,3044
"So sorry, my dear,
I see that tear,
But just as you fear,
Your end is near.",143,19,2,164,648,3371
"The pledge, the turn, and the prestige, leaving not a shred of evidence.",136,20,1,157,648,691
"Because I borrowed this wand from Harry Potter, I’m sure it will be fine.",138,16,3,157,648,2890
"Abracadabra, this will be shredded",157,19,3,179,648,2600
"You will see, I don't need the directions to put her back together again.",152,16,4,172,648,1258
"Abracadabra ladies and gentlemen, the bills disappear.",144,19,2,165,648,2529
Before your very eyes the shredini will turn this document into confetti.,138,18,2,158,648,3647
"And now, I will make Robert Mueller disappear.",133,15,3,151,648,2061
Um.. I don't this Banksy did it this way!,131,19,1,151,648,3275
"... And now, for my next trick, I will make this magic wand disappear, using only this jammed shredder!",133,15,3,151,648,3341
"And, with the twist of my wand, I'll reduce the wage gap from 30% to 29.95%.",164,20,3,187,648,3049
"Never hire the Great Accounto to do your taxes...
""I will now make your IRS audit DISAPPEAR!""",147,15,4,166,648,745
That time machine made Abe's magician dream come true.,128,16,1,145,648,1985
"Her visa vanishes - voilà! - and my lovely assistant, and her request for paid sick leave, disappear back to Croatia.",152,20,2,174,648,3698
For this trick the magic word isn't 'abracadabra'; it's 'arbadacarba'.,145,21,1,167,648,484
"If we can get this trick to work, it will be money in the bank, see?",149,13,5,167,648,586
Trump is raising money for re-election. Please destroy his letter.,150,11,6,167,648,3083
"If I just swish my wand like so and put the paper in the slot it disappears, fascinating",141,16,3,160,648,1671
"And for my next trick, watch as our divorce notice disappears.",140,18,2,160,648,2073
Now for the magic word. ra-ca-Ab-dab-ra!,159,21,2,182,648,2391
This will draw out those pesky ninja turtles.,136,14,3,153,648,508
. . . and voila!  [Not a rabbit!],133,19,1,153,648,3168
Hocus Pocus ... a cure for thrombosis,133,19,1,153,648,3697
"My fulltime job is a lawyer, watch me make this parking ticket go away with one swipe of my magic wand.",153,20,2,175,648,196
"Kazaam"", to shred and then to unshred later - redacting is so commo",154,19,2,175,648,2679
"Hocus pocus, Your transcript of my speech is hush-hush",146,21,1,168,648,2029
"And now, with the help of my lovely assistant and a few magic words, I will turn this sheet of paper into wonderful ribbons.",147,19,2,168,648,2671
CROSS CUT!,148,17,3,168,648,2775
'This next trick was inspired by the 2016 Clinton campaign',148,17,3,168,648,2935
"For my next trick, the CFO will throw-up lunch.",122,15,2,139,648,1842
I used to be a snowboarder.,156,16,4,176,648,1461
"And here, as I think out of the box..",155,18,3,176,648,2490
Bippity Boppity destroy the evidence!,168,20,3,191,648,1218
"This is what happens when you fuck a stranger in the ass, Larry.”",149,18,2,169,648,1471
I am shredding  your resignation; I want you to stay.,162,20,2,184,648,3389
Abracadeborah,158,14,5,177,648,1135
"NOW  YOU SEE IT , AND NOW YOU WON""T.",138,13,4,155,648,3683
Yonic to phallic to chance,168,23,1,192,648,1601
And Abracadabra your phone bill is toast,161,23,1,185,648,308
And now this man will perform my job for your applause.,131,14,3,148,648,1346
Good news Mr. Smith. After shredding your free parking pass I have reversed the process and your pass is as good as new. The bad news is that ten minutes ago your car was stolen from our parking facility.,129,18,1,148,648,3426
"C’mon, you said you wanted to try a little role-playing to spice up our daily life...",144,16,3,163,648,2882
The trail's end.,139,14,3,156,648,2488
Abracadabra!  I’m going to shred this...,136,19,1,156,648,2878
Farewell typos on the Chinese Water Torture Cell Escape notes I gave to my late partner.,139,13,4,156,648,3136
"Now you see the translation, now you don't.",135,21,0,156,648,3726
"For those who can’t wait til after breakfast, a toaster/fax for taxting.",152,15,4,171,648,973
"Your not the only one who can  shred, ""Barracuda.""",149,21,1,171,648,4154
Roll up! Roll up! Here for one night only - Banksy and Theresa May.,145,17,2,164,648,1359
"It´s weird, isn´t? But I have received instructions to always entertain the President at the same time that we fulfill his wishes.",144,18,2,164,648,2044
Instant charcoal. Clean energy!,158,18,3,179,648,1064
"Ah, but will you be able to read its contents afterward?!",157,20,2,179,648,1360
I can change anyones ballot vote but fortunately nobody would  ever believe you that it is possible,136,21,0,157,648,1485
I call this little trick The Iranian Hostage Crisis.,137,19,1,157,648,2528
NOW AS I PUT THIS INTO THE SHREDDER-WAMO!,139,16,2,157,648,3537
"Abracadabra...it has not necessarily disappeared, but most certainly has been shredded!",154,15,3,172,648,2675
"Abracadabra, attend as before your very eyes another 1099 doth liquify!",157,22,1,180,648,450
"These generously buttered noodles, sprinkled with just a quarter cup of parsley for color and freshness, are the perfect blank canvas for practically any stew or braise.",146,16,3,165,648,3378
"Remember last time, you became Cinderella and I became the ugly step-mother",146,16,3,165,648,3886
"Honey, what do you think about getting the kids a pet rabbit?",134,12,4,150,648,4139
I'm only up to Chapter 1 in the book. Do you think anyone can tell?,153,17,3,173,648,1126
"- Do not worry , I'll cut you only by four pieces. I've promised it at this paper agreement.",153,17,3,173,648,2842
Abracadabra and my assistant will piece it back together.,140,15,3,158,648,1220
"During the tattered Trump era, desperate Republicans were willing to try anything to win a vote.",140,15,3,158,648,1476
Abra-ca-d b a a r d b r a a b b a d d b b r r . . .,140,15,3,158,648,1855
"And now, Doreen's hand will pass through the machine and emerge intact, holding the shredded NDA.",147,16,3,166,648,1544
"Say the magic words: ""contract you lack, I lied - your fired!""",146,18,2,166,648,4167
"Sir, they're still no clapping...",132,18,1,151,648,3134
"I’m just going to check and see if it works, first.",167,19,3,189,648,175
A. Shred - B. Mix - C. Print ( What you should have said.),153,19,2,174,648,3919
He can make your mortgage disappear.,141,15,3,159,648,1136
"Another parking ticket Jaz, fetch the shredder.",139,19,1,159,648,1358
"Be prepared, you are next...",142,13,4,159,648,1643
"For my next trick, I'll print the directions as it's new to my repertoire.",134,16,2,152,648,872
OY VEy! The extraordinary winner is P.C. VEy,154,19,2,175,648,2721
I will now insert your Social Security card and out will come a blank piece of paper,141,17,2,160,648,2045
Abrakadabra!  This speech is toast.,156,17,3,176,648,2295
"And I’ll just put this authenticated, singed Lincoln letter in the shredder, like so...",142,17,2,161,648,2792
And presto!  Said 'unfair' contract disappears.,148,20,1,169,648,297
"Take care of yourself, debts makes me aphasic!",149,18,2,169,648,847
Voila!,148,20,1,169,648,2457
I will now shred this subpoena from my wife's divorce lawyer...,157,17,3,177,648,2595
Once this finally works we can stop shredding our tax returns.,136,16,2,154,648,164
"They know it’s all fake, so why bother to spend the time to actually perform?",137,14,3,154,648,887
And for my next trick - GDPR Compliance,136,16,2,154,648,1963
I really didn't anticipate my job getting taken by AI.,138,12,4,154,648,2731
"Ok, let us make a copy of my magic secrets",141,21,0,162,648,487
I know it's a shredder and this is my ballot! I'm voting for Mickey Mouse anyway.,142,19,1,162,648,1233
"Be amazed, as I make our divorce papers... disappear!",142,19,1,162,648,2025
"""And...you brought out an actual shredder.  Thanks, Nancy.  Good night everyone!""",172,18,3,193,648,805
Ta da! We are not having twins.,126,8,5,139,648,4194
Now close your eyes and make a wish.,151,16,3,170,648,1755
And now I'll produce my termination notice.,151,16,3,170,648,1916
And when I take it out Presto!  It will be a different color.,151,16,3,170,648,3616
". . . and with a wave of my wand, the Girl with Balloon is shredded.",158,17,3,178,648,671
Watch my bills disappear.,163,23,0,186,648,2773
And now I will make this Toast-It note disappear.,143,19,1,163,648,780
"I wave my magic wand, and TaDa, my wife's alimony check vanishes.",146,13,4,163,648,2042
"First the paper, then my assistant.",151,18,2,171,648,2041
"Abracadabra, this is my will,
wish this could be done without having to paying the bill!",160,16,3,179,648,2531
I am going to make this sold paper reappear in shreds,148,12,4,164,648,708
Abracadabra!  Now the most competent candidate will disappear!,145,17,2,164,648,2742
And now my debt will disappear.,152,18,2,172,648,4127
"Abracadabra … this self-restoring note confirms everything I promised.
Now, where is the rabbit ?",153,16,3,172,648,4146
"Now, I will create my next paper puzzle!",160,17,3,180,648,3480
Abracadabra. My will is toast.,167,18,3,188,648,2146
"I'm happy you're taking my thumbs, rather than cutting me in two.",132,15,2,149,648,3101
And now my lazy agent's contract will disappear!,139,17,1,157,648,2467
"The Great Miragini traded all his fancy flash for bigger cash, making evidence disappear at big corporate gigs.",147,15,3,165,648,1306
Instead of abracadabra I've been saying arbadacarba ....still cant reverse it,145,19,1,165,648,3770
"Now, watch me make the secret to my tricks disappear.",155,14,4,173,648,1039
"And for the tax magicians next trick, he will get you abraca-audited!",167,20,2,189,648,886
"Von Charles it’s a Jumbo stock certificate for Apple, you sure this time?",125,16,1,142,648,1962
Can you believe the fax still held up after all these years?,138,20,0,158,648,2139
Say goodbye to my first why sweetie.,146,19,1,166,648,178
This Is Trump’s Last Oval Office Speech And I am Shredding It!,147,17,2,166,648,953
Industrial strength... I arrived with a skirt.,146,19,1,166,648,1019
There goes another parking ticket magically away,145,21,0,166,648,2009
"You want it hotter, my Lord.",147,18,1,166,648,3266
Now watch as pull the pre-gavel Bansky out of my hat!,137,10,4,151,648,3075
And now... To make my contracts dissapear!,142,14,3,159,648,2823
"Markell West: """"Getting a divorce is too expensive, so I'll just shred our marriage license.""  Tom Potter: ""Watch closely as I un-shred a compromise between the Democrats and the Republicans.""",141,16,2,159,648,4098
"My next act is a hit except for politicians, who hate to see me finish.",149,17,1,167,648,600
My personal time off...,154,20,1,175,648,135
"Ok, just a thousand more to go, Donald Trump hates these circus speeches I wrote for him.",154,20,1,175,648,772
And by shredding this paper I can make my taxes disappear.,161,21,1,183,648,1954
"Liar, liar, pants on fire!  They will say that of me now that he took destroyed my hardcopy.",156,18,2,176,648,678
Then we have confetti!,149,17,2,168,648,1599
Abracadra,143,15,2,160,648,2094
And now for our last trick before the one-hour intermission,151,14,3,168,648,3944
And now for the disappearing magician whose hand is not faster than the eye candy.,156,18,2,176,648,3949
"Ladies and gentlemen, behold the tiniest little bits.",135,17,1,153,648,4032
Alakazam your job is gone!,129,14,2,145,648,4143
Like so - each and every one of you in my audience - drop your currencies into my little magic box...,161,12,5,178,648,789
"To prove that I'm leaving my wife, watch my marriage license disappear.",152,15,3,170,648,1122
"...and this is the only copy of my high school diploma. Now that all my plan B’s are gone, and my bridges are burned, I have no choice but to pursue my dream of becoming an erotic magician.",143,18,1,162,648,395
"Adding the shredder will produce a bigger, richer sound, with greater timbral variety.",143,18,1,162,648,551
...and a demographically accurate GPS activates the On-Off switch!,144,16,2,162,648,2355
"My Assistant's W2!
Fax or Scan or Copy or Shred...",144,16,2,162,648,3974
"Now kids, I may not be able to saw a woman in half, but this is even more spectacular when you think about it.",161,15,3,179,648,1969
"When I pass the magic wand, this incriminating document will disappear. Er, not disappear exactly, disintegrate into tiny pieces that the FBI can paste together if you are Michael Cohen.",143,20,0,163,648,420
A jury of  my peers would not convict me of making this jury summons disappear.,132,14,2,148,648,2066
The  Confett-O-Magicon was known to frighten small animals and children were warned away from it.,162,17,2,181,648,1005
Rely on your third eye.,161,18,2,181,648,1199
Hocus Pocus Shred a Docus! No mirrors required.,161,18,2,181,648,1806
Ten seconds to FUBAR fettuccine.,161,18,2,181,648,3880
and for my next trick I shall pay your taxes,146,18,1,165,648,875
"Easy on the vinegar, please!",184,21,2,207,648,52
"And now, my best recipe for toasted rabbit.",156,15,3,174,648,547
A sexual harassment policy never worked!,139,19,0,158,648,982
"Taking economic uncertainty by the horns, Tracy and Glenn combined skill sets.",141,15,2,158,648,1583
"Please, please, pa-leaseee Harold, do not put that in, you know it says Trump! For Chrissakes you’re a Magician.",140,17,1,158,648,2359
Now before I turn on the shredder,134,14,2,150,648,399
You make my brown eyes blue,157,15,3,175,648,585
"And PRESTO, it's gone! OR IS IT??? I will now produce a copy of the SAME DOCUMENT out of THIN AIR! (psst—get the fax machine!)",136,12,2,150,648,2521
Any minute now our divorce papers will disappear!,157,15,3,175,648,4133
"Do you ""Wanda"" see this disappear?",149,16,2,167,648,1206
Women's suffering you say? Yes I'll support that.,138,8,5,151,648,3112
"And now, I will make the manual to this magic trick — disappear.",148,20,0,168,648,228
"And now, my Magical Truth Trick!",149,18,1,168,648,2017
This trick would work better had I saved the ‘Baby Hands’ trick for last. When will I learn?!,167,14,4,185,648,3484
And for my final act: the disappearing playbill.,141,19,0,160,648,1042
Every magician's dream:  start by shredding the script.,136,14,2,152,648,3734
"Anetta, this will never work!",162,12,4,178,648,3130
And for the next trick:paper getting fried by a toaster”,161,13,4,178,648,3601
"Someday, I'm going to be old hat. A computer will be the one drawing the lucky winner.",139,10,4,153,648,2046
"For my next trick, I’m going to attempt to get Stormy Daniels to puke confetti into a hole in one.",137,14,2,153,648,3076
We are excited to introduce this new trick in replacement of,158,21,0,179,648,4142
"As the audience can see, this heavy duty shedder can render a piece of paper unrecognizable.  Next, I am going to place my assisstant's small right hand into the shredder and she will not feel a thing.",148,10,4,162,648,695
Abra-cadabra is clearly a dying art.,145,15,2,162,648,1782
"Abra-cadabra, abra-kazeem, abra-ca-muncho, get rid of the ream!",130,13,2,145,648,3938
"Sadly, magically changing VHS tape players into fax machines failed to win The Great Wondinni steady bookings.",140,13,1,154,648,662
And now we will learn who is going to Mars.,139,12,3,154,648,2338
and now performing the make-a - puzzle - for -fraudsters act! viola,160,19,1,180,648,1155
"The Amazing Waldo, Esq.",145,17,1,163,648,2150
Magical thinking will make this prenup disappear.,169,18,2,189,648,1986
This vibrating wand is just what you need.,163,15,3,181,648,3802
Abracadabra and your mortgage is gone,146,17,1,164,648,2786
"And abracadabra, your OSH complaint is gone.  Trust me Deborah,  the saw wont hurt you.",147,15,2,164,648,3813
"Sale or no sale, you did remember to avoid crosscut?",148,15,2,165,648,975
It's a Fawn Hall,125,12,2,139,648,2179
"I will shred this marriage certificate right
before your eyes!""",128,7,4,139,648,4080
"We just put the birth certificate in the magic box and....One! Two! Presto! My assistant has ceased to exist.""",141,16,0,157,648,740
"...and presto, your Honda has legally vanished for the next 26 working days. Longer if you don’t know a notary.",156,18,1,175,648,2279
"Abracadabra, and just like that I can make my pavement report - DISAPPEAR!",156,18,1,175,648,2388
"This is an indignity. 
I told you, we don’t spell and tell!",173,18,2,193,648,738
Watch as unreality TV scripts become a magical success fantasy!....Before our very eyes!,141,16,1,158,648,15
But what will happen to my thumbs?!,150,15,2,167,648,579
Abracadabra! I made paper appear out of this seemingly ordinary box.,150,15,2,167,648,2597
"And for my next trick, I will magically make a carrot disappear using only a  slight stainless steel apparatus.",152,13,3,168,648,2097
Ever heard of Shredded Wheat cereal?,158,18,1,177,648,3351
"abra kadabra.........ohh that is so cool.  
Do it again!",159,17,1,177,648,3366
And no2w...the next person to be toasted is...,144,14,2,160,648,2510
"Mr. Neville Shoeffenhoeffer, White House special guest-in-residence.",145,12,3,160,648,3631
"And now that my daring escape from prison is complete, we can start the show",151,17,1,169,648,1352
For my third trivk..,137,13,2,152,648,3610
My bonus price...,160,18,1,179,648,137
Everyone can be fooled once but one cannot be fooled every time,144,18,0,162,648,69
"I realize you don't think I have a career as a magician, Martha, but let me prove it to you by reappearing the receipt for this costume!",145,16,1,162,648,1665
This bread is toast -- it's magic!,170,19,1,190,648,1415
No mincing words about the Unshredder: she’s a magical ex-stripper.,147,14,2,163,648,3500
"Abracadabra . . . (uh-oh - Barbara, you got the strip-cutter, right?)",137,17,0,154,648,2184
"For my next trick I will destroy your passport so that you cannot leave the country and are forced to remain my assistant for the foreseeable future. Suck it, Magician's Union!",156,15,2,173,648,1681
"""In magic school, we learned to de-shred.
I think I've lost my touch.""",148,14,2,164,648,3772
This is how my ex-wife got everything by the alimony check to disappear.,172,19,1,192,648,660
"Peter the magician: “Now only I will know the secret to our new and extraordinary magic trick”
*seconds later *
Peter the magician: “OH NO, MARIAM! TURN IT OFF! I ALREADY FORGOT!!!!”",149,16,1,166,648,3705
For my next magic trick... Now is not the time to make a toast.,143,11,3,157,648,1097
"Magician assistants 101, first shred your belief in contracts",133,14,1,148,648,1175
That’s a prediction that will never come true....unfortunately!,166,18,1,185,648,1933
"It is our marriage license, my dear.  Shall I see if I can reconstitute it?",143,13,2,158,648,1637
"So many CPAs think THEY are the magician! Watch me put Nadine’s W-2s in here. In six weeks, she will have her refund!",153,12,3,168,648,1788
I thought I asked for the _beheader_ ...,135,14,1,150,648,3162
"Unlike Banksy, I can reverse the shredding! (...wait, can I?)",136,12,2,150,648,3850
"No, no — your union paperwork won’t go back together, but YOU will for sure.",152,16,1,169,648,3947
"During my next trick, a rabbit may get singed but won't get burned",162,15,2,179,648,3564
I am a magician and this is a shredder.,155,12,3,170,648,204
Focus your attention on the shredding machine as I say ‘Masicate Cadabra’  and the document will be unseen by FBI eyes forever.,153,16,1,170,648,3641
"For my next trick, The Disappearing Human, I'm going to need a pool of acid.",166,13,3,182,648,500
"I'M SORRY--I'M JUST NOT GOING T0 WORK-OVER MORE VOTING MACHINES"" !!",156,16,1,173,648,1568
"Before read it, let me heat the spiritual food first.",165,17,1,183,648,140
And now ladies and gentlemen: The Girl with Balloon !,158,14,2,174,648,3398
"And now, with the help from Deborah, I will demonstrate how my job is much more efficient in the 21st century! Alaka-shred!",131,13,1,145,648,4023
Abrah CRAPla - this thing never works when you need it to!,141,12,2,155,648,467
"Abra-ka-dabra: Your problem is solved! But, oh, Arbad-ak-arba: It's baaaaaaaaaack!",123,12,1,136,648,2301
All vows shall be considered no vows.  All promises shall be considered no promises.,160,13,2,175,648,3528
Behold: Girl with Balloon.,168,15,2,185,648,521
"She loves me, she loves me not.",176,18,1,195,648,18
"And, if you need it back to rat out the Don, viola!",140,16,0,156,648,1347
Fnvdnnwnfnwofinweoifn,161,13,2,176,648,139
Abracadabra! You'll olove my Toaster Boondoggle!,159,18,0,177,648,1981
"Sir, don't put my pants in the shredder..it's chilly in here.",153,13,2,168,648,176
"Yes, but the manual states it can only shred TEN pieces of paper at a time!",153,13,2,168,648,1865
"See, Miss, here's the first love poem you ever wrote - to my dearest Lizzie! My, my...",160,18,0,178,648,1072
"I always told myself not to make New Year's resolutions while I'm still drunk. At any rate, shredding these is music to my ears.",162,15,1,178,648,3020
Don't look or I'll bean you!,153,15,1,169,648,2324
"Now,Susan, tell the audience if you see your document getting shredded. Then I’ll wave my magic wand.",145,14,1,160,648,718
I am shredding all the instructions for the terrible tricks I will attempt on my assistant.,155,13,2,170,648,2002
"My assistant, Ms. Buffy will now manipulate me for sexual favors.",174,15,2,191,648,62
Ahh... the final ballot...we'll get the vote tally with a wave of my special Congressional-approved 'Wand of Wonks' in no time!,166,12,3,181,648,1975
"For my next trick, I will turn the shreds of my assistant's late father's will into a handkerchief.",155,15,1,171,648,2907
"For my next trick, I’ll make my last-year’s tax return disappear. And... voilà!",129,11,1,141,648,40
"Thank you,Wanda.",157,13,2,172,648,1227
Is this for a paying audience?,147,14,1,162,648,3194
"That cannot be ! ! ! 
Self Assessment Tax Form don’t shred, ladies and gentlemen.",157,15,1,173,648,117
"...and now, feats of magic by The Great Spoliatio!",157,15,1,173,648,2609
Of course it is not ice - it is frozen.,158,13,2,173,648,3328
I have another exact copy we'll show them later.,149,12,2,163,648,985
"Wingardium Leviosa.""

""I don't think that's what it means.",139,13,1,153,648,1301
You can be damn sure the Russians aren't going to get their,148,16,0,164,648,2814
This is my latest trick,162,12,2,176,648,207
"And now, in Magical Businessman, let's make disappear some",162,13,2,177,648,1763
"Next time, we'll  just go for the model with a reverse switch...",144,13,1,158,648,233
"Toasted shred?!  Excellent, my dear.",145,12,1,158,648,3846
BEST WAY TO GEY RID OF THOSE DARN CREDIT CARD STATEMENT,146,13,1,160,648,1153
Next at the Georgia state fair we have a pie eating contest..,146,13,1,160,648,2871
"If Uncle Sam really wants it he can go in and get it himself.
It's O.K. I've worked for the federal government before...
Obviously sending the bill back to them isn't really an option!
I could recycle it but I'm voting for the other person!",155,16,0,171,648,1211
Betch can't play Lady of Spain on that thing.,156,14,1,171,648,1708
I hope that's not my debloma,146,15,0,161,648,3545
"And now, all documentation will be online with glitz for the next new things and omissions of the endlessly deprecated.",157,14,1,172,648,3077
"Just like magic, a  deed to a property!",147,15,0,162,648,1380
I will know shred my book on how to make things disappear.,158,14,1,173,648,66
The magic is...it,149,13,1,163,648,3496
I've found it cheaper to shred paper than paying for c-section repairs on my assistant,159,14,1,174,648,3053
I'm sure I can mend your contract with 'hocus pocus!',140,14,0,154,648,1164
"What is this? Is it a printer or a fax machine or a black box? Or is it like your dress, skimpy and short?",150,15,0,165,648,2334
Watch as the Amazing Joel makes a utility bill...disappear!,151,13,1,165,648,2744
"Real magic comes while improvising; after all, this script is so overrated!",141,14,0,155,648,2887
Better hope it's not rabbit stew.,143,14,0,157,648,2325
"Alakazam!
Don’t you know who I am?
Presto Chango!
This won’t my career anymore.
Hocus Pocus!
I suggest you change your mind, miss.  
Bibbidy Bobbidy Boo!
Nevertheless, no one is going to believe you.",137,7,3,147,648,2397
WHAT TIME IS YOUR LAST PICKUP“  ? !!,147,10,2,159,648,3720
"When his disappears,Trump's Twitter finger will be frozen.",187,18,0,205,648,497
I told my boss that the new contact terms were not acceptable!,147,14,0,161,648,2635
"First I touch the magic button with my wand to make the paper disappear, then abracadabra, I pull a red paper herring out of my hat!",160,14,0,174,648,2794
"Lets just put your vote through the shredder, what are woman's rights.""       -Every Man Before 192",154,11,1,166,648,3479
The audience doesn't know the shredder is just the act's MacGuffin.,143,13,0,156,648,49
The joke’s on you. I knew all along that you were using avtoaster.,154,14,0,168,648,943
We need to change brands.,156,12,1,169,648,3334
"fuck you it isn't magic. whered you learn how to do magic. hogwarts? show me your degree from hogwarts motherfucker.

yeah, that's what i thought. grab last year's folder and shut the hell up.",161,4,5,170,648,1444
"Abracadabra, no more counting, start shredding.",155,13,0,168,648,1240
You may need to lose a little bit of weight first Sylvia.,146,12,0,158,648,3571
ABBRA KADABRA!,162,7,3,172,648,1598
It's easier to hide your magic secrets when they're conveniently in a list!,162,9,2,173,648,1628
I'll take the paper but this isn't a printing show!,157,12,0,169,648,3054
...ab...ba.... no...abra! Ka...dab...,157,11,0,168,648,1801
It's okay. I'll use the tape holding my boobs up to put it back together.,157,11,0,168,648,2410
"Ryan McElveen, that ballot says your name only if there's no school tomorrow.",143,10,0,153,648,2036
"Magic more suck up those tears.""  

Hilary Kingsbury, Harrisville, N.H",168,11,0,179,648,3220
The Maninist Community has taken away your right to not be objectified any further- I'm sure you understand that this is the natural order of things.,173,7,2,182,648,2416
"Damn you woman, did you at least get a baby sitter""",177,11,0,188,648,2344
Banksy is going to sent my kids to college!,134,8,0,142,648,2926
"For a mere $50 you are  receiving
a letter of adoration, admiration
and advocacy...What a bargain !",135,8,0,143,648,2608
"I know what you’re thinking... this is a magic wand. I call it Mr Pritt!

Martin Greenough
Sheffield, UK",158,7,0,165,648,3979
