target_id,rank,funny,somewhat_funny,unfunny,count,score,precision,contest,caption
3160,1,19,22,22,63,1.9523809523809523,0.10227462059426916,508,Can YOU remember what you had for dinner 3 days ago?
3911,2,14,13,22,49,1.836734693877551,0.12145286443100087,508,"Yeah, maybe I did. Like I said, I eat a lot of people."
6344,3,13,11,21,45,1.8222222222222222,0.12827089740112443,508,"So then this guy said, 'Hey, you want a piece of me?'"
2119,4,10,15,18,43,1.813953488372093,0.12116001680272737,508,Do YOU remember what you had for lunch last Thursday?
3380,5,10,14,18,42,1.8095238095238095,0.12399699913052034,508,I’m not good with faces. You got a shot of the legs?
864,6,11,10,19,40,1.8,0.1349263806863884,508,I'm in the catch and release program
6064,7,8,18,17,43,1.7906976744186047,0.11313581022733663,508,I'm not sure. What does the other leg look like?
867,8,6,19,15,40,1.775,0.11028808429953589,508,No I don't know the face. Got a picture of his legs?
5997,9,10,10,19,39,1.7692307692307692,0.1347839700097043,508,It was a feeding frenzy--who remembers faces?
3507,10,8,7,15,30,1.7666666666666666,0.1567143483321807,508,Would you wave it around a bit?
3190,11,7,15,16,38,1.763157894736842,0.12182940832000048,508,Go ahead waterboard me
4285,12,5,14,14,33,1.7272727272727273,0.12517205789286595,508,The leg looks familiar but I'm terrible with faces.
3488,13,7,9,16,32,1.71875,0.14364477214474647,508,"Sure, I remember him. He tasted like chicken."
3082,14,7,8,16,31,1.7096774193548387,0.14805947938114844,508,A little closer please.
4448,14,5,12,14,31,1.7096774193548387,0.13274236010332013,508,I eat guys like you for breakfast.
1847,16,5,11,14,30,1.7,0.13687816547538925,508,"If I'd eaten that, I'd remember."
942,17,7,8,17,32,1.6875,0.14506325094314393,508,"Last time I heard, he was in the can."
1710,18,6,7,15,28,1.6785714285714286,0.15476190476190477,508,I can't sign that.
1752,19,6,8,16,30,1.6666666666666667,0.14647845813401372,508,"That could be me, but like I said, Shark Week is all kind of a big blur."
3368,19,5,10,15,30,1.6666666666666667,0.13840913308956662,508,Can we make this quick? I gotta keep moving.
5251,19,6,8,16,30,1.6666666666666667,0.14647845813401372,508,Do you have a picture of him wearing a diving helmet?
4573,22,7,5,17,29,1.6551724137931034,0.15909118484684867,508,"I can't read that, move a little closer."
5098,23,5,8,15,28,1.6428571428571428,0.14741409223021198,508,It's not my fault! He was in my home and wearing a mask.
1099,24,3,11,13,27,1.6296296296296295,0.13234837207221575,508,Can't say that I've seen the face. Got a picture of the feet?
2346,25,4,8,14,26,1.6153846153846154,0.14756404687116062,508,"I'm not sure, they all taste like chicken."
327,25,2,12,12,26,1.6153846153846154,0.12498520622516866,508,I'm not talking until I get some water.
6601,25,4,8,14,26,1.6153846153846154,0.14756404687116062,508,You're making me wish I hadn't eaten my lawyer.
4808,25,3,10,13,26,1.6153846153846154,0.13674145257408601,508,I remember him. I found him distasteful.
6002,25,4,8,14,26,1.6153846153846154,0.14756404687116062,508,"In my effort to find locally sourced food, I made an error in judgment."
559,25,4,8,14,26,1.6153846153846154,0.14756404687116062,508,"Look, I already told you. I was trying to free the human trapped in the cage."
2598,25,2,12,12,26,1.6153846153846154,0.12498520622516866,508,Could you guys waterboard me again?
4437,25,2,12,12,26,1.6153846153846154,0.12498520622516866,508,You can't hold me. That guy was in international waters.
96,25,4,8,14,26,1.6153846153846154,0.14756404687116062,508,"Well technically officer, everything I do is in cold blood."
2281,25,3,10,13,26,1.6153846153846154,0.13674145257408601,508,It was in international waters
6684,25,4,8,14,26,1.6153846153846154,0.14756404687116062,508,Hold that just a tad closer.
4999,25,3,10,13,26,1.6153846153846154,0.13674145257408601,508,"Yeah, I was at the frenzy, but I did not bite."
3797,37,5,4,14,23,1.608695652173913,0.17489839438606788,508,I'm not talking till you water board me.
1914,38,1,13,11,25,1.6,0.11547005383792516,508,Of course it was cold-blooded ! I'm a shark!
2094,38,3,9,13,25,1.6,0.1414213562373095,508,Of course my alibi smells fishy.
1273,38,3,9,13,25,1.6,0.1414213562373095,508,It was a feeding frenzy. Things happen.
1469,38,3,9,13,25,1.6,0.1414213562373095,508,I never met a man I didn't like.
1522,38,4,7,14,25,1.6,0.15275252316519466,508,Show me the one of her feet again.
4523,38,4,7,14,25,1.6,0.15275252316519466,508,I never had nobody canned.
3386,38,5,5,15,25,1.6,0.16329931618554522,508,"Yeah, maybe it's him, who knows---can you guys identify every damn donut you ever ate?"
5802,45,4,6,14,24,1.5833333333333333,0.15830472663009768,508,I got caught up in the frenzy.
4414,45,5,4,15,24,1.5833333333333333,0.16936225931188761,508,So what's the charge? 'Ordering off the menu?'
5215,45,3,8,13,24,1.5833333333333333,0.14641447355925183,508,Just got a leg. Never saw the face.
3343,48,3,6,12,21,1.5714285714285714,0.16288220358559116,508,"If it'd been me, there wouldn't be anything left to photograph."
5061,49,4,5,14,23,1.565217391304348,0.16425766604885492,508,"I'm not sure, move it a little closer?"
1118,49,4,5,14,23,1.565217391304348,0.16425766604885492,508,"Yeah, I recognize him. Tasted like chicken."
2109,49,3,7,13,23,1.565217391304348,0.15174983257274677,508,Tell me he doesn't look just like a seal.
6237,49,4,5,14,23,1.565217391304348,0.16425766604885492,508,I made him a loan he couldn't refuse.
1355,49,3,7,13,23,1.565217391304348,0.15174983257274677,508,I've never seen that leg in my life.
2960,49,2,9,12,23,1.565217391304348,0.1381138751751474,508,"If the bite don't fit, you must acquit"
549,49,3,7,13,23,1.565217391304348,0.15174983257274677,508,"Look fellas, I'm just a link in the food chain."
4441,56,4,3,13,20,1.55,0.1846048411294272,508,"Yeah, that's him. That's the guy that jumped me."
1290,56,4,3,13,20,1.55,0.1846048411294272,508,"Closer. I'm nearsighted. Real, real nearsighted."
14,58,2,8,12,22,1.5454545454545454,0.14305378044898964,508,You got nothing on me...that's just a red herring.
1349,58,2,8,12,22,1.5454545454545454,0.14305378044898964,508,That's the guy who accused me? He doesn't have a leg to stand on!
345,58,2,8,12,22,1.5454545454545454,0.14305378044898964,508,I'll bite. Who is he?
6208,58,2,8,12,22,1.5454545454545454,0.14305378044898964,508,I'm bad with faces but I never forget a leg.
5890,58,4,4,14,22,1.5454545454545454,0.17065284280889198,508,"Yeah, I took her out for a bite but never heard from her again."
1689,58,4,4,14,22,1.5454545454545454,0.17065284280889198,508,I don't know from faces; you got any pictures of their legs?
3250,58,3,6,13,22,1.5454545454545454,0.15745916432444337,508,When my attorney gets here he is going to eat you guys alive.
946,58,2,8,12,22,1.5454545454545454,0.14305378044898964,508,They all look delicious.
5313,58,3,6,13,22,1.5454545454545454,0.15745916432444337,508,How am I supposed to remember what I had for lunch two days ago?
6578,58,4,4,14,22,1.5454545454545454,0.17065284280889198,508,We didn't swim in the same circles.
4597,58,2,8,12,22,1.5454545454545454,0.14305378044898964,508,I tell ya I don't eat surfers. I'm latex intolerant.
603,58,4,4,14,22,1.5454545454545454,0.17065284280889198,508,"Like I told you before, I only saw her legs."
1650,58,3,6,13,22,1.5454545454545454,0.15745916432444337,508,Catch and release. Are you kidding?
290,58,3,6,13,22,1.5454545454545454,0.15745916432444337,508,"Bait me all ya want, but I ain't bite'n"
293,58,3,6,13,22,1.5454545454545454,0.15745916432444337,508,I know when I'm being baited.
5231,58,3,6,13,22,1.5454545454545454,0.15745916432444337,508,That's a face. I don't know faces. I'm a leg guy.
4384,58,2,8,12,22,1.5454545454545454,0.14305378044898964,508,"That's it, a severed arm? You got nothin'."
1983,75,4,2,13,19,1.5263157894736843,0.19298245614035087,508,I can't quite make out those teeth marks. Bring it in a little closer... little bit closer...
5221,76,4,3,14,21,1.5238095238095237,0.17753668459340238,508,"Statistically speaking, it's far more likely he was struck by lightning."
2631,76,3,5,13,21,1.5238095238095237,0.1635768003554064,508,"Yes, I ate the sheriff but I did not eat the deputy!"
5857,76,2,7,12,21,1.5238095238095237,0.1483086809752137,508,Can I have that glass of water now?
6470,76,3,5,13,21,1.5238095238095237,0.1635768003554064,508,"In my defense, he was wearing an ill-fitting speedo."
2255,76,4,3,14,21,1.5238095238095237,0.17753668459340238,508,That's the one who jumped me.
4729,76,2,7,12,21,1.5238095238095237,0.1483086809752137,508,"Then he says, 'Bite me!' What was I supposed to do?"
6063,76,4,3,14,21,1.5238095238095237,0.17753668459340238,508,Those pictures of me from “Shark Week” were edited!
6031,76,2,7,12,21,1.5238095238095237,0.1483086809752137,508,"Once again ... show me feet, not faces."
6062,76,2,7,12,21,1.5238095238095237,0.1483086809752137,508,Know him?? He was delicious!
807,76,4,3,14,21,1.5238095238095237,0.17753668459340238,508,What made me do it? 450 million years of evolution made me do it.
2425,76,1,9,11,21,1.5238095238095237,0.13127665478181166,508,"Yeah, we swim in the same circles."
5207,76,2,7,12,21,1.5238095238095237,0.1483086809752137,508,"OK, so I did some time in the tank. So what?"
857,76,3,5,13,21,1.5238095238095237,0.1635768003554064,508,Don't you have bigger fish to fry?!
408,76,2,7,12,21,1.5238095238095237,0.1483086809752137,508,Since when is eating a crime?
3213,76,3,5,13,21,1.5238095238095237,0.1635768003554064,508,Dental records don't lie!
607,76,4,3,14,21,1.5238095238095237,0.17753668459340238,508,"I keep telling ya, officer, I haven't seen Katy Perry in a year."
3012,76,1,9,11,21,1.5238095238095237,0.13127665478181166,508,"Ok, now you're just fishing."
5782,76,5,1,15,21,1.5238095238095237,0.1904761904761905,508,I was nowhere near the sequels.
247,76,4,3,14,21,1.5238095238095237,0.17753668459340238,508,When's the water-boarding going to start?
5570,76,3,5,13,21,1.5238095238095237,0.1635768003554064,508,I'm not good with faces. Do you maybe have a blood sample?
1952,76,2,7,12,21,1.5238095238095237,0.1483086809752137,508,"Hey, 'In cold blood' is the only way I do ANYTHING."
2200,97,2,6,12,20,1.5,0.15389675281277312,508,Don't grill me.
6483,97,2,5,11,18,1.5,0.16666666666666666,508,Are you familiar with the term 'catch and release'?
200,97,1,7,10,18,1.5,0.14574577203253436,508,I knew this would come back to bite me.
1133,97,1,7,10,18,1.5,0.14574577203253436,508,The legs look familiar but I can't place the face.
961,97,3,4,13,20,1.5,0.17013926184468015,508,"You know, I never see you guys pull in any white sharks..."
1178,97,4,1,13,18,1.5,0.20211302086361083,508,Hey... Being my chum was his idea.
914,97,1,7,10,18,1.5,0.14574577203253436,508,I'm not signing anything.'
4009,97,2,5,11,18,1.5,0.16666666666666666,508,"You say blood-bath, I say brunch."
5385,97,1,8,11,20,1.5,0.13572417850765922,508,"Hmm, I can't quite tell. Can you come a little closer?"
6214,97,1,7,10,18,1.5,0.14574577203253436,508,Can YOU remember every little thing you ate two days ago?
4276,97,3,3,12,18,1.5,0.1852396434087371,508,"I told ya, if you want someone to squeal, talk to a dolphin."
261,97,2,5,11,18,1.5,0.16666666666666666,508,Yeah I remember him. My cholesterol went up 6 points.
4015,97,3,3,12,18,1.5,0.1852396434087371,508,Grill me all you want I'm tough!
1145,97,3,3,12,18,1.5,0.1852396434087371,508,Can I please just get a tank of water.
2073,97,1,8,11,20,1.5,0.13572417850765922,508,"Afternoon snack, last Tuesday."
3724,97,2,5,11,18,1.5,0.16666666666666666,508,How can I tell? You all look alike to me!
6108,97,2,6,12,20,1.5,0.15389675281277312,508,Hold it a little closer.
3916,97,1,8,11,20,1.5,0.13572417850765922,508,How should I know? You all look alike.
2537,97,2,5,11,18,1.5,0.16666666666666666,508,"I swear, I've never seen that pair of legs before in my life."
6632,97,3,4,13,20,1.5,0.17013926184468015,508,That's the work of a Great White. I'm actually pretty unremarkable.
2534,97,1,8,11,20,1.5,0.13572417850765922,508,The leg is familiar.
6187,97,1,7,10,18,1.5,0.14574577203253436,508,"Well, do you remember what you had for breakfast 3 months ago?"
2128,97,3,4,13,20,1.5,0.17013926184468015,508,"Yeah, I know that guy. Tastes like chicken."
2571,97,3,3,12,18,1.5,0.1852396434087371,508,You're fishing and you know it.
2204,97,4,1,13,18,1.5,0.20211302086361083,508,Why does my alibi sound fishy?
5686,97,3,3,12,18,1.5,0.1852396434087371,508,That's not me. I'm strictly vegetarian.
3046,97,2,6,12,20,1.5,0.15389675281277312,508,I dunno. You humans all look the same to me.
5474,97,1,8,11,20,1.5,0.13572417850765922,508,"Oh no, I guess you'll have to waterboard me."
4669,97,1,8,11,20,1.5,0.13572417850765922,508,That's the last time I post a lunch pic on social media.
2616,97,4,1,13,18,1.5,0.20211302086361083,508,"It's like I told you, officer. I didn't see his face. He was wearing a mask."
4911,97,2,5,11,18,1.5,0.16666666666666666,508,Let's forget this interrogation nonsense and get on with the waterboarding.
4848,97,3,3,12,18,1.5,0.1852396434087371,508,"I want to see a lawyer. Oh wait, I am a lawyer."
3212,97,1,7,10,18,1.5,0.14574577203253436,508,Wasn’t me! I’m a leg man.
6170,97,3,4,13,20,1.5,0.17013926184468015,508,"Officer, I swear he was a seal."
853,97,3,3,12,18,1.5,0.1852396434087371,508,Can I at least get a glass of saltwater?
1414,97,2,5,11,18,1.5,0.16666666666666666,508,That could be anybody's foot.
459,97,1,7,10,18,1.5,0.14574577203253436,508,"What are you gonna do, throw me in the tank?"
6525,97,2,5,11,18,1.5,0.16666666666666666,508,"You know, all I ever see are legs."
6398,97,2,5,11,18,1.5,0.16666666666666666,508,"I prefer to think of him not so much as my victim, but as a victim of global climate change."
6399,97,1,7,10,18,1.5,0.14574577203253436,508,That clearly isn't my work. Ask anyone at the Discovery Channel.
469,97,2,5,11,18,1.5,0.16666666666666666,508,Someone gets bit and right away you blame a shark.
4112,97,1,7,10,18,1.5,0.14574577203253436,508,Don't you guys have bigger fish to fry?
706,97,2,5,11,18,1.5,0.16666666666666666,508,"It was a feeding frenzy, so why am I being singled out?"
74,97,2,5,11,18,1.5,0.16666666666666666,508,"Statistically speaking, it's more likely she was struck by lightning."
2967,97,3,3,12,18,1.5,0.1852396434087371,508,"Yeah, that's the guy, he was delicious."
494,97,1,7,10,18,1.5,0.14574577203253436,508,"I've never seen that surfer before, but he looks delicious."
5584,97,1,7,10,18,1.5,0.14574577203253436,508,I'm really more of a leg guy.
1562,97,2,6,12,20,1.5,0.15389675281277312,508,Looks like a boating accident to me.
3503,97,2,5,11,18,1.5,0.16666666666666666,508,"Excuse me, but I was told I would be auditioning for Shark Tank."
3502,97,1,8,11,20,1.5,0.13572417850765922,508,Can you show me the lower half again?
6446,97,2,4,10,16,1.5,0.18257418583505536,508,"OK, I chewed up the sheriff, but I did not eat the deputy."
6455,97,1,7,10,18,1.5,0.14574577203253436,508,I ain’t saying squat until he stops humming the theme from Jaws.
2763,97,2,5,11,18,1.5,0.16666666666666666,508,Don't know the face but the leg looks familiar.
2386,97,1,7,10,18,1.5,0.14574577203253436,508,I'm gonna need to see a swimsuit shot.
5327,97,2,5,11,18,1.5,0.16666666666666666,508,You're wasting you're time–I'm not going to take the bait.
6756,97,2,5,11,18,1.5,0.16666666666666666,508,I eat guys like you for lunch!
2438,97,2,5,11,18,1.5,0.16666666666666666,508,"First, Sherlock, that surveillance photo is a hammerhead."
612,97,2,6,12,20,1.5,0.15389675281277312,508,"I've seen him around, but we swim in different circles."
604,97,2,6,12,20,1.5,0.15389675281277312,508,"Like I said, I felt threatened."
1728,97,1,7,10,18,1.5,0.14574577203253436,508,What you've got there is a red herring.
5871,97,3,4,13,20,1.5,0.17013926184468015,508,Why ask me? I'm just his lawyer.
2295,97,4,2,14,20,1.5,0.18496087779795348,508,"I was home, in the ocean, alone."
101,97,3,3,12,18,1.5,0.1852396434087371,508,You know it's more likely that a hippo did it.
5464,97,2,6,12,20,1.5,0.15389675281277312,508,"Yes, I'd use the word chum to describe him."
1881,97,2,6,12,20,1.5,0.15389675281277312,508,That could be anyone's dorsal fin.
4021,97,3,3,12,18,1.5,0.1852396434087371,508,Rectangle!
2276,97,2,5,11,18,1.5,0.16666666666666666,508,That wasn't me. I'm a leg man!
1892,97,3,4,13,20,1.5,0.17013926184468015,508,Never seen him. What's he smell like?
2265,97,2,5,11,18,1.5,0.16666666666666666,508,"You've got nothing on me, you're just fishing."
1894,97,1,7,10,18,1.5,0.14574577203253436,508,Why do you always haul ME in every time someone's leg goes missing?
1440,97,1,7,10,18,1.5,0.14574577203253436,508,All I can tell you is he tasted like chicken.
3014,97,1,8,11,20,1.5,0.13572417850765922,508,I suppose now you plan to grill me.
1426,97,3,3,12,18,1.5,0.1852396434087371,508,Maybe he disagreed with something that ate him.
6725,170,2,5,12,19,1.4736842105263157,0.15983216805516315,508,Fine. Waterboard me.
1090,171,2,4,11,17,1.4705882352941178,0.1740023465617534,508,How come you guys never bring in the great white shark for questioning?
2100,171,1,6,10,17,1.4705882352941178,0.15140632560275,508,Next you'll tell me I'm cold blooded.
6464,171,4,0,13,17,1.4705882352941178,0.21209125149788172,508,"The Jets did that, not us."
1015,171,1,6,10,17,1.4705882352941178,0.15140632560275,508,"OK, Ok I ate your toupee"
1555,171,1,6,10,17,1.4705882352941178,0.15140632560275,508,"It was international waters, you've got nothing!"
4030,171,1,6,10,17,1.4705882352941178,0.15140632560275,508,It looks like him. At least the foot does.
63,171,1,6,10,17,1.4705882352941178,0.15140632560275,508,Ok I'm guilty of never quite evolving!
651,171,2,4,11,17,1.4705882352941178,0.1740023465617534,508,"Laws of nature, gentlemen, laws of nature."
3219,171,1,6,10,17,1.4705882352941178,0.15140632560275,508,"Yeh, that's him! I'll never forget that peg-leg."
2002,171,2,4,11,17,1.4705882352941178,0.1740023465617534,508,If you want me to co-operate I'm really going to have to insist on that water.
1049,171,1,6,10,17,1.4705882352941178,0.15140632560275,508,"'I don't recognize the face, but the arm looks familiar'."
6587,171,1,6,10,17,1.4705882352941178,0.15140632560275,508,Haven't you bigger fish to fry?
4982,171,1,6,10,17,1.4705882352941178,0.15140632560275,508,"Last I heard, he was in witness protection at Sea World."
3504,171,2,4,11,17,1.4705882352941178,0.1740023465617534,508,I don't think this is what the chief meant when he told us to grill him.
1399,171,2,4,11,17,1.4705882352941178,0.1740023465617534,508,I didn't get a good look at him. Everyone was in such a frenzy.
5941,171,1,6,10,17,1.4705882352941178,0.15140632560275,508,I'll be my own attorney.
313,171,3,2,12,17,1.4705882352941178,0.19398391115107233,508,Listen...what happens in a feeding frenzy stays in a feeding frenzy.
2121,171,1,6,10,17,1.4705882352941178,0.15140632560275,508,You're just fishin' now.
3850,171,1,6,10,17,1.4705882352941178,0.15140632560275,508,How do you expect me to remember what I had for dinner last week?
3104,171,2,4,11,17,1.4705882352941178,0.1740023465617534,508,"Last I saw him, he was sleeping with the fishes."
2564,171,1,6,10,17,1.4705882352941178,0.15140632560275,508,That guy left a bad taste in my mouth.
2712,171,3,2,12,17,1.4705882352941178,0.19398391115107233,508,"I've answered all of your questions, and now I'm getting kinda hungry. I want a lawyer."
5426,171,3,2,12,17,1.4705882352941178,0.19398391115107233,508,My bite is larger
1940,171,0,8,9,17,1.4705882352941178,0.12478354962115544,508,I dunno. Looks like my work. Can I go now?
2653,171,2,4,11,17,1.4705882352941178,0.1740023465617534,508,Never seen the lady. I'd remember those legs.
2239,171,1,6,10,17,1.4705882352941178,0.15140632560275,508,Can you remember every piece of fish YOU ever ate?
3052,171,2,4,11,17,1.4705882352941178,0.1740023465617534,508,I can't even tell the difference between a surfer and a seal and you want me to make a positive I.D.?
771,171,1,6,10,17,1.4705882352941178,0.15140632560275,508,I want a lawyer! And some clarified butter.
263,171,2,4,11,17,1.4705882352941178,0.1740023465617534,508,You must be kidding. They freed Willy?
3408,171,2,4,11,17,1.4705882352941178,0.1740023465617534,508,"Sure I forged the deed, my house was under water."
4579,171,2,4,11,17,1.4705882352941178,0.1740023465617534,508,I would have noticed those legs.
2850,171,1,6,10,17,1.4705882352941178,0.15140632560275,508,"He'd come around when there was blood in the water, but then again who didn't?"
6768,171,1,6,10,17,1.4705882352941178,0.15140632560275,508,"Just remember, I never sleep."
1155,171,2,4,11,17,1.4705882352941178,0.1740023465617534,508,"Okay, I'm a cold blooded killer"
6454,171,1,6,10,17,1.4705882352941178,0.15140632560275,508,I'm still digesting that one.
4785,171,1,6,10,17,1.4705882352941178,0.15140632560275,508,I can only tell you what he tasted like.
2059,171,2,4,11,17,1.4705882352941178,0.1740023465617534,508,"The ocean? . . . .Yeah, I been there."
2395,171,3,2,12,17,1.4705882352941178,0.19398391115107233,508,That's legal in international waters.
723,171,2,4,11,17,1.4705882352941178,0.1740023465617534,508,I have the right to remain a silent killer.
1296,171,1,6,10,17,1.4705882352941178,0.15140632560275,508,"Yeah, that's the guy whose surf board ran into me."
4157,171,1,6,10,17,1.4705882352941178,0.15140632560275,508,All you mammals look the same to me.
4244,212,1,5,9,15,1.4666666666666666,0.1652319197418807,508,Hmmmm I'm not sure. Do you have one where he's screaming?
4290,212,1,5,9,15,1.4666666666666666,0.1652319197418807,508,Can I get a cup of water?
5788,212,1,5,9,15,1.4666666666666666,0.1652319197418807,508,It was just a love bite.
1569,212,0,7,8,15,1.4666666666666666,0.13333333333333336,508,Define 'eat'.
6537,212,2,3,10,15,1.4666666666666666,0.1918994445677132,508,That could be anybody's fin. I haven't frenzied in years.
2371,217,2,4,12,18,1.4444444444444444,0.1661211114658671,508,How am I supposed to remember what I had for breakfast a month ago?
3816,218,0,7,9,16,1.4375,0.128086884574495,508,I ain't bitin.'
414,218,0,7,9,16,1.4375,0.128086884574495,508,Can you just bring it a little closer?
628,218,2,3,11,16,1.4375,0.1818596070232933,508,"You can't touch me, cop. I'm an endangered species."
6457,218,2,3,11,16,1.4375,0.1818596070232933,508,Couldn't tell ya... I joined mid frenzy.
5220,218,2,3,11,16,1.4375,0.1818596070232933,508,Couldn't say. You got a picture of his legs?
2411,218,2,3,11,16,1.4375,0.1818596070232933,508,"Look, I know it's hard to believe, but not all sharks know each other."
1110,218,1,5,10,16,1.4375,0.15728821740147395,508,That's the one that got away.
2268,218,2,3,11,16,1.4375,0.1818596070232933,508,Nope. Doesn't look like anyone I've eaten lately.
2918,218,3,1,12,16,1.4375,0.20348525745124632,508,I haven't fully digested what happened out there.
5332,218,1,5,10,16,1.4375,0.15728821740147395,508,You're fishing and I'm not biting.
2439,218,2,3,11,16,1.4375,0.1818596070232933,508,"Yes, those are the surfers who attacked me."
849,218,1,5,10,16,1.4375,0.15728821740147395,508,I want immunity. And a bucket of fish guts.
5338,218,0,7,9,16,1.4375,0.128086884574495,508,Would you bring it a little closer?
5620,218,1,5,10,16,1.4375,0.15728821740147395,508,You know there's more than one way to grill a fish.
6319,218,1,5,10,16,1.4375,0.15728821740147395,508,"Can we move on to the waterboarding, already?"
642,218,2,3,11,16,1.4375,0.1818596070232933,508,I was in school that night.
4064,218,2,3,11,16,1.4375,0.1818596070232933,508,"Actually, Detective, I CAN'T see what's 'right in front of me'. Move it to the side."
2995,218,2,3,11,16,1.4375,0.1818596070232933,508,They should have had a bigger boat.
6307,218,1,5,10,16,1.4375,0.15728821740147395,508,I don't remember faces.
4779,218,1,5,10,16,1.4375,0.15728821740147395,508,"Never seen him before, but he looks delicious."
4781,218,0,7,9,16,1.4375,0.128086884574495,508,It's hard to tell. Do you have any pictures of her underwater?
929,218,2,3,11,16,1.4375,0.1818596070232933,508,"I don't need a lawyer, I am a lawyer."
794,218,1,5,10,16,1.4375,0.15728821740147395,508,"C'mon, I can't remember who I had for dinner last night!!"
465,218,2,3,11,16,1.4375,0.1818596070232933,508,Go fish.
2211,218,1,5,10,16,1.4375,0.15728821740147395,508,Do I look like a lawyer to you pal?
3962,218,1,5,10,16,1.4375,0.15728821740147395,508,"I might be a shark, but I ain't no rat."
3957,218,2,3,11,16,1.4375,0.1818596070232933,508,Of course I remember him. He was delicious.
6533,218,2,3,11,16,1.4375,0.1818596070232933,508,"I'll save you some time, Detective - they all look delicious."
860,218,1,5,10,16,1.4375,0.15728821740147395,508,"I swear, I've never seen that leg before."
956,218,1,5,10,16,1.4375,0.15728821740147395,508,I'm not taking the bait.
4143,218,2,3,11,16,1.4375,0.1818596070232933,508,That guy I ate was already dead.
4115,218,1,5,10,16,1.4375,0.15728821740147395,508,Nobody told me it was catch and release.
2908,218,0,7,9,16,1.4375,0.128086884574495,508,It's not first-degree if you're hungry.
2966,218,0,7,9,16,1.4375,0.128086884574495,508,I bet you can't remember where you ate lunch last week either.
2359,218,1,5,10,16,1.4375,0.15728821740147395,508,Can I get some water?
5365,218,2,3,11,16,1.4375,0.1818596070232933,508,Don't recognize him. But I only saw half of him.
4048,218,1,5,10,16,1.4375,0.15728821740147395,508,I don't recognize the face. Show me the legs.
1037,218,2,3,11,16,1.4375,0.1818596070232933,508,"Hey, this is dorsal profiling."
5582,218,2,3,11,16,1.4375,0.1818596070232933,508,I think you're species profiling.
502,218,2,3,11,16,1.4375,0.1818596070232933,508,That could be any fin.
4863,218,2,3,11,16,1.4375,0.1818596070232933,508,Let's skip the preliminaries and get straight to the water boarding.
3880,218,2,3,11,16,1.4375,0.1818596070232933,508,"Honestly officers, most of Shark Week was a blur for me."
656,218,2,3,11,16,1.4375,0.1818596070232933,508,You might say he took a swim with the fishes.
6445,218,2,3,11,16,1.4375,0.1818596070232933,508,"Yeah, I knew him; a real unsavory character."
2116,218,2,3,11,16,1.4375,0.1818596070232933,508,I'm tired of you guys reeling me in here every time something fishy happens.
6599,218,2,3,11,16,1.4375,0.1818596070232933,508,"It's clearly posted, 'swim at your own risk.'"
2969,218,1,5,10,16,1.4375,0.15728821740147395,508,Am I the only one who feels like we're swimming in circles?
3886,218,0,7,9,16,1.4375,0.128086884574495,508,Sure I know him; we were in the same school.
6484,218,2,3,11,16,1.4375,0.1818596070232933,508,I prefer predatory lender.
135,218,0,7,9,16,1.4375,0.128086884574495,508,"I remember him,we were in a school together"
3299,218,1,5,10,16,1.4375,0.15728821740147395,508,I've never tasted...I mean seen that guy before in my life.
4608,218,1,5,10,16,1.4375,0.15728821740147395,508,I dunno. You humans all look alike to me.
3576,218,1,5,10,16,1.4375,0.15728821740147395,508,Yeah. That's the guy who said 'We're gonna need a bigger boat.'
3229,218,2,3,11,16,1.4375,0.1818596070232933,508,Let’s wait for my client to arrive.
1487,218,1,5,10,16,1.4375,0.15728821740147395,508,"OK, the face, I don't know, the legs, maybe."
5987,218,0,7,9,16,1.4375,0.128086884574495,508,What can I say? They needed a bigger boat.
1530,218,2,3,11,16,1.4375,0.1818596070232933,508,Jailbait!
3526,218,1,5,10,16,1.4375,0.15728821740147395,508,Yeah- that guy looks like a seal too!
211,218,2,3,11,16,1.4375,0.1818596070232933,508,"I can't be sure it's him, I eat with my eyes closed."
1246,218,2,3,11,16,1.4375,0.1818596070232933,508,He needed a bigger boat.
6154,218,1,5,10,16,1.4375,0.15728821740147395,508,"Sorry, they all look the same from below."
5824,218,1,5,10,16,1.4375,0.15728821740147395,508,You can't pin it on me. There was a frenzy going on.
219,218,2,3,11,16,1.4375,0.1818596070232933,508,"I didn't lend him anything, I swear!"
56,218,1,5,10,16,1.4375,0.15728821740147395,508,Is it my fault she thought it was safe to get back in the water?
1791,218,2,3,11,16,1.4375,0.1818596070232933,508,I've never eaten that person in my life
3593,218,2,3,11,16,1.4375,0.1818596070232933,508,You call that evidence? When my lawyer gets here he'll eat you alive.
48,218,1,5,10,16,1.4375,0.15728821740147395,508,That tip? It's a red herring.
5005,218,0,7,9,16,1.4375,0.128086884574495,508,"It was such a frenzy at dinner, I don't know who ate him."
4583,218,2,3,11,16,1.4375,0.1818596070232933,508,That's the guy who tried to jump me.
1931,218,2,3,11,16,1.4375,0.1818596070232933,508,Do you remember everyone you ever ate?
5764,218,1,5,10,16,1.4375,0.15728821740147395,508,"Even if I did make that loan, I wouldn't charge an arm AND a leg!"
6672,218,1,5,10,16,1.4375,0.15728821740147395,508,"For the umpteenth time, can I please have some water?"
4438,218,2,3,11,16,1.4375,0.1818596070232933,508,I don't tell tales out of school.
1906,218,1,5,10,16,1.4375,0.15728821740147395,508,"I want a lawyer. Wait, I am a lawyer."
6087,218,2,3,11,16,1.4375,0.1818596070232933,508,You've got the wrong guy. My ID clearly says LONE shark.
1342,218,1,5,10,16,1.4375,0.15728821740147395,508,That is a standard interest rate.
134,218,1,5,10,16,1.4375,0.15728821740147395,508,"OK, I’ll confess. Just stop airboarding me."
2671,218,2,3,11,16,1.4375,0.1818596070232933,508,"Yes, that's him. Now can I please get some water?"
1329,218,1,5,10,16,1.4375,0.15728821740147395,508,Closer. A little closer...
4990,218,3,1,12,16,1.4375,0.20348525745124632,508,Thrash it around a little.
1902,218,0,7,9,16,1.4375,0.128086884574495,508,Of course I'm cold blooded. What's your point?
1320,218,2,3,11,16,1.4375,0.1818596070232933,508,"Like, do you remember what you had for dinner last night?"
1435,218,2,3,11,16,1.4375,0.1818596070232933,508,Could you waterboard me again? I have the right to remain saline.
1438,218,2,3,11,16,1.4375,0.1818596070232933,508,"Yeah, I remember her – she was all legs."
5790,218,2,3,11,16,1.4375,0.1818596070232933,508,Do I look like the kind of shark that goes to the Hamptons?
224,218,2,3,11,16,1.4375,0.1818596070232933,508,That could be anyone's fin.
1926,218,2,3,11,16,1.4375,0.1818596070232933,508,I'll confess. Just put me anywhere but Seaworld.
1656,218,0,7,9,16,1.4375,0.128086884574495,508,It was consensual.
1649,218,1,5,10,16,1.4375,0.15728821740147395,508,Surfer? Seal? Who can tell?
5115,218,1,5,10,16,1.4375,0.15728821740147395,508,"Alright, I'll do it......but I'm not wearing a tag......"
2609,218,2,3,11,16,1.4375,0.1818596070232933,508,Since when is it a crime to be a lone shark?
6181,218,0,7,9,16,1.4375,0.128086884574495,508,How was I supposed to know it was endangered.
5073,218,2,3,11,16,1.4375,0.1818596070232933,508,"Nope, not him. My guy had two legs."
34,218,0,7,9,16,1.4375,0.128086884574495,508,Very funny. Show me the legs.
3491,218,1,5,10,16,1.4375,0.15728821740147395,508,"Yeah, that's him. And that's the last time I go undercover at the aquarium."
3451,218,3,1,12,16,1.4375,0.20348525745124632,508,"How can it be illegal? Your slogan is, 'Take a bite out of crime.'"
2599,218,1,5,10,16,1.4375,0.15728821740147395,508,"I don't care if you send me back to the tank, I'm not taking the bait."
4378,218,1,5,10,16,1.4375,0.15728821740147395,508,Nice legs .
5093,218,2,3,11,16,1.4375,0.1818596070232933,508,"I swear, Officer, he had both legs last time I saw him."
5716,218,2,3,11,16,1.4375,0.1818596070232933,508,Sharks don't squeal
2825,318,2,2,10,14,1.4285714285714286,0.20203050891044214,508,That can't be him. The guy I saw looked TERRIFIED.
377,318,2,2,10,14,1.4285714285714286,0.20203050891044214,508,"I'm telling you, I have never seen that leg before in my life."
5319,318,1,4,9,14,1.4285714285714286,0.1727058642362825,508,I stand on the fish amendment.
6109,321,3,2,14,19,1.4210526315789473,0.17631360738808577,508,"No, that's not me. You're just on a fishing expedition."
6362,322,1,5,11,17,1.411764705882353,0.14997116216449366,508,You can't handle the tooth!
2785,322,1,5,11,17,1.411764705882353,0.14997116216449366,508,You want me to I.D. a face? Show me some legs or arms.
1897,324,0,6,9,15,1.4,0.13093073414159545,508,You wouldn't even have brought me in if I was a great white.
3656,324,2,2,11,15,1.4,0.1902379462422684,508,My alibi is water tight. I was working on shark week for Discovery Channel.
4430,324,1,4,10,15,1.4,0.16329931618554522,508,Every time a surfer goes missing you guys drag me in here.
4538,324,0,6,9,15,1.4,0.13093073414159545,508,"Hey, that was no chum of mine!"
6359,324,1,4,10,15,1.4,0.16329931618554522,508,Faces mean nothing to me. I just see thrashing legs.
6690,324,1,4,10,15,1.4,0.16329931618554522,508,When did eating become a crime?
6535,324,1,4,10,15,1.4,0.16329931618554522,508,"You do realize I'm a shark, right?"
1742,324,1,4,10,15,1.4,0.16329931618554522,508,"Looks like him, but it's hard to tell without all the snorkeling gear."
401,324,1,4,10,15,1.4,0.16329931618554522,508,"Ok, I'll bite, who's that?"
2784,324,1,4,10,15,1.4,0.16329931618554522,508,So? A guy's gotta eat.
4529,324,2,2,11,15,1.4,0.1902379462422684,508,"No thanks, I'm full."
4467,324,1,4,10,15,1.4,0.16329931618554522,508,"Curved fin, fat tail, phony smile...THAT is a dolphin!"
4995,324,2,2,11,15,1.4,0.1902379462422684,508,"``That's the way it goes; he owed me money, he didn't make the payments, so I ate him."
5555,324,1,4,10,15,1.4,0.16329931618554522,508,That's her. I'd know those legs anywhere.
858,324,0,6,9,15,1.4,0.13093073414159545,508,"For the last time, I have poor vision and and shape recognition. Don't you guys watch PBS?"
2503,324,1,4,10,15,1.4,0.16329931618554522,508,That's a loan shark.....I've told you a hundred times I'm a lone shark
2664,324,2,2,11,15,1.4,0.1902379462422684,508,"It looks like him, but he was wearing a blue snorkel."
3637,324,1,4,10,15,1.4,0.16329931618554522,508,May I please have a tank of water?
4277,324,1,4,10,15,1.4,0.16329931618554522,508,Since when has eating people been a crime?
6616,324,1,4,10,15,1.4,0.16329931618554522,508,"I'll be representing myself, of course."
5427,324,2,2,11,15,1.4,0.1902379462422684,508,He was missing that appendage when I met him.
2403,324,0,6,9,15,1.4,0.13093073414159545,508,It was a bait and switch!!
5104,324,1,4,10,15,1.4,0.16329931618554522,508,Being able to taste him would help me make an identification>
4162,324,0,6,9,15,1.4,0.13093073414159545,508,Do I look like a predator?
3013,324,1,4,10,15,1.4,0.16329931618554522,508,Go ahead! Say it! We all look the same to you!
3287,324,2,2,11,15,1.4,0.1902379462422684,508,Those fingerprints aren't mine!
5873,324,2,2,11,15,1.4,0.1902379462422684,508,You could get 20 years in the tank for this
4018,324,0,6,9,15,1.4,0.13093073414159545,508,I was in the Pacific Ocean that day.
598,324,1,4,10,15,1.4,0.16329931618554522,508,It's a great white lie!
3647,324,0,6,9,15,1.4,0.13093073414159545,508,Since when did having dinner become a crime?
5897,324,2,2,11,15,1.4,0.1902379462422684,508,"I keep telling you, l'm a JET!"
5415,324,1,4,10,15,1.4,0.16329931618554522,508,Gill-ty!
514,324,1,4,10,15,1.4,0.16329931618554522,508,Save that good carp/bad carp routine. I'm not saying anything until I talk to my lawyer.
2925,324,2,2,11,15,1.4,0.1902379462422684,508,I'm not talking without my client present.
2710,324,0,6,9,15,1.4,0.13093073414159545,508,"Yeah, I knew him. He was my chum."
690,324,1,4,10,15,1.4,0.16329931618554522,508,So bite me.
689,324,1,4,10,15,1.4,0.16329931618554522,508,"Yeah, that's the guy. I knew he looked fishy."
4690,324,2,2,11,15,1.4,0.1902379462422684,508,I was in the Pacific that day.
5923,324,0,6,9,15,1.4,0.13093073414159545,508,"I've already told you, all your legs look the same to me."
5042,324,2,2,11,15,1.4,0.1902379462422684,508,I'll take the fish amendment.
5845,324,1,4,10,15,1.4,0.16329931618554522,508,"I will never talk, you will have to water-board me!"
495,324,2,2,11,15,1.4,0.1902379462422684,508,I tell ya there was something fishy about that guy.
2351,324,2,2,11,15,1.4,0.1902379462422684,508,I've never seen those legs before in my life!
4553,324,2,2,11,15,1.4,0.1902379462422684,508,"Yeah, I know Spielberg. So what?"
528,324,0,6,9,15,1.4,0.13093073414159545,508,Do you have any pictures of her legs?
6440,324,0,6,9,15,1.4,0.13093073414159545,508,"As you can see, I didn't have a hand in this."
5321,324,2,2,11,15,1.4,0.1902379462422684,508,I may be a fish out'a water but I'm no rat
6507,324,1,4,10,15,1.4,0.16329931618554522,508,I see he's missing a leg. What's that got to do with me?
6453,324,0,6,9,15,1.4,0.13093073414159545,508,"Yeah that's him, before I collected what he owed me"
6452,324,1,4,10,15,1.4,0.16329931618554522,508,I've been working deep undercover.
5349,324,1,4,10,15,1.4,0.16329931618554522,508,You caught me.
520,324,0,6,9,15,1.4,0.13093073414159545,508,"Yeah, I recognize him. He sleeps with the fishes."
2728,324,2,2,11,15,1.4,0.1902379462422684,508,"No, the guy had a bigger boat."
4204,324,1,4,10,15,1.4,0.16329931618554522,508,I can't even remember who I had for dinner last night.
3330,324,2,2,11,15,1.4,0.1902379462422684,508,Can we go back to water boarding?
5592,324,1,4,10,15,1.4,0.16329931618554522,508,I don't even know what a loan shark is.
4773,324,1,4,10,15,1.4,0.16329931618554522,508,It figures Moby would go spouting off
2453,324,1,4,10,15,1.4,0.16329931618554522,508,Goddamn dental records!
4074,324,2,2,11,15,1.4,0.1902379462422684,508,I ain’t sayin’ nothin’ unless you waterboard me.
4075,324,1,4,10,15,1.4,0.16329931618554522,508,"That's the guy officer. I'm swimming by, minding my own business, and he punches me in the nose!"
5533,324,1,4,10,15,1.4,0.16329931618554522,508,Why should I call a lawyer? I AM a lawyer.
6389,324,1,4,10,15,1.4,0.16329931618554522,508,"Like I told you, I didn't know she was the Little Mermaid."
3588,324,0,6,9,15,1.4,0.13093073414159545,508,"If you think I'm a shark, wait till my lawyer gets here."
458,324,2,2,11,15,1.4,0.1902379462422684,508,I'm not a dolphin. I can't read.
2970,324,2,2,11,15,1.4,0.1902379462422684,508,Making a couple of loans doesn't make me a killer.
4526,324,0,6,9,15,1.4,0.13093073414159545,508,"That guy?! Oh yeah, I remember him. Talk about heartburn!"
1859,324,1,4,10,15,1.4,0.16329931618554522,508,"Yeah, I seen him. He's swimmin' with the fishes."
6757,324,2,2,11,15,1.4,0.1902379462422684,508,"You and I both know Maritime Law doesn’t apply here, so what’s this really about?"
2977,324,1,4,10,15,1.4,0.16329931618554522,508,I'd need a taste to be sure.
6724,324,1,4,10,15,1.4,0.16329931618554522,508,"Where I'm from, it's not a crime to be a predator."
1501,324,0,6,9,15,1.4,0.13093073414159545,508,How would I know? You all look the same to me.
4107,324,0,6,9,15,1.4,0.13093073414159545,508,You realize this is turning into a fishing expedition.
4114,324,1,4,10,15,1.4,0.16329931618554522,508,"Those aren't my bite marks, and this is just a fishing expedition."
2253,324,1,4,10,15,1.4,0.16329931618554522,508,"What is this? Good carp, bad carp?"
4085,324,2,2,11,15,1.4,0.1902379462422684,508,And what makes you think I should know everybody that works on Wall Street?
2343,324,0,6,9,15,1.4,0.13093073414159545,508,Come on. Tell me you've got something more than a dorsal fin.
4634,324,1,4,10,15,1.4,0.16329931618554522,508,How should I know? My eyes were closed!
6677,324,1,4,10,15,1.4,0.16329931618554522,508,"Wait, is this because I'm a shark?"
4923,324,1,4,10,15,1.4,0.16329931618554522,508,"Buddy, that's a hammerhead. Do we all look the same to you?"
2007,324,0,6,9,15,1.4,0.13093073414159545,508,"Oh, so you think all sharks know each other?"
4656,324,1,4,10,15,1.4,0.16329931618554522,508,Not my work. I identify as dolphin.
210,324,2,2,11,15,1.4,0.1902379462422684,508,I demand to be waterboarded
209,324,0,6,9,15,1.4,0.13093073414159545,508,I've never seen that delicious but overly salty person before.
3898,324,0,6,9,15,1.4,0.13093073414159545,508,I eat people like you for lunch.
1041,324,1,4,10,15,1.4,0.16329931618554522,508,"Unless you guys are the Coast Guard, you got no jurisdiction!"
6645,324,1,4,10,15,1.4,0.16329931618554522,508,"Maybe I do, maybe I don't. I see a lot of legs."
1040,324,1,4,10,15,1.4,0.16329931618554522,508,All I remember is the indigestion.
4920,324,1,4,10,15,1.4,0.16329931618554522,508,"Yes, I'm sure that is the little girl who attacked me in shallow water!"
4974,324,2,2,11,15,1.4,0.1902379462422684,508,"As a matter of fact, he did taste like chicken"
333,324,0,6,9,15,1.4,0.13093073414159545,508,Is that all you've got? That could be ANYBODY's dorsal fin.
5736,324,1,4,10,15,1.4,0.16329931618554522,508,"Yeah, I seen him before. He was my chum."
6135,324,2,2,11,15,1.4,0.1902379462422684,508,But he jumped me first.
338,324,1,4,10,15,1.4,0.16329931618554522,508,"Navy SEAL, harbor seal, they're all seals to me, pal."
6131,324,1,4,10,15,1.4,0.16329931618554522,508,Are you saying we all look alike?
340,324,1,4,10,15,1.4,0.16329931618554522,508,I'm not answering any questions without my Ichthyologist present.
6269,324,1,4,10,15,1.4,0.16329931618554522,508,"Technically, we all sleep with the fishes."
6657,324,0,6,9,15,1.4,0.13093073414159545,508,I don't know. We were all in a frenzy!
6271,324,2,2,11,15,1.4,0.1902379462422684,508,"I'd say more a chum, than an aquintance."
6649,324,3,0,12,15,1.4,0.2138089935299395,508,How do you know that surfer wasn't already missing his left leg before we reportedly met?
1067,324,1,4,10,15,1.4,0.16329931618554522,508,"Yeah, I recognize him...I believe his name was Lunch."
2123,324,1,4,10,15,1.4,0.16329931618554522,508,Which one of you is the 'good cop'?
1074,324,1,4,10,15,1.4,0.16329931618554522,508,Yea that's him.. now can I get some water?
2601,324,1,4,10,15,1.4,0.16329931618554522,508,"I keep telling ya, all tuna look alike to me"
271,324,0,6,9,15,1.4,0.13093073414159545,508,I'm not identifying anyone until I get some water.
272,324,2,2,11,15,1.4,0.1902379462422684,508,"I'm telling you, I don't know anyone named Quint!"
5492,324,2,2,11,15,1.4,0.1902379462422684,508,"You know, officer, dragging me in here every time a limb goes missing is considered racial profiling."
3835,324,0,6,9,15,1.4,0.13093073414159545,508,"If it's not scratch and sniff, I really can't tell you."
6179,324,2,2,11,15,1.4,0.1902379462422684,508,Never saw him before – I'm a lone shark.
5688,324,1,4,10,15,1.4,0.16329931618554522,508,Never seen those legs in my life
1177,324,0,6,9,15,1.4,0.13093073414159545,508,Face doesn't ring a bell. Got a picture of the legs?
4636,324,0,6,9,15,1.4,0.13093073414159545,508,He looks like someone I ate.
286,324,1,4,10,15,1.4,0.16329931618554522,508,I'm not talking until you waterboard me.
1108,324,0,6,9,15,1.4,0.13093073414159545,508,I'm not that cold-blooded.
4885,324,1,4,10,15,1.4,0.16329931618554522,508,"Seal, sea lion, surfer...they all look the same to me."
4370,324,2,2,11,15,1.4,0.1902379462422684,508,You think I'M a shark. Wait until my lawyer gets here.
1183,324,1,4,10,15,1.4,0.16329931618554522,508,"Like I told you, I've never even been to Amity."
1186,324,1,4,10,15,1.4,0.16329931618554522,508,"Since I met that guy, he doesn't have a leg to stand on!"
2110,324,2,2,11,15,1.4,0.1902379462422684,508,You two don't understand. I want you to put me back in the tank!
228,324,0,6,9,15,1.4,0.13093073414159545,508,"Last week? I dunno, maybe- I can't even remember who I had for breakfast this morning."
5500,324,1,4,10,15,1.4,0.16329931618554522,508,"Look, how was I supposed to know he was a beloved subject of a children's animated film and thus protected by international copyright?"
2036,324,0,6,9,15,1.4,0.13093073414159545,508,I can’t tell. Can you move your hand just a liiiiiiitle bit closer?
3779,324,2,2,11,15,1.4,0.1902379462422684,508,No. I've never eaten this man in my life.
6163,324,0,6,9,15,1.4,0.13093073414159545,508,"Please, not another Rorshark Test."
3237,324,0,6,9,15,1.4,0.13093073414159545,508,I demand to go back to the tank!
3065,324,1,4,10,15,1.4,0.16329931618554522,508,I agree.....this whole thing feels fishy.
3901,324,2,2,11,15,1.4,0.1902379462422684,508,He should've had a bigger boat.
167,324,2,2,11,15,1.4,0.1902379462422684,508,Can I meet my client now?!
6316,324,2,2,11,15,1.4,0.1902379462422684,508,"Yeah, that's me alright. Damn GoPro's."
5377,324,1,4,10,15,1.4,0.16329931618554522,508,I recognize a bait and switch when I see one.
4826,324,1,4,10,15,1.4,0.16329931618554522,508,Don't know him. I was a lone shark.
5638,324,2,2,11,15,1.4,0.1902379462422684,508,"I'll talk, but I need to be in the holding tank."
3054,324,1,4,10,15,1.4,0.16329931618554522,508,"It looks like a seal. I told you, everything looks like a seal."
3053,324,0,6,9,15,1.4,0.13093073414159545,508,"I told you already, I was just pulling his leg."
5761,324,1,4,10,15,1.4,0.16329931618554522,508,"No offense, but you all look the same to me."
361,324,2,2,11,15,1.4,0.1902379462422684,508,I've never seen that leg before in my life.
1313,324,0,6,9,15,1.4,0.13093073414159545,508,I never saw that leg before in my life!
2536,324,1,4,10,15,1.4,0.16329931618554522,508,Maybe if you held you fingers under there and wiggled them like legs.
3698,324,0,6,9,15,1.4,0.13093073414159545,508,All scuba divers look the same to me.
2225,324,2,2,11,15,1.4,0.1902379462422684,508,"By any chance, does good cop/bad cop refer to taste?"
2560,324,1,4,10,15,1.4,0.16329931618554522,508,I've had enough of this fishing expedition!'
1322,324,2,2,11,15,1.4,0.1902379462422684,508,All people look the same to me!
3707,324,1,4,10,15,1.4,0.16329931618554522,508,"If I tell you anything, they'll break every cartilage in my body."
6670,324,2,2,11,15,1.4,0.1902379462422684,508,If I say 'I don't know' will you waterboard me again?
2221,324,1,4,10,15,1.4,0.16329931618554522,508,"I don't know, people all look the same to me."
4003,324,2,2,11,15,1.4,0.1902379462422684,508,I can't comment without consulting my client.
4427,324,1,4,10,15,1.4,0.16329931618554522,508,I knew she was jail bait!
6284,324,2,2,11,15,1.4,0.1902379462422684,508,"Yeah, we served time together in the tank, so what?"
5745,324,1,4,10,15,1.4,0.16329931618554522,508,"So, you find the guy in the picture with his head and upper torso bit off a little after I deliver a candygram to his place and right away it's 'The shark did it!'"
969,324,2,2,11,15,1.4,0.1902379462422684,508,"Spielberg. Yeah,that's the guy."
5124,473,2,3,13,18,1.3888888888888888,0.16447358865570744,508,Show me the other leg.
3365,474,1,3,9,13,1.3846153846153846,0.18040060614705497,508,You're just trying to bait me.
2643,474,1,3,9,13,1.3846153846153846,0.18040060614705497,508,"No I haven't seen that arm, I'm strictly a leg man."
4742,474,1,3,9,13,1.3846153846153846,0.18040060614705497,508,"Detective, are you trying to shock me or make me hungry?"
5391,477,1,4,11,16,1.375,0.15478479684172258,508,He looks as good as he tasted.
796,477,2,2,12,16,1.375,0.17969882210706523,508,You say feeding frenzy; I say lunch.
2931,477,1,4,11,16,1.375,0.15478479684172258,508,"Alright, alright, you've caught me."
4132,477,2,2,12,16,1.375,0.17969882210706523,508,Why do you guys always assume I don't want a lawyer?
4167,477,1,4,11,16,1.375,0.15478479684172258,508,"No, I told you, I'm a JET."
4139,482,0,4,7,11,1.3636363636363635,0.1521200048243774,508,"I told you, my eyes were closed!"
5718,483,2,1,11,14,1.3571428571428572,0.19909528496696088,508,' That's NOT my bite pattern!!
5684,483,2,1,11,14,1.3571428571428572,0.19909528496696088,508,I need to see my client.
6450,483,1,3,10,14,1.3571428571428572,0.1692628769313117,508,Admit it ... you hate the Hamptons too.
5218,483,1,3,10,14,1.3571428571428572,0.1692628769313117,508,Wouldn't you also attack a man who entered your home wearing nothing but a speedo?
2113,483,2,1,11,14,1.3571428571428572,0.19909528496696088,508,"It couldn't have been me, I'm a vegetarian!"
1154,483,1,3,10,14,1.3571428571428572,0.1692628769313117,508,Don't you have any bigger fish to fry!?
4140,483,0,5,9,14,1.3571428571428572,0.13289435848843764,508,"Sure, I'd eat him, too. What's this all about, officer?"
3492,483,1,3,10,14,1.3571428571428572,0.1692628769313117,508,You got it wrong--I'm a lone shark! A lone shark!
3366,483,1,3,10,14,1.3571428571428572,0.1692628769313117,508,You people think we all look the same!
1085,483,0,5,9,14,1.3571428571428572,0.13289435848843764,508,Hey - she SAID she wanted to lose fifteen pounds.
3355,483,0,5,9,14,1.3571428571428572,0.13289435848843764,508,"Yeah I had her for dinner, but let's contextualize it, OK?"
3994,483,2,1,11,14,1.3571428571428572,0.19909528496696088,508,"E,F,P,T,O,Z,L,P,E,D...the rest are blurry."
1616,483,0,5,9,14,1.3571428571428572,0.13289435848843764,508,"She had two legs when I last saw her, I swear!"
1168,483,1,3,10,14,1.3571428571428572,0.1692628769313117,508,Can I get a glass of water?
5711,483,2,1,11,14,1.3571428571428572,0.19909528496696088,508,He never said his name was Charlie. Just looked like another tuna to me.
6314,483,1,3,10,14,1.3571428571428572,0.1692628769313117,508,I ate him too.
3833,483,1,3,10,14,1.3571428571428572,0.1692628769313117,508,"Hey, all your legs look alike to me"
3037,483,1,3,10,14,1.3571428571428572,0.1692628769313117,508,The court-appointed attorney — can I have that to go?
5079,483,2,1,11,14,1.3571428571428572,0.19909528496696088,508,"I'm a fish, not a rat."
3174,483,1,3,10,14,1.3571428571428572,0.1692628769313117,508,"I ain't a rat, detective."
633,483,1,3,10,14,1.3571428571428572,0.1692628769313117,508,We are swimming in circles here.
876,483,0,5,9,14,1.3571428571428572,0.13289435848843764,508,That could be anyone's severed leg!
5922,483,1,3,10,14,1.3571428571428572,0.1692628769313117,508,"I'm not taking the bait, he's no chum of mine"
2394,483,2,1,11,14,1.3571428571428572,0.19909528496696088,508,I'll have the tuna salad.
4000,483,1,3,10,14,1.3571428571428572,0.1692628769313117,508,I'm telling you that's not my handwriting.
6088,483,2,1,11,14,1.3571428571428572,0.19909528496696088,508,Let's wait for my client.
2047,483,1,3,10,14,1.3571428571428572,0.1692628769313117,508,Do I need a lawyer? I AM a lawyer.
1192,483,1,3,10,14,1.3571428571428572,0.1692628769313117,508,"You've got the wrong guy, I'm not a loan shark."
5224,483,1,3,10,14,1.3571428571428572,0.1692628769313117,508,"Yeah, I'd seen the guy floating around. You might say he was my chum."
4012,483,0,5,9,14,1.3571428571428572,0.13289435848843764,508,I know I'm cold-blooded.
5567,483,0,5,9,14,1.3571428571428572,0.13289435848843764,508,"Yea, okay, that's Louie, the loan shark."
2181,483,0,5,9,14,1.3571428571428572,0.13289435848843764,508,"I signed up for Shark Tank, not CSI!"
1959,483,1,3,10,14,1.3571428571428572,0.1692628769313117,508,Yes officer. That's the guy that jumped me.
3543,483,2,1,11,14,1.3571428571428572,0.19909528496696088,508,That could be any school of fish.
1023,483,1,3,10,14,1.3571428571428572,0.1692628769313117,508,You act like I'm some kind of cold blooded killer.
3323,483,1,3,10,14,1.3571428571428572,0.1692628769313117,508,Hey that's Mackie! I didn't know he was back in town
5137,483,1,3,10,14,1.3571428571428572,0.1692628769313117,508,"Yeah, I ate him. Nice work 'Sherlock'"
797,483,1,3,10,14,1.3571428571428572,0.1692628769313117,508,"Yeah, I know Robert Shaw.' So what?"
1256,483,1,3,10,14,1.3571428571428572,0.1692628769313117,508,Gimme a break....he was already dead when I ate him.
5000,483,0,5,9,14,1.3571428571428572,0.13289435848843764,508,"All I know is, I saw a one-armed man leaving the scene!"
5598,483,0,5,9,14,1.3571428571428572,0.13289435848843764,508,"Nope, I've only seen his legs."
3566,483,2,1,11,14,1.3571428571428572,0.19909528496696088,508,"Good cop, bad cop. You both look delicious."
5309,483,0,5,9,14,1.3571428571428572,0.13289435848843764,508,"That's not my signature on the loan agreement. In fact, I can't even write."
3297,483,2,1,11,14,1.3571428571428572,0.19909528496696088,508,That line-up was a joke. Me and five barracudas.
4841,483,2,1,11,14,1.3571428571428572,0.19909528496696088,508,"Yes, that's the guy. Can I get back in the water now?"
3084,483,1,3,10,14,1.3571428571428572,0.1692628769313117,508,His shirt said 'bite me.' Maybe he needs to learn to do irony more effectively.
1860,483,1,3,10,14,1.3571428571428572,0.1692628769313117,508,Don't blame me. He was wearing a Speedo.
3602,483,0,5,9,14,1.3571428571428572,0.13289435848843764,508,"Yeah, I know him. So what? We were in the tank together."
4769,483,1,3,10,14,1.3571428571428572,0.1692628769313117,508,The moment True Detective jumped the shark.
1276,483,0,5,9,14,1.3571428571428572,0.13289435848843764,508,"Yes for the fourteenth time, your kids are very cute. Now can we continue with the interrogation?"
2193,483,1,3,10,14,1.3571428571428572,0.1692628769313117,508,"Nice try, but I ain't taking the bait!"
4772,483,2,1,11,14,1.3571428571428572,0.19909528496696088,508,Doesn't look like any chum of mine.
5298,483,0,5,9,14,1.3571428571428572,0.13289435848843764,508,'Underwater confessions don't count.
4833,483,2,1,11,14,1.3571428571428572,0.19909528496696088,508,"Look, I can't say I recognise him - have you got a shot of the legs?"
707,483,1,3,10,14,1.3571428571428572,0.1692628769313117,508,It's over! Your chum rolled on you.
3870,483,2,1,11,14,1.3571428571428572,0.19909528496696088,508,I'm not talking until I see my client.
5813,483,2,1,11,14,1.3571428571428572,0.19909528496696088,508,"For the last time, he jumped me!"
5034,483,2,1,11,14,1.3571428571428572,0.19909528496696088,508,I only eat cruelty-free children.
3129,483,1,3,10,14,1.3571428571428572,0.1692628769313117,508,We just all look the same to you don't we.
3351,483,0,5,9,14,1.3571428571428572,0.13289435848843764,508,You can drop the yummy cop/yucky cop routine.
1580,483,1,3,10,14,1.3571428571428572,0.1692628769313117,508,I never ate him before in my life
659,483,1,3,10,14,1.3571428571428572,0.1692628769313117,508,We believe this man is currently in your digestive system.
2266,483,1,3,10,14,1.3571428571428572,0.1692628769313117,508,No. It was a left leg.
5826,483,0,5,9,14,1.3571428571428572,0.13289435848843764,508,"Yeah, I ate him. Is there a law against that?"
5622,483,1,3,10,14,1.3571428571428572,0.1692628769313117,508,I'm totally innocent. All I do is play cards and shoot pool.
669,483,1,3,10,14,1.3571428571428572,0.1692628769313117,508,Do you take me for a chum?
5287,483,2,1,11,14,1.3571428571428572,0.19909528496696088,508,Sign this and you can go.
1896,483,2,1,11,14,1.3571428571428572,0.19909528496696088,508,"Hey…I might be a killer, but I didn't murder nobody."
5271,483,1,3,10,14,1.3571428571428572,0.1692628769313117,508,"Let's face it--if I were a Great White, I wouldn't be here."
2134,483,2,1,11,14,1.3571428571428572,0.19909528496696088,508,That miserable sponge--he owes me a hundred clams.
679,483,1,3,10,14,1.3571428571428572,0.1692628769313117,508,I don't talk out of school
682,483,1,3,10,14,1.3571428571428572,0.1692628769313117,508,"I'll tell you anything you want. Please, just waterboard me!"
3332,483,1,3,10,14,1.3571428571428572,0.1692628769313117,508,"I'm telling you, he wasn't my chum!"
6431,483,2,1,11,14,1.3571428571428572,0.19909528496696088,508,My client didn't do it
2203,483,0,5,9,14,1.3571428571428572,0.13289435848843764,508,We have to keep this moving for me to stay alive.
4823,483,1,3,10,14,1.3571428571428572,0.1692628769313117,508,"For the umpteenth time, —I'm a lone shark, not a loan shark."
3610,483,1,3,10,14,1.3571428571428572,0.1692628769313117,508,You can never trust a hammerhead.
2000,483,0,5,9,14,1.3571428571428572,0.13289435848843764,508,If you think I'm a ruthless shark wait till you meet my lawyer.
6112,483,1,3,10,14,1.3571428571428572,0.1692628769313117,508,But I did not eat the deputy.
1997,483,2,1,11,14,1.3571428571428572,0.19909528496696088,508,"I'd never kill a lawyer! That would be, like, fratricide."
3813,483,1,3,10,14,1.3571428571428572,0.1692628769313117,508,I'm not talkin' 'til you feed me a lawyer.
1707,483,0,5,9,14,1.3571428571428572,0.13289435848843764,508,"For Christ sake, it was only a movie!"
2743,483,0,5,9,14,1.3571428571428572,0.13289435848843764,508,Yeah....I know him! He's doing time at Sea World.
4528,483,0,5,9,14,1.3571428571428572,0.13289435848843764,508,I'm tellin' ya I wasn't anywhere near that school...
4680,483,1,3,10,14,1.3571428571428572,0.1692628769313117,508,I ate the evidence.
2644,483,0,5,9,14,1.3571428571428572,0.13289435848843764,508,He was tasty!
6638,483,1,3,10,14,1.3571428571428572,0.1692628769313117,508,"Honestly, you all look alike to me."
364,483,1,3,10,14,1.3571428571428572,0.1692628769313117,508,"For the last time, I've never seen that leg before in my life."
2566,483,0,5,9,14,1.3571428571428572,0.13289435848843764,508,I've never been to that school.
2565,483,1,3,10,14,1.3571428571428572,0.1692628769313117,508,That one tasted like chicken too!
2719,483,1,3,10,14,1.3571428571428572,0.1692628769313117,508,No! No! I said I'm a 'LONE' shark!
2760,483,1,3,10,14,1.3571428571428572,0.1692628769313117,508,"Okay, I'll talk....but nobody will believe you."
5343,483,2,1,11,14,1.3571428571428572,0.19909528496696088,508,I wouldn't eat that guy if you paid me.
5535,483,2,1,11,14,1.3571428571428572,0.19909528496696088,508,I haven't brought my specs with me. Could you bring it just a little closer?
4558,483,1,3,10,14,1.3571428571428572,0.1692628769313117,508,I would have remembered that bathing suit.
4461,483,2,1,11,14,1.3571428571428572,0.19909528496696088,508,Wasn't me. Those things are full of gluten.
464,483,0,5,9,14,1.3571428571428572,0.13289435848843764,508,Looks fishy to me.
6620,483,1,3,10,14,1.3571428571428572,0.1692628769313117,508,He wasn't that kind of chum.
16,483,1,3,10,14,1.3571428571428572,0.1692628769313117,508,"Nah, I never seen that one-legged man before in my life."
29,483,2,1,11,14,1.3571428571428572,0.19909528496696088,508,"I'm not sure officer, it looks like him, but it could also just be a seal."
60,483,2,1,11,14,1.3571428571428572,0.19909528496696088,508,I already told you I could only see his legs.
2867,483,0,5,9,14,1.3571428571428572,0.13289435848843764,508,Never seen her. I told you I am a MAN-eater.
2695,483,1,3,10,14,1.3571428571428572,0.1692628769313117,508,"Nice try, Officer, but I'm not biting."
2922,483,2,1,11,14,1.3571428571428572,0.19909528496696088,508,"Oh, sure, like *I'm* going to fall for the old 'bait and switch...'"
434,483,1,3,10,14,1.3571428571428572,0.1692628769313117,508,Tasted like chicken
2501,483,1,3,10,14,1.3571428571428572,0.1692628769313117,508,"Harbor Seal, Gray Seal, Navy Seal...I'm telling you, they all look alike to me!"
6732,483,1,3,10,14,1.3571428571428572,0.1692628769313117,508,The air in this room is killing me.
6699,483,1,3,10,14,1.3571428571428572,0.1692628769313117,508,I was told there would be snacks.
2766,483,1,3,10,14,1.3571428571428572,0.1692628769313117,508,So we were in the same school...is that a crime?
5519,483,1,3,10,14,1.3571428571428572,0.1692628769313117,508,I claim the right to be hydrated.
493,483,2,1,11,14,1.3571428571428572,0.19909528496696088,508,I know what you're trying to do. You're trying to make me a murderer.
4450,483,1,3,10,14,1.3571428571428572,0.1692628769313117,508,"I'm tellin' ya', it was self defense!"
351,483,1,3,10,14,1.3571428571428572,0.1692628769313117,508,"I keep telling you. I'm not a loan shark, I'm just a lone shark."
2619,483,0,5,9,14,1.3571428571428572,0.13289435848843764,508,"Could you move your hand, er, the picture in a little closer?"
5429,483,0,5,9,14,1.3571428571428572,0.13289435848843764,508,"I swear, I've never seen this Nemo guy before."
2423,483,1,3,10,14,1.3571428571428572,0.1692628769313117,508,"Yeah, maybe. I'm not good with faces."
5484,483,0,5,9,14,1.3571428571428572,0.13289435848843764,508,"No, I did NOT take the bait!"
4306,483,2,1,11,14,1.3571428571428572,0.19909528496696088,508,Seriously? Predatory lending?
5479,483,1,3,10,14,1.3571428571428572,0.1692628769313117,508,"Yeah, I know the guy. He sleeps with the fishes."
6748,483,2,1,11,14,1.3571428571428572,0.19909528496696088,508,"If the tooth mark don’t fit, you must acquit."
4383,483,2,1,11,14,1.3571428571428572,0.19909528496696088,508,Don't need no lawyer. I am a lawyer.
4536,483,2,1,11,14,1.3571428571428572,0.19909528496696088,508,So what? We were chummy...
444,483,1,3,10,14,1.3571428571428572,0.1692628769313117,508,Ya got nothin' on me. That could be anybody's leg.
347,483,1,3,10,14,1.3571428571428572,0.1692628769313117,508,"Listen, you can't arrest me for being a 'lone' shark."
6515,483,1,3,10,14,1.3571428571428572,0.1692628769313117,508,One surfer-dude looks like every other surfer-dude.
461,483,0,5,9,14,1.3571428571428572,0.13289435848843764,508,"No, I was not drinking and diving."
2597,483,2,1,11,14,1.3571428571428572,0.19909528496696088,508,Yeah... that could be her. Could you show me an artist's rendition of her screaming and paddling for shore?
4488,483,1,3,10,14,1.3571428571428572,0.1692628769313117,508,Bruce was speechless when confronted with the consequences of his predatory lending.
2859,483,2,1,11,14,1.3571428571428572,0.19909528496696088,508,Your problem is you guys have seen too many movies.
2366,612,1,4,12,17,1.3529411764705883,0.14705882352941177,508,"Don't bother, you all look alike to me."
4238,613,1,3,11,15,1.3333333333333333,0.15936381457791912,508,I'm not a rat Lieutenant.
4368,613,1,3,11,15,1.3333333333333333,0.15936381457791912,508,Sure it looks like Charlie but all Tuna's look alike.
2500,613,1,2,9,12,1.3333333333333333,0.18802535827258876,508,I've never seen that clown fish before in my life.
1054,613,0,4,8,12,1.3333333333333333,0.14213381090374033,508,"I guess we all look alike to you, huh?"
1102,613,1,2,9,12,1.3333333333333333,0.18802535827258876,508,You're kidding me right? I have better taste than that!
808,613,1,2,9,12,1.3333333333333333,0.18802535827258876,508,All these pictures of swimmers are making me hungry.
2053,613,1,2,9,12,1.3333333333333333,0.18802535827258876,508,Yuck. I hate the taste of sunscreen.
1344,613,0,4,8,12,1.3333333333333333,0.14213381090374033,508,"Look, they all taste the same to me."
6261,613,0,4,8,12,1.3333333333333333,0.14213381090374033,508,I just wanted to get a movie contract.
1890,613,1,3,11,15,1.3333333333333333,0.15936381457791912,508,"Cut the good carp, bad carp routine."
4230,613,0,4,8,12,1.3333333333333333,0.14213381090374033,508,"Statistically, it's more likely that he was killed by a vending machine!"
2789,613,1,2,9,12,1.3333333333333333,0.18802535827258876,508,I've never tasted that surfer before in my life!
2418,613,1,3,11,15,1.3333333333333333,0.15936381457791912,508,"I didn't get his name, but he tasted like chicken."
4891,613,0,4,8,12,1.3333333333333333,0.14213381090374033,508,So it's a bunch of shrimp. Don't your guys eat shrimp?
1698,613,0,4,8,12,1.3333333333333333,0.14213381090374033,508,"If the teethmarks don't fit, you must acquit."
2474,613,2,1,12,15,1.3333333333333333,0.18687063686046268,508,This never would've been an issue if I was a great white.
1834,613,0,4,8,12,1.3333333333333333,0.14213381090374033,508,"Yea, that’s me right behind the surfer. What’s that supposed to prove?"
5222,613,1,3,11,15,1.3333333333333333,0.15936381457791912,508,You've got it all wrong. He jumped me.
6382,631,1,3,12,16,1.3125,0.1505199322349037,508,"Yea, that's Charlie the Tuna."
1006,631,1,3,12,16,1.3125,0.1505199322349037,508,"Yes, those do appear to be my billable hours from my time at Mako, White and Hammerhead."
4801,633,0,4,9,13,1.3076923076923077,0.13323467750529827,508,"Yeah, that's my lunch. So what?"
5448,633,1,2,10,13,1.3076923076923077,0.1748484832946905,508,Can I get a bowl of water?
2292,633,0,4,9,13,1.3076923076923077,0.13323467750529827,508,This would be a lot easier if you had a picture of his legs.
5285,633,1,2,10,13,1.3076923076923077,0.1748484832946905,508,Really? Do I look like a killer whale?
2573,633,2,0,11,13,1.3076923076923077,0.20830867704194772,508,I'm not sure to me all sharks look alike.
3309,633,1,2,10,13,1.3076923076923077,0.1748484832946905,508,"Yeah, I gave the guy a loan. Is that a crime?"
6034,633,1,2,10,13,1.3076923076923077,0.1748484832946905,508,"Look, I haven't had contact with any of the Jets since Broadway Joe borrowed my fishnets."
780,633,1,2,10,13,1.3076923076923077,0.1748484832946905,508,'I can't be sure. They all like alike from the back'.
1872,633,1,2,10,13,1.3076923076923077,0.1748484832946905,508,Without fingerprints you got nothin'.
5524,633,1,2,10,13,1.3076923076923077,0.1748484832946905,508,"I keep telling you, I'm the guy's lawyer."
2898,633,1,2,10,13,1.3076923076923077,0.1748484832946905,508,"Ah... I see we're playing 'good carp, bad carp.'"
6343,633,1,2,10,13,1.3076923076923077,0.1748484832946905,508,I'll talk when you turn that menacing music off.
4453,633,2,0,11,13,1.3076923076923077,0.20830867704194772,508,I already told you. I don't know who's at the top of the food chain.
188,633,1,2,10,13,1.3076923076923077,0.1748484832946905,508,"His name's Nemo? Nah, I never seen 'im."
4013,633,1,2,10,13,1.3076923076923077,0.1748484832946905,508,Are you going to believe me or some X-ray technician?
6040,633,1,2,10,13,1.3076923076923077,0.1748484832946905,508,I'm not positive but it could be flipper.
4313,633,0,4,9,13,1.3076923076923077,0.13323467750529827,508,"For the last time, I'm a LONE shark!"
5520,633,0,4,9,13,1.3076923076923077,0.13323467750529827,508,I don't recognize him but he looks delicious!
1843,633,0,4,9,13,1.3076923076923077,0.13323467750529827,508,I didn't do it.' 'That was a boat accident.
5024,633,0,4,9,13,1.3076923076923077,0.13323467750529827,508,"Yeah, that's him all right. Back in the day we used to swim in the same circles."
843,633,0,4,9,13,1.3076923076923077,0.13323467750529827,508,How can I be expected to remember what I had for dinner last Tuesday?
5616,633,0,4,9,13,1.3076923076923077,0.13323467750529827,508,"I'm a lone shark, not a loan shark!"
421,633,2,0,11,13,1.3076923076923077,0.20830867704194772,508,You say massacre. I say Codfest.
6366,633,1,2,10,13,1.3076923076923077,0.1748484832946905,508,I demand to see my Marine Biologist.
3891,633,1,2,10,13,1.3076923076923077,0.1748484832946905,508,"I don't know 'em, I just eat 'em."
5676,633,2,0,11,13,1.3076923076923077,0.20830867704194772,508,"A fat kid on an air mattress gets eaten and it's always, blame the shark, blame the shark."
2570,633,1,2,10,13,1.3076923076923077,0.1748484832946905,508,"I told you guys already, that's not my handwriting!"
6371,633,1,2,10,13,1.3076923076923077,0.1748484832946905,508,I loaned nobody nothin'
5796,633,0,4,9,13,1.3076923076923077,0.13323467750529827,508,Hard to say... it was a feeding frenzy!
3777,633,1,2,10,13,1.3076923076923077,0.1748484832946905,508,Never tasted him.
1460,633,1,2,10,13,1.3076923076923077,0.1748484832946905,508,I was nowhere near that school.
5801,633,1,2,10,13,1.3076923076923077,0.1748484832946905,508,Looks tasty.
2693,633,1,2,10,13,1.3076923076923077,0.1748484832946905,508,Well the shoes look familiar.
6244,633,0,4,9,13,1.3076923076923077,0.13323467750529827,508,"No way that's me. Let me guess, all sharks look alike to you?"
104,633,2,0,11,13,1.3076923076923077,0.20830867704194772,508,'Show me one more picture of a Fish Fry and I'm calling my lawyer'.
2504,633,2,0,11,13,1.3076923076923077,0.20830867704194772,508,Just the leg.
5380,633,0,4,9,13,1.3076923076923077,0.13323467750529827,508,"Yeah, I recognize that guy, but I swear I spit him out."
2496,633,1,2,10,13,1.3076923076923077,0.1748484832946905,508,"Okay, I'll admit it: He left a bad taste in my mouth."
4464,633,1,2,10,13,1.3076923076923077,0.1748484832946905,508,"Last time, I saw him, he was swimming with the fishes."
109,633,1,2,10,13,1.3076923076923077,0.1748484832946905,508,Could that someone be Mack the Knife?
325,633,0,4,9,13,1.3076923076923077,0.13323467750529827,508,"I thought he was a seal, I swear!"
2029,633,1,2,10,13,1.3076923076923077,0.1748484832946905,508,"If the gill slit don't fit, you must acquit."
4480,633,0,4,9,13,1.3076923076923077,0.13323467750529827,508,I can't read cursive.
2698,633,0,4,9,13,1.3076923076923077,0.13323467750529827,508,"Sure, I did it, but she was trespassing in my property."
2129,633,1,2,10,13,1.3076923076923077,0.1748484832946905,508,My lawyer is going to rip you guys apart for this.
2883,633,0,4,9,13,1.3076923076923077,0.13323467750529827,508,It's hard to say without tasting him.
3199,633,1,2,10,13,1.3076923076923077,0.1748484832946905,508,It's upside down.
1220,633,2,0,11,13,1.3076923076923077,0.20830867704194772,508,It's noon. Can I take a feeding frenzy break?
3578,633,0,4,9,13,1.3076923076923077,0.13323467750529827,508,I was farmed!
3020,633,2,0,11,13,1.3076923076923077,0.20830867704194772,508,I already told you! He's swimming with the fishes!
2788,633,1,2,10,13,1.3076923076923077,0.1748484832946905,508,"Yeah, I bit the Sherrif, but I didn't bite the Deputy."
2520,633,1,2,10,13,1.3076923076923077,0.1748484832946905,508,"I don't always eat two people at once. But when I do, I start with the dude who shoved a typo-riddled report in my face."
1000,633,0,4,9,13,1.3076923076923077,0.13323467750529827,508,Don't play 'Good Cop -- Sea World' with me.
3251,633,2,0,11,13,1.3076923076923077,0.20830867704194772,508,You are arrested for impersonating a lawyer!
4842,633,2,0,11,13,1.3076923076923077,0.20830867704194772,508,"Ate her, too."
1986,633,1,2,10,13,1.3076923076923077,0.1748484832946905,508,"Your 'good cod', 'bad cod' ain't gonna work."
5512,633,0,4,9,13,1.3076923076923077,0.13323467750529827,508,"Yeah, that's the surfboard that attacked me. I was only acting in self -defense."
3924,633,1,2,10,13,1.3076923076923077,0.1748484832946905,508,I swear I've never eaten him before in my life.
1269,633,0,4,9,13,1.3076923076923077,0.13323467750529827,508,"No, I'll never attack one of my own as a professional courtesy."
6298,633,1,2,10,13,1.3076923076923077,0.1748484832946905,508,Last time I saw him he was swimming for the beach.
172,633,0,4,9,13,1.3076923076923077,0.13323467750529827,508,I'm sure I never ate that guy.
6093,633,0,4,9,13,1.3076923076923077,0.13323467750529827,508,All of those divers look alike to me.
6091,633,1,2,10,13,1.3076923076923077,0.1748484832946905,508,"Big deal, the dolphin confessed. You know, half what they say is actually complete gibberish."
6299,633,0,4,9,13,1.3076923076923077,0.13323467750529827,508,"I'd demand my lawyer, but I think...that's him."
930,633,1,2,10,13,1.3076923076923077,0.1748484832946905,508,I'm going with the 'sharkfluenza' defense.
1950,633,1,2,10,13,1.3076923076923077,0.1748484832946905,508,I'll go with the tuna sashimi and side order of krill.
2218,633,0,4,9,13,1.3076923076923077,0.13323467750529827,508,"Oh great, my eyes are closed."
4960,633,1,2,10,13,1.3076923076923077,0.1748484832946905,508,Sorry but all surfers look alike to me.
922,633,1,2,10,13,1.3076923076923077,0.1748484832946905,508,I'd like to see my client in person.
6566,633,1,2,10,13,1.3076923076923077,0.1748484832946905,508,"I'm telling ya, I never seen that leg before."
6083,633,0,4,9,13,1.3076923076923077,0.13323467750529827,508,I have the right to remain violent.
366,633,1,2,10,13,1.3076923076923077,0.1748484832946905,508,Let's just say he's a chum of mine.
6567,633,0,4,9,13,1.3076923076923077,0.13323467750529827,508,I need my attorney—and a glass of water.
4937,633,1,2,10,13,1.3076923076923077,0.1748484832946905,508,How should I know? I'm a Land Shark!
6278,633,1,2,10,13,1.3076923076923077,0.1748484832946905,508,"You say, 'blood bath.' I say, 'dinner.'"
1280,633,1,2,10,13,1.3076923076923077,0.1748484832946905,508,My word! Now I see why he tasted so funny.
3711,633,1,2,10,13,1.3076923076923077,0.1748484832946905,508,"I'll take No. 13, The Surfer Deluxe. Hold the fries."
4944,633,1,2,10,13,1.3076923076923077,0.1748484832946905,508,Yeah? So? You dangle a cage in front of me with food in it? I call that entrapment.
352,633,0,4,9,13,1.3076923076923077,0.13323467750529827,508,Can I have some water first?
2173,633,0,4,9,13,1.3076923076923077,0.13323467750529827,508,I got pieces of guys like you in my stool.'
4945,633,1,2,10,13,1.3076923076923077,0.1748484832946905,508,Always a shark never a dolphin.
2190,633,1,2,10,13,1.3076923076923077,0.1748484832946905,508,He ain't my chum.
2634,633,0,4,9,13,1.3076923076923077,0.13323467750529827,508,I want an attorney. Or at least someone from Greenpeace.
5509,633,1,2,10,13,1.3076923076923077,0.1748484832946905,508,Are you really gonna believe the fisherman's tale?
3702,633,0,4,9,13,1.3076923076923077,0.13323467750529827,508,See. I told you he had a spear.
2633,633,1,2,10,13,1.3076923076923077,0.1748484832946905,508,The ocean gets its saltiness from tears of misunderstood sharks
5751,633,1,2,10,13,1.3076923076923077,0.1748484832946905,508,I want to speak to my brother. He's a lawyer.
1317,633,0,4,9,13,1.3076923076923077,0.13323467750529827,508,I knew I shoulda eaten the camera first!
6268,633,0,4,9,13,1.3076923076923077,0.13323467750529827,508,"Of course I would eat him, but that doesn't mean I did."
954,633,0,4,9,13,1.3076923076923077,0.13323467750529827,508,I maintain it happened in international waters.
951,633,0,4,9,13,1.3076923076923077,0.13323467750529827,508,"Okay, I'll bite."
4587,633,0,4,9,13,1.3076923076923077,0.13323467750529827,508,"Yeah, you could say he was a chum."
5399,633,2,0,11,13,1.3076923076923077,0.20830867704194772,508,"Look, I was at home watching the debate on tv and was surprised like everyone else when Trump wasn't there."
6651,633,1,2,10,13,1.3076923076923077,0.1748484832946905,508,Looks like they should've had a bigger boat
334,633,1,2,10,13,1.3076923076923077,0.1748484832946905,508,I did not have sexual relations with that woman.
5515,633,1,2,10,13,1.3076923076923077,0.1748484832946905,508,"Look, for the last time...all I remember is they tasted like chicken."
1390,633,1,2,10,13,1.3076923076923077,0.1748484832946905,508,You've got it all wrong...he was my chum.
4811,633,0,4,9,13,1.3076923076923077,0.13323467750529827,508,I'm not that good with faces. Have you got a picture of his legs?
6326,633,0,4,9,13,1.3076923076923077,0.13323467750529827,508,I keep tellin' ya - the last time I saw him he was still afloat.
2006,633,0,4,9,13,1.3076923076923077,0.13323467750529827,508,"Yes, that's my client."
768,633,2,0,11,13,1.3076923076923077,0.20830867704194772,508,"I don't know, it was a frenzy down there."
1909,633,1,2,10,13,1.3076923076923077,0.1748484832946905,508,You can take your Miranda rights and bite them!
6689,633,0,4,9,13,1.3076923076923077,0.13323467750529827,508,What are you going to do? Send me up the river?
4983,633,0,4,9,13,1.3076923076923077,0.13323467750529827,508,one arm. that's him.
2621,633,1,2,10,13,1.3076923076923077,0.1748484832946905,508,"The one next to Katy Perry? Maybe I know him, maybe I don't. What's it to you?"
6641,633,1,2,10,13,1.3076923076923077,0.1748484832946905,508,"I may be a cruel, merciless and cold-blooded eating machine but I'm no snitch."
870,633,0,4,9,13,1.3076923076923077,0.13323467750529827,508,Everyone knows I went vegan last year.
3632,633,0,4,9,13,1.3076923076923077,0.13323467750529827,508,"Yea,that's him. Minus the surfboard and wet suit."
5193,633,2,0,11,13,1.3076923076923077,0.20830867704194772,508,"500 feet from a school, huh?"
5280,633,0,4,9,13,1.3076923076923077,0.13323467750529827,508,Keep fishin' you ain't got nuthin' on me.
865,633,1,2,10,13,1.3076923076923077,0.1748484832946905,508,"yeah,that's the arm that fed me."
5277,633,1,2,10,13,1.3076923076923077,0.1748484832946905,508,I prefer the term 'high interest lender.'
1991,633,1,2,10,13,1.3076923076923077,0.1748484832946905,508,"No, I didn't stop there. I'm always in motion."
1919,633,2,0,11,13,1.3076923076923077,0.20830867704194772,508,What if I told you I was a privileged Great White male?
2797,633,1,2,10,13,1.3076923076923077,0.1748484832946905,508,"For the last time, no, I do not recognize that leg."
3266,633,1,2,10,13,1.3076923076923077,0.1748484832946905,508,The surfer dude is a sissy. I don't have arms either and I do just fine.
3982,633,0,4,9,13,1.3076923076923077,0.13323467750529827,508,"Those aren't my bite marks, officer."
3268,633,1,2,10,13,1.3076923076923077,0.1748484832946905,508,Nemo? Never seen him before in my life.
909,633,1,2,10,13,1.3076923076923077,0.1748484832946905,508,I want to see my lawyer! You told me I was auditioning for Shark Tank.
6076,633,1,2,10,13,1.3076923076923077,0.1748484832946905,508,Yo. What happened was he cut his leg fallin' OFF the board. I was just helpin' him back ON!!!
1368,633,1,2,10,13,1.3076923076923077,0.1748484832946905,508,"I'll answer your question, but can I get a glass of water first?"
4973,633,1,2,10,13,1.3076923076923077,0.1748484832946905,508,"What can I say? In my line of work, I see a lot of red bathing suits."
3050,633,1,2,10,13,1.3076923076923077,0.1748484832946905,508,I ain't no Flipper.
5153,633,0,4,9,13,1.3076923076923077,0.13323467750529827,508,I can't see it. Will you bring your hand a little closer? (Sam age 8)
3048,633,0,4,9,13,1.3076923076923077,0.13323467750529827,508,I have the right to have a bottom feeder present.
6678,633,1,2,10,13,1.3076923076923077,0.1748484832946905,508,"Until you move it to either side of me, I can't see a damn thing!"
1927,633,1,2,10,13,1.3076923076923077,0.1748484832946905,508,"You are looking for a loan shark, not a lone shark."
6559,633,1,2,10,13,1.3076923076923077,0.1748484832946905,508,That's not my handwriting. I don't have hands.
3047,633,1,2,10,13,1.3076923076923077,0.1748484832946905,508,I've never been on 'Saturday Night Live.' That's not me!
5471,633,1,2,10,13,1.3076923076923077,0.1748484832946905,508,"Haven't seen him, but he looks tasty."
1378,633,1,2,10,13,1.3076923076923077,0.1748484832946905,508,And then he ran into my teeth... He ran into my teeth ten times.
4289,633,0,4,9,13,1.3076923076923077,0.13323467750529827,508,"No, he wasn't an acquaintance of mine, more like a chum."
4434,633,1,2,10,13,1.3076923076923077,0.1748484832946905,508,I guess we all look the same to you?
2706,633,1,2,10,13,1.3076923076923077,0.1748484832946905,508,"Sure I recognize him, he was my chum."
1504,633,0,4,9,13,1.3076923076923077,0.13323467750529827,508,"'I know it looks bad, but is it my fault he was wearing a seal costume?"
5235,633,0,4,9,13,1.3076923076923077,0.13323467750529827,508,I'll start with shrimp cocktail and follow that with tuna casserole.
2761,633,1,2,10,13,1.3076923076923077,0.1748484832946905,508,"Guy washes up on shore, bitten in two so you just assume a shark must've done it."
650,633,2,0,11,13,1.3076923076923077,0.20830867704194772,508,"Yeah, fancy gloves, a jackknife, sure I know him, so what?"
3479,633,2,0,11,13,1.3076923076923077,0.20830867704194772,508,My alibi is ironclad. I was out for sushi.
4524,633,1,2,10,13,1.3076923076923077,0.1748484832946905,508,I'll say it again. I've never been to Sea World.
4645,633,0,4,9,13,1.3076923076923077,0.13323467750529827,508,"Yeah, that's Charlie. He left a bad taste in my mouth."
1759,633,1,2,10,13,1.3076923076923077,0.1748484832946905,508,I already told you . . . all you people look alike to me.
5062,633,0,4,9,13,1.3076923076923077,0.13323467750529827,508,"Sure I recognize him, we were in the same school."
1621,633,0,4,9,13,1.3076923076923077,0.13323467750529827,508,I get jumped all the time.
3470,633,0,4,9,13,1.3076923076923077,0.13323467750529827,508,It's hard to tell officer... There was a lot of blood.
6502,633,0,4,9,13,1.3076923076923077,0.13323467750529827,508,"Hey, man, we're all endangered."
2919,633,1,2,10,13,1.3076923076923077,0.1748484832946905,508,I'll have the herb-crusted cod
635,633,0,4,9,13,1.3076923076923077,0.13323467750529827,508,"Yeah, he looks kinda familiar. Then again, they all seem to make that same face."
4638,633,1,2,10,13,1.3076923076923077,0.1748484832946905,508,He bit me first.
1163,633,1,2,10,13,1.3076923076923077,0.1748484832946905,508,"I guess we all look the same to you, huh?"
5551,633,1,2,10,13,1.3076923076923077,0.1748484832946905,508,That's him! The black and white whale. He's the real killer!
4704,633,0,4,9,13,1.3076923076923077,0.13323467750529827,508,I see a lotta slippery characters down there!
2447,633,1,2,10,13,1.3076923076923077,0.1748484832946905,508,"It's a common misconception, officer, but I'm a 'card shark,' not a 'card sharp.'"
2457,633,1,2,10,13,1.3076923076923077,0.1748484832946905,508,I don't recognize any of them. I go by smell.
4223,633,1,2,10,13,1.3076923076923077,0.1748484832946905,508,"The real criminals are on Wall Street. But, yeah, I ate that surfer."
1174,633,1,2,10,13,1.3076923076923077,0.1748484832946905,508,I'll talk but my life is endangered.
2106,633,0,4,9,13,1.3076923076923077,0.13323467750529827,508,I'll take the court-appointed remora.
5316,633,1,2,10,13,1.3076923076923077,0.1748484832946905,508,You know I can't read cursive!
1785,633,2,0,11,13,1.3076923076923077,0.20830867704194772,508,"Yeah yeah, that's the guy. Name's Jaws!"
681,633,1,2,10,13,1.3076923076923077,0.1748484832946905,508,I've never seen that torso.
2358,633,1,2,10,13,1.3076923076923077,0.1748484832946905,508,But there's nothing illegal about 100% interest rates.
5838,633,1,2,10,13,1.3076923076923077,0.1748484832946905,508,I don't even know what a candygram is.
46,633,1,2,10,13,1.3076923076923077,0.1748484832946905,508,Got one of her bottom half?
3852,633,1,2,10,13,1.3076923076923077,0.1748484832946905,508,What makes you think I can read that?
2360,633,1,2,10,13,1.3076923076923077,0.1748484832946905,508,He's just another fish in the sea
1606,633,1,2,10,13,1.3076923076923077,0.1748484832946905,508,Jonah who ?
4233,633,0,4,9,13,1.3076923076923077,0.13323467750529827,508,Well from that angle he don't look like a seal.
499,633,0,4,9,13,1.3076923076923077,0.13323467750529827,508,What did he expect wearing that cage?
1838,633,1,2,10,13,1.3076923076923077,0.1748484832946905,508,Just because I gave somebody a loan...
294,633,0,4,9,13,1.3076923076923077,0.13323467750529827,508,I was just showing a little fin officer.
5842,633,1,2,10,13,1.3076923076923077,0.1748484832946905,508,So I won the contest with that stupid caption. That still doesn't prove I bribed Bob Mankoff.
292,633,1,2,10,13,1.3076923076923077,0.1748484832946905,508,I told you I never went near that school!
6441,633,0,4,9,13,1.3076923076923077,0.13323467750529827,508,Go ahead and throw me in the tank.
6760,633,0,4,9,13,1.3076923076923077,0.13323467750529827,508,So I had the tuna. Big deal.
1789,633,1,2,10,13,1.3076923076923077,0.1748484832946905,508,"You don't scare me, everyone in my family is a lawyer!"
2605,633,1,2,10,13,1.3076923076923077,0.1748484832946905,508,"That's a seriously ugly hard-to-forget comb-over. Still, I need to see him in a speedo."
1749,633,1,2,10,13,1.3076923076923077,0.1748484832946905,508,"Look buddy, I've seen LOTS of legs and butts."
3405,633,1,2,10,13,1.3076923076923077,0.1748484832946905,508,But he asked for the loan.
4718,633,0,4,9,13,1.3076923076923077,0.13323467750529827,508,"Also not an associate. I told you, I'm a lone shark."
5558,633,2,0,11,13,1.3076923076923077,0.20830867704194772,508,We don't all know each other.
583,633,2,0,11,13,1.3076923076923077,0.20830867704194772,508,"Yeah, I've seen that plankton around. He's a drifter."
7,633,0,4,9,13,1.3076923076923077,0.13323467750529827,508,"Yeah, he was my chum...what's it to ya."
1719,633,0,4,9,13,1.3076923076923077,0.13323467750529827,508,My lawyer will rip you two apart in court
1717,633,1,2,10,13,1.3076923076923077,0.1748484832946905,508,"That's the guy - rainbow trunks, hairy legs, screams like a girl..."
6469,633,0,4,9,13,1.3076923076923077,0.13323467750529827,508,Let me chew on it for a while.
6475,633,2,0,11,13,1.3076923076923077,0.20830867704194772,508,"Yeah, I seen that guy...he sleeps with the fishes."
267,633,0,4,9,13,1.3076923076923077,0.13323467750529827,508,What makes you think he owed me money?
2077,633,1,2,10,13,1.3076923076923077,0.1748484832946905,508,"Come on, spit it out."
572,633,1,2,10,13,1.3076923076923077,0.1748484832946905,508,I ain't no porpoise. I'm not going to flip.
5872,633,0,4,9,13,1.3076923076923077,0.13323467750529827,508,"So if I sing, I’m off the hook?"
5430,633,1,2,10,13,1.3076923076923077,0.1748484832946905,508,What exactly does my Super Bowl performance have to do with this?
5561,633,0,4,9,13,1.3076923076923077,0.13323467750529827,508,I plead not guilty by reason of instinct.
4721,633,1,2,10,13,1.3076923076923077,0.1748484832946905,508,Yeah...That's the loan agreement. So what?
4358,633,0,4,9,13,1.3076923076923077,0.13323467750529827,508,"Surfer- Swimmer, whatever. They all taste like chicken."
6619,633,1,2,10,13,1.3076923076923077,0.1748484832946905,508,'I told him he was going to need a bigger boat'.
3432,633,1,2,10,13,1.3076923076923077,0.1748484832946905,508,I’m famished. Which one of you is the good cop.
258,633,0,4,9,13,1.3076923076923077,0.13323467750529827,508,It was either Shaw or Dreyfus. Blame Spielberg.
1747,633,1,2,10,13,1.3076923076923077,0.1748484832946905,508,Why do you always suspect the great white guy?
6762,633,0,4,9,13,1.3076923076923077,0.13323467750529827,508,All those arms look alike to me.
2950,633,2,0,11,13,1.3076923076923077,0.20830867704194772,508,Dou you remember every
3456,633,2,0,11,13,1.3076923076923077,0.20830867704194772,508,"Take a hike, copper. I may be a shark but I ain't no rat."
4705,633,0,4,9,13,1.3076923076923077,0.13323467750529827,508,Maybe this bar tab from Sea World will jog your memory.
4707,633,0,4,9,13,1.3076923076923077,0.13323467750529827,508,What are you implying? That's clearly the work of an amateur.
5902,633,1,2,10,13,1.3076923076923077,0.1748484832946905,508,I'm not saying anything until I talk to Spielberg.
3395,633,0,4,9,13,1.3076923076923077,0.13323467750529827,508,I'm a pool shark. I didn't kill him.
2923,633,1,2,10,13,1.3076923076923077,0.1748484832946905,508,"Yes, that looks familiar, but my lawyer would question your jurisdiction."
606,633,0,4,9,13,1.3076923076923077,0.13323467750529827,508,There's something fishy about this.
1120,633,0,4,9,13,1.3076923076923077,0.13323467750529827,508,How many times do I have to tell you? All cephalopods look alike to me!
6767,633,0,4,9,13,1.3076923076923077,0.13323467750529827,508,He swam up to me in a black suit dressed as a seal. That's entrapment!
3397,633,0,4,9,13,1.3076923076923077,0.13323467750529827,508,"No, but he looks delicious."
4158,633,0,4,9,13,1.3076923076923077,0.13323467750529827,508,"I'm just asking for a little professional courtesy, that's all."
600,633,1,2,10,13,1.3076923076923077,0.1748484832946905,508,No I have not seen the leg that belongs to this boy
3436,633,1,2,10,13,1.3076923076923077,0.1748484832946905,508,Yep. That's him.
1732,633,1,2,10,13,1.3076923076923077,0.1748484832946905,508,I wish to exercise my right to remain saline.
6499,633,0,4,9,13,1.3076923076923077,0.13323467750529827,508,I barely recognize him without the surfboard.
4513,633,0,4,9,13,1.3076923076923077,0.13323467750529827,508,I swear I didn't do it on porpoise
5930,633,0,4,9,13,1.3076923076923077,0.13323467750529827,508,I told you before: I wasn't there. I summer in Southampton.
2715,633,1,2,10,13,1.3076923076923077,0.1748484832946905,508,I can't say that I'd recognize him but I can tell you how he tasted.
5682,633,1,2,10,13,1.3076923076923077,0.1748484832946905,508,"I already told you, I've never even been in that pool hall."
2578,633,2,0,11,13,1.3076923076923077,0.20830867704194772,508,I would like to order something off of the sushi menu.
5965,633,1,2,10,13,1.3076923076923077,0.1748484832946905,508,If you can read this you are hired with full benefits
6633,633,1,2,10,13,1.3076923076923077,0.1748484832946905,508,"I couldn't say for sure, all dolphins look the same to me."
3342,633,0,4,9,13,1.3076923076923077,0.13323467750529827,508,Ain't it enough you guys got me to talk; you want me to confess to murder too?
4377,633,0,4,9,13,1.3076923076923077,0.13323467750529827,508,That also looks like dinner to me.
4099,633,0,4,9,13,1.3076923076923077,0.13323467750529827,508,Can you hold it sideways?
5537,633,1,2,10,13,1.3076923076923077,0.1748484832946905,508,This is just a fishing expedition!
3521,633,0,4,9,13,1.3076923076923077,0.13323467750529827,508,"Come on, Banks charge even higher rates."
5353,633,1,2,10,13,1.3076923076923077,0.1748484832946905,508,"Looks delicious, but it's not him."
6598,633,1,2,10,13,1.3076923076923077,0.1748484832946905,508,You guys are only on a fishing expedition.
4326,633,1,2,10,13,1.3076923076923077,0.1748484832946905,508,I don't recall him smiling.
5954,633,1,2,10,13,1.3076923076923077,0.1748484832946905,508,"Yeah, he owed me money, but it doesn't mean I killed him."
5593,633,2,0,11,13,1.3076923076923077,0.20830867704194772,508,"Bottom line? D,E,F,P,O,T,E,C."
2768,633,1,2,10,13,1.3076923076923077,0.1748484832946905,508,"It was 'Shark Week,' can you blame me?"
1543,633,2,0,11,13,1.3076923076923077,0.20830867704194772,508,It wasn't me. I'm a vegetarian.
2981,633,1,2,10,13,1.3076923076923077,0.1748484832946905,508,"All I'm saying is, 'shark fin soup' isn't a phrase I take lightly."
5971,633,0,4,9,13,1.3076923076923077,0.13323467750529827,508,Wait a minute. That's a writ of habeus porpoise.
453,633,2,0,11,13,1.3076923076923077,0.20830867704194772,508,"I tell you, you've got the wrong Chondrichthye!"
312,633,1,2,10,13,1.3076923076923077,0.1748484832946905,508,Seriously do I look like a rat?
4493,633,1,2,10,13,1.3076923076923077,0.1748484832946905,508,I can't tell them apart. They all taste like chicken.
4249,633,0,4,9,13,1.3076923076923077,0.13323467750529827,508,"Quarter flounder with cheese, or I ain't talkin'"
6731,633,1,2,10,13,1.3076923076923077,0.1748484832946905,508,"Yeah I knew him, and he was delicious."
3545,633,1,2,10,13,1.3076923076923077,0.1748484832946905,508,"you might as well put me back in the tank, i'm not talking."
77,633,1,2,10,13,1.3076923076923077,0.1748484832946905,508,That guy gave me indigestion. Can we just call it even?
2708,633,1,2,10,13,1.3076923076923077,0.1748484832946905,508,Could you bring that little closer?
310,633,1,2,10,13,1.3076923076923077,0.1748484832946905,508,They all look alike to me.
3538,633,2,0,11,13,1.3076923076923077,0.20830867704194772,508,Have you questioned the bees? Everybody knows they kill more people every year.
5501,633,1,2,10,13,1.3076923076923077,0.1748484832946905,508,"No dice. The last time I played ball with you guys, I ended up balancing one at Sea World."
3537,633,1,2,10,13,1.3076923076923077,0.1748484832946905,508,"No, I will not take a bite out of crime."
6593,633,0,4,9,13,1.3076923076923077,0.13323467750529827,508,She wasn't as tasty as she looks in the profile.
5972,633,0,4,9,13,1.3076923076923077,0.13323467750529827,508,I want to regurgitate my lawyer.
3333,633,1,2,10,13,1.3076923076923077,0.1748484832946905,508,Yeah that's him....Said he worked for the Discovery Channel.
712,633,1,2,10,13,1.3076923076923077,0.1748484832946905,508,Read the fine print. No airboarding fish.
2111,633,0,4,9,13,1.3076923076923077,0.13323467750529827,508,"Yeah, I know Pamela; we filmed an episode of Bay Watch together."
4940,633,0,4,9,13,1.3076923076923077,0.13323467750529827,508,Keep shoving that thing in my face and you'll find out.
1803,633,1,2,10,13,1.3076923076923077,0.1748484832946905,508,"I don't care what he says, he doesn't have a leg to stand on."
3510,633,1,2,10,13,1.3076923076923077,0.1748484832946905,508,"No, I don't want an attorney, I AM an attorney."
5208,633,1,2,10,13,1.3076923076923077,0.1748484832946905,508,"If you think I'm cold-blooded, just wait until you meet my lawyer."
2348,633,0,4,9,13,1.3076923076923077,0.13323467750529827,508,Not only WON'T I talk...I CAN'T talk.
53,633,1,2,10,13,1.3076923076923077,0.1748484832946905,508,You won't get any info by grilling me.
2468,633,0,4,9,13,1.3076923076923077,0.13323467750529827,508,"What did you expect, I'm a shark."
2349,633,0,4,9,13,1.3076923076923077,0.13323467750529827,508,"I'm not good with faces, what did he taste like?"
1574,633,0,4,9,13,1.3076923076923077,0.13323467750529827,508,Let's just say we were chums.
6747,633,1,2,10,13,1.3076923076923077,0.1748484832946905,508,Sorry…I can only recognize him by his feet.
6514,633,1,2,10,13,1.3076923076923077,0.1748484832946905,508,You're wasting your time. I know when I'm being baited.
3350,633,1,2,10,13,1.3076923076923077,0.1748484832946905,508,"Listen, like I said a hundred times, I only got a look at her legs."
1793,633,1,2,10,13,1.3076923076923077,0.1748484832946905,508,Never seen that leg before.
4117,633,1,2,10,13,1.3076923076923077,0.1748484832946905,508,"You're taking this whole 'Loan Shark' thing quite literally, aren't you?"
2156,900,1,2,11,14,1.2857142857142858,0.1633633928276759,508,What are my chances of getting some water?
2212,900,0,4,10,14,1.2857142857142858,0.12529400275814703,508,"Whatever, I'll be back in the seas in no time with the catch and release laws."
5323,900,0,4,10,14,1.2857142857142858,0.12529400275814703,508,Let me guess...a white surfer picked me out of the line up!
231,900,1,2,11,14,1.2857142857142858,0.1633633928276759,508,"Yeah, it looks like my dorsal fin, but I'm telling you, I was in Jersey visiting family."
3144,904,0,3,8,11,1.2727272727272727,0.14083575804390613,508,"I'm not talking until I get a fat, juicy lawyer."
6340,904,1,1,9,11,1.2727272727272727,0.1949782780866111,508,The top letter is E.
769,904,0,3,8,11,1.2727272727272727,0.14083575804390613,508,What can I say? Someone cued the music.
5938,904,0,3,8,11,1.2727272727272727,0.14083575804390613,508,I think I'd like to eat my lawyer now.
3334,904,1,1,9,11,1.2727272727272727,0.1949782780866111,508,"Enough of my Wrongs, read me my Rights."
202,904,0,3,8,11,1.2727272727272727,0.14083575804390613,508,I tell you when I swam away he was alive. You can check my stomach contents.
3522,904,1,1,9,11,1.2727272727272727,0.1949782780866111,508,There must be a misunderstanding...I'm the lawyer.
3598,904,1,1,9,11,1.2727272727272727,0.1949782780866111,508,I now see it’s a surfboard — but this photo is from above.
3761,904,1,1,9,11,1.2727272727272727,0.1949782780866111,508,"I chewed, but I didn't swallow"
2044,904,1,1,9,11,1.2727272727272727,0.1949782780866111,508,I don't get it - why do you keep showing me pictures of jets?
6251,904,0,3,8,11,1.2727272727272727,0.14083575804390613,508,"I'm in no hurry, this place is a 5-star resort compared to SeaWorld"
4552,904,1,1,9,11,1.2727272727272727,0.1949782780866111,508,"Those god damn lifeguards, am I right?"
2994,904,1,1,9,11,1.2727272727272727,0.1949782780866111,508,"I keep telling you, my memory is a little fishy."
838,904,0,3,8,11,1.2727272727272727,0.14083575804390613,508,"So, I suppose you never had a tuna sandwich?"
2184,904,0,3,8,11,1.2727272727272727,0.14083575804390613,508,"Yeah, like I said before I was in a school at the time, couldn't have been me."
512,904,1,1,9,11,1.2727272727272727,0.1949782780866111,508,That could be any surfer's butt.
3579,904,1,1,9,11,1.2727272727272727,0.1949782780866111,508,Lenny knew that even his Great White privilege couldn't save him now.
1779,921,0,4,11,15,1.2666666666666666,0.11818736805705578,508,How should I know? All the legs look the same to me.
4933,922,0,3,9,12,1.25,0.13055824196677338,508,Can you bring it a little closer...chum?
3205,922,1,1,10,12,1.25,0.17943514064131835,508,"As I told Officer Krupke, I wasn't at the rumble."
1150,922,1,1,10,12,1.25,0.17943514064131835,508,I'd only recognize his taste.
1153,922,0,3,9,12,1.25,0.13055824196677338,508,Forget it. I ain't no rat.
3762,922,1,1,10,12,1.25,0.17943514064131835,508,"Do I look like the Lost and Found?' 'If Nemo is missing again, that's HIS problem."
2629,922,1,1,10,12,1.25,0.17943514064131835,508,"I'm not answering any more questions, until I see my lawyer. You think I'M a shark. just wait!"
249,922,0,3,9,12,1.25,0.13055824196677338,508,Have you even seen finding nemo?
2074,922,1,1,10,12,1.25,0.17943514064131835,508,"I'm not falling for your good cod, bad cod routine."
3727,922,0,3,9,12,1.25,0.13055824196677338,508,"I've never even seen that terrified ,very delicious, young tanned surfer."
6615,922,1,1,10,12,1.25,0.17943514064131835,508,All I know is that one minute I was swimming in the ocean and the next I was in some sort of tornado.
6178,922,1,1,10,12,1.25,0.17943514064131835,508,Get that out of my face or you're gonna really find out what it's like to take a bite outta crime.
1978,922,0,3,9,12,1.25,0.13055824196677338,508,This is out of my depth.
6640,922,0,3,9,12,1.25,0.13055824196677338,508,"It's like I told you before, 'I don't know nothing about no surfboard.'"
4386,922,1,1,10,12,1.25,0.17943514064131835,508,Why do you guys bring me in every time a dead seal washes up?
1200,922,0,3,9,12,1.25,0.13055824196677338,508,"I demand to see a lawyer, preferably someone grass-fed."
6168,922,1,1,10,12,1.25,0.17943514064131835,508,"I'm not a pool or a loan shark, I'm a Mako."
3770,922,0,3,9,12,1.25,0.13055824196677338,508,"So tell me, officer, where would you put the wire?"
1195,922,1,1,10,12,1.25,0.17943514064131835,508,"Yeah, he's swimming with the fishes."
1281,922,1,1,10,12,1.25,0.17943514064131835,508,Do I look like a stool-pigeon to you!
4381,922,1,1,10,12,1.25,0.17943514064131835,508,"It's because I'm a shark, isn't it?"
6158,922,0,3,9,12,1.25,0.13055824196677338,508,"Well, of course I killed him in cold blood. I'm a shark, for God's sake!"
2032,922,0,3,9,12,1.25,0.13055824196677338,508,He wanted to make soup out of my fin! What was I supposed to do?
3166,922,0,3,9,12,1.25,0.13055824196677338,508,"Officers, I can't help but feel this fishing expedition is developing into some kind of investigation."
2066,922,0,3,9,12,1.25,0.13055824196677338,508,Whitey knew the two detectives were just fishing for answers.
1213,922,0,3,9,12,1.25,0.13055824196677338,508,.. and that one's me at Woodstock.
3776,922,1,1,10,12,1.25,0.17943514064131835,508,Do you recognize this arm and a leg?
1164,922,0,3,9,12,1.25,0.13055824196677338,508,"Like I been telling you guys, I can't finger NOBODY!"
3214,922,0,3,9,12,1.25,0.13055824196677338,508,His legs look familiar.
3170,922,0,3,9,12,1.25,0.13055824196677338,508,This 'sleeps with the fishes' is getting old.
2815,922,1,1,10,12,1.25,0.17943514064131835,508,You know we fast during Shark Week.
1999,922,1,1,10,12,1.25,0.17943514064131835,508,"I can't tell if it's Bruce or not. Like I, said, it was a feeding frenzy."
4375,922,1,1,10,12,1.25,0.17943514064131835,508,Yea. Mark Cuban. Who wants to know?
2030,922,0,3,9,12,1.25,0.13055824196677338,508,Go ahead and grill me.I'm not on that menu
1175,922,0,3,9,12,1.25,0.13055824196677338,508,"Nope, never tasted him before in my life"
4930,922,0,3,9,12,1.25,0.13055824196677338,508,"No, I did not eat my client."
2003,922,1,1,10,12,1.25,0.17943514064131835,508,"Yea, I've seen him swim by! What of it!"
3803,922,0,3,9,12,1.25,0.13055824196677338,508,"Detective, I swear that minnow was 18."
2826,922,0,3,9,12,1.25,0.13055824196677338,508,How should I know? They all look the same from the waist up!
6644,922,0,3,9,12,1.25,0.13055824196677338,508,Sure it's Macky; look at those pearly whites.
4374,922,0,3,9,12,1.25,0.13055824196677338,508,Call it anything ya want Copper. It's still profiling
6144,922,1,1,10,12,1.25,0.17943514064131835,508,Stop asking me questions. I'm the lawyer.
5493,922,0,3,9,12,1.25,0.13055824196677338,508,"Alright, I ate 'em... But how many years in the tank?"
6162,922,0,3,9,12,1.25,0.13055824196677338,508,Only if you promise to stop eating shark fin soup.
1257,922,1,1,10,12,1.25,0.17943514064131835,508,"I don't care what Spielberg told you, I only do cards, pool, and loans!"
6129,922,0,3,9,12,1.25,0.13055824196677338,508,You have to believe me. I didn't write that!
1235,922,1,1,10,12,1.25,0.17943514064131835,508,That guy never jumped me.
4387,922,1,1,10,12,1.25,0.17943514064131835,508,"Peter Benchley you say? Nope, never heard of him..."
5212,922,1,1,10,12,1.25,0.17943514064131835,508,...I know you're just fishin' here.
2612,922,0,3,9,12,1.25,0.13055824196677338,508,"Yeah, I know that dolphin, but she told me she was a porpoise."
3807,922,0,3,9,12,1.25,0.13055824196677338,508,I want to see my Maritime Lawyer.
2829,922,1,1,10,12,1.25,0.17943514064131835,508,I'm an attorney. I know my rights!
4394,922,1,1,10,12,1.25,0.17943514064131835,508,I don't know if that's the guy. All seals look alike to me.
1211,922,0,3,9,12,1.25,0.13055824196677338,508,He is not my partner. I am a lone shark.
5706,922,0,3,9,12,1.25,0.13055824196677338,508,"Yeah, that's the one. I'd recognize that leg anywhere."
1190,922,1,1,10,12,1.25,0.17943514064131835,508,That's the guy - really long hair and an even longer surfboard
1267,922,1,1,10,12,1.25,0.17943514064131835,508,"Triggerfish, in the coral reef, with the revolver."
5489,922,0,3,9,12,1.25,0.13055824196677338,508,I never saw that seal in my life.
2620,922,0,3,9,12,1.25,0.13055824196677338,508,Holy mackerel -- it's the Codfather
5177,922,0,3,9,12,1.25,0.13055824196677338,508,"Fin to God, I have never seen that surfboard in my life.."
6134,922,1,1,10,12,1.25,0.17943514064131835,508,"Yeah, it's my diet."
5729,922,1,1,10,12,1.25,0.17943514064131835,508,"Recognize this seal, Willy?"
1229,922,0,3,9,12,1.25,0.13055824196677338,508,We all look the same to you!
2422,922,0,3,9,12,1.25,0.13055824196677338,508,"Man, ever since Jaws came out, you guys always blame a shark if a severed arm washes up on shore..."
1294,922,0,3,9,12,1.25,0.13055824196677338,508,he was already dead when i got there.
5130,922,1,1,10,12,1.25,0.17943514064131835,508,He was delish!
5128,922,0,3,9,12,1.25,0.13055824196677338,508,Why are we always the usual suspects?
1814,922,1,1,10,12,1.25,0.17943514064131835,508,That's not my fin-gerprint!
2713,922,1,1,10,12,1.25,0.17943514064131835,508,"So what if those're my teeth marks? If some dude burst into your house in just a speedo, you'd probably bite him, too..."
2716,922,0,3,9,12,1.25,0.13055824196677338,508,"For the last time I didn't do that - I'm a lone shark, not a loan shark"
3520,922,0,3,9,12,1.25,0.13055824196677338,508,"That's Mobius. We call him Moby, Dick."
3516,922,0,3,9,12,1.25,0.13055824196677338,508,I'd need a blood sample to be sure...
5828,922,1,1,10,12,1.25,0.17943514064131835,508,"I can't place the face, but the taste is familiar."
6741,922,0,3,9,12,1.25,0.13055824196677338,508,"What's that, a lunch menu?"
4551,922,0,3,9,12,1.25,0.13055824196677338,508,"Looks delicious, but I never seen him before."
2767,922,1,1,10,12,1.25,0.17943514064131835,508,"Hey, do I look like a stool pigeon to you?"
4549,922,1,1,10,12,1.25,0.17943514064131835,508,"No need for a Miranda warning, I'll be representing myself."
1584,922,1,1,10,12,1.25,0.17943514064131835,508,"Naw, He's just a cardshark."
5942,922,1,1,10,12,1.25,0.17943514064131835,508,That's not me. I was the Right Shark.
3358,922,1,1,10,12,1.25,0.17943514064131835,508,"Ok, I recognize that guy. But I ain't spillin' my guts to YOU about it!"
5037,922,1,1,10,12,1.25,0.17943514064131835,508,I told you -- I spent Spring Break at the Cape this year.
2765,922,0,3,9,12,1.25,0.13055824196677338,508,"Yeah, I've seen him. That's the water skiing greaser who jumped me."
1824,922,1,1,10,12,1.25,0.17943514064131835,508,You know what’ll happen if we send you up the river…
3539,922,1,1,10,12,1.25,0.17943514064131835,508,Of course I ate him...how was I supposed to know that was a paddleboard and not a giant cracker
5423,922,0,3,9,12,1.25,0.13055824196677338,508,"I'm in pretty deep, huh?"
89,922,0,3,9,12,1.25,0.13055824196677338,508,We were under water. It's all a blur now.
3308,922,0,3,9,12,1.25,0.13055824196677338,508,Nemo? Haven't seen him.
1489,922,1,1,10,12,1.25,0.17943514064131835,508,It was the Jets that done it.
1850,922,0,3,9,12,1.25,0.13055824196677338,508,"Maaan, I eat 'em all feet first."
5016,922,0,3,9,12,1.25,0.13055824196677338,508,They all look like chum to me.
4487,922,0,3,9,12,1.25,0.13055824196677338,508,Do I look look like a rat?
5020,922,1,1,10,12,1.25,0.17943514064131835,508,You ain't pinnin' the heist at Nobu on me!
1509,922,1,1,10,12,1.25,0.17943514064131835,508,I'm the lawyer.
1513,922,1,1,10,12,1.25,0.17943514064131835,508,It's not me. Too Jawish looking.
5028,922,0,3,9,12,1.25,0.13055824196677338,508,"That was no boating accident, Sherlock."
1516,922,1,1,10,12,1.25,0.17943514064131835,508,"Yeah, but the last time I saw him he had two legs."
3549,922,0,3,9,12,1.25,0.13055824196677338,508,You're bluffing. I'm guessing you haven't found the body.
5979,922,0,3,9,12,1.25,0.13055824196677338,508,"Yeah, I saw him once, just before I ate him."
5977,922,0,3,9,12,1.25,0.13055824196677338,508,Would you mind moving that a bit closer please?
5817,922,1,1,10,12,1.25,0.17943514064131835,508,He was my chum then and he's chum now.
6007,922,0,3,9,12,1.25,0.13055824196677338,508,It appears to me as though I was in international waters.
5121,922,0,3,9,12,1.25,0.13055824196677338,508,I never tasted him before.
4516,922,1,1,10,12,1.25,0.17943514064131835,508,Forget it. I 'm no schoolie!
5858,922,0,3,9,12,1.25,0.13055824196677338,508,I told you before. My game is poker. I don't even own a pool cue!
3446,922,0,3,9,12,1.25,0.13055824196677338,508,He's the one in my lower abdomen.
2738,922,0,3,9,12,1.25,0.13055824196677338,508,"Yeh, I remember him, and they thought he would be 'just sleeping with the fishes.'"
5861,922,1,1,10,12,1.25,0.17943514064131835,508,Ahab? Never seen him before in my life.
1733,922,1,1,10,12,1.25,0.17943514064131835,508,"Yea, that looks like him. Can you rip the photo in half? Just to be sure?"
2740,922,1,1,10,12,1.25,0.17943514064131835,508,Sure I remember him. Blood type A.
3401,922,1,1,10,12,1.25,0.17943514064131835,508,Not another word until I talk to my sea snake.
3404,922,1,1,10,12,1.25,0.17943514064131835,508,"Yeah, I gnawed 'im! A lotta us gnawed 'im!"
3406,922,1,1,10,12,1.25,0.17943514064131835,508,"Hey, guys! I was just trying to take a bite outta crime!"
3407,922,1,1,10,12,1.25,0.17943514064131835,508,D....W....C....A....R
5885,922,1,1,10,12,1.25,0.17943514064131835,508,"That's him alright, he was wearing cement shoes. I'll never forget that..."
5869,922,0,3,9,12,1.25,0.13055824196677338,508,It was an honest mistake. I thought he was a seal.
1695,922,0,3,9,12,1.25,0.13055824196677338,508,I take the fish...er...Fifth.
5882,922,0,3,9,12,1.25,0.13055824196677338,508,I have an alibi. I was in school
5880,922,1,1,10,12,1.25,0.17943514064131835,508,"So, I'm naked! Sharks are SUPPOSED to be naked!"
3450,922,1,1,10,12,1.25,0.17943514064131835,508,You got nothin'. That could be anybody's dorsal fin.
5931,922,0,3,9,12,1.25,0.13055824196677338,508,"That's him, - I recognize the Hillfinger wet-suit."
5900,922,1,1,10,12,1.25,0.17943514064131835,508,"Yep, that is the person I had for lunch!"
4532,922,1,1,10,12,1.25,0.17943514064131835,508,"Yeah, I recognize Fonzie. But I'm completely innocent since he was trespassing when he water-skied through my back yard."
1612,922,1,1,10,12,1.25,0.17943514064131835,508,"So, he owed me a fin, so what?"
42,922,0,3,9,12,1.25,0.13055824196677338,508,"No, that's not me, that's my lawyer. He's got way more teeth."
41,922,0,3,9,12,1.25,0.13055824196677338,508,"I told you, from my vantage point, you humans all look the same!"
3370,922,0,3,9,12,1.25,0.13055824196677338,508,"In my defense, he was trespassing."
3485,922,0,3,9,12,1.25,0.13055824196677338,508,"They all look pretty much the same to me, detective."
3372,922,1,1,10,12,1.25,0.17943514064131835,508,"I swear officers, I've never loaned a dime to anyone"
5926,922,1,1,10,12,1.25,0.17943514064131835,508,What... I was hungry!
1762,922,1,1,10,12,1.25,0.17943514064131835,508,"OK, I'll talk. Now, waterboard me, quick."
1760,922,1,1,10,12,1.25,0.17943514064131835,508,"Yeah that's them, Quint,Brody and Hooper. The ones that killed my big brother."
2733,922,0,3,9,12,1.25,0.13055824196677338,508,"Well, duh…of course it was cold blooded."
1757,922,1,1,10,12,1.25,0.17943514064131835,508,Never seen him. And what kind of name is 'Nemo?'
1640,922,1,1,10,12,1.25,0.17943514064131835,508,"Yeah that's him alright. My cousin, the lawyer"
5909,922,0,3,9,12,1.25,0.13055824196677338,508,... and then this tornado came along.
3460,922,1,1,10,12,1.25,0.17943514064131835,508,"I told you before, I don't recognize any of these guys without their feet."
4530,922,0,3,9,12,1.25,0.13055824196677338,508,"Light meat, dark meat -- they all taste the same."
2737,922,0,3,9,12,1.25,0.13055824196677338,508,"Look, you can see I'm an attorney. You don't have to keep showing me my rights."
1293,922,1,1,10,12,1.25,0.17943514064131835,508,"EVERY TIME a torso washes ashore, you assume it's me."
6008,922,1,1,10,12,1.25,0.17943514064131835,508,Didn't taste like chicken
5141,922,1,1,10,12,1.25,0.17943514064131835,508,What? Are you kidding me? That's bait...
3687,922,0,3,9,12,1.25,0.13055824196677338,508,I was at seaworld that day.
3253,922,0,3,9,12,1.25,0.13055824196677338,508,I eat guys like that for breakfast.
6095,922,1,1,10,12,1.25,0.17943514064131835,508,Don't threaten me. I know my animal rights.
2803,922,0,3,9,12,1.25,0.13055824196677338,508,I ain't taking the bait.
5475,922,1,1,10,12,1.25,0.17943514064131835,508,"I'm tellin ya, dem ain't my tooth marks."
1348,922,1,1,10,12,1.25,0.17943514064131835,508,He slept with fishes. That's why they killed him.
6668,922,1,1,10,12,1.25,0.17943514064131835,508,"I'm a vegan, I tell you. It wasn't me!"
4599,922,0,3,9,12,1.25,0.13055824196677338,508,"Yeah, I seen him. He hangs around a few sand bars near Jersey."
4424,922,1,1,10,12,1.25,0.17943514064131835,508,It wasn't love at first bite.
1357,922,1,0,7,8,1.25,0.25,508,Take a look Killer. Your loan shark days are over.
1939,922,1,1,10,12,1.25,0.17943514064131835,508,Don't all sharks look alike?
6673,922,1,1,10,12,1.25,0.17943514064131835,508,Ha! I know a fishing expedition when I see one!
1362,922,1,1,10,12,1.25,0.17943514064131835,508,I'd like to speak to my lawyer.
6072,922,0,3,9,12,1.25,0.13055824196677338,508,I swear.. I wasn't in The Reef at that time
153,922,0,3,9,12,1.25,0.13055824196677338,508,'I keep telling ya. They all look like food.'
5167,922,0,3,9,12,1.25,0.13055824196677338,508,"Last time I saw them, they said they were going to get a bigger boat."
5150,922,0,3,9,12,1.25,0.13055824196677338,508,"How are you so sure it's me? We all look alike, you know."
1327,922,1,1,10,12,1.25,0.17943514064131835,508,"I demand to see a lawyer – no wait, I am a lawyer."
2647,922,1,1,10,12,1.25,0.17943514064131835,508,"Like I said, food."
1295,922,0,3,9,12,1.25,0.13055824196677338,508,It wasn't me. You should talk to the killer whale.
4405,922,0,3,9,12,1.25,0.13055824196677338,508,Do you recognize your breakfast?
4942,922,0,3,9,12,1.25,0.13055824196677338,508,"Sorry, I only see in black and white."
3709,922,1,1,10,12,1.25,0.17943514064131835,508,This looks a little fishy
184,922,1,1,10,12,1.25,0.17943514064131835,508,Now you're just phishing.
5478,922,1,1,10,12,1.25,0.17943514064131835,508,"Sir, do you recognize the fin in this bowl of soup?"
1966,922,0,3,9,12,1.25,0.13055824196677338,508,I don't do loans; I'm a lawyer.
4946,922,1,1,10,12,1.25,0.17943514064131835,508,"Officer, what are you fishing at?"
2642,922,1,1,10,12,1.25,0.17943514064131835,508,Do all sharks look the same to you?
4947,922,1,1,10,12,1.25,0.17943514064131835,508,We've got to get a bigger boat. What the hell does that mean?
4948,922,1,1,10,12,1.25,0.17943514064131835,508,I'm not good with faces... Do you have a picture of their legs?
1962,922,0,3,9,12,1.25,0.13055824196677338,508,"Yeah, I know him. Who can forget those 'dead' eyes?"
4410,922,1,1,10,12,1.25,0.17943514064131835,508,Its a loan. So what.
3249,922,1,1,10,12,1.25,0.17943514064131835,508,"Like I said, that ain't our work. Go talk to the Jets."
4412,922,0,3,9,12,1.25,0.13055824196677338,508,What happened to 'Good Carp--Bad Carp'?
4955,922,0,3,9,12,1.25,0.13055824196677338,508,He had a hat.
3581,922,0,1,3,4,1.25,0.28867513459481287,508,I ask that the plea sentencing include time served at Sea World.
1921,922,1,1,10,12,1.25,0.17943514064131835,508,Let's just say he's sleepin with the fishes.
3650,922,0,3,9,12,1.25,0.13055824196677338,508,"This good cop, bad cop routine isn't going to work. You both look delicious to me."
4455,922,0,3,9,12,1.25,0.13055824196677338,508,"Ironically, actually spilling my guts is the only way you'll get the license plate on that getaway car."
3291,922,1,1,10,12,1.25,0.17943514064131835,508,They promised an arm and a leg.
116,922,0,3,9,12,1.25,0.13055824196677338,508,It could be him. I don't really look at their heads before I bite them off.
4582,922,0,3,9,12,1.25,0.13055824196677338,508,"If the waterboarding didn't break me, you think flashcards will?"
3608,922,1,1,10,12,1.25,0.17943514064131835,508,"No, he only had one arm."
1888,922,0,3,9,12,1.25,0.13055824196677338,508,If I say yes am I off the hook?
3293,922,0,3,9,12,1.25,0.13055824196677338,508,From the right angle everyone looks like a seal.
6712,922,0,3,9,12,1.25,0.13055824196677338,508,You wouldn't be accusing me if I was a Great White Shark.
3601,922,0,3,9,12,1.25,0.13055824196677338,508,This just isn't my week.
3600,922,1,1,10,12,1.25,0.17943514064131835,508,Let’s get on with the waterboarding.
6022,922,1,1,10,12,1.25,0.17943514064131835,508,"Sorry Bub, that's not my handwriting"
3300,922,0,3,9,12,1.25,0.13055824196677338,508,"No way, candidates give me reflux!"
1875,922,1,1,10,12,1.25,0.17943514064131835,508,If you think I’m going to bite on that you’re nuts!
1467,922,1,1,10,12,1.25,0.17943514064131835,508,"I told you, I'm a vegetarian."
1868,922,1,1,10,12,1.25,0.17943514064131835,508,That's NOT my license plate!
4454,922,1,1,10,12,1.25,0.17943514064131835,508,"For the millionth time, I’m vegan."
2661,922,0,3,9,12,1.25,0.13055824196677338,508,"Yeah I knew the guy, left a bad taste in my mouth."
5787,922,0,3,9,12,1.25,0.13055824196677338,508,Are you kidding? You all look the same from the waist up!
4360,922,0,3,9,12,1.25,0.13055824196677338,508,I swear I haven't seen him since our school days
1917,922,1,1,10,12,1.25,0.17943514064131835,508,Can I taste it instead?
6057,922,0,3,9,12,1.25,0.13055824196677338,508,I couldn't help it...I was on a feeding feeding frenzy!
6686,922,0,3,9,12,1.25,0.13055824196677338,508,"Nah, I can't ID him without seeing him in scuba gear."
3643,922,1,1,10,12,1.25,0.17943514064131835,508,I'm a shark----not a rat.
5777,922,1,1,10,12,1.25,0.17943514064131835,508,"Just 'cause it happened on the west side doesn't mean it was us, what about the Jets?"
6049,922,0,3,9,12,1.25,0.13055824196677338,508,"If he's swimming with the fishies, he ain't swimming with the fishies I know."
1408,922,1,1,10,12,1.25,0.17943514064131835,508,Do I look like I can shuffle cards?
3633,922,1,1,10,12,1.25,0.17943514064131835,508,"Again, a butterfly! Are you guys detectives or psychiatrists?"
3631,922,0,3,9,12,1.25,0.13055824196677338,508,I still maintain that I was smiling for a photo when the tourist slipped off the deck and and into my mouth.
2673,922,0,3,9,12,1.25,0.13055824196677338,508,"I'll tell you everything, if it keeps me out of the tank."
5781,922,0,3,9,12,1.25,0.13055824196677338,508,And he was my attorney!
126,922,1,1,10,12,1.25,0.17943514064131835,508,He was my chum.
3289,922,0,3,9,12,1.25,0.13055824196677338,508,"It was not me. I have been telling you, I'm a vegan."
1423,922,0,3,9,12,1.25,0.13055824196677338,508,"I ate the sheriff, but I did not eat the deputy."
4997,922,0,3,9,12,1.25,0.13055824196677338,508,"No, I can't tell...he was wearing a wetsuit"
6038,922,0,3,9,12,1.25,0.13055824196677338,508,Scheider? Dreyfuss? Never seen them before.
4898,922,0,3,9,12,1.25,0.13055824196677338,508,Does your arm have any last words?
3823,922,0,3,9,12,1.25,0.13055824196677338,508,"I already told ya, I left him a loan."
4280,922,0,3,9,12,1.25,0.13055824196677338,508,I've never dined at that beach in my life!
975,922,1,1,10,12,1.25,0.17943514064131835,508,For the last time! Im a vegetarian
5267,922,0,3,9,12,1.25,0.13055824196677338,508,'That's a script change from 'Jaws' and I had nothing to do with it. Wait... bring it closer...closer...closer.
5604,922,1,1,10,12,1.25,0.17943514064131835,508,The Fonz? Yeah he's the guy who jumped me.
2186,922,1,1,10,12,1.25,0.17943514064131835,508,"Like I told you, I had no accomplice because I'm a lone shark."
6283,922,0,3,9,12,1.25,0.13055824196677338,508,'Kinda hard to say with the legs missing'
462,922,1,1,10,12,1.25,0.17943514064131835,508,It wasn't me. I'm vegan.
751,922,0,3,9,12,1.25,0.13055824196677338,508,Yeah. That's the guy who jumped me. They call him 'The Fonz'.
968,922,0,3,9,12,1.25,0.13055824196677338,508,What was I supposed to do? He was jumping over me.
965,922,1,1,10,12,1.25,0.17943514064131835,508,It's hard to know in street clothes.
2476,922,0,3,9,12,1.25,0.13055824196677338,508,Careful! I've been known eat 'bad cop'.
6287,922,1,1,10,12,1.25,0.17943514064131835,508,I never tasted anything like him in my life
6395,922,1,1,10,12,1.25,0.17943514064131835,508,Look. Don't you think appearing in Jaws 3 was punishment enough?
4302,922,0,3,9,12,1.25,0.13055824196677338,508,"For the last time, I have never seen that limb."
5306,922,1,1,10,12,1.25,0.17943514064131835,508,That couldn't be me. I was still wearing braces then.
5654,922,0,3,9,12,1.25,0.13055824196677338,508,That is a chum wrap!
2304,922,1,1,10,12,1.25,0.17943514064131835,508,Did you or didn't you issue this underwater mortgage?
6390,922,1,1,10,12,1.25,0.17943514064131835,508,I didn't eat that little shrimp.
5376,922,1,1,10,12,1.25,0.17943514064131835,508,"Like I told you, I'm not biting."
6568,922,1,1,10,12,1.25,0.17943514064131835,508,"Sure, it looks like my cousin."
5651,922,1,1,10,12,1.25,0.17943514064131835,508,Forget it. I ain't taking de bait.
451,922,1,1,10,12,1.25,0.17943514064131835,508,He deserved it. He was a bottom-feeder.
2480,922,0,3,9,12,1.25,0.13055824196677338,508,"Aaaaa,,all you humans look alike"
2546,922,1,1,10,12,1.25,0.17943514064131835,508,I'm color blind but I still see race.
2206,922,0,3,9,12,1.25,0.13055824196677338,508,Shamu had it coming...
5648,922,1,1,10,12,1.25,0.17943514064131835,508,How was I supposed to know it was an endangered species.
2481,922,0,3,9,12,1.25,0.13055824196677338,508,I tell you it was self defense. His surfboard slammed into me.
2545,922,1,0,7,8,1.25,0.25,508,Don't like how you're spelling lone shark
2209,922,0,3,9,12,1.25,0.13055824196677338,508,Isn't one of you supposed to be a good cop?
757,922,0,3,9,12,1.25,0.13055824196677338,508,"The Fonz jumped me, I tell you!"
2482,922,0,3,9,12,1.25,0.13055824196677338,508,Are you baiting me?
4093,922,1,1,10,12,1.25,0.17943514064131835,508,We sent him to walk with the animals.
4098,922,1,1,10,12,1.25,0.17943514064131835,508,I was in the gulf of Mexico at the time.
2246,922,0,3,9,12,1.25,0.13055824196677338,508,Of course it looks fishy – I’m a fish!
3095,922,1,1,10,12,1.25,0.17943514064131835,508,I swallowed him in self defense.
3087,922,1,1,10,12,1.25,0.17943514064131835,508,"Yeah, he wuz my chum...so what?"
6425,922,1,1,10,12,1.25,0.17943514064131835,508,"Looks like quite the catch, but I've never seen her."
702,922,0,3,9,12,1.25,0.13055824196677338,508,Wipe that toothy grin off your face.
2905,922,1,1,10,12,1.25,0.17943514064131835,508,"Yeah, he was one of my chums"
708,922,1,1,10,12,1.25,0.17943514064131835,508,What do you mean it's against the law to fish without a license
4660,922,0,3,9,12,1.25,0.13055824196677338,508,It's quite obvious I'm not your man.
995,922,1,1,10,12,1.25,0.17943514064131835,508,We're gonna need a bigger picture.
476,922,0,3,9,12,1.25,0.13055824196677338,508,Yep. Ol' Macky's back in town.
4661,922,0,3,9,12,1.25,0.13055824196677338,508,The white guy did it!
2171,922,0,3,9,12,1.25,0.13055824196677338,508,Your DNA has been linked to numerous seal deaths.
992,922,0,3,9,12,1.25,0.13055824196677338,508,Closer…so I can see.
2322,922,1,1,10,12,1.25,0.17943514064131835,508,"I'll tell you anything, just don't grill me!"
475,922,0,3,9,12,1.25,0.13055824196677338,508,I want to call my dolphin.
2972,922,0,2,6,8,1.25,0.16366341767699427,508,There's something fishy going on in here.
2904,922,0,3,9,12,1.25,0.13055824196677338,508,"Yeah, I might have been chummy with that tuna..."
717,922,0,3,9,12,1.25,0.13055824196677338,508,He's sleeping with the fishes because he's a FISH.
718,922,1,1,10,12,1.25,0.17943514064131835,508,Cough it up!
721,922,0,3,9,12,1.25,0.13055824196677338,508,Dental records prove it's one of your 400 teeth.
471,922,1,1,10,12,1.25,0.17943514064131835,508,"For an appetizer I'll have the Tuna Sushi, and for a main course I'd like the Chilean Sea Bass."
2976,922,1,1,10,12,1.25,0.17943514064131835,508,"Yeah, he was the crabby guy at the Sand Bar."
4834,922,1,1,10,12,1.25,0.17943514064131835,508,Is this edible?
727,922,1,1,10,12,1.25,0.17943514064131835,508,There are plenty of fish in the sea...you expect me to remember just one?
2902,922,1,1,10,12,1.25,0.17943514064131835,508,Mack the Knife
6413,922,1,1,10,12,1.25,0.17943514064131835,508,Surfboard? Looks like a sea lion to me!
3078,922,1,1,10,12,1.25,0.17943514064131835,508,"I'm telling you, it was a bigger boat."
5260,922,0,3,9,12,1.25,0.13055824196677338,508,That whale owed me money.
6274,922,1,1,10,12,1.25,0.17943514064131835,508,Any chance I'll be out of here in time for surf school?
2863,922,0,3,9,12,1.25,0.13055824196677338,508,"Well, they should have had a bigger boat."
3010,922,0,3,9,12,1.25,0.13055824196677338,508,"A surfer you say? No, never seen that guy!"
447,922,1,1,10,12,1.25,0.17943514064131835,508,"Yup, Macky's back in town."
6561,922,1,1,10,12,1.25,0.17943514064131835,508,"Yeah, that's him. I'd know those pearly whites anywhere."
6310,922,1,1,10,12,1.25,0.17943514064131835,508,It was the Jet.
2231,922,0,3,9,12,1.25,0.13055824196677338,508,"I can't be sure, the diver was wearing a mask."
384,922,1,1,10,12,1.25,0.17943514064131835,508,You wouldn’t be such a tough guy if we took off these fin cuffs.
824,922,0,3,9,12,1.25,0.13055824196677338,508,I already told you I was in Cape Cod getting a bite to eat.
901,922,0,3,9,12,1.25,0.13055824196677338,508,How would I know- sharks eat with their eyes closed.
3990,922,1,1,10,12,1.25,0.17943514064131835,508,"So let me get this straight. If I don't talk, you're going to throw me in the tank?"
6355,922,1,1,10,12,1.25,0.17943514064131835,508,"That's her face. I only saw her legs, from below."
897,922,1,1,10,12,1.25,0.17943514064131835,508,It's like I told you. I never bite anyone below the knee.
2869,922,0,3,9,12,1.25,0.13055824196677338,508,"Nice try, but I'm not biting."
6318,922,0,3,9,12,1.25,0.13055824196677338,508,Let me see the other half.' 'Let me see the other half?
422,922,1,1,10,12,1.25,0.17943514064131835,508,"He looks familiar, but all tuna look alike to me."
893,922,1,1,10,12,1.25,0.17943514064131835,508,"Look, I'm just a loan shark, I didn't bite nobody!"
2889,922,0,3,9,12,1.25,0.13055824196677338,508,I'd have to see him without his goggles.
841,922,0,3,9,12,1.25,0.13055824196677338,508,What's the crime in loaning money to people in need?
890,922,0,3,9,12,1.25,0.13055824196677338,508,Never laid A tooth on him!
5281,922,1,1,10,12,1.25,0.17943514064131835,508,That's him! That's the killer whale who raped me.
5634,922,0,3,9,12,1.25,0.13055824196677338,508,Of course I will be representing myself.
887,922,0,3,9,12,1.25,0.13055824196677338,508,Okay already...I'll take a hot pastrami on rye
2509,922,1,1,10,12,1.25,0.17943514064131835,508,This fishing expedition of yours is leaving a bad taste in my mouth.
402,922,1,1,10,12,1.25,0.17943514064131835,508,This is not my week.
6553,922,0,3,9,12,1.25,0.13055824196677338,508,"Hey Columbo, you know I'm still blind, right?"
4807,922,1,1,10,12,1.25,0.17943514064131835,508,"I said he was my chum, and that's all I'm saying until my lawyer gets here."
6329,922,0,3,9,12,1.25,0.13055824196677338,508,"Yeah, that's my old chum. So what?"
3044,922,1,1,10,12,1.25,0.17943514064131835,508,Loan shark? I'm a dolphin!
5278,922,0,3,9,12,1.25,0.13055824196677338,508,"Like I said, they ALL look like seals to me."
880,922,0,3,9,12,1.25,0.13055824196677338,508,But it was shark week...
2526,922,1,1,10,12,1.25,0.17943514064131835,508,"I keep telling you, that could be anybody's dorsal fin!"
2870,922,0,3,9,12,1.25,0.13055824196677338,508,I plead the fish!
4261,922,0,3,9,12,1.25,0.13055824196677338,508,Could be me–there’s no mirrors in the ocean.
2495,922,0,3,9,12,1.25,0.13055824196677338,508,I told you. Whitey done it.
4036,922,0,3,9,12,1.25,0.13055824196677338,508,Are you why we can't find Nemo?
5614,922,0,3,9,12,1.25,0.13055824196677338,508,"Yeah, I know the guy...I heard he's swimming with the fishes."
5647,922,0,3,9,12,1.25,0.13055824196677338,508,What? I was just getting take out.
4774,922,1,1,10,12,1.25,0.17943514064131835,508,"No, that's not the bad cop, that's the good cop. In fact, they were both very good."
4063,922,0,3,9,12,1.25,0.13055824196677338,508,He don't look the same without them cement shoes.
2486,922,0,3,9,12,1.25,0.13055824196677338,508,I only sign in blood.
4780,922,1,1,10,12,1.25,0.17943514064131835,508,"How should I know? All sharks look alike to me, too."
2290,922,0,3,9,12,1.25,0.13055824196677338,508,I ain't no stool pigeon.
5274,922,0,3,9,12,1.25,0.13055824196677338,508,"That does look like one of my loans, but I was in Lake Como at that time."
791,922,0,3,9,12,1.25,0.13055824196677338,508,"Hey, you all look the same to me"
4783,922,0,3,9,12,1.25,0.13055824196677338,508,He had a lot of anemones.
2489,922,0,3,9,12,1.25,0.13055824196677338,508,What? You expect me to remember everyone I ate?
795,922,1,1,10,12,1.25,0.17943514064131835,508,Stop showing me photos of your mother.
438,922,1,1,10,12,1.25,0.17943514064131835,508,"No way I was even there, I know I'm not supposed to swim within 100 yards of a school"
6372,922,0,3,9,12,1.25,0.13055824196677338,508,"Yes, that's the killer whale."
3972,922,1,1,10,12,1.25,0.17943514064131835,508,"So, which one of you is the bad cop?"
4784,922,0,3,9,12,1.25,0.13055824196677338,508,He should'a gotten a bigger boat.
2224,922,0,3,9,12,1.25,0.13055824196677338,508,It's times like these that I wish I had a little more backbone
4049,922,0,3,9,12,1.25,0.13055824196677338,508,"Oh, get real. Anyone can see that's the LEFT shark."
3976,922,1,1,10,12,1.25,0.17943514064131835,508,You have the right to remain salient.
2285,922,1,1,10,12,1.25,0.17943514064131835,508,I already told you..you seals all look alike to me.
4789,922,1,1,10,12,1.25,0.17943514064131835,508,"Sure, I seen him. He swims with the fishes!"
376,922,1,1,10,12,1.25,0.17943514064131835,508,Advising me to hire a lawyer would be redundant
3022,922,1,1,10,12,1.25,0.17943514064131835,508,One fish two fish red fish blue fish...are you gonna make me do the whole thing?
3979,922,1,1,10,12,1.25,0.17943514064131835,508,"But officer, I'm a vegan!"
4259,922,0,3,9,12,1.25,0.13055824196677338,508,You guys gotta admit he kinda looks like a seal.
6306,922,1,1,10,12,1.25,0.17943514064131835,508,I can't name that tuna.
814,922,1,1,10,12,1.25,0.17943514064131835,508,"Okay...I agree, this was no boating accident."
2280,922,0,3,9,12,1.25,0.13055824196677338,508,Everyone always wants to blame the shark.
5374,922,0,3,9,12,1.25,0.13055824196677338,508,"Amity Island, 1975? Never heard of it."
2160,922,1,1,10,12,1.25,0.17943514064131835,508,I never heard of no Mack the Knife.
695,922,1,1,10,12,1.25,0.17943514064131835,508,"OK, OK, but it did look like a seal."
483,922,0,3,9,12,1.25,0.13055824196677338,508,I tell you that's not me in the surveillance photo. You must think all sharks look alike.
6427,922,1,1,10,12,1.25,0.17943514064131835,508,Looks like he got what he fished for.
4160,922,1,1,10,12,1.25,0.17943514064131835,508,Are you supposed to be the good carp?
6492,922,1,1,10,12,1.25,0.17943514064131835,508,You hauled in the wrong shark. Legs like that I'd remember.
6494,922,0,3,9,12,1.25,0.13055824196677338,508,This was no boat accident.
2588,922,1,1,10,12,1.25,0.17943514064131835,508,So I smoked him. Can me.
6220,922,1,1,10,12,1.25,0.17943514064131835,508,"Yeah, that's Miranda all right. I ate her last week."
4880,922,0,3,9,12,1.25,0.13055824196677338,508,"It's just like I told you, I ate him Tuesday for breakfast. What's the problem, officer?"
608,922,0,3,9,12,1.25,0.13055824196677338,508,"No, I've never given him a loan either"
5685,922,1,1,10,12,1.25,0.17943514064131835,508,"I swear, he was already a one-armed man."
4876,922,1,1,10,12,1.25,0.17943514064131835,508,Is it my handwriting? What do you think?
4649,922,1,1,10,12,1.25,0.17943514064131835,508,Hey fellas for the last time I am telling you he was dressed like a seal
5386,922,1,1,10,12,1.25,0.17943514064131835,508,I don't know; I wasn't biting him on the face!
2396,922,1,1,10,12,1.25,0.17943514064131835,508,But he was swimming outside the buoys.
610,922,0,3,9,12,1.25,0.13055824196677338,508,They all look like seals to me.
4739,922,0,3,9,12,1.25,0.13055824196677338,508,I don't have my glasses.
613,922,1,1,10,12,1.25,0.17943514064131835,508,"You know, if I'd been a dolphin, you woulda never hauled me in."
1082,922,0,3,9,12,1.25,0.13055824196677338,508,You're gonna need a bigger charge sheet.
4322,922,0,3,9,12,1.25,0.13055824196677338,508,"As I've told you repeatedly, attorney-client communication is privileged."
538,922,0,3,9,12,1.25,0.13055824196677338,508,He was sleeping with the fishes. So I ate him!
615,922,0,3,9,12,1.25,0.13055824196677338,508,"Look, he jumped me alright?"
2393,922,0,3,9,12,1.25,0.13055824196677338,508,"Nah, I don't do loans, I'm more in the pay back business."
4151,922,0,3,9,12,1.25,0.13055824196677338,508,"No, he wasn't my chum."
3877,922,1,1,10,12,1.25,0.17943514064131835,508,Can I get a tank of water first?
532,922,1,1,10,12,1.25,0.17943514064131835,508,I've never seen that beach in my life.
5679,922,1,1,10,12,1.25,0.17943514064131835,508,"Yeah. It's Luca Brasi, but I never swam with him."
625,922,1,1,10,12,1.25,0.17943514064131835,508,What happens during 'Shark Week' stays in 'Shark Week'.
314,922,0,3,9,12,1.25,0.13055824196677338,508,I told you. I haven't eaten a bluefin since they were declared endangered.
6426,922,1,1,10,12,1.25,0.17943514064131835,508,"No, I don't recognize him. I told you when I found that leg there wasn't anybody attached to it."
5556,922,1,1,10,12,1.25,0.17943514064131835,508,"Jaws, but you didn't hear it from me."
1103,922,0,3,9,12,1.25,0.13055824196677338,508,Five'll get you ten ol' Mackie's back in town.
2402,922,0,3,9,12,1.25,0.13055824196677338,508,I ain't talkin' till I've eaten my lawyer.
4716,922,0,3,9,12,1.25,0.13055824196677338,508,Could you repeat the question. I'm hard of herring.
5494,922,0,3,9,12,1.25,0.13055824196677338,508,"Where I come from, arm robbery isn't a crime"
6613,922,1,1,10,12,1.25,0.17943514064131835,508,"'We all have dead eyes, what's your point?"
3826,922,1,1,10,12,1.25,0.17943514064131835,508,"Yeah, that's an overbite, so what?"
2084,922,0,3,9,12,1.25,0.13055824196677338,508,You want an alibi? Check with my agent. I was on set shooting Shark Week.
6481,922,1,1,10,12,1.25,0.17943514064131835,508,'I want a lawyer. And some water.
4181,922,0,3,9,12,1.25,0.13055824196677338,508,Legs? Really? They all look the same to me...
2088,922,1,1,10,12,1.25,0.17943514064131835,508,Yeah? Those could be anybody's teethmarks.
4629,922,0,3,9,12,1.25,0.13055824196677338,508,I don't recognize that leg.
275,922,1,1,10,12,1.25,0.17943514064131835,508,We're marine biologists. We have ways of making you talk.
558,922,1,1,10,12,1.25,0.17943514064131835,508,"Yeah, I ate him. What part of feeding frenzy don't you get?"
3142,922,0,3,9,12,1.25,0.13055824196677338,508,This is a clear case of dorsal profiling.
2937,922,0,3,9,12,1.25,0.13055824196677338,508,You can't prove a thing without at least 50% of a body.
4189,922,1,1,10,12,1.25,0.17943514064131835,508,It's the dentist I see to get my teeth sharpened.
4149,922,1,1,10,12,1.25,0.17943514064131835,508,"Sure, he looks familiar. But in my line of work, you meet a lot of seals..."
2426,922,0,3,9,12,1.25,0.13055824196677338,508,"That's not me, that's a dolphin!"
4889,922,0,3,9,12,1.25,0.13055824196677338,508,"No, I would have eaten the surfboard too."
6211,922,1,1,10,12,1.25,0.17943514064131835,508,"Never seen him, bro. I don't hang with hammerheads."
5497,922,1,1,10,12,1.25,0.17943514064131835,508,Of course I recognize Richard Dreyfuss.
3138,922,0,3,9,12,1.25,0.13055824196677338,508,Miranda ? I think I had her for lunch a while back.
4171,922,1,1,10,12,1.25,0.17943514064131835,508,"It looks like Charlie, but that's no tuna."
4347,922,0,3,9,12,1.25,0.13055824196677338,508,Way too low in the food chain for me.
4717,922,1,1,10,12,1.25,0.17943514064131835,508,I don't give a damn what he calls himself; that's Mack the Spoon!
2590,922,0,3,9,12,1.25,0.13055824196677338,508,How do you expect me to recognize a leg!
4345,922,0,3,9,12,1.25,0.13055824196677338,508,Robert Shaw? Never heard of him.
589,922,0,3,9,12,1.25,0.13055824196677338,508,Why is it so implausible that I was home sleeping?
4883,922,1,1,10,12,1.25,0.17943514064131835,508,"Yeah, that looks like the long arm of the law."
4735,922,1,1,10,12,1.25,0.17943514064131835,508,"I'm not so good with faces, officer. I'm more of a leg man."
4736,922,0,3,9,12,1.25,0.13055824196677338,508,"Surfer, what surfer? Like I told ya..it was a sea lion."
4730,922,1,1,10,12,1.25,0.17943514064131835,508,"For the last time, I'm a WHITE shark!"
526,922,0,3,9,12,1.25,0.13055824196677338,508,This has Netflix documentary written all over it.
5326,922,0,3,9,12,1.25,0.13055824196677338,508,I've never even been to Amity Island
4232,922,0,3,9,12,1.25,0.13055824196677338,508,"Technically speaking, I agree it looks fishy."
5247,922,0,3,9,12,1.25,0.13055824196677338,508,I liked the thigh photo better.
5574,922,0,3,9,12,1.25,0.13055824196677338,508,Those surfers had it coming. They were all up in my krill.
4136,922,1,1,10,12,1.25,0.17943514064131835,508,I've never seen that surfboard before in my life.
5249,922,1,1,10,12,1.25,0.17943514064131835,508,You can plainly see why I had to disarm him.
6252,922,1,1,10,12,1.25,0.17943514064131835,508,"L-O-N-E, not L-O-A-N. Read it yourself."
4691,922,0,3,9,12,1.25,0.13055824196677338,508,The bikini looks familiar but the face is a blur...
672,922,0,3,9,12,1.25,0.13055824196677338,508,"Eleven hundred men went into the water, three hundred sixteen came out. That's all I know."
4133,922,1,1,10,12,1.25,0.17943514064131835,508,"Let me guess: the good carp, bad carp routine?"
331,922,0,3,9,12,1.25,0.13055824196677338,508,"Yeah, that's me. But he was already bleeding when I got there."
3910,922,0,3,9,12,1.25,0.13055824196677338,508,Of course I did it in cold blood.
496,922,1,1,10,12,1.25,0.17943514064131835,508,That's him! That's the man who jumped me!
1026,922,0,3,9,12,1.25,0.13055824196677338,508,"Like I said, they all look like seals."
492,922,1,1,10,12,1.25,0.17943514064131835,508,He asked for it. He said he was my chum!
4659,922,1,1,10,12,1.25,0.17943514064131835,508,Faces don't mean nothin' to me. Show me the feet.
1021,922,0,3,9,12,1.25,0.13055824196677338,508,"I'm telling you, he came after me with a surf board!"
490,922,1,1,10,12,1.25,0.17943514064131835,508,Do I look like a stool pigeon?
4311,922,0,3,9,12,1.25,0.13055824196677338,508,"Look, it's not my proudest moment. But it was Shark Week."
2355,922,0,3,9,12,1.25,0.13055824196677338,508,"Haven't seen her, and I never forget a tan line"
487,922,0,3,9,12,1.25,0.13055824196677338,508,And just how does a creature without any fingers pull a trigger?
1018,922,1,1,10,12,1.25,0.17943514064131835,508,Are you intimating I had something to do with Mr. Spielberg’s unfortunate accident?
4749,922,0,3,9,12,1.25,0.13055824196677338,508,I told you already - I've never seen those legs before!
6257,922,1,1,10,12,1.25,0.17943514064131835,508,It's just another red herring.
3917,922,0,3,9,12,1.25,0.13055824196677338,508,They all look the same to me
337,922,1,1,10,12,1.25,0.17943514064131835,508,"I know it looks like my bite mark, but I would never attack a lawyer - professional courtesy!"
3919,922,1,1,10,12,1.25,0.17943514064131835,508,It's krill! Krill don't have names!
6581,922,0,3,9,12,1.25,0.13055824196677338,508,Tommy Bahama? You gotta be kidding. Not my taste.
5315,922,0,3,9,12,1.25,0.13055824196677338,508,"I swear, I never ate that guy in my life."
2910,922,1,1,10,12,1.25,0.17943514064131835,508,I confess that my loans have not been above water.
1036,922,1,1,10,12,1.25,0.17943514064131835,508,I’ve been facially profiled!
4809,922,1,1,10,12,1.25,0.17943514064131835,508,"Yes, I am a shark, but I would never, ever push loan terms like those."
6443,922,0,3,9,12,1.25,0.13055824196677338,508,"I don't know loans, I just play pool"
4655,922,0,3,9,12,1.25,0.13055824196677338,508,"Every time a swimmer goes missing, you guys drag me in here!"
318,922,1,1,10,12,1.25,0.17943514064131835,508,Hey! They all look alike. A meal's a meal.
4218,922,0,3,9,12,1.25,0.13055824196677338,508,"I want a lawyer, a real lawyer not some shark!"
2572,922,0,3,9,12,1.25,0.13055824196677338,508,"Holy mackerel you guys, I keep telling you I just saw the legs."
2383,922,0,3,9,12,1.25,0.13055824196677338,508,"I admit I'd been drinking heavily, but I'm not a monster."
5243,922,1,1,10,12,1.25,0.17943514064131835,508,"I'm tellin' ya, ya want a guy named Moby Dick."
3893,922,1,1,10,12,1.25,0.17943514064131835,508,"Yeah, he's my client. So what."
2138,922,1,1,10,12,1.25,0.17943514064131835,508,"Look, I may be a killer shark, but I'm no murderer."
2382,922,0,3,9,12,1.25,0.13055824196677338,508,He was a chum from my school days.
2458,922,1,1,10,12,1.25,0.17943514064131835,508,I demand to see my client.
2140,922,0,3,9,12,1.25,0.13055824196677338,508,"Nope. That's Carl, but I guess we all look the same, don't we Detective?"
2378,922,0,3,9,12,1.25,0.13055824196677338,508,"Yeah, I ate him. And I'd do it again!"
1045,922,1,1,10,12,1.25,0.17943514064131835,508,"Ah, you're just gonna say, 'It takes one to know one.'"
1048,922,0,3,9,12,1.25,0.13055824196677338,508,"I told you, my memory gets a little fuzzy when I go into a feeding frenzy."
2452,922,0,3,9,12,1.25,0.13055824196677338,508,"'Sure I seen all dem seals , but I never touched em ! See , just cruised bye said how ya dowin? I bin framed , see ?"
507,922,0,3,9,12,1.25,0.13055824196677338,508,"Yes, you do look great in a speedo"
5503,922,0,3,9,12,1.25,0.13055824196677338,508,"Stop, I can't eat another thing, your holding tank was superb."
4314,922,1,1,10,12,1.25,0.17943514064131835,508,Self defense. He tried to jump me.
4856,922,0,3,9,12,1.25,0.13055824196677338,508,"Yes, I have received my Miranda Rights. Move on!"
2954,922,0,3,9,12,1.25,0.13055824196677338,508,"Sorry pal, it's not me. I'm a vegetarian."
511,922,0,3,9,12,1.25,0.13055824196677338,508,"I can't be sure, but those look like the right legs."
3112,922,1,1,10,12,1.25,0.17943514064131835,508,Yeah! That's him! And he swore my name would be above the title!'
753,1383,1,1,11,13,1.2307692307692308,0.16617283842071434,508,That's him. I'd recognize that leg anywhere.
1012,1383,0,3,10,13,1.2307692307692308,0.12162606385262995,508,"Ask my pilot fish, he will tell you I was in Miami at the time."
2804,1383,0,3,10,13,1.2307692307692308,0.12162606385262995,508,That's Lenny. He's the top of the food chain.
539,1383,0,3,10,13,1.2307692307692308,0.12162606385262995,508,"You're assuming I did that 'cause I'm a blue shark. A great white would never do that, right?"
5563,1383,0,3,10,13,1.2307692307692308,0.12162606385262995,508,"I've seen the one half of him, now bring the picture around to my other side."
3744,1383,0,3,10,13,1.2307692307692308,0.12162606385262995,508,"Him? Yeah, I seen him. He sleeps with the fishes."
3280,1383,0,3,10,13,1.2307692307692308,0.12162606385262995,508,"Sorry, one-legged people all look the same to me."
3481,1390,0,2,7,9,1.2222222222222223,0.1469861839480328,508,"No, no; the board that ran over me was green with yellow diagonal stripes and ten toes dangling off the back."
486,1390,0,2,7,9,1.2222222222222223,0.1469861839480328,508,I want a maritime lawyer.
747,1390,0,2,7,9,1.2222222222222223,0.1469861839480328,508,"I am not guilty! Like I was telling you, fish are friends not food."
1636,1390,0,2,7,9,1.2222222222222223,0.1469861839480328,508,Yes that's the surfboard that broke my tooth.
5329,1390,0,2,7,9,1.2222222222222223,0.1469861839480328,508,"Nah, that's not me -- I don't go to frenzies any more."
3533,1390,1,0,8,9,1.2222222222222223,0.2222222222222222,508,"No, that's not my card."
4727,1390,0,2,7,9,1.2222222222222223,0.1469861839480328,508,"Sure I know him, he owes me a 100 bucks."
2746,1390,0,2,7,9,1.2222222222222223,0.1469861839480328,508,I told you it's the left leg!
3472,1390,0,2,7,9,1.2222222222222223,0.1469861839480328,508,I ain't sayin' a word until I talk to my court appointed shark.
3657,1390,0,2,7,9,1.2222222222222223,0.1469861839480328,508,I don't know; Can you draw a scuba mask on him?
242,1390,1,0,8,9,1.2222222222222223,0.2222222222222222,508,Looks like Mack the Knife...what of it?
883,1390,0,2,7,9,1.2222222222222223,0.1469861839480328,508,You can't pin this on me copper. They shoulda got a bigger boat!
264,1390,0,2,7,9,1.2222222222222223,0.1469861839480328,508,"It wasn't me, so stop fishing"
5197,1390,0,2,7,9,1.2222222222222223,0.1469861839480328,508,How many times do I have to say it ?It's a red herring!
379,1390,0,2,7,9,1.2222222222222223,0.1469861839480328,508,That shark cage doesn't scare me.
4300,1390,0,2,7,9,1.2222222222222223,0.1469861839480328,508,"Sure, everyone knows Honolulu Lulu."
3359,1406,0,2,8,10,1.2,0.13333333333333333,508,"Whatta you gonna do, waterboard me?"
2909,1406,1,0,9,10,1.2,0.19999999999999998,508,"Idiot, I said, 'Lone Shark.'"
2153,1406,0,2,8,10,1.2,0.13333333333333333,508,I've never even heard of Riff or Tony.
1781,1406,0,2,8,10,1.2,0.13333333333333333,508,"You know this 'good cop, bad cop' thing won't work on me. I'd just as soon eat either one of you."
2012,1406,0,2,8,10,1.2,0.13333333333333333,508,Not my chum.
2150,1406,0,2,8,10,1.2,0.13333333333333333,508,"So, if I talk before the giant squid, I get to swim, right?"
3356,1406,1,0,9,10,1.2,0.19999999999999998,508,"Yeh, that's Spielberg."
1780,1406,0,2,8,10,1.2,0.13333333333333333,508,I'd never bite into anything that ugly
5318,1406,0,2,8,10,1.2,0.13333333333333333,508,It was either the chef or me in that sushi bar.
5586,1406,0,2,8,10,1.2,0.13333333333333333,508,The last time I saw that guy he was swimmin' with the fishes.
2149,1406,1,0,9,10,1.2,0.19999999999999998,508,"Way too skinny for me, totally not my type. I like em’ with more meat on the bone. Know what I'm sayin’ captain?"
2723,1406,0,2,8,10,1.2,0.13333333333333333,508,It's not a crime for my species to charge 12% interest.
5192,1406,0,2,8,10,1.2,0.13333333333333333,508,What do you mean I'm not a legal U.S. citizen?
2623,1406,0,2,8,10,1.2,0.13333333333333333,508,That surfboard does NOT look familiar
2622,1406,0,2,8,10,1.2,0.13333333333333333,508,Check with SeaWorld!
5543,1406,0,2,8,10,1.2,0.13333333333333333,508,"Yes, your son's drawing is very good, now can we get back to work?"
5186,1406,0,2,8,10,1.2,0.13333333333333333,508,"Yes, I've worked for that loan company for six years, why do you ask?"
5576,1406,1,0,9,10,1.2,0.19999999999999998,508,"So, it's a picture of your legless friend?"
3200,1406,0,2,8,10,1.2,0.13333333333333333,508,What happens in Shark Week stays in Shark Week.
5438,1406,0,2,8,10,1.2,0.13333333333333333,508,I ain't talkin' so you might as well water-board me.
2142,1406,0,2,8,10,1.2,0.13333333333333333,508,"So now what, you boys gonna lock me in the aquarium again?"
2015,1406,0,2,8,10,1.2,0.13333333333333333,508,"Like I told the other guy, I *found* that surfboard."
5350,1406,0,2,8,10,1.2,0.13333333333333333,508,"Even if it is my tooth, I have no idea how it got there."
2014,1406,0,2,8,10,1.2,0.13333333333333333,508,"I'm tellin' ya, I don't know anything about that loan!"
5118,1406,0,2,8,10,1.2,0.13333333333333333,508,Can't quite put my finger on him. Do you have a blood sample?
5580,1406,0,2,8,10,1.2,0.13333333333333333,508,Of course I ate her! I'm a shark for God's sake.
3111,1406,0,2,8,10,1.2,0.13333333333333333,508,"Like I said, it was self-defense."
2762,1406,0,2,8,10,1.2,0.13333333333333333,508,"No, but I ate his wife."
1770,1406,0,2,8,10,1.2,0.13333333333333333,508,I insist on an attorney--preferably salted.
5674,1406,1,0,9,10,1.2,0.19999999999999998,508,"Of course I don't know that fish, you idiot. It's a rainbow trout. They're freshwater fish."
2848,1406,1,0,9,10,1.2,0.19999999999999998,508,"Yeah, I seen him in the neighborhood, sleeping with the fishes."
2370,1406,1,0,9,10,1.2,0.19999999999999998,508,"Come on, this whole good-cop, bad-cop act has jumped the me."
2013,1406,0,2,8,10,1.2,0.13333333333333333,508,"That couldn't have hurt anyone, I only keep it around for training porpoises."
2354,1406,0,2,8,10,1.2,0.13333333333333333,508,I don't know. They all taste alike to me.
2663,1406,0,2,8,10,1.2,0.13333333333333333,508,Hath not a shark teeth?
2824,1406,0,2,8,10,1.2,0.13333333333333333,508,No! I didn't make that loan.
3086,1406,0,2,8,10,1.2,0.13333333333333333,508,"Yeah, that's me hangin' around that school. Which one of those herrings squealed?"
5314,1406,0,2,8,10,1.2,0.13333333333333333,508,Too late. He's swimming with fishes now.
3234,1406,0,2,8,10,1.2,0.13333333333333333,508,From my angle it looked like a big seal.
2172,1406,0,2,8,10,1.2,0.13333333333333333,508,I want to speak to my scum sucking bottom feeder.
3348,1406,1,0,9,10,1.2,0.19999999999999998,508,I never loaned money to that person.
5259,1406,1,0,9,10,1.2,0.19999999999999998,508,I'm innocent I tell ya. You guys jumped the shark.
1807,1406,0,2,8,10,1.2,0.13333333333333333,508,"I don't know, one pair of kicking legs looks like another to me."
2469,1406,0,2,8,10,1.2,0.13333333333333333,508,He wore a wire into the ocean. What did you expect?
5171,1406,0,2,8,10,1.2,0.13333333333333333,508,Why would I? I’m a vegetarian!
2636,1406,1,0,9,10,1.2,0.19999999999999998,508,"Yeah, well, he didn’t taste so good."
1809,1406,1,0,9,10,1.2,0.19999999999999998,508,"I dont know how the shark tooth got there, I've never even been to Manitowoc."
1976,1406,0,2,8,10,1.2,0.13333333333333333,508,What happens in the ocean stays in the ocean.
2339,1406,0,2,8,10,1.2,0.13333333333333333,508,You can't pump my stomach. I got my rights.
1974,1406,0,2,8,10,1.2,0.13333333333333333,508,This is dorsal profiling.
3346,1406,0,2,8,10,1.2,0.13333333333333333,508,So you found Nemo.
2168,1406,0,2,8,10,1.2,0.13333333333333333,508,I've never seen that surf board before.
5829,1406,0,2,8,10,1.2,0.13333333333333333,508,"Yeah that’s me in a frenzy, but I wasn’t feeding."
5541,1406,0,2,8,10,1.2,0.13333333333333333,508,"Smells like blood, but I'll defer to the forensic pathologist."
5352,1406,0,2,8,10,1.2,0.13333333333333333,508,Of course it sounds fishy.
2822,1406,0,2,8,10,1.2,0.13333333333333333,508,I've never eaten him before in my life
3354,1406,0,2,8,10,1.2,0.13333333333333333,508,"Sorry man, I got the munchies"
1994,1406,0,2,8,10,1.2,0.13333333333333333,508,Waterboarding won't work.
1794,1406,1,0,9,10,1.2,0.19999999999999998,508,We'll see about that when my attorney gets here.
5181,1406,1,0,9,10,1.2,0.19999999999999998,508,I ain't talking until my lawyer gets here. She's also a shark.
5668,1406,0,2,8,10,1.2,0.13333333333333333,508,"Sure I knew him, but it doesn't mean I ate him."
5832,1406,1,0,9,10,1.2,0.19999999999999998,508,That's not my writing.
3198,1406,0,2,8,10,1.2,0.13333333333333333,508,"Thats right, it was a Red Herring!"
1990,1406,1,0,9,10,1.2,0.19999999999999998,508,"Protecting one's home is not a crime, brrp!"
1799,1406,0,2,8,10,1.2,0.13333333333333333,508,That looks like Mack's work to me.
2721,1406,0,2,8,10,1.2,0.13333333333333333,508,"Yeah I saw her, but she wasn't my type."
5667,1406,0,2,8,10,1.2,0.13333333333333333,508,You've seen one leg you've seen 'em all
2167,1406,1,0,9,10,1.2,0.19999999999999998,508,Predatory lending? Are you calling me a loan shark? I'm a respectable Wall Street hedge fund manager.
2813,1406,0,2,8,10,1.2,0.13333333333333333,508,"Those aren't my teeth marks and, anyway, leg isn't my thing."
5830,1406,1,0,9,10,1.2,0.19999999999999998,508,So you want to use me as bait.
5351,1406,0,2,8,10,1.2,0.13333333333333333,508,I told you it was a tuna. Stop showing me marlins.
5739,1406,0,2,8,10,1.2,0.13333333333333333,508,Why would I kill my wife to be with that woman? They all look the same!
5116,1406,0,2,8,10,1.2,0.13333333333333333,508,He's the one who tricked me with the bait & switch.
2139,1406,1,0,9,10,1.2,0.19999999999999998,508,"Oooh, has our boy done somethin' rash?"
2717,1406,0,2,8,10,1.2,0.13333333333333333,508,Big deal! Who doesn't sleep with the fishes?
5708,1406,0,2,8,10,1.2,0.13333333333333333,508,I'm not that 'Jaws'.
2589,1406,1,0,9,10,1.2,0.19999999999999998,508,"Yeah, that's him. I'd recognize that leg anywhere."
3136,1406,0,2,8,10,1.2,0.13333333333333333,508,It says here your last employment was Candygram delivery- tell us more about that...
5490,1406,0,2,8,10,1.2,0.13333333333333333,508,"Fellas, you got the wrong guy! I ain't no loan shark!"
5687,1406,0,2,8,10,1.2,0.13333333333333333,508,I won't answer questions until the bottom feeder shows up.
2742,1406,0,2,8,10,1.2,0.13333333333333333,508,Get this straight- I'm not a rat!
3171,1406,0,2,8,10,1.2,0.13333333333333333,508,I'll NEVER forget those legs.
3173,1406,0,2,8,10,1.2,0.13333333333333333,508,"Yeah, he owed me a few clams and I had to use some mussel."
1731,1406,0,2,8,10,1.2,0.13333333333333333,508,I told you before and I'll tell you again: it was shark week.
2607,1406,0,2,8,10,1.2,0.13333333333333333,508,"You say victim, I say main course..."
2400,1406,1,0,9,10,1.2,0.19999999999999998,508,"Grill me all you want, but I prefer to stew in my own juices."
2432,1406,1,0,9,10,1.2,0.19999999999999998,508,He looked a lot tastier in person.
5863,1406,0,2,8,10,1.2,0.13333333333333333,508,Do you think I have eyes on the front of my head?
5862,1406,1,0,9,10,1.2,0.19999999999999998,508,I can smell a set-up a mile away!
2399,1406,0,2,8,10,1.2,0.13333333333333333,508,"I told you. I'm just a regular shark, not a loan shark"
5568,1406,0,2,8,10,1.2,0.13333333333333333,508,"Like I told you, I haven't seen megalodon since the Pliocene."
2608,1406,1,0,9,10,1.2,0.19999999999999998,508,Give me one good reason why I would kill my own accountant.
2405,1406,0,2,8,10,1.2,0.13333333333333333,508,Take another look. His name is Charlie the Tuna.
2752,1406,0,2,8,10,1.2,0.13333333333333333,508,"For the last time, I'm Right Shark."
3157,1406,0,2,8,10,1.2,0.13333333333333333,508,"Yeah, I knew him. Ok, I ate him."
3146,1406,1,0,9,10,1.2,0.19999999999999998,508,Miranda? I thought that was last week's lunch.
1712,1406,0,2,8,10,1.2,0.13333333333333333,508,That was no boating accident!
3159,1406,0,2,8,10,1.2,0.13333333333333333,508,Yeah I did it...I did it on porpoise!
5390,1406,0,2,8,10,1.2,0.13333333333333333,508,"Nah, not me. I was in school at the time."
3161,1406,0,2,8,10,1.2,0.13333333333333333,508,Who's this? Did I eat him?
3162,1406,0,2,8,10,1.2,0.13333333333333333,508,"You know I'm not a mammal, right? I am literally a fish out of water."
5334,1406,0,2,8,10,1.2,0.13333333333333333,508,"Yeah, I recognize him--he was delicious."
1716,1406,0,2,8,10,1.2,0.13333333333333333,508,I am not a loan shark!
2068,1406,0,2,8,10,1.2,0.13333333333333333,508,"I tell you he's a Jet, not a Shark!"
2593,1406,0,2,8,10,1.2,0.13333333333333333,508,This guy's riddled with bullets! I may be a killer but that ain't my M.O.
5870,1406,0,2,8,10,1.2,0.13333333333333333,508,"Ok, I admit it. I ate him. And I'd eat him again. He was delicious."
2833,1406,0,2,8,10,1.2,0.13333333333333333,508,'Ok! So you found his legs. But those aren't my tooth marks.'
1720,1406,1,0,9,10,1.2,0.19999999999999998,508,He's just an old chum.
2406,1406,1,0,9,10,1.2,0.19999999999999998,508,"No, I don't recognize that arm."
5689,1406,0,2,8,10,1.2,0.13333333333333333,508,You can't make me sign that.
2380,1406,0,2,8,10,1.2,0.13333333333333333,508,...and I'm telling you I don't know any one-legged surfers.
2104,1406,0,2,8,10,1.2,0.13333333333333333,508,"Yea, I gave him a loan , but I didn't kill em'."
5859,1406,0,2,8,10,1.2,0.13333333333333333,508,Think about it: 'Sign your confession?'
5205,1406,0,2,8,10,1.2,0.13333333333333333,508,"Ya ok, you're right; I did it to save my own fin..."
3390,1406,0,2,8,10,1.2,0.13333333333333333,508,"What would I know about a loan shar—... okay, I see what's going on here."
5108,1406,0,2,8,10,1.2,0.13333333333333333,508,"Yeah, that's the loan shark."
5553,1406,1,0,9,10,1.2,0.19999999999999998,508,"I'm swimming along, minding my own business and that guy slugs me in the nose!"
2757,1406,0,2,8,10,1.2,0.13333333333333333,508,"No, never seen him. I keep telling you, I'm a lone shark, not a loan shark."
5573,1406,0,2,8,10,1.2,0.13333333333333333,508,"No officer, I told you already.....I've never seen that surfer before....the one I saw had BOTH his arms."
2618,1406,0,2,8,10,1.2,0.13333333333333333,508,Charlie the Tuna? Never heard of the fish.
2035,1406,0,2,8,10,1.2,0.13333333333333333,508,I'm telling you I am not gonna take the bait.
5548,1406,0,2,8,10,1.2,0.13333333333333333,508,"No, I don't know Sharkeesha, and you wouldn't be doing this if I were a Great White."
2034,1406,0,2,8,10,1.2,0.13333333333333333,508,"I want my lawyer, who, it just so happens, is also a shark."
2574,1406,0,2,8,10,1.2,0.13333333333333333,508,We know you did it! You past her swimsuit this morning.
2916,1406,0,2,8,10,1.2,0.13333333333333333,508,I ain't no rat.
5721,1406,1,0,9,10,1.2,0.19999999999999998,508,"I told you, they jumped me."
5547,1406,0,2,8,10,1.2,0.13333333333333333,508,"Look, pal! I don't know who this 'boogie boarder' is you're talking about. All I saw was a seal."
2132,1406,0,2,8,10,1.2,0.13333333333333333,508,May I have some salt water?
2127,1406,0,2,8,10,1.2,0.13333333333333333,508,Did he hear the theme music? Then I think we're done here.
2107,1406,1,0,9,10,1.2,0.19999999999999998,508,"This National Geographic is dated 1968, give me a freakin' break."
5853,1406,1,0,9,10,1.2,0.19999999999999998,508,"You cops see a predator, but I'll beat this rap because a jury will see an endangered shark."
3124,1406,0,2,8,10,1.2,0.13333333333333333,508,So I told him he'd swim with the fishes. It doesn't prove a thing!
2839,1406,0,2,8,10,1.2,0.13333333333333333,508,"Hey Sherlock, you do realize that I can't see a thing when you hold that directly in front of my snout, right?"
3179,1406,0,2,8,10,1.2,0.13333333333333333,508,"I tell ya, I never saw the guy. He jumped me and then dropped out of the limelight."
2581,1406,0,2,8,10,1.2,0.13333333333333333,508,To be honest you all look alike to me.
5229,1406,0,2,8,10,1.2,0.13333333333333333,508,That may be me--bring it a little closer.
2046,1406,0,2,8,10,1.2,0.13333333333333333,508,I'd say the blood spatter pattern suggests....LUNCH!
2846,1406,1,0,9,10,1.2,0.19999999999999998,508,"Sorry Bub, never heard of 'Charlie the Tuna'"
5502,1406,0,2,8,10,1.2,0.13333333333333333,508,Quit trying to bait me
2122,1406,1,0,9,10,1.2,0.19999999999999998,508,"Yes, that's him--that's Donald Trump"
2392,1406,1,0,9,10,1.2,0.19999999999999998,508,The guy you're looking for is Mack the Knife.
2043,1406,0,2,8,10,1.2,0.13333333333333333,508,"I'm a shark, not a stool pigeon."
3182,1406,0,2,8,10,1.2,0.13333333333333333,508,"I tell ya, I've never seen that torso before!"
3394,1406,0,2,8,10,1.2,0.13333333333333333,508,"You're gonna need a bigger picture, flatfoot; my eyes are on my sides."
3393,1406,1,0,9,10,1.2,0.19999999999999998,508,"For the third time, I don't recognize that leg."
3392,1406,0,2,8,10,1.2,0.13333333333333333,508,That is not my signature!
5571,1406,1,0,9,10,1.2,0.19999999999999998,508,"Listen, I already told you you've got the wrong shark. I was the one on the RIGHT."
2756,1406,0,2,8,10,1.2,0.13333333333333333,508,...or you won't swim with the fishes.
5312,1406,0,2,8,10,1.2,0.13333333333333333,508,The octopus wrote it; he's got a monopoly on the ink.
2337,1406,0,2,8,10,1.2,0.13333333333333333,508,"For the last time, Hooper, it was a boating accident."
5776,1406,1,0,9,10,1.2,0.19999999999999998,508,I haven't seen Ms Perry in 12 months.
5528,1406,0,2,8,10,1.2,0.13333333333333333,508,"I'm no good with faces, let me smell his blood."
5765,1406,0,2,8,10,1.2,0.13333333333333333,508,He kept bumping into me.
2229,1406,0,2,8,10,1.2,0.13333333333333333,508,I guess 'sleeping with the fishes' means something very different where I come from.
1934,1406,0,2,8,10,1.2,0.13333333333333333,508,I told you I don't know about any loans. I just play cards.
3024,1406,1,0,9,10,1.2,0.19999999999999998,508,"What, you think I'm some kinda card shark?"
2277,1406,0,2,8,10,1.2,0.13333333333333333,508,It all happened so fast.
5473,1406,0,2,8,10,1.2,0.13333333333333333,508,That's just his cellphone bill. I'm no loan shark.
3275,1406,0,2,8,10,1.2,0.13333333333333333,508,I'm pretty sure I didn't eat that one.
2532,1406,0,2,8,10,1.2,0.13333333333333333,508,"Yeah Krupke, dat’s him! Dat’s da Jet what done it! I seen him by da school."
2783,1406,1,0,9,10,1.2,0.19999999999999998,508,So what if those are my bite marks? It was shark week.
5637,1406,0,2,8,10,1.2,0.13333333333333333,508,Can I see the dessert menu?
3025,1406,1,0,9,10,1.2,0.19999999999999998,508,I'm the one that's swimming with the fishes!
5459,1406,0,2,8,10,1.2,0.13333333333333333,508,Well look what we have here. A search warrant.
5286,1406,0,2,8,10,1.2,0.13333333333333333,508,I've never seen that torso in my life.
5623,1406,1,0,9,10,1.2,0.19999999999999998,508,They all look the same. Are you saying you could identify the cow your steak came from?
5455,1406,0,2,8,10,1.2,0.13333333333333333,508,Is that take out ?
1922,1406,0,2,8,10,1.2,0.13333333333333333,508,"Sure, I sampled, him, why not, he was delicious. But I didn’t kill him!"
5451,1406,0,2,8,10,1.2,0.13333333333333333,508,"Why yes, I'll have the ahi tuna rare."
2227,1406,0,2,8,10,1.2,0.13333333333333333,508,"He was a chum, so what?"
5143,1406,0,2,8,10,1.2,0.13333333333333333,508,They all look fishy to me!
3302,1406,1,0,9,10,1.2,0.19999999999999998,508,I'd ask for my lawyer but he's literally a barnacle.
1945,1406,0,2,8,10,1.2,0.13333333333333333,508,"That's Stevan Spielberg, he made me do it."
5798,1406,0,2,8,10,1.2,0.13333333333333333,508,He threw the first nose punch.
1870,1406,0,2,8,10,1.2,0.13333333333333333,508,We found this I.O.U. on a guy who's sleeping with the fishes.
5449,1406,1,0,9,10,1.2,0.19999999999999998,508,"They all look alike, but a backlit surfboard? -- that's a recipe for disaster."
2492,1406,1,0,9,10,1.2,0.19999999999999998,508,That's him. Donald Trump. He's the guy who jumped me.
5762,1406,0,2,8,10,1.2,0.13333333333333333,508,"Nuh uh. Nah, nuh uh."
5160,1406,0,2,8,10,1.2,0.13333333333333333,508,It's obvious to anyone those are barracuda bite marks.
5795,1406,0,2,8,10,1.2,0.13333333333333333,508,"I tell ya, I've never seen those legs before!"
5289,1406,0,2,8,10,1.2,0.13333333333333333,508,"I dunno, the leg looks vaguely familiar."
1876,1406,0,2,8,10,1.2,0.13333333333333333,508,Try putting it under water; it might jog my memory.
5422,1406,0,2,8,10,1.2,0.13333333333333333,508,I agree--the signature does look fishy.
5643,1406,1,0,9,10,1.2,0.19999999999999998,508,Oh yeah? Bite me.
2282,1406,0,2,8,10,1.2,0.13333333333333333,508,"Sorry, Great Whites all look the same to me."
1880,1406,0,2,8,10,1.2,0.13333333333333333,508,That’s the guy who jumped me.
2678,1406,0,2,8,10,1.2,0.13333333333333333,508,"I told you, I've never heard of this Nemo"
2264,1406,1,0,9,10,1.2,0.19999999999999998,508,"Unless you want to end up like your chum, I suggest you talk."
2505,1406,0,2,8,10,1.2,0.13333333333333333,508,"I'm telling you that it was an accident. I was yawning, and my mouth was open."
2675,1406,1,0,9,10,1.2,0.19999999999999998,508,"Yeah, I killed him and, no, I don't feel any remoras."
2674,1406,1,0,9,10,1.2,0.19999999999999998,508,"I keep tellin' ya, I didn't kill no stinking flounder."
5373,1406,1,0,9,10,1.2,0.19999999999999998,508,"I'm telling you, it was a Jet."
3282,1406,1,0,9,10,1.2,0.19999999999999998,508,No more Mr. Nice Guy--Did you or did you not cause this blood bath?
2251,1406,0,2,8,10,1.2,0.13333333333333333,508,Yeah I seen him - standin' in a bucket of cement.
5516,1406,1,0,9,10,1.2,0.19999999999999998,508,Put me back in the holding tank so I can finish my dinner .
2525,1406,0,2,8,10,1.2,0.13333333333333333,508,"That's right, no address. I move around a lot."
1915,1406,0,2,8,10,1.2,0.13333333333333333,508,I am not a cold-blooded killer!
2662,1406,0,2,8,10,1.2,0.13333333333333333,508,That's not me--it's my twin brother.
5465,1406,0,2,8,10,1.2,0.13333333333333333,508,Do you have a picture of her from the waist down?
2665,1406,0,2,8,10,1.2,0.13333333333333333,508,"Okay, okay, it was Cousteau! Now get me into witness protection!"
3283,1406,1,0,9,10,1.2,0.19999999999999998,508,"No, I told you I've never seen the tornado in question."
5779,1406,0,2,8,10,1.2,0.13333333333333333,508,"You make a few loans, play some poker. So what?"
5149,1406,0,2,8,10,1.2,0.13333333333333333,508,It's the guy on the motorcycle. He jumped me!
2527,1406,0,2,8,10,1.2,0.13333333333333333,508,"Like I said, Mack, that ain't my knife."
3039,1406,0,2,8,10,1.2,0.13333333333333333,508,No I have never seen those feet before in my life. Nor that arm.
2244,1406,0,2,8,10,1.2,0.13333333333333333,508,You're going to need a bigger mugshot.
3288,1406,1,0,9,10,1.2,0.19999999999999998,508,"You got me, hook, line and sinker."
1900,1406,1,0,9,10,1.2,0.19999999999999998,508,"guys, this is species profiling. I want my lawyer. Gray lives matter, you know?"
3031,1406,0,2,8,10,1.2,0.13333333333333333,508,I've never slept with THOSE fishes!
1891,1406,0,2,8,10,1.2,0.13333333333333333,508,"Sorry pal. If that's your offer, I ain't biting."
1920,1406,0,2,8,10,1.2,0.13333333333333333,508,No.....I've never seen that foot before.
3032,1406,0,2,8,10,1.2,0.13333333333333333,508,He's sleeping with the fishes.
2241,1406,0,2,8,10,1.2,0.13333333333333333,508,"I swear I didn't do it...I'm a loaner, not a killer."
5628,1406,0,2,8,10,1.2,0.13333333333333333,508,Don't remember the loan...
5786,1406,0,2,8,10,1.2,0.13333333333333333,508,"I thought he was a sea lion in that wet suit, I tell ya'!"
5356,1406,0,2,8,10,1.2,0.13333333333333333,508,The dolphin did it.
2508,1406,1,0,9,10,1.2,0.19999999999999998,508,"I never saw that guy before. By the way that must be an old picture, because, trust me, he was mostly fat."
5522,1406,0,2,8,10,1.2,0.13333333333333333,508,You're wasting your time. I don't even like surfers!
5367,1406,0,2,8,10,1.2,0.13333333333333333,508,Do I look like a Dolphin to you?
2258,1406,0,2,8,10,1.2,0.13333333333333333,508,I prefer to call it 'shark-loaning'.
2514,1406,0,2,8,10,1.2,0.13333333333333333,508,Amity Island? Never seen it.
2518,1406,0,2,8,10,1.2,0.13333333333333333,508,I don't recall. They all just look like food to me.
2421,1406,1,0,9,10,1.2,0.19999999999999998,508,This is just not my week.
3038,1406,0,2,8,10,1.2,0.13333333333333333,508,"Okay, I'll confess -- but you're gonna hafta waterboard me like my life depended on it."
1918,1406,1,0,9,10,1.2,0.19999999999999998,508,That's him! The Loan Shark did it.
3080,1406,1,0,9,10,1.2,0.19999999999999998,508,I thought 'the right to an attorney' meant as food.
2652,1406,1,0,9,10,1.2,0.19999999999999998,508,"I recognize him, but I wouldn't use the word 'chum.'"
5162,1406,0,2,8,10,1.2,0.13333333333333333,508,"Get Real! If I had done that, you never would have found the body."
2313,1406,1,0,9,10,1.2,0.19999999999999998,508,Know him? Why - I could smell his blood a quarter of a mile away!
5168,1406,0,2,8,10,1.2,0.13333333333333333,508,One hit movie 40 years ago and we're all murderers
2993,1406,0,2,8,10,1.2,0.13333333333333333,508,"Sure, it could be the victim. It could be a seal. I can't tell the difference."
5445,1406,0,2,8,10,1.2,0.13333333333333333,508,"Yeah, that's just what happened. Like I said, the guy was trying to jump me."
2640,1406,0,2,8,10,1.2,0.13333333333333333,508,"All sharks look the same to you, don't they?"
2857,1406,0,2,8,10,1.2,0.13333333333333333,508,"Look, fellas. Shark bait's one thing. But jailbait? What do I look like—an animal?"
3246,1406,0,2,8,10,1.2,0.13333333333333333,508,"Oh, I see how it is, every half eaten corpse, pin it on the shark!"
2707,1406,0,2,8,10,1.2,0.13333333333333333,508,I don't know a Sheriff Brody
2192,1406,0,2,8,10,1.2,0.13333333333333333,508,"Yeah, I seen him before...once."
3248,1406,1,0,9,10,1.2,0.19999999999999998,508,I confess. I'm just a fish outta water.
1832,1406,1,0,9,10,1.2,0.19999999999999998,508,"What's the matter, Detective? Chum of yours?"
5653,1406,1,0,9,10,1.2,0.19999999999999998,508,No way. Everyone know's I've been vegan for years.
1833,1406,0,2,8,10,1.2,0.13333333333333333,508,"Yeah, that dude...left a bad taste in my mouth."
2305,1406,0,2,8,10,1.2,0.13333333333333333,508,"Yea - I 'lent' him the money, so what? Can I get that water now?"
5133,1406,0,2,8,10,1.2,0.13333333333333333,508,I ain't takin' the bait till you gets me some water.
2990,1406,0,2,8,10,1.2,0.13333333333333333,508,I'm terrible with faces. Do you have any pictures of arms and legs?
2198,1406,1,0,9,10,1.2,0.19999999999999998,508,He can't be my partner in crime--I'm a lone shark.
2639,1406,1,0,9,10,1.2,0.19999999999999998,508,Yeah I remember him. He wasn't a good surfer and he tasted like a vegan.
3073,1406,0,2,8,10,1.2,0.13333333333333333,508,So he's missing a leg - what's that got to do with me?
3240,1406,0,2,8,10,1.2,0.13333333333333333,508,"Hey, not my fault he didn't get a bigger boat! Hey, not my fault he didn't get a bigger boat!"
2177,1406,0,2,8,10,1.2,0.13333333333333333,508,"I tell you, I don't know any loansharks."
2637,1406,0,2,8,10,1.2,0.13333333333333333,508,Candygram? I don't know what your talking about. I'm a dolphin!
2978,1406,1,0,9,10,1.2,0.19999999999999998,508,You're all wrong. I haven't got it in me.'
5746,1406,0,2,8,10,1.2,0.13333333333333333,508,Don't as me. All I did was loan him a fin.
5597,1406,0,2,8,10,1.2,0.13333333333333333,508,"I didn’t loan that guy no money, and I don’t know how his leg got broke."
5821,1406,0,2,8,10,1.2,0.13333333333333333,508,I don't recognize anyone from the neck up.
3243,1406,1,0,9,10,1.2,0.19999999999999998,508,"Yeah, that's Manny T. He's in hot water down by the utility outflow."
2330,1406,0,2,8,10,1.2,0.13333333333333333,508,"I told you already, she lured me in."
5504,1406,1,0,9,10,1.2,0.19999999999999998,508,"I'm just a loan shark, I tell ya!"
2329,1406,0,2,8,10,1.2,0.13333333333333333,508,I'm sorry but that is not a complete Miranda warning.
5263,1406,0,2,8,10,1.2,0.13333333333333333,508,"Nah, I don't recognize those juicy stubs...er knees"
3244,1406,0,2,8,10,1.2,0.13333333333333333,508,"I keep telling you, I'm a pool shark, not a loan shark!"
2987,1406,0,2,8,10,1.2,0.13333333333333333,508,"Yeah, he's a loan shark from Miami Beach..."
2318,1406,0,2,8,10,1.2,0.13333333333333333,508,I've never seen that leg before.
1825,1406,1,0,9,10,1.2,0.19999999999999998,508,I can turn sharply in any direction if you make it worth my while.
2549,1406,1,0,9,10,1.2,0.19999999999999998,508,No way I did that. I am a vegetarian!
5354,1406,0,2,8,10,1.2,0.13333333333333333,508,I swear it looks like a donut from below.
5812,1406,1,0,9,10,1.2,0.19999999999999998,508,A picture of my dorsal fin doesn't make me a loanshark .
3311,1406,0,2,8,10,1.2,0.13333333333333333,508,I'm still pleading innocent. I was acting in self-defense.
1855,1406,0,2,8,10,1.2,0.13333333333333333,508,I told you before. All I can remember were his eyes. Those dead human eyes...
3310,1406,0,2,8,10,1.2,0.13333333333333333,508,"OK, so I got no friends. That only `makes me a lone shark."
5531,1406,0,2,8,10,1.2,0.13333333333333333,508,"I didn't do it. Now, to the waterboarding."
5646,1406,0,2,8,10,1.2,0.13333333333333333,508,"Yeah, that's him...that's Fonzie."
2864,1406,1,0,9,10,1.2,0.19999999999999998,508,"Could be him, or could be a seal, I can never tell."
2701,1406,0,2,8,10,1.2,0.13333333333333333,508,"Nice try copper, but you can't cuff me and you know it."
3258,1406,1,0,9,10,1.2,0.19999999999999998,508,"That's Amity Island, 1975. Remember?"
5165,1406,0,2,8,10,1.2,0.13333333333333333,508,This is nothing short of dorsal profiling.
2220,1406,0,2,8,10,1.2,0.13333333333333333,508,"You do realize that you're talking to a lawyer, right?"
2802,1406,0,2,8,10,1.2,0.13333333333333333,508,No hablo Ingles
3019,1406,1,0,9,10,1.2,0.19999999999999998,508,I'm a sand shark. That's a pool shark.
5375,1406,1,0,9,10,1.2,0.19999999999999998,508,"I don't care what the statement says, I'm not signing anything until you give me a hand."
2538,1406,1,0,9,10,1.2,0.19999999999999998,508,Right to counsel - ha! Wait till you see my lawyer.
2896,1406,0,2,8,10,1.2,0.13333333333333333,508,Lending at 10% a week doesn't make me a shark
3312,1406,1,0,9,10,1.2,0.19999999999999998,508,Isn't it a little unfair to put me in a lineup with a bunch of cards?
2484,1406,1,0,9,10,1.2,0.19999999999999998,508,"Your good-tasting cop, bad-tasting cop routine won't work on me."
2296,1406,0,2,8,10,1.2,0.13333333333333333,508,"Okay, which presidential candidate do you want me to eat now?"
1951,1406,1,0,9,10,1.2,0.19999999999999998,508,Never ate the guy.
3001,1406,1,0,9,10,1.2,0.19999999999999998,508,"Yes that's him, he swims with the sharks, Donald Trump."
5532,1406,0,2,8,10,1.2,0.13333333333333333,508,"Yeah, it's a loan contract. What's the problem?"
5403,1406,0,2,8,10,1.2,0.13333333333333333,508,So I'm a shark and I make loans. What's it to you?
2705,1406,0,2,8,10,1.2,0.13333333333333333,508,Of course I ate him! You expect me to resist a hundred million years of evolution?!
3008,1406,0,2,8,10,1.2,0.13333333333333333,508,I confess. He was two payments late so I ate him.
2208,1406,0,2,8,10,1.2,0.13333333333333333,508,The left arm looks slightly familiar...
1841,1406,0,2,8,10,1.2,0.13333333333333333,508,"I've never seen that torso before in my life, detectives."
3263,1406,0,2,8,10,1.2,0.13333333333333333,508,"Yeah, I know him. He tried to jump me."
2210,1406,0,2,8,10,1.2,0.13333333333333333,508,"Yeah, that's Tony. He's a Jet."
3254,1406,0,2,8,10,1.2,0.13333333333333333,508,He was a chum of mine.
2214,1406,1,0,9,10,1.2,0.19999999999999998,508,"No, we did not fall for the bait this time."
1846,1406,0,2,8,10,1.2,0.13333333333333333,508,"You ain't gonna find no leaks in my story, Pal."
2704,1406,0,2,8,10,1.2,0.13333333333333333,508,"I'm telling you, there are no loans - I bite kneecaps for fun."
2215,1406,0,2,8,10,1.2,0.13333333333333333,508,Would you consider a little professional courtesy here?
5447,1406,1,0,9,10,1.2,0.19999999999999998,508,That will never hold water.
3314,1406,0,2,8,10,1.2,0.13333333333333333,508,Gimme a water and I'll talk.
3319,1406,1,0,9,10,1.2,0.19999999999999998,508,Not my fault. I run a hedge fund.
3153,1406,0,2,8,10,1.2,0.13333333333333333,508,"Let me get this straight--I take care of this clown fish, and you forget about the parking tickets?"
4541,1406,1,0,9,10,1.2,0.19999999999999998,508,I said--'You have the right to remain silent ....'
2749,1406,1,0,9,10,1.2,0.19999999999999998,508,No he not the one that attacked me.
1043,1406,0,2,8,10,1.2,0.13333333333333333,508,You're not gonna bait me.
3902,1406,0,2,8,10,1.2,0.13333333333333333,508,"I keep telling you, LONE shark!"
4852,1406,0,2,8,10,1.2,0.13333333333333333,508,"Yeah, like I said, I don't do vegans."
3907,1406,0,2,8,10,1.2,0.13333333333333333,508,Dolphin? Surfboard? They all look the same.
3909,1406,0,2,8,10,1.2,0.13333333333333333,508,I was told to keep moving.
6255,1406,0,2,8,10,1.2,0.13333333333333333,508,"I'm telling you, that wasn't me. I'm a leg man."
6246,1406,0,2,8,10,1.2,0.13333333333333333,508,"Sure, he was a chum. That doesn't mean I knew him."
1019,1406,0,2,8,10,1.2,0.13333333333333333,508,He was just a school chum
3923,1406,0,2,8,10,1.2,0.13333333333333333,508,I see blood but I don't see a body.
4304,1406,0,2,8,10,1.2,0.13333333333333333,508,"Whaddya think I am, a rat?"
6262,1406,1,0,9,10,1.2,0.19999999999999998,508,I've never even seen that school before.
6263,1406,1,0,9,10,1.2,0.19999999999999998,508,I disagreed with someone I ate
1002,1406,0,2,8,10,1.2,0.13333333333333333,508,"'What is this, 'Cold Case'? I was no where near Amity in the 70s.'"
998,1406,0,2,8,10,1.2,0.13333333333333333,508,Card Shark is just an expression.
3922,1406,0,2,8,10,1.2,0.13333333333333333,508,"That's the guy! I was just minding my own business, and he came at me with a surfboard."
6267,1406,1,0,9,10,1.2,0.19999999999999998,508,"Sorry officer, not ringing any bells. I'm more of a legs guy."
1046,1406,0,2,8,10,1.2,0.13333333333333333,508,So I loaned some guy a fin! - that ain’t illegal.
4860,1406,0,2,8,10,1.2,0.13333333333333333,508,I am acting as my own attorney.
1076,1406,0,2,8,10,1.2,0.13333333333333333,508,"I was nowhere near the Cape last summer, I was at the beach in North Carolina with some buddies enjoying a nice meal. Let me give you their names and they can verify it."
4865,1406,0,2,8,10,1.2,0.13333333333333333,508,"Sure, I'll sign a confession. Now, where did I put my hands ... ?"
317,1406,1,0,9,10,1.2,0.19999999999999998,508,"I got you the Giant Dog, but you're complaining about the condiments?"
4318,1406,0,2,8,10,1.2,0.13333333333333333,508,Never laid teeth on him in my life.
6235,1406,0,2,8,10,1.2,0.13333333333333333,508,"No, I said lone shark."
6236,1406,1,0,9,10,1.2,0.19999999999999998,508,"Oh the shark has pretty teeth dear, And he shows them pearly white..."
4858,1406,0,2,8,10,1.2,0.13333333333333333,508,That's Tony our collector--I just made the loans
3884,1406,0,2,8,10,1.2,0.13333333333333333,508,"The leg looks familiar, but I cannot say about the rest."
4658,1406,0,2,8,10,1.2,0.13333333333333333,508,"Nope, never seen that family of sardines before."
324,1406,0,2,8,10,1.2,0.13333333333333333,508,Humming the 'Jaws' theme won't help. All legs look the same to me.
328,1406,0,2,8,10,1.2,0.13333333333333333,508,Who goes swimming in a seal skin speedo?
6584,1406,0,2,8,10,1.2,0.13333333333333333,508,You can't pin that on me. I'm Vegan.
6583,1406,0,2,8,10,1.2,0.13333333333333333,508,Ignorance of the sustainable seafood guide is no excuse.
6577,1406,0,2,8,10,1.2,0.13333333333333333,508,That seal's a liar. I was in school all day.
321,1406,1,0,9,10,1.2,0.19999999999999998,508,That's not my fin.
4301,1406,1,0,9,10,1.2,0.19999999999999998,508,"Maybe, maybe not. Lots of turbidity down there that night."
4837,1406,1,0,9,10,1.2,0.19999999999999998,508,Do you recognize this bite mark?
6569,1406,1,0,9,10,1.2,0.19999999999999998,508,I am Abe Vigoda; I am not dead; and I recognize that person.
3961,1406,1,0,9,10,1.2,0.19999999999999998,508,"OKay, okay. It's a porpoise named Flipper . Are you satisfied?"
938,1406,0,2,8,10,1.2,0.13333333333333333,508,Why isn't one of two playing the 'good cop?'
382,1406,0,2,8,10,1.2,0.13333333333333333,508,"I know him, he's a chum"
4291,1406,1,0,9,10,1.2,0.19999999999999998,508,Could've been a Blue Shark. THIS IS SPECIES-PROFILING!!
934,1406,0,2,8,10,1.2,0.13333333333333333,508,I did not make that loan.
6558,1406,0,2,8,10,1.2,0.13333333333333333,508,"OK, I know him--he's a red herring."
4665,1406,1,0,9,10,1.2,0.19999999999999998,508,How do I know its her...I only saw the leg!
390,1406,0,2,8,10,1.2,0.13333333333333333,508,He's missing since your Friday lunch
3970,1406,1,0,9,10,1.2,0.19999999999999998,508,"Worst part was, tasted like chicken."
926,1406,0,2,8,10,1.2,0.13333333333333333,508,Looks greater and whiter than me.
6300,1406,0,2,8,10,1.2,0.13333333333333333,508,"Come on guys, dat don't look nuttin' like me!"
393,1406,0,2,8,10,1.2,0.13333333333333333,508,That was before I gave up red meat.
4668,1406,0,2,8,10,1.2,0.13333333333333333,508,"Sorry, salmon all look the same to me."
918,1406,0,2,8,10,1.2,0.13333333333333333,508,May I have some water?
928,1406,0,2,8,10,1.2,0.13333333333333333,508,you mammals all look the same to me
4821,1406,1,0,9,10,1.2,0.19999999999999998,508,He bit me first it was self defense
3958,1406,0,2,8,10,1.2,0.13333333333333333,508,She told me she was eighteen
949,1406,1,0,9,10,1.2,0.19999999999999998,508,"Sorry, Charlie!"
986,1406,0,2,8,10,1.2,0.13333333333333333,508,"One-piece polka dot — nope, don't remember that one either."
4835,1406,0,2,8,10,1.2,0.13333333333333333,508,I demand to eat my attorney.
360,1406,0,2,8,10,1.2,0.13333333333333333,508,If I was a dolphin you wouldn't have even pulled me over.
978,1406,0,2,8,10,1.2,0.13333333333333333,508,"Yes, that's what I said I was, a L-O-N-E shark."
3942,1406,1,0,9,10,1.2,0.19999999999999998,508,"That's correct detective, I normally charge thousand dollars an hour - but for Moby vs captain Ahab I'll go pro bono just this once."
974,1406,0,2,8,10,1.2,0.13333333333333333,508,That's not even my handwriting.
6280,1406,1,0,9,10,1.2,0.19999999999999998,508,I plead not gill-ty!
369,1406,0,2,8,10,1.2,0.13333333333333333,508,"It's my paleo diet, what do you expect?"
6282,1406,0,2,8,10,1.2,0.13333333333333333,508,Looks like the work of an orca.
371,1406,0,2,8,10,1.2,0.13333333333333333,508,"Look Mack, the knife ain't mine!"
373,1406,0,2,8,10,1.2,0.13333333333333333,508,"Yeah, that's him. Name's Spielberg - I'm telling ya', he directed me to do it."
3949,1406,0,2,8,10,1.2,0.13333333333333333,508,"Listen, chum! I ain't seen a fish called Wanda."
4825,1406,1,0,9,10,1.2,0.19999999999999998,508,You're mistaking me for that killer whale.
6563,1406,1,0,9,10,1.2,0.19999999999999998,508,"As a professional courtesy, you get two calls."
4822,1406,0,2,8,10,1.2,0.13333333333333333,508,I'm more card shark than man eater.
6591,1406,1,0,9,10,1.2,0.19999999999999998,508,I'm not talking until I have my EPA lawyer present.
6229,1406,0,2,8,10,1.2,0.13333333333333333,508,"Nope, never ate...uh seen him."
308,1406,0,2,8,10,1.2,0.13333333333333333,508,You know we have notoriously bad eyesight.
1083,1406,0,2,8,10,1.2,0.13333333333333333,508,I'm a fish! of course I'm a cold-blooded killer!
1205,1406,0,2,8,10,1.2,0.13333333333333333,508,Do you have a more recent photo without the limbs?
3782,1406,0,2,8,10,1.2,0.13333333333333333,508,How many times do I have to tell you guys that you're looking for a card-shark.
1203,1406,1,0,9,10,1.2,0.19999999999999998,508,"Nah, he wasn't a friend. More like... chum."
4625,1406,0,2,8,10,1.2,0.13333333333333333,508,"E, F, P, T, O, Z..."
3784,1406,1,0,9,10,1.2,0.19999999999999998,508,"Excuse me, but I think you've forgotten that I can't read!"
3786,1406,1,0,9,10,1.2,0.19999999999999998,508,"Yes, Officer Kupke, I tried to eat Riff, but he was just no good."
1208,1406,0,2,8,10,1.2,0.13333333333333333,508,"We don't identify faces, show me her legs..."
1196,1406,0,2,8,10,1.2,0.13333333333333333,508,Never seen that fish in my life
1191,1406,0,2,8,10,1.2,0.13333333333333333,508,shaw shark redemption
6625,1406,1,0,9,10,1.2,0.19999999999999998,508,What do you expect---I'm a shark.
252,1406,1,0,9,10,1.2,0.19999999999999998,508,"Without my glasses, you're going to need a bigger note."
6174,1406,0,2,8,10,1.2,0.13333333333333333,508,"While I admire the work, I'm sure forensics has already told you that's an orca bite. Why don't you fellas tell me what this is really all about?"
6623,1406,1,0,9,10,1.2,0.19999999999999998,508,Why does your species bother to name bait?
6622,1406,0,2,8,10,1.2,0.13333333333333333,508,It was a feeding frenzy. Things got very confusing.
1194,1406,0,2,8,10,1.2,0.13333333333333333,508,"I don't recognise the face, but the feet look familiar."
243,1406,0,2,8,10,1.2,0.13333333333333333,508,"You're aware that 'sleeps with the fishes' is just an expression, aren't you?"
239,1406,0,2,8,10,1.2,0.13333333333333333,508,For the last time. I'm his lawyer.
237,1406,0,2,8,10,1.2,0.13333333333333333,508,You all look the same to me.
3752,1406,1,0,9,10,1.2,0.19999999999999998,508,"OK, besides the teeth marks and severed body what makes you think I did it?"
4921,1406,0,2,8,10,1.2,0.13333333333333333,508,Oh! Was that MY lawyer?
3758,1406,1,0,9,10,1.2,0.19999999999999998,508,Yes that's Mack the Knife.
4388,1406,0,2,8,10,1.2,0.13333333333333333,508,So they are sitting around a floating poker table. What's a card shark to do? I razed!
216,1406,1,0,9,10,1.2,0.19999999999999998,508,"You can't frighten me with this 'good cop, bad cop' routine. I am a lawyer, in case you haven't noticed."
6157,1406,1,0,9,10,1.2,0.19999999999999998,508,"You cops, always bottom feeders, you should be talking to my lawyer."
3771,1406,0,2,8,10,1.2,0.13333333333333333,508,"Dude, do I look like a loan shark?!"
218,1406,0,2,8,10,1.2,0.13333333333333333,508,"Listen i'm a Thresher shark, not a Shredder."
1222,1406,0,2,8,10,1.2,0.13333333333333333,508,"I'm a great white, just like Trump thinks he is."
4616,1406,1,0,9,10,1.2,0.19999999999999998,508,Yeah I know him-- Friday's dinner--so what?
1219,1406,0,2,8,10,1.2,0.13333333333333333,508,It's hard to tell without my water goggles.
3773,1406,0,2,8,10,1.2,0.13333333333333333,508,They used me as bait!
1217,1406,1,0,9,10,1.2,0.19999999999999998,508,He was a lawyer. No jury will convict me for that.
4619,1406,1,0,9,10,1.2,0.19999999999999998,508,Clearly I misunderstood the meaning of Shark Week
233,1406,0,2,8,10,1.2,0.13333333333333333,508,"Nemo?? No, no never heard of 'em.."
3800,1406,1,0,9,10,1.2,0.19999999999999998,508,Since when is being a pool shark against the law?
3412,1406,0,2,8,10,1.2,0.13333333333333333,508,"Yeah, that's him. That's the guy who gave me diarrhea."
4362,1406,0,2,8,10,1.2,0.13333333333333333,508,"Say, are you trying to guilt-trip me?"
1160,1406,1,0,9,10,1.2,0.19999999999999998,508,"No, I meant that he was literally sleeping with the fishes."
6212,1406,0,2,8,10,1.2,0.13333333333333333,508,How am I supposed to sign it? How?!
3839,1406,0,2,8,10,1.2,0.13333333333333333,508,"I may be a loan shark, but I ain't no rat."
3840,1406,0,2,8,10,1.2,0.13333333333333333,508,"I've told you already, I only saw the hook and worm."
1112,1406,0,2,8,10,1.2,0.13333333333333333,508,Never eaten him in my life!
1111,1406,0,2,8,10,1.2,0.13333333333333333,508,I never saw that surfboard.
4882,1406,0,2,8,10,1.2,0.13333333333333333,508,"He was a chum, if you know what I mean."
6209,1406,0,2,8,10,1.2,0.13333333333333333,508,Looks like bait to me.
1104,1406,0,2,8,10,1.2,0.13333333333333333,508,"Nope, I don't eat Italian."
3849,1406,1,0,9,10,1.2,0.19999999999999998,508,That's the work of a murder shark. I just do loans.
6597,1406,1,0,9,10,1.2,0.19999999999999998,508,"Yep, that's the lawyer that tried to take a bite out of me."
1092,1406,0,2,8,10,1.2,0.13333333333333333,508,"Yeh, that's the guy. I recognize the wetsuit."
3859,1406,0,2,8,10,1.2,0.13333333333333333,508,Don't get chummy with me.
3860,1406,0,2,8,10,1.2,0.13333333333333333,508,"Help, I can't breathe."
1084,1406,0,2,8,10,1.2,0.13333333333333333,508,Does this leg look familiar?
1101,1406,0,2,8,10,1.2,0.13333333333333333,508,"It's a list of my food preferences...If I remove people, can I go?"
298,1406,0,2,8,10,1.2,0.13333333333333333,508,We warned him that humans taste awful.
3831,1406,0,2,8,10,1.2,0.13333333333333333,508,He got too chummy.
1128,1406,0,2,8,10,1.2,0.13333333333333333,508,"I swim by that reef every day, so what?"
4354,1406,0,2,8,10,1.2,0.13333333333333333,508,No officer. I had no idea that he was not a seal.
6611,1406,0,2,8,10,1.2,0.13333333333333333,508,I'm being punished for disarming an intruder!?
6189,1406,0,2,8,10,1.2,0.13333333333333333,508,"He might have been wearing concrete shoes,,"
279,1406,0,2,8,10,1.2,0.13333333333333333,508,We have enough on you to put you in the tank for life!
6190,1406,1,0,9,10,1.2,0.19999999999999998,508,"That’s him, I’ll never forget that hammerhead smirk"
3811,1406,0,2,8,10,1.2,0.13333333333333333,508,You're profiling.
280,1406,0,2,8,10,1.2,0.13333333333333333,508,"Sorry, Charlie. You can Star-Kist my fin!"
6194,1406,0,2,8,10,1.2,0.13333333333333333,508,"They all look alike to me, you eat one, you eat them all."
3815,1406,0,2,8,10,1.2,0.13333333333333333,508,I'm just the lawyer.
6198,1406,0,2,8,10,1.2,0.13333333333333333,508,I forgot which one of you is the good cop!
4330,1406,0,2,8,10,1.2,0.13333333333333333,508,"Quit profiling me, man. We all have dorsal fins."
4895,1406,1,0,9,10,1.2,0.19999999999999998,508,"Hammerhead, schmammerhead. It's a Great White."
3827,1406,0,2,8,10,1.2,0.13333333333333333,508,``Yes. I ate him. I feared for my life.
1130,1406,0,2,8,10,1.2,0.13333333333333333,508,Big deal! You know how many millions of sharks use an ATM machine every day!
3829,1406,1,0,9,10,1.2,0.19999999999999998,508,"Yeah, I'm his loan shark."
6618,1406,0,2,8,10,1.2,0.13333333333333333,508,"Please, I've bitten much better legs than that. Why would I bother?"
1242,1406,0,2,8,10,1.2,0.13333333333333333,508,Poor guy. He still owes me three grand.
3985,1406,0,2,8,10,1.2,0.13333333333333333,508,She was bleeding all over the place. What would you have done?
4670,1406,0,2,8,10,1.2,0.13333333333333333,508,You think I remember what Richard Dreyfuss looked like 40 years ago?
4137,1406,0,2,8,10,1.2,0.13333333333333333,508,"Yes, that's the menacing dolphin!"
663,1406,1,0,9,10,1.2,0.19999999999999998,508,"Before I answer, I'd like a toothpick."
4243,1406,0,2,8,10,1.2,0.13333333333333333,508,I already told you guys! They all look like food to me.
6444,1406,1,0,9,10,1.2,0.19999999999999998,508,"I'm going to need you to be more pacific, I mean specific."
654,1406,0,2,8,10,1.2,0.13333333333333333,508,I think I should speak to my shark now.
653,1406,0,2,8,10,1.2,0.13333333333333333,508,Yeah we were in the same school but he turned out to be a sucker.
467,1406,0,2,8,10,1.2,0.13333333333333333,508,I had my teeth replaced.
652,1406,0,2,8,10,1.2,0.13333333333333333,508,Yea. I loaned him some money. So what?
6520,1406,0,2,8,10,1.2,0.13333333333333333,508,It wasn't my fault he was swimming
644,1406,0,2,8,10,1.2,0.13333333333333333,508,I wouldn't say we were in a relationship. She was more of a chum.
474,1406,0,2,8,10,1.2,0.13333333333333333,508,It's clear to sea you've been up to something fishy.
478,1406,0,2,8,10,1.2,0.13333333333333333,508,It started with an argument over whether it's 'card sharp' or 'card shark.'
4148,1406,0,2,8,10,1.2,0.13333333333333333,508,Not me. I am strictly vegan.
626,1406,0,2,8,10,1.2,0.13333333333333333,508,That guy sleeps with the fishes.
4141,1406,1,0,9,10,1.2,0.19999999999999998,508,"Yeah, I ate that guy, but I thought he was my chum at the time."
6460,1406,0,2,8,10,1.2,0.13333333333333333,508,"Just because 'the shark, babe, has such teeth, dear, and it shows them pearly white,' doesn't mean I did it!"
6439,1406,0,2,8,10,1.2,0.13333333333333333,508,"Since my bite mark doesn't fit, you must acquit."
6438,1406,0,2,8,10,1.2,0.13333333333333333,508,Never seen those thighs in my life. I want my lawyer!
6421,1406,0,2,8,10,1.2,0.13333333333333333,508,I don't even like legs!
6422,1406,0,2,8,10,1.2,0.13333333333333333,508,"With all due respect, officer... bite me!"
6423,1406,0,2,8,10,1.2,0.13333333333333333,508,"He came into the joint strapped for cash. I told him it would cost an arm and a leg, so he left."
697,1406,1,0,9,10,1.2,0.19999999999999998,508,The chum made me do it.
4120,1406,0,2,8,10,1.2,0.13333333333333333,508,"You wanna pin this on me, you're gonna need a bigger boat picture."
4121,1406,0,2,8,10,1.2,0.13333333333333333,508,"My lawyer will eat you alive,boys!"
670,1406,0,2,8,10,1.2,0.13333333333333333,508,"Yes, that is a copy of my gym membership. And no, I don't know what happened to the other swimmers."
4127,1406,0,2,8,10,1.2,0.13333333333333333,508,Yes! That's who jumped me!
6435,1406,1,0,9,10,1.2,0.19999999999999998,508,"Jail-bait...shark-bait, what's the difference?"
4131,1406,0,2,8,10,1.2,0.13333333333333333,508,That letter looks fishy to me.
4746,1406,0,2,8,10,1.2,0.13333333333333333,508,I'm allergic to seafood.
4686,1406,1,0,9,10,1.2,0.19999999999999998,508,But I'm a vegetarian!
6437,1406,0,2,8,10,1.2,0.13333333333333333,508,yes he too tasted like chicken
4687,1406,0,2,8,10,1.2,0.13333333333333333,508,"Maybe, maybe not. Look, there’s a lot of surfers out there."
4130,1406,1,0,9,10,1.2,0.19999999999999998,508,I didn't kill him. I have better taste than that.
479,1406,0,2,8,10,1.2,0.13333333333333333,508,I'm Sam the Shark. You have me mixed up with Charlie the Tuna.
622,1406,0,2,8,10,1.2,0.13333333333333333,508,I've never seen that severed limb before in my life!
4152,1406,0,2,8,10,1.2,0.13333333333333333,508,"Hey, that's not me! I don't do humans no more 'cuz they're too high in fat!"
513,1406,0,2,8,10,1.2,0.13333333333333333,508,I'd never LEAVE that amount of blood.
567,1406,0,2,8,10,1.2,0.13333333333333333,508,I referred to him as 'chum' but that doesn't mean I knew him.
6505,1406,0,2,8,10,1.2,0.13333333333333333,508,"I'm an indiscriminate flesh eating killing machine copper, but I'm no rat."
4724,1406,1,0,9,10,1.2,0.19999999999999998,508,"Swear to gills, I have /never/ seen that leg before!"
4722,1406,1,0,9,10,1.2,0.19999999999999998,508,I'm a lawyer. You don't have to read me my Miranda rights.
560,1406,1,0,9,10,1.2,0.19999999999999998,508,Those are not my tooth marks.
509,1406,0,2,8,10,1.2,0.13333333333333333,508,I saw him last week. He was swimming with the fishes.
554,1406,0,2,8,10,1.2,0.13333333333333333,508,I ain't talkin' 'til I see my orca.
4217,1406,0,2,8,10,1.2,0.13333333333333333,508,Okay! That's her..... I was hungry.
4199,1406,0,2,8,10,1.2,0.13333333333333333,508,Usury?! You guys must be on a fishing expedition!
4200,1406,1,0,9,10,1.2,0.19999999999999998,508,"He looks a little like the guy I ate, but like I said, I really didn't get a good look at him...."
524,1406,1,0,9,10,1.2,0.19999999999999998,508,"Yeah, I ate the guy. So what?"
540,1406,1,0,9,10,1.2,0.19999999999999998,508,Looks looks the schmuck ran into an anchor
6497,1406,1,0,9,10,1.2,0.19999999999999998,508,"We call him Hammerhead because ... well, you know"
4719,1406,0,2,8,10,1.2,0.13333333333333333,508,"I already told you, it was Shark Week!"
508,1406,0,2,8,10,1.2,0.13333333333333333,508,this says you're a loan shark.
575,1406,1,0,9,10,1.2,0.19999999999999998,508,"Nah, I’m a hedge-fund shark. You’re lookin’ for my cousin Rudy."
4176,1406,0,2,8,10,1.2,0.13333333333333333,508,Speak up. Where are these minnows?
618,1406,0,2,8,10,1.2,0.13333333333333333,508,Not all of us are lawyers.
4740,1406,0,2,8,10,1.2,0.13333333333333333,508,"I'm innocent, don't you see? That's an underbite!"
614,1406,0,2,8,10,1.2,0.13333333333333333,508,I guess it's true that all sharks look alike to you guys.
609,1406,0,2,8,10,1.2,0.13333333333333333,508,I recognize her legs but not her face.
605,1406,0,2,8,10,1.2,0.13333333333333333,508,That's one big fish tale you just told us!
4239,1406,0,2,8,10,1.2,0.13333333333333333,508,So you think my alibi smells fishy.
599,1406,0,2,8,10,1.2,0.13333333333333333,508,I will not squeal on who jumped the shark.
489,1406,0,2,8,10,1.2,0.13333333333333333,508,Yeah...he's sleepin' with the fishes.
595,1406,0,2,8,10,1.2,0.13333333333333333,508,I haven't seen that seal before in my life!
594,1406,1,0,9,10,1.2,0.19999999999999998,508,That doesn't look fishy to me
4236,1406,0,2,8,10,1.2,0.13333333333333333,508,"Come on, guys, now you're just fishing."
586,1406,1,0,9,10,1.2,0.19999999999999998,508,Can you get me mugshots just showing them from the waist down?
6509,1406,1,0,9,10,1.2,0.19999999999999998,508,It was a loan!
4172,1406,1,0,9,10,1.2,0.19999999999999998,508,So what. We all look alike.
4728,1406,1,0,9,10,1.2,0.19999999999999998,508,"I told you, those surfer dudes all look the same"
713,1406,0,2,8,10,1.2,0.13333333333333333,508,"I'm a shark, not a narc."
714,1406,1,0,9,10,1.2,0.19999999999999998,508,"Yeah, that's me...but I wasn't feeding!'"
6528,1406,0,2,8,10,1.2,0.13333333333333333,508,I'd like to speak with Seaworld.
4253,1406,0,2,8,10,1.2,0.13333333333333333,508,I don't recognize her. I'm a Leg man.
4017,1406,0,2,8,10,1.2,0.13333333333333333,508,"You can't convict an endangered species, and we both know it."
6348,1406,0,2,8,10,1.2,0.13333333333333333,508,"I've never seen that meal...um, SEAL, in my life!"
6350,1406,1,0,9,10,1.2,0.19999999999999998,508,"Charlie the Tuna, Yea I know him, so what?"
4673,1406,0,2,8,10,1.2,0.13333333333333333,508,Does this leg look familiar to you?
831,1406,0,2,8,10,1.2,0.13333333333333333,508,You're looking for a loan shark. I'm a lone shark.
4796,1406,0,2,8,10,1.2,0.13333333333333333,508,Ya got the wrong guy. Never been in Loch Ness in my life!
840,1406,0,2,8,10,1.2,0.13333333333333333,508,It's really hard tell. The guy was wearing flippers and a mask.
6354,1406,0,2,8,10,1.2,0.13333333333333333,508,I'd like some water before I answer anymore questions
412,1406,0,2,8,10,1.2,0.13333333333333333,508,I thought that guy was a legitimate businessman.
4032,1406,0,2,8,10,1.2,0.13333333333333333,508,Grilled fish.
4793,1406,0,2,8,10,1.2,0.13333333333333333,508,"Yea, he looks delicious, but I didn't eat him."
4037,1406,1,0,9,10,1.2,0.19999999999999998,508,"But she squealed like a seal, tasted like a seal, and - as you can see - looked like a seal!"
813,1406,0,2,8,10,1.2,0.13333333333333333,508,"Sure, I could cough him up."
812,1406,0,2,8,10,1.2,0.13333333333333333,508,"Maybe if you scratch it, I can sniff it."
411,1406,0,2,8,10,1.2,0.13333333333333333,508,You're way off. He's a small fry
6345,1406,0,2,8,10,1.2,0.13333333333333333,508,Could I just get some water first?
844,1406,0,2,8,10,1.2,0.13333333333333333,508,That's a red herring.
4016,1406,1,0,9,10,1.2,0.19999999999999998,508,"Yeah, it might be him... I don't know, he looked different without his head"
6317,1406,0,2,8,10,1.2,0.13333333333333333,508,"I told you, I don't murder people, I'm just a loan shark."
3992,1406,1,0,9,10,1.2,0.19999999999999998,508,I have a right to be provided with a lawyer. Oh wait ...
892,1406,0,2,8,10,1.2,0.13333333333333333,508,"I didn't see her face, do you have a shot of her feet?"
6320,1406,0,2,8,10,1.2,0.13333333333333333,508,I admit it...I know Richard Dreyfuss.
888,1406,0,2,8,10,1.2,0.13333333333333333,508,What do you mean 'all you sharks' look the same?
6321,1406,0,2,8,10,1.2,0.13333333333333333,508,I couldn't help it. He said he was going to make me into shark's fin soup.
3995,1406,0,2,8,10,1.2,0.13333333333333333,508,Every time a Jet dies you drag me in here.
4001,1406,0,2,8,10,1.2,0.13333333333333333,508,I thought the dame was a mermaid.
869,1406,0,2,8,10,1.2,0.13333333333333333,508,I keep telling you boys in Vice; they ALL sleep with the fishes.
4005,1406,0,2,8,10,1.2,0.13333333333333333,508,I heard this odd music and I wasn't sure what had come over me.
6334,1406,0,2,8,10,1.2,0.13333333333333333,508,"Nope, never lent him a cent."
4007,1406,0,2,8,10,1.2,0.13333333333333333,508,I want my lawyer and ten thousand gallons of water immediately.
4806,1406,0,2,8,10,1.2,0.13333333333333333,508,"I told you, I've never seen those legs and feet before."
6337,1406,0,2,8,10,1.2,0.13333333333333333,508,"Are you kidding me, do I look like a hammerhead to you?"
854,1406,0,2,8,10,1.2,0.13333333333333333,508,"I hate to be ethnocentric, but none of these crimes seem so bad."
4791,1406,1,0,9,10,1.2,0.19999999999999998,508,Is this 'To Catch a Predator?'
905,1406,0,2,8,10,1.2,0.13333333333333333,508,"He was wearing a mask, it was self-defense."
413,1406,0,2,8,10,1.2,0.13333333333333333,508,My client never saw this guy!
4782,1406,0,2,8,10,1.2,0.13333333333333333,508,He sleeps with the fishes. We ALL sleep with the fishes.
4090,1406,0,2,8,10,1.2,0.13333333333333333,508,I'm a Great White - that's a Mako...
4764,1406,0,2,8,10,1.2,0.13333333333333333,508,"As I said earlier, I was at school the night of the aback."
6404,1406,0,2,8,10,1.2,0.13333333333333333,508,"'Yes, I ate him too...Do I have to tell you again, I'm a shark!"
4092,1406,0,2,8,10,1.2,0.13333333333333333,508,"Yeah, I ate the bigger boat, too. So what?"
4763,1406,0,2,8,10,1.2,0.13333333333333333,508,I'm just gonna let the cell phone video tell the whole story.
441,1406,0,2,8,10,1.2,0.13333333333333333,508,You're just making me hungry.
440,1406,0,2,8,10,1.2,0.13333333333333333,508,That's him -- that's the guy who jumped me!
6530,1406,0,2,8,10,1.2,0.13333333333333333,508,"You can sweat a tuna, but good luck trying to grill a shark!"
732,1406,0,2,8,10,1.2,0.13333333333333333,508,"Yeah... I knew him, he used to run with the Jets. But what's that got to do with me?"
448,1406,0,2,8,10,1.2,0.13333333333333333,508,You think I've gotten this far falling for the chumming routine?
729,1406,0,2,8,10,1.2,0.13333333333333333,508,You're charged with promoting reefer madness.
4104,1406,0,2,8,10,1.2,0.13333333333333333,508,You're going to need a bigger subpoena.
6415,1406,1,0,9,10,1.2,0.19999999999999998,508,"I'm tellin' ya, it ain't me. It's Left Shark. He's the crazy one."
722,1406,0,2,8,10,1.2,0.13333333333333333,508,You're going to need a warrant to check the contents of my stomach.
6408,1406,1,0,9,10,1.2,0.19999999999999998,508,His name is Quinn.
6532,1406,1,0,9,10,1.2,0.19999999999999998,508,Have you seen this license plate?
6534,1406,0,2,8,10,1.2,0.13333333333333333,508,He said he was gonna need a bigger boat
4258,1406,0,2,8,10,1.2,0.13333333333333333,508,At this point it was clear to viewers that 'Law and Order' had jumped the shark.
4675,1406,1,0,9,10,1.2,0.19999999999999998,508,"Yeah, I'm sure. He tasted like chicken."
788,1406,0,2,8,10,1.2,0.13333333333333333,508,"This man was clearly hit over the head with a hammer, and as you can see, I am not a hammerhead shark."
4270,1406,1,0,9,10,1.2,0.19999999999999998,508,"Yeh, but I swear I didn't know when I took her across state lines it was for immoral porpoises."
4269,1406,1,0,9,10,1.2,0.19999999999999998,508,"As a lawyer, he insisted on being read his rights."
784,1406,0,2,8,10,1.2,0.13333333333333333,508,That's Remora. What a sucker.
425,1406,1,0,9,10,1.2,0.19999999999999998,508,"For the last time, I am not in a gang, and I don't know who shot Tony."
4070,1406,0,2,8,10,1.2,0.13333333333333333,508,"I keep telling ya, I'm a dolphin."
774,1406,1,0,9,10,1.2,0.19999999999999998,508,"Sure, angles can make anything look worse."
4071,1406,0,2,8,10,1.2,0.13333333333333333,508,"Looked like a seal, really? I'm going to call bullshark on that."
4073,1406,0,2,8,10,1.2,0.13333333333333333,508,"Sure, we was in the tank together, so what?"
4262,1406,1,0,9,10,1.2,0.19999999999999998,508,I told you....the leg was already severed by the time I arrived.
6388,1406,1,0,9,10,1.2,0.19999999999999998,508,Just a movie. No humans harmed in its production.
6392,1406,0,2,8,10,1.2,0.13333333333333333,508,Is this the diver who accousted you?
4081,1406,0,2,8,10,1.2,0.13333333333333333,508,I told you...I was in the Indian Ocean at the time !
431,1406,0,2,8,10,1.2,0.13333333333333333,508,I'm no rat!
417,1406,0,2,8,10,1.2,0.13333333333333333,508,"We dated briefly, but she wasn't my taste."
205,1406,0,2,8,10,1.2,0.13333333333333333,508,"I don't know, all you humans look the same to me."
4210,1406,1,0,9,10,1.2,0.19999999999999998,508,"Yea, maybe we once crossed paths in law school."
76,1406,0,2,8,10,1.2,0.13333333333333333,508,I've advised my client not to sign this.
5026,1406,1,0,9,10,1.2,0.19999999999999998,508,"Of course I did it in cold blood you idiot, I'm a fish!"
5991,1406,1,0,9,10,1.2,0.19999999999999998,508,I ain't taking the bait. I don't know where this guy Jonas is.
4593,1406,1,0,9,10,1.2,0.19999999999999998,508,I didn't bite her. I never met her. I don't go for that kind of food.
6714,1406,0,2,8,10,1.2,0.13333333333333333,508,He had it chummin'
1398,1406,1,0,9,10,1.2,0.19999999999999998,508,"I keep telling ya, there is no good shark recipe"
1401,1406,0,2,8,10,1.2,0.13333333333333333,508,Look me in the face and tell me you did not eat this man!!
5993,1406,0,2,8,10,1.2,0.13333333333333333,508,I swear I've never seen that leg before in my life.
5050,1406,0,2,8,10,1.2,0.13333333333333333,508,"Hey, that was 41 years ago!"
6754,1406,0,2,8,10,1.2,0.13333333333333333,508,"Na, not him. He had a bigger boat."
67,1406,0,2,8,10,1.2,0.13333333333333333,508,"Yeah, I'm a loan shark and I charge an arm and a leg interest!"
4981,1406,1,0,9,10,1.2,0.19999999999999998,508,"You're wasting your time, copper. Real sharks don't talk!"
3628,1406,0,2,8,10,1.2,0.13333333333333333,508,And then I said to him 'nobody jumps the Shark'.
38,1406,0,2,8,10,1.2,0.13333333333333333,508,I'm gonna need a bigger picture.
4491,1406,0,2,8,10,1.2,0.13333333333333333,508,I'm telling you. We don't eat agents.
4988,1406,0,2,8,10,1.2,0.13333333333333333,508,I wasn't rolling my eyes at you. I'm just getting hungry.
4517,1406,0,2,8,10,1.2,0.13333333333333333,508,Is this person inside you?
1417,1406,1,0,9,10,1.2,0.19999999999999998,508,Who's Chevy Chase?'
5063,1406,0,2,8,10,1.2,0.13333333333333333,508,Not another word until I've eaten a lawyer.
1418,1406,0,2,8,10,1.2,0.13333333333333333,508,"Wait, water-boarding is only practiced on humans?"
3476,1406,0,2,8,10,1.2,0.13333333333333333,508,That's him. Tasted great..
1630,1406,0,2,8,10,1.2,0.13333333333333333,508,Let's stop going around in circles.
6681,1406,1,0,9,10,1.2,0.19999999999999998,508,"Yes, we were chummy in school."
5027,1406,0,2,8,10,1.2,0.13333333333333333,508,I haven't seen that shark since Alcatraz.
1391,1406,0,2,8,10,1.2,0.13333333333333333,508,Hey- you didn't signal that you were going to turn under me.
6058,1406,1,0,9,10,1.2,0.19999999999999998,508,I did NOT make that loan to Hillary Clinton!
1648,1406,0,2,8,10,1.2,0.13333333333333333,508,"Yep, he was in my law school class."
27,1406,0,2,8,10,1.2,0.13333333333333333,508,"Statistically speaking, that's more likely to be a jellyfish bite."
3666,1406,1,0,9,10,1.2,0.19999999999999998,508,'That was just a little love bite'.
117,1406,0,2,8,10,1.2,0.13333333333333333,508,Nemo? Never heard of him.
3664,1406,0,2,8,10,1.2,0.13333333333333333,508,"That's my brother hangin' around the school, not me."
3660,1406,0,2,8,10,1.2,0.13333333333333333,508,Why aren't you rounding up the white sharks?
4522,1406,1,0,9,10,1.2,0.19999999999999998,508,You know the loan shark code. Never sign a confession!
1588,1406,1,0,9,10,1.2,0.19999999999999998,508,You have the biological imperative to remain silent.
3465,1406,1,0,9,10,1.2,0.19999999999999998,508,"'Christ! Do ya think I'm a dolphin?' (Is that the correct spelling for 'do ya?' And if 'Christ' isn't PC, replace it with 'Jeez')"
4975,1406,0,2,8,10,1.2,0.13333333333333333,508,"This is a case of mistaken identity: I am a tiger shark, not an evil 'loan' shark."
3498,1406,0,2,8,10,1.2,0.13333333333333333,508,I think you guys are misunderstanding the term 'crime wave.'
2748,1406,1,0,9,10,1.2,0.19999999999999998,508,"So, you found a torn bathing suit? I told you, I only ate the surfboard."
95,1406,0,2,8,10,1.2,0.13333333333333333,508,I dare you to waterboard me
5067,1406,0,2,8,10,1.2,0.13333333333333333,508,That's a typo. I'm a l-o-n-e shark!
4570,1406,0,2,8,10,1.2,0.13333333333333333,508,"Jerry? Sure he's a whale, a real high roller. But a killer whale? Doesn't have it in him.'"
6069,1406,0,2,8,10,1.2,0.13333333333333333,508,"I keep tellin' you, the guy jumped me."
4432,1406,1,0,9,10,1.2,0.19999999999999998,508,That looks like an old chum of mine.
6066,1406,0,2,8,10,1.2,0.13333333333333333,508,I'm telling you it was an accident - I swear that arm belongs to an octopus.
6065,1406,0,2,8,10,1.2,0.13333333333333333,508,"Yes, I lent her the money, but it wasn't predatory!"
1589,1406,1,0,9,10,1.2,0.19999999999999998,508,"For the fourth time, you cannot park on Wall Street even if you work there."
3649,1406,1,0,9,10,1.2,0.19999999999999998,508,"Back off, guys. I used to be in the Marines!"
6059,1406,0,2,8,10,1.2,0.13333333333333333,508,On the advish of my attorney I plead the fish.
6070,1406,0,2,8,10,1.2,0.13333333333333333,508,"First supersized drinks... now, baby seals?"
1595,1406,0,2,8,10,1.2,0.13333333333333333,508,Call? I am the attorney.
5053,1406,0,2,8,10,1.2,0.13333333333333333,508,"Yes, I already told you I vacationed in Amity that summer!"
4992,1406,1,0,9,10,1.2,0.19999999999999998,508,"The guy yelled 'Hey, Chum!'....so I went for it..."
3591,1406,1,0,9,10,1.2,0.19999999999999998,508,It's just a ticket to watch the game; my performing days are over!
1605,1406,0,2,8,10,1.2,0.13333333333333333,508,"Okay, but from my angle, she looked like a seal."
4509,1406,1,0,9,10,1.2,0.19999999999999998,508,You've lost Nemo again?
1490,1406,0,2,8,10,1.2,0.13333333333333333,508,Try holding the picture up over my head.
5007,1406,0,2,8,10,1.2,0.13333333333333333,508,I'm not going to take the bait!
6739,1406,0,2,8,10,1.2,0.13333333333333333,508,"No officer, I've never seen that surfer in my life."
5008,1406,1,0,9,10,1.2,0.19999999999999998,508,"I assumed they were international waters, sir."
1464,1406,0,2,8,10,1.2,0.13333333333333333,508,I want my lawyer. He's a real shark.
6014,1406,0,2,8,10,1.2,0.13333333333333333,508,"OK, OK, so they're pearly white, so what!"
4463,1406,0,2,8,10,1.2,0.13333333333333333,508,Yeah. It's a seal. Chewed in half. So what?
130,1406,0,2,8,10,1.2,0.13333333333333333,508,Keep me here as long as you want. I never sleep.
6697,1406,0,2,8,10,1.2,0.13333333333333333,508,"I want a lawyer ... in fact, I could go for two!"
5056,1406,0,2,8,10,1.2,0.13333333333333333,508,"Yes sir, that's the man who jumped me."
6652,1406,0,2,8,10,1.2,0.13333333333333333,508,Not my teeth marks--I have an overbite.
6012,1406,1,0,9,10,1.2,0.19999999999999998,508,"I know, I know...I didn't have an updated fishing permit"
128,1406,0,2,8,10,1.2,0.13333333333333333,508,How about that glass of water?
124,1406,0,2,8,10,1.2,0.13333333333333333,508,"You know I'm the attorney, right?"
6003,1406,1,0,9,10,1.2,0.19999999999999998,508,I smell a mackerel!
4452,1406,0,2,8,10,1.2,0.13333333333333333,508,Why do you assume that the aggressor was me?
57,1406,0,2,8,10,1.2,0.13333333333333333,508,Recognize this surfboard?
1474,1406,0,2,8,10,1.2,0.13333333333333333,508,is this the last person you ate
1600,1406,0,2,8,10,1.2,0.13333333333333333,508,Just because I provide much needed loans to small businesses doesn't mean I'm a shark
1470,1406,0,2,8,10,1.2,0.13333333333333333,508,"Yes, he was always chummy -- why?"
3667,1406,1,0,9,10,1.2,0.19999999999999998,508,"Yeah,he was a client,but I didn't eat im."
3493,1406,1,0,9,10,1.2,0.19999999999999998,508,"No, I ain't seen him. Plus, he tasted lousy."
3572,1406,1,0,9,10,1.2,0.19999999999999998,508,"I keep telling you, they all look the same!"
6736,1406,1,0,9,10,1.2,0.19999999999999998,508,"You cops are all the same. Whenever someone is bitten in half while surfing, it's always the shark's fault."
1495,1406,1,0,9,10,1.2,0.19999999999999998,508,"You see a victim, I see lunch; you must see the cognitive dissonance."
4514,1406,0,2,8,10,1.2,0.13333333333333333,508,Lots of sharks have three sets of teeth! Anybody could have done that!
3494,1406,0,2,8,10,1.2,0.13333333333333333,508,You're bluffing...there's no way that can be my fingerprint!
6039,1406,0,2,8,10,1.2,0.13333333333333333,508,"Yeah, it looks like him, but he was riding a different color surfboard"
1617,1406,0,2,8,10,1.2,0.13333333333333333,508,I was merely trying to reattach his arm.
3612,1406,0,2,8,10,1.2,0.13333333333333333,508,"Sorry Governor, never bit the chap before in me life."
6035,1406,0,2,8,10,1.2,0.13333333333333333,508,"Seriously, all humans look the same."
1433,1406,0,2,8,10,1.2,0.13333333333333333,508,"With all due respect, I am not a rat."
1434,1406,0,2,8,10,1.2,0.13333333333333333,508,"I told ya, I'm just a loan shark, not a killer whale"
6708,1406,0,2,8,10,1.2,0.13333333333333333,508,Why is it that every time someone has a big bite taken out of them you bring me in?
1436,1406,1,0,9,10,1.2,0.19999999999999998,508,"Come on, she was obviously a sea turtle."
4472,1406,0,2,8,10,1.2,0.13333333333333333,508,"Bring a 100,000-gallon tank of water, then I'll talk."
3486,1406,0,2,8,10,1.2,0.13333333333333333,508,You know the 'duunnn dunnn... duuuunnnn duun... duuunnnnnnnn dun dun dun dun dun dun dun dun dun dun dunnnnnnnnnnn dunnnn' is not helping me concentrate.
6695,1406,0,2,8,10,1.2,0.13333333333333333,508,Is this Mac Krel?
3487,1406,0,2,8,10,1.2,0.13333333333333333,508,Release me or I'll sue your asses for species profiling.
3605,1406,0,2,8,10,1.2,0.13333333333333333,508,My chum? Sure he was my chum! That's why I ate him.
6696,1406,1,0,9,10,1.2,0.19999999999999998,508,Is this your only menu?
1607,1406,0,2,8,10,1.2,0.13333333333333333,508,"Really, a pasty white thigh is all you have to go on? They all look the same to me."
5015,1406,0,2,8,10,1.2,0.13333333333333333,508,"Looks like someone wants to play 'good cop, dead cop'"
6026,1406,0,2,8,10,1.2,0.13333333333333333,508,"I already told you, I had nothing to do with that, I'm a vegetarian."
1458,1406,0,2,8,10,1.2,0.13333333333333333,508,"Wave it around like a wounded fish, then I'll tell you if I recognize him."
1614,1406,0,2,8,10,1.2,0.13333333333333333,508,"I didn’t lend him money, and I resent being stereotyped."
1523,1406,0,2,8,10,1.2,0.13333333333333333,508,"Hey, just because the guy was wearing a sharkskin suit doesn't mean it was me."
4525,1406,0,2,8,10,1.2,0.13333333333333333,508,"Sorry, I just never look at faces."
1361,1406,0,2,8,10,1.2,0.13333333333333333,508,"Gentlemen, this is profiling. Anyone could've chewed off that leg."
1275,1406,0,2,8,10,1.2,0.13333333333333333,508,I'm fed up with all the loan shark stereotypes.
4404,1406,1,0,9,10,1.2,0.19999999999999998,508,What loan??
1279,1406,0,2,8,10,1.2,0.13333333333333333,508,You're wasting your time. I've never seen that delicious man before.
3531,1406,0,2,8,10,1.2,0.13333333333333333,508,No way that'd be my accomplice. I'm a lone shark.
6122,1406,1,0,9,10,1.2,0.19999999999999998,508,"I did not eat that man, I'm a vegan."
86,1406,0,2,8,10,1.2,0.13333333333333333,508,"And just when I thought it was safe to go back to the beach, I run into HIM!"
5884,1406,0,2,8,10,1.2,0.13333333333333333,508,Define 'chum'.
3535,1406,0,2,8,10,1.2,0.13333333333333333,508,"That someone, is Mack The Knife."
6662,1406,1,0,9,10,1.2,0.19999999999999998,508,He called himself Charlie Tuna.
5090,1406,0,2,8,10,1.2,0.13333333333333333,508,"Like I already told you guys, I ain't never seen that tuna before in my life. Urrrrp."
3721,1406,1,0,9,10,1.2,0.19999999999999998,508,Listen coppers I'm a shark not a rat
3426,1406,0,2,8,10,1.2,0.13333333333333333,508,You wanna know what happened during Shark Week then its gonna cost you an arm and a leg
5886,1406,1,0,9,10,1.2,0.19999999999999998,508,That beach had it coming.
4941,1406,0,2,8,10,1.2,0.13333333333333333,508,I'm not talking until I regurgitate a lawyer.
8,1406,0,2,8,10,1.2,0.13333333333333333,508,Fuhgeddaboudit. I'm not gonna take the bait.
1540,1406,1,0,9,10,1.2,0.19999999999999998,508,I want my lawyer. Call my brother.
6116,1406,0,2,8,10,1.2,0.13333333333333333,508,"Yeah, I confess that IS hard to swallow."
6111,1406,1,0,9,10,1.2,0.19999999999999998,508,"Honestly man, I have a memory of a goldfish..."
6675,1406,0,2,8,10,1.2,0.13333333333333333,508,"That's a Hammerhead, hammerhead!"
4408,1406,0,2,8,10,1.2,0.13333333333333333,508,Your prints are a match.
5973,1406,0,2,8,10,1.2,0.13333333333333333,508,I don't have an accomplice. I'm a 'lone shark'!
3512,1406,0,2,8,10,1.2,0.13333333333333333,508,I know it sounds superfluous but I still want my lawyer.
6,1406,0,2,8,10,1.2,0.13333333333333333,508,Your kids are ugly.
4564,1406,1,0,9,10,1.2,0.19999999999999998,508,'You can't prove that's my client. He has an airtight alibi on the night in question.
4934,1406,0,2,8,10,1.2,0.13333333333333333,508,I never put loans in writing.
4613,1406,0,2,8,10,1.2,0.13333333333333333,508,Told ya is was a Jet.
4612,1406,0,2,8,10,1.2,0.13333333333333333,508,Never saw him. I keep my eyes closed when I'm eating.
6139,1406,1,0,9,10,1.2,0.19999999999999998,508,Chumming?
5959,1406,0,2,8,10,1.2,0.13333333333333333,508,I DON'T KNOW NO JACK THE KNIFE
3417,1406,1,0,9,10,1.2,0.19999999999999998,508,Yeah. That's Ralph. He did it. I didn't do nothin' - I was just there to be in the documentary.
5095,1406,0,2,8,10,1.2,0.13333333333333333,508,"I already told you, it all looks like plankton down there."
3513,1406,1,0,9,10,1.2,0.19999999999999998,508,How was I supposed to know they were filming the whole thing?
6772,1406,0,2,8,10,1.2,0.13333333333333333,508,"We'll I have to admit, it does look a little fishy."
3735,1406,0,2,8,10,1.2,0.13333333333333333,508,I told you--I won't flip.
3734,1406,1,0,9,10,1.2,0.19999999999999998,508,I need my attorney
1683,1406,0,2,8,10,1.2,0.13333333333333333,508,I'm not signing a thing until I eat an attorney.
1258,1406,0,2,8,10,1.2,0.13333333333333333,508,That right there is the work of Vinnie. He's a bull shark that circles down in the cove.
4932,1406,0,2,8,10,1.2,0.13333333333333333,508,Doesn't look familiar. My eyes were rolled back at the time.
6133,1406,0,2,8,10,1.2,0.13333333333333333,508,No. I was a LONE shark.
5962,1406,0,2,8,10,1.2,0.13333333333333333,508,"I already told you, I ain't from the West Side and I don't know no Jets."
3731,1406,1,0,9,10,1.2,0.19999999999999998,508,What? Wuz he your chum or somethin'?
6130,1406,0,2,8,10,1.2,0.13333333333333333,508,"Where I come from, everyone's cold-blooded."
5963,1406,0,2,8,10,1.2,0.13333333333333333,508,"No, you idiots! I did not say that I could shoot someone in New York City and get away with it! You've got the wrong man!"
1271,1406,1,0,9,10,1.2,0.19999999999999998,508,"Yeah, that's him. The tuna. It's always the tuna."
3529,1406,0,2,8,10,1.2,0.13333333333333333,508,"Yeah, that's the fixed rate mortgage"
1694,1406,1,0,9,10,1.2,0.19999999999999998,508,I've never seen that diver before in my life.
1548,1406,0,2,8,10,1.2,0.13333333333333333,508,I'd rather swim with the fishes than take the bait.
5881,1406,1,0,9,10,1.2,0.19999999999999998,508,I never really saw his face.
1536,1406,0,2,8,10,1.2,0.13333333333333333,508,"I'm not a cold-blooded killer, Detective Brody."
4407,1406,0,2,8,10,1.2,0.13333333333333333,508,"Look buddy, color printing makes no difference, I'm color blind - it still looks like a seal! Do you think I like splinters?"
112,1406,0,2,8,10,1.2,0.13333333333333333,508,I don't know anything about loans!
1353,1406,0,2,8,10,1.2,0.13333333333333333,508,"Yeah, I ate him too, so what?"
1672,1406,0,2,8,10,1.2,0.13333333333333333,508,"Ugh, another rorshark test"
173,1406,0,2,8,10,1.2,0.13333333333333333,508,Recognize this man? We found pieces of his swim trunks in your teeth.
3439,1406,1,0,9,10,1.2,0.19999999999999998,508,But I'm a LONE shark!
1666,1406,0,2,8,10,1.2,0.13333333333333333,508,"Okay, I took a nibble, but look at the way she was dressed!"
6663,1406,0,2,8,10,1.2,0.13333333333333333,508,For the ratings; why else?
6671,1406,0,2,8,10,1.2,0.13333333333333333,508,You do know my eyes are on the side of my head.
4559,1406,0,2,8,10,1.2,0.13333333333333333,508,"I can't sing it, but I can hum it for you."
23,1406,0,2,8,10,1.2,0.13333333333333333,508,"Yes, I made that loan."
24,1406,0,2,8,10,1.2,0.13333333333333333,508,You two are obviously on a fishing expedition
3684,1406,0,2,8,10,1.2,0.13333333333333333,508,"Yeah I know him, he gave me indigestion."
4959,1406,0,2,8,10,1.2,0.13333333333333333,508,something smells pretty fishy
1339,1406,0,2,8,10,1.2,0.13333333333333333,508,"I don't ask their names, just eat 'em."
170,1406,1,0,9,10,1.2,0.19999999999999998,508,"If I talk, I'll be 'swimming with the fishes'."
4961,1406,0,2,8,10,1.2,0.13333333333333333,508,"Look, Sharknado was just a movie, ok?"
6084,1406,0,2,8,10,1.2,0.13333333333333333,508,Go back to the one of him in a yellow speedo
5035,1406,1,0,9,10,1.2,0.19999999999999998,508,"We know you did it, now tell us where Flipper is."
5901,1406,1,0,9,10,1.2,0.19999999999999998,508,I can't be sure. There was a lot of blood in the water that day!
5945,1406,0,2,8,10,1.2,0.13333333333333333,508,I would say we were more bicurious than chummy.
4485,1406,0,2,8,10,1.2,0.13333333333333333,508,so I swim with sharks - doesn't everybody?
3457,1406,1,0,9,10,1.2,0.19999999999999998,508,"If I talk, it's pow and I sleep with the fishes."
3509,1406,1,0,9,10,1.2,0.19999999999999998,508,"Change 'attacked' to 'dined on,' and I sign."
4958,1406,0,2,8,10,1.2,0.13333333333333333,508,"No, I don't recognize him. There's a lot of fish in the sea."
1312,1406,1,0,9,10,1.2,0.19999999999999998,508,"Always blaming the great white sharks, aren't you? Bigots!"
5887,1406,0,2,8,10,1.2,0.13333333333333333,508,"Are you crazy? Considering his FICO score, that's a perfectly reasonable rate!"
6769,1406,0,2,8,10,1.2,0.13333333333333333,508,"He's asking for another waterboarding chief, if you ask me!!"
1360,1406,1,0,9,10,1.2,0.19999999999999998,508,"Seriously, it's more likely he got hit by lightning than that I had anything to do with it."
3459,1406,0,2,8,10,1.2,0.13333333333333333,508,We're trying to find Nemo and we have reason to believe that you know where he is.
5975,1406,0,2,8,10,1.2,0.13333333333333333,508,I'm not a killer. I'm a great white.
1316,1406,0,2,8,10,1.2,0.13333333333333333,508,"Nope, that leg doesn't look familiar."
3699,1406,1,0,9,10,1.2,0.19999999999999998,508,"Officer, I've never seen that surfboard before in my life"
3672,1406,1,0,9,10,1.2,0.19999999999999998,508,"' I told you, I took his leg and swam. Never saw his face"
1321,1406,1,0,9,10,1.2,0.19999999999999998,508,I'd like to regurgitate my lawyer.
12,1406,0,2,8,10,1.2,0.13333333333333333,508,Alibi? I was in school at the time.
1680,1406,0,2,8,10,1.2,0.13333333333333333,508,"So I was there? There were a lot of guys there, it was a frenzy."
178,1406,1,0,9,10,1.2,0.19999999999999998,508,"Actually, it *would* have killed me to stop for a closer look."
5891,1406,0,2,8,10,1.2,0.13333333333333333,508,Ask anyone! Nurse sharks are vegetarians!
4954,1406,0,2,8,10,1.2,0.13333333333333333,508,Could you hold it a little closer?
5943,1406,0,2,8,10,1.2,0.13333333333333333,508,Who's Miranda?
11,1406,0,2,8,10,1.2,0.13333333333333333,508,I told you I never saw that leg before
3458,1406,0,2,8,10,1.2,0.13333333333333333,508,How many times do I have to tell you- I didn't gnaw him
3675,1406,0,2,8,10,1.2,0.13333333333333333,508,This fin was seen leaving the harbor of the crime. Look familiar?
1657,1406,0,2,8,10,1.2,0.13333333333333333,508,"Oh sure, always blame the shark !"
2540,2202,0,3,13,16,1.1875,0.10077822185373188,508,You can tell Surfer Boy I'll be countersuing for splinters.
1797,2203,0,2,9,11,1.1818181818181819,0.12196734422726127,508,"Yeah, I freed Willy. What's it to you?"
1565,2203,0,2,9,11,1.1818181818181819,0.12196734422726127,508,Can I have a pool of water?
5031,2203,0,2,9,11,1.1818181818181819,0.12196734422726127,508,You're gonna need a bigger 'boatload of evidence.'
392,2203,0,2,9,11,1.1818181818181819,0.12196734422726127,508,"Its a boat called the Orca, now do you recognize it!"
5632,2203,0,2,9,11,1.1818181818181819,0.12196734422726127,508,Hey! What can I tell you. It was lunch.
724,2203,1,0,10,11,1.1818181818181819,0.18181818181818182,508,I'm gonna need a bigger lawyer.
3000,2203,0,2,9,11,1.1818181818181819,0.12196734422726127,508,"He tasted terrible! ... I mean, I've never seen the guy before!"
3027,2203,0,2,9,11,1.1818181818181819,0.12196734422726127,508,I'm signing nothing until I speak with my Shark.
2335,2203,1,0,10,11,1.1818181818181819,0.18181818181818182,508,"That's it, it was a blue Mustang."
4282,2203,1,0,10,11,1.1818181818181819,0.18181818181818182,508,That's a mammal: I'm a fish.
6333,2203,0,2,9,11,1.1818181818181819,0.12196734422726127,508,"I told you, I've never tasted him before in my life..."
3991,2203,0,2,9,11,1.1818181818181819,0.12196734422726127,508,We swam in the same school but always in different circles.
5940,2203,1,0,10,11,1.1818181818181819,0.18181818181818182,508,How many times do I have to tell you: Luca Brasi sleeps with the fishes!
1852,2203,0,2,9,11,1.1818181818181819,0.12196734422726127,508,She didn't look THAT good in a bathing suit.
826,2203,0,2,9,11,1.1818181818181819,0.12196734422726127,508,I keep telling you. I don't know this Louie Miller or a MacHeath.
6538,2203,0,2,9,11,1.1818181818181819,0.12196734422726127,508,He owed me money.
1539,2203,0,2,9,11,1.1818181818181819,0.12196734422726127,508,"I'll make you an offer. $100,000 for a 15% stake in your company."
1817,2203,0,2,9,11,1.1818181818181819,0.12196734422726127,508,Im not talking until my lawyer swims in here.
6551,2203,1,0,10,11,1.1818181818181819,0.18181818181818182,508,"I told you I can't see the blood, I need to smell it."
4436,2203,1,0,10,11,1.1818181818181819,0.18181818181818182,508,I wanna talk to my lobster.
381,2203,0,2,9,11,1.1818181818181819,0.12196734422726127,508,I did not eat that guy!
6580,2203,0,2,9,11,1.1818181818181819,0.12196734422726127,508,What can I say? We had cartilage to pick with someone.
646,2203,0,2,9,11,1.1818181818181819,0.12196734422726127,508,I demand to speak to my scum-sucking bottom dweller.
5324,2203,1,0,10,11,1.1818181818181819,0.18181818181818182,508,"I didn't eat that guy, I am vegeterian."
2531,2203,0,2,9,11,1.1818181818181819,0.12196734422726127,508,I can't help ya. All them damn hammerheads look alike to me.
5772,2203,0,2,9,11,1.1818181818181819,0.12196734422726127,508,Your job performance has not improved. I'm afraid we're going to have to give you your swimming papers.
3278,2203,1,0,10,11,1.1818181818181819,0.18181818181818182,508,"You're looking for a card 'sharp,' idiots. Don't you use urban dictionary?"
4688,2203,0,2,9,11,1.1818181818181819,0.12196734422726127,508,"Yes, that's the foot that assaulted me. Please arrest it."
3854,2203,0,2,9,11,1.1818181818181819,0.12196734422726127,508,"Yeah, I know him. We ate a school together."
1356,2203,0,2,9,11,1.1818181818181819,0.12196734422726127,508,His cement boots were larger.
4689,2203,0,2,9,11,1.1818181818181819,0.12196734422726127,508,I never laid a fin on the guy...I did; however; loan him some money....
1126,2203,0,2,9,11,1.1818181818181819,0.12196734422726127,508,That looks nothing like me! You can't even tell one shark from another.
2089,2203,0,2,9,11,1.1818181818181819,0.12196734422726127,508,Can we take a break now guys? These handcuffs are starting to chafe.
4542,2203,0,2,9,11,1.1818181818181819,0.12196734422726127,508,More like a hammer.
2460,2203,0,2,9,11,1.1818181818181819,0.12196734422726127,508,He was kind of rubbery. I blamed it on the wetsuit.
1167,2203,0,2,9,11,1.1818181818181819,0.12196734422726127,508,I thought I had passed the water boarding test.
3796,2203,1,0,10,11,1.1818181818181819,0.18181818181818182,508,Are you kidding me? You thought THIS was a walrus?
6176,2203,0,2,9,11,1.1818181818181819,0.12196734422726127,508,"For the last time, I never see the faces."
5565,2203,1,0,10,11,1.1818181818181819,0.18181818181818182,508,Are you kidding? I wouldn't lend that killer whale a shrimp!
4699,2203,0,2,9,11,1.1818181818181819,0.12196734422726127,508,We have your client dead in the water
3185,2203,0,2,9,11,1.1818181818181819,0.12196734422726127,508,Is that supposed to send me into some sort of frenzy?
1691,2203,1,0,10,11,1.1818181818181819,0.18181818181818182,508,I never saw that harbor seal before in my life.
1982,2203,0,2,9,11,1.1818181818181819,0.12196734422726127,508,That's him. Quint. His ship's the 'Orca'.
519,2203,1,0,10,11,1.1818181818181819,0.18181818181818182,508,Does this look like anyone you've eaten recently?
3732,2203,0,2,9,11,1.1818181818181819,0.12196734422726127,508,Lookit. I told you already: the greaser in the leather jacket jumped me first!
5730,2203,0,2,9,11,1.1818181818181819,0.12196734422726127,508,I've never seen that nude swimmer before in my life.
1704,2203,1,0,10,11,1.1818181818181819,0.18181818181818182,508,"For the last time, I wouldn't know a loanshark if I saw one."
537,2203,0,2,9,11,1.1818181818181819,0.12196734422726127,508,Steven Spielberg.
4310,2203,1,0,10,11,1.1818181818181819,0.18181818181818182,508,"Yeah, my wife slept with Luca Brasi. We all did."
3641,2203,0,2,9,11,1.1818181818181819,0.12196734422726127,508,"What is this, some kinda fishing expedition?"
6232,2203,0,2,9,11,1.1818181818181819,0.12196734422726127,508,I've never seen those swim trunks before.
647,2203,1,0,10,11,1.1818181818181819,0.18181818181818182,508,Yeah I seen 'im ... he's sleeping with the fishes.
6013,2203,0,2,9,11,1.1818181818181819,0.12196734422726127,508,Ever loan to him?
1466,2203,0,2,9,11,1.1818181818181819,0.12196734422726127,508,"Amity Island, 1974, so what if I was there?"
710,2203,0,2,9,11,1.1818181818181819,0.12196734422726127,508,"Look, I'm a vegetarian."
6286,2203,1,0,10,11,1.1818181818181819,0.18181818181818182,508,The suspect was last seen swimming with the fishes.
703,2203,1,0,10,11,1.1818181818181819,0.18181818181818182,508,"Before making any comment, I want a glass of water ... a really big glass."
2191,2203,0,2,9,11,1.1818181818181819,0.12196734422726127,508,"So, you think he could be swimming with the fishes?"
4298,2203,0,2,9,11,1.1818181818181819,0.12196734422726127,508,"Holy mackerel, that's the guy!"
1775,2203,1,0,10,11,1.1818181818181819,0.18181818181818182,508,"OK, one more time, do you recognize this leg?"
981,2203,0,2,9,11,1.1818181818181819,0.12196734422726127,508,"Nope,don't recall her....but Hey! It's who I am, I sleep with a lot of fishes!"
3079,2203,0,2,9,11,1.1818181818181819,0.12196734422726127,508,"I told you, you can't bait me into saying anything. I know my rights."
3640,2203,0,2,9,11,1.1818181818181819,0.12196734422726127,508,"No, it is not one my loans"
1615,2203,0,2,9,11,1.1818181818181819,0.12196734422726127,508,He was wearing fins and a face mask.
991,2203,0,2,9,11,1.1818181818181819,0.12196734422726127,508,One more second of not moving and I will be dead
1619,2203,1,0,10,11,1.1818181818181819,0.18181818181818182,508,"Listen, I want to be nice, but my friend here wants to go Robert Shaw all over you."
6276,2203,0,2,9,11,1.1818181818181819,0.12196734422726127,508,"Last time I saw him, he was in shallow water."
3374,2203,0,2,9,11,1.1818181818181819,0.12196734422726127,508,How exactly do you think I pulled the trigger?!
6575,2203,0,2,9,11,1.1818181818181819,0.12196734422726127,508,"Yeah, I lent him some money."
3108,2203,1,0,10,11,1.1818181818181819,0.18181818181818182,508,"Yeah, I recognize him. Steve something. Said he was gonna make me a movie star, but then I never heard back from the bum. What'd he do, kill somebody?"
6260,2203,0,2,9,11,1.1818181818181819,0.12196734422726127,508,Is this the guy that jumped over you?
6573,2203,0,2,9,11,1.1818181818181819,0.12196734422726127,508,"Take it from me, he sleeps with the fish."
668,2203,0,2,9,11,1.1818181818181819,0.12196734422726127,508,"Wrong, my friend, YOU'RE gonna need a bigger boat."
5916,2203,0,2,9,11,1.1818181818181819,0.12196734422726127,508,This loan-sharking thing is so species profiling.
5441,2203,0,2,9,11,1.1818181818181819,0.12196734422726127,508,"I keep telling you I'm a card shark, not a loan shark."
1332,2278,0,2,10,12,1.1666666666666667,0.11236664374387371,508,Honestly he should be glad that I did not press charges because he was the one to punch me in the nose first
3284,2278,0,2,10,12,1.1666666666666667,0.11236664374387371,508,How was I supposed to know she wasn't a sea lion?
4264,2278,1,0,11,12,1.1666666666666667,0.16666666666666669,508,This isn't what we meant when we said take a bite out of crime.
4118,2278,1,0,11,12,1.1666666666666667,0.16666666666666669,508,Yeah my teeth could use a little white whitening
5425,2278,0,2,10,12,1.1666666666666667,0.11236664374387371,508,Yeah. There's something fishy about him.
4936,2278,0,2,10,12,1.1666666666666667,0.11236664374387371,508,Looks like chum. Can I go now?
5599,2278,0,2,10,12,1.1666666666666667,0.11236664374387371,508,"Okay, okay, yes I did it. But please don't send me back to SeaWorld!"
5723,2278,0,2,10,12,1.1666666666666667,0.11236664374387371,508,"I loaned him the cash, but I don't know how he ended up like that."
2587,2286,0,2,11,13,1.1538461538461537,0.10415433852097389,508,I want the Miranda rights not the Herman Melville book review.
3062,2286,0,2,11,13,1.1538461538461537,0.10415433852097389,508,"Yeah, I know him. We were in school together."
3983,2286,0,2,11,13,1.1538461538461537,0.10415433852097389,508,...and what exactly were you doing within 500 feet of a school?
3834,2286,1,0,12,13,1.1538461538461537,0.15384615384615385,508,Yeah I've sea-n him a couple of times around the Pacific...
6658,2290,0,1,6,7,1.1428571428571428,0.1543033499620919,508,"So this must be the “tasty cop, inedible cop” routine."
827,2290,0,1,6,7,1.1428571428571428,0.1543033499620919,508,He doesn't look familiar with his limbs still attached.
4255,2290,0,2,12,14,1.1428571428571428,0.09705231721239395,508,"I don't know anything about loans, cards, or pool, and this is profiling."
255,2290,0,1,6,7,1.1428571428571428,0.1543033499620919,508,You're gonna need a bigger photo.
1157,2290,0,2,12,14,1.1428571428571428,0.09705231721239395,508,Of course I know her...I served on her tenure review board.
555,2295,0,1,7,8,1.125,0.1336306209562122,508,"Come on guys, give me a break, I haven't slept in....ever."
3424,2295,0,1,7,8,1.125,0.1336306209562122,508,"Check my alibi, I was out making loans."
2985,2295,0,1,7,8,1.125,0.1336306209562122,508,"You guys can play good carp bad carp all you want, I didn't see anything."
2327,2295,0,2,14,16,1.125,0.08539125638299665,508,It does seem like something fishy is going on here... how long have you been looking for this Nemo character?
4614,2295,0,1,7,8,1.125,0.1336306209562122,508,I didn't really get a good look at him --- he kept moving.
391,2295,0,1,7,8,1.125,0.1336306209562122,508,Never seen that ankle in my life.
4411,2295,0,1,7,8,1.125,0.1336306209562122,508,"Now this jury that you speak of, will it be your peers or mine?"
2099,2295,0,1,7,8,1.125,0.1336306209562122,508,That is such a red herring!
1932,2295,0,1,7,8,1.125,0.1336306209562122,508,"No, that's not my signature! You see any arms?"
959,2295,0,1,7,8,1.125,0.1336306209562122,508,"'I eat people like that for breakfast,' is a figure of speech!"
3785,2295,0,1,7,8,1.125,0.1336306209562122,508,Now he would go well with fave beans and a nice Chianti.
3713,2295,0,1,7,8,1.125,0.1336306209562122,508,I'm going to say it one more time! I THOUGHT he was a seal!
2273,2295,0,1,7,8,1.125,0.1336306209562122,508,We many have chummed once or twice; he was never part of the gam.
6193,2295,0,1,7,8,1.125,0.1336306209562122,508,I was nowhere near Amity that day
5707,2295,0,1,7,8,1.125,0.1336306209562122,508,"I don't know, they were from a school of fish, they all look the same..."
6248,2295,0,1,7,8,1.125,0.1336306209562122,508,"If you've seen one anchovy, you've seen 'em all."
1488,2295,0,1,7,8,1.125,0.1336306209562122,508,I've told you that I don't know what happened to Charlie the Tuna.
5146,2295,0,1,7,8,1.125,0.1336306209562122,508,Kanye West's fingers?
4336,2313,0,1,8,9,1.1111111111111112,0.11785113019775792,508,"Yes, it's true, I work at Goldman Sachs."
5345,2313,0,1,8,9,1.1111111111111112,0.11785113019775792,508,'Can you identify this 'loan shark' ?
4543,2313,0,1,8,9,1.1111111111111112,0.11785113019775792,508,Swimmers? I don't know nothin' 'bout no missin' swimmers.
4604,2313,0,1,8,9,1.1111111111111112,0.11785113019775792,508,"Sure, it looks like me...it's a shark!"
2837,2313,0,1,8,9,1.1111111111111112,0.11785113019775792,508,Clearly not the smart one here...or you're a lefty.
4650,2313,0,1,8,9,1.1111111111111112,0.11785113019775792,508,Those can't be my toothmarks.
4603,2313,0,1,8,9,1.1111111111111112,0.11785113019775792,508,"I heard about being grilled eventually, but is this the way?"
4600,2313,0,1,8,9,1.1111111111111112,0.11785113019775792,508,"Yeah, that's him alright. That's the one that bit me."
4605,2313,0,1,8,9,1.1111111111111112,0.11785113019775792,508,"'Alright. One more 'dah-dum' at the end, then I'll sign it.'"
4561,2313,0,1,8,9,1.1111111111111112,0.11785113019775792,508,You can't prove that's my dorsal fin.
2805,2313,0,1,8,9,1.1111111111111112,0.11785113019775792,508,Looks like a bottom feeder to me.
4425,2313,0,1,8,9,1.1111111111111112,0.11785113019775792,508,I told you the guy you are looking for is a narc.
5406,2313,0,1,8,9,1.1111111111111112,0.11785113019775792,508,"...and I would have gotten away with it too, if it wasn't for that damn cellist."
4652,2313,0,1,8,9,1.1111111111111112,0.11785113019775792,508,"Why would I bite her? I,m a vegetarian."
2759,2313,0,1,8,9,1.1111111111111112,0.11785113019775792,508,There's no way you can make me sign that.
5381,2313,0,1,8,9,1.1111111111111112,0.11785113019775792,508,I don't know. He wasn't over me that long.
4653,2313,0,1,8,9,1.1111111111111112,0.11785113019775792,508,I saw him yesterday after the school.
4321,2313,0,1,8,9,1.1111111111111112,0.11785113019775792,508,Does anything look fishy to you?
4319,2313,0,1,8,9,1.1111111111111112,0.11785113019775792,508,"Maybe that is him, maybe it ain't -- all those mollusks look the same to me."
4545,2313,0,1,8,9,1.1111111111111112,0.11785113019775792,508,"I was in the tank at the time, I swear!"
5407,2313,0,1,8,9,1.1111111111111112,0.11785113019775792,508,Mack? I don't know any Mack the Knife!
5409,2313,0,1,8,9,1.1111111111111112,0.11785113019775792,508,That beach is not familiar and in any case I would never eat anything wearing yoga pants.
2851,2313,0,1,8,9,1.1111111111111112,0.11785113019775792,508,"I've never seen that delicious meal...oops, I mean that guy...in my life."
4305,2313,0,1,8,9,1.1111111111111112,0.11785113019775792,508,"Hey, pal, I already told you. I'm no rat."
4651,2313,0,1,8,9,1.1111111111111112,0.11785113019775792,508,Your kidding right? A fish out of water citation....
5382,2313,0,1,8,9,1.1111111111111112,0.11785113019775792,508,What can I say; he was a chum.
2754,2313,0,1,8,9,1.1111111111111112,0.11785113019775792,508,What part of me being a 'life-long vegetarian' do you guys not get?
4547,2313,0,1,8,9,1.1111111111111112,0.11785113019775792,508,your story sounds fishy
4539,2313,0,1,8,9,1.1111111111111112,0.11785113019775792,508,That's me without the toupee!
4392,2313,0,1,8,9,1.1111111111111112,0.11785113019775792,508,Yeah...well that's what happens when you swim with the fishes.
5400,2313,0,1,8,9,1.1111111111111112,0.11785113019775792,508,"No way, man. I wouldn't look twice at her; she's skin and bones. I like 'em fat and juicy."
4702,2313,0,1,8,9,1.1111111111111112,0.11785113019775792,508,"I never loaned money to nobody, now where's my lawyer!"
4214,2313,0,1,8,9,1.1111111111111112,0.11785113019775792,508,I won't talk until I eat my lawyer.
4390,2313,0,1,8,9,1.1111111111111112,0.11785113019775792,508,I wasn't even in those waters when that happened!
4398,2313,0,1,8,9,1.1111111111111112,0.11785113019775792,508,"Oh, sure - it's always the sharks with you guys. Nobody ever says anything about that gang of dolphins!"
4389,2313,0,1,8,9,1.1111111111111112,0.11785113019775792,508,Miranda rights! What about Shark rights?
4216,2313,0,1,8,9,1.1111111111111112,0.11785113019775792,508,Steven Spielberg... that's your man!
4399,2313,0,1,8,9,1.1111111111111112,0.11785113019775792,508,"'Yes I knew Charley the Tuna, but those are not my teeth marks'."
4610,2313,0,1,8,9,1.1111111111111112,0.11785113019775792,508,"To the best of my recollection, I don't recall"
4537,2313,0,1,8,9,1.1111111111111112,0.11785113019775792,508,"I'm innocent, it was the killer whale."
4219,2313,0,1,8,9,1.1111111111111112,0.11785113019775792,508,It all looks like white meat to me.
2811,2313,0,1,8,9,1.1111111111111112,0.11785113019775792,508,"Yeah, I know the guy - He tasted like chicken"
4353,2313,0,1,8,9,1.1111111111111112,0.11785113019775792,508,I ain't no card shark.
5392,2313,0,1,8,9,1.1111111111111112,0.11785113019775792,508,How was I supposed to know they were an endangered species? To me they looked like just another school.
2828,2313,0,1,8,9,1.1111111111111112,0.11785113019775792,508,You're making me hungry.
4607,2313,0,1,8,9,1.1111111111111112,0.11785113019775792,508,"Yeah, he used to work for me; now he sleeps with the wiseguys."
4367,2313,0,1,8,9,1.1111111111111112,0.11785113019775792,508,So you're really telling me you don't recognize this arm?
5401,2313,0,1,8,9,1.1111111111111112,0.11785113019775792,508,"Don't try to bait me, chum. I ain't biting."
4365,2313,0,1,8,9,1.1111111111111112,0.11785113019775792,508,And you expect me to sign THAT?!?
4406,2313,0,1,8,9,1.1111111111111112,0.11785113019775792,508,"You're crazy if you expect me to sign that confession, copper!"
4364,2313,0,1,8,9,1.1111111111111112,0.11785113019775792,508,I was on top of the food chain. Then she swam into my life.
2911,2313,0,1,8,9,1.1111111111111112,0.11785113019775792,508,That was a hot lunch
4363,2313,0,1,8,9,1.1111111111111112,0.11785113019775792,508,You can't pin that torso on me!
4696,2313,0,1,8,9,1.1111111111111112,0.11785113019775792,508,"Hey Einstein, do I look like a stool pigeon to you?"
4228,2313,0,1,8,9,1.1111111111111112,0.11785113019775792,508,I've never eaten a man like that in my life.
2830,2313,0,1,8,9,1.1111111111111112,0.11785113019775792,508,You can't prove that's me. I never heard of Amity.
4626,2313,0,1,8,9,1.1111111111111112,0.11785113019775792,508,I don't recognize none of 'em - it was a bloody feeding frenzy!
4627,2313,0,1,8,9,1.1111111111111112,0.11785113019775792,508,"Of course I ate him! I'm a shark, stupid!"
5347,2313,0,1,8,9,1.1111111111111112,0.11785113019775792,508,"No, I have not seen him. My eyes close while I eat."
2852,2313,0,1,8,9,1.1111111111111112,0.11785113019775792,508,"Look, I’m not saying anything without my attorney and the SPCA present."
2854,2313,0,1,8,9,1.1111111111111112,0.11785113019775792,508,You're going to need a bigger scapegoat.
2853,2313,0,1,8,9,1.1111111111111112,0.11785113019775792,508,You think I did it because I'm great? And white?
4574,2313,0,1,8,9,1.1111111111111112,0.11785113019775792,508,"I can't put a fin on it, but it looks fishy."
2899,2313,0,1,8,9,1.1111111111111112,0.11785113019775792,508,I will not identify any meals without my lawyer present.
2778,2313,0,1,8,9,1.1111111111111112,0.11785113019775792,508,"For the last time, I've never even watched the Discovery Channel."
4682,2313,0,1,8,9,1.1111111111111112,0.11785113019775792,508,I want to speak to my Cousin Vinny.
4279,2313,0,1,8,9,1.1111111111111112,0.11785113019775792,508,that's bait I 'm just not gonna take!
2777,2313,0,1,8,9,1.1111111111111112,0.11785113019775792,508,It wasn't me! It was Jaws! I was framed!
4278,2313,0,1,8,9,1.1111111111111112,0.11785113019775792,508,I don't remember--it was pretty dark out.
5419,2313,0,1,8,9,1.1111111111111112,0.11785113019775792,508,Naw! I quit snacking on little kids years ago. I'm strictly a pescatarian now.
5371,2313,0,1,8,9,1.1111111111111112,0.11785113019775792,508,That's not my bite radius.
2876,2313,0,1,8,9,1.1111111111111112,0.11785113019775792,508,"I may be out of my element here, but that is definitely Sinatra!"
5420,2313,0,1,8,9,1.1111111111111112,0.11785113019775792,508,"I keep telling you guys - I'm a LONE shark, not a LOAN shark."
2897,2313,0,1,8,9,1.1111111111111112,0.11785113019775792,508,That X-ray doesn't prove anything!
4474,2313,0,1,8,9,1.1111111111111112,0.11785113019775792,508,"You've got the wrong guy, I was never even near Lake Placid!"
5421,2313,0,1,8,9,1.1111111111111112,0.11785113019775792,508,"That's the guy! And, well...he had only one leg!"
4479,2313,0,1,8,9,1.1111111111111112,0.11785113019775792,508,Notice the resemblance? This came from the surfer's GoPro camera just before you ate him!
4568,2313,0,1,8,9,1.1111111111111112,0.11785113019775792,508,"I Dunno, I told ya. They all look the same to me."
4556,2313,0,1,8,9,1.1111111111111112,0.11785113019775792,508,I have TMJ; I only wish I could do something like that.
4490,2313,0,1,8,9,1.1111111111111112,0.11785113019775792,508,Quinn? Quinn who?
4272,2313,0,1,8,9,1.1111111111111112,0.11785113019775792,508,Can you stop saying 'Something's fishy'?
4274,2313,0,1,8,9,1.1111111111111112,0.11785113019775792,508,My attorney told me to keep my gills shut.
2892,2313,0,1,8,9,1.1111111111111112,0.11785113019775792,508,Those aren't my bite marks
5424,2313,0,1,8,9,1.1111111111111112,0.11785113019775792,508,"No, it's no me. For the last time, all killer sharks don't look alike."
5357,2313,0,1,8,9,1.1111111111111112,0.11785113019775792,508,"Okay, so I have a fool for a client."
2779,2313,0,1,8,9,1.1111111111111112,0.11785113019775792,508,Bite me !!
5366,2313,0,1,8,9,1.1111111111111112,0.11785113019775792,508,You have the right to remain silent. Any fish we find will be held against you.
2894,2313,0,1,8,9,1.1111111111111112,0.11785113019775792,508,"She's wearing neoprene., I don't do neoprene."
4496,2313,0,1,8,9,1.1111111111111112,0.11785113019775792,508,"Yeah, that's Jenkins. I eat guys like him for breakfast."
4565,2313,0,1,8,9,1.1111111111111112,0.11785113019775792,508,"C'mon man, all sea lions look the same to me."
5368,2313,0,1,8,9,1.1111111111111112,0.11785113019775792,508,Big deal! I literally 'sleep with the fishes.'
4501,2313,0,1,8,9,1.1111111111111112,0.11785113019775792,508,I bet a fin he's the guy who perpetrated a bait and switch on my best chum!
4567,2313,0,1,8,9,1.1111111111111112,0.11785113019775792,508,"I'm tellin' ya, I don't tell no tales outta school."
4260,2313,0,1,8,9,1.1111111111111112,0.11785113019775792,508,I won't take the bait.
4242,2313,0,1,8,9,1.1111111111111112,0.11785113019775792,508,Just because his home was underwater doesn't mean I killed him.
5416,2313,0,1,8,9,1.1111111111111112,0.11785113019775792,508,"Yea that's him Roy Schenider, he's the one that killed my brother."
4555,2313,0,1,8,9,1.1111111111111112,0.11785113019775792,508,"Alright fellas, I confess! That's the guy I ate. But I didn't do it on porpoise."
4265,2313,0,1,8,9,1.1111111111111112,0.11785113019775792,508,"Listen, if it doesn't smell like blood, I can't help you."
2764,2313,0,1,8,9,1.1111111111111112,0.11785113019775792,508,"Like I told you before, the only time I ever saw that Robert Shaw guy was in From Russia With Love."
2855,2313,0,1,8,9,1.1111111111111112,0.11785113019775792,508,"Wow,is that Spielberg?He got old!"
5378,2313,0,1,8,9,1.1111111111111112,0.11785113019775792,508,Ya got it all wrong! I'm not the top of the food chain anymore!
4443,2313,0,1,8,9,1.1111111111111112,0.11785113019775792,508,What do mean that's my signed confession?
2858,2313,0,1,8,9,1.1111111111111112,0.11785113019775792,508,I know my rights. I'm an attorney.
4589,2313,0,1,8,9,1.1111111111111112,0.11785113019775792,508,"Yep, I'm sure it was the Fonz."
4515,2313,0,1,8,9,1.1111111111111112,0.11785113019775792,508,"So, you deny that these are your tooth marks?"
4303,2313,0,1,8,9,1.1111111111111112,0.11785113019775792,508,You have the right to remain silent. Anything you say can and will be held against you during Shark Week.
4446,2313,0,1,8,9,1.1111111111111112,0.11785113019775792,508,That's the guy who hit my little friend. He's Japanese and has a club.
2794,2313,0,1,8,9,1.1111111111111112,0.11785113019775792,508,"You're not going to get anyone out of me, copper."
4511,2313,0,1,8,9,1.1111111111111112,0.11785113019775792,508,It wasn't me. I have implants. You can check.
5411,2313,0,1,8,9,1.1111111111111112,0.11785113019775792,508,I only smelled the blood.
2792,2313,0,1,8,9,1.1111111111111112,0.11785113019775792,508,"OK, I'll sign the confession, but you have to waterboard me one more time first."
4247,2313,0,1,8,9,1.1111111111111112,0.11785113019775792,508,"Yeah sure, he was a uh... a chum of mine."
4250,2313,0,1,8,9,1.1111111111111112,0.11785113019775792,508,Don't blame ME! Talk to Mr. Wonderful.
4447,2313,0,1,8,9,1.1111111111111112,0.11785113019775792,508,That doesn't prove I'm a loan shark.
2871,2313,0,1,8,9,1.1111111111111112,0.11785113019775792,508,"OK, I've read the charges. Now BRING ME MY CLIENT!"
4286,2313,0,1,8,9,1.1111111111111112,0.11785113019775792,508,Do we have to order seafood for lunch?
2787,2313,0,1,8,9,1.1111111111111112,0.11785113019775792,508,You got it all wrong - I'm just one of the minnows.
4458,2313,0,1,8,9,1.1111111111111112,0.11785113019775792,508,You're asking a shark to identify a lawyer?
4667,2313,0,1,8,9,1.1111111111111112,0.11785113019775792,508,You think I could eat that squid?
4663,2313,0,1,8,9,1.1111111111111112,0.11785113019775792,508,You'd better find other fish to fry.
2873,2313,0,1,8,9,1.1111111111111112,0.11785113019775792,508,That's not me. It's the Donald.
4683,2313,0,1,8,9,1.1111111111111112,0.11785113019775792,508,He's not a shark- he's a jet.
4297,2313,0,1,8,9,1.1111111111111112,0.11785113019775792,508,"No, I don’t know who they are and yes they do look delicious."
4510,2313,0,1,8,9,1.1111111111111112,0.11785113019775792,508,"And I'm telling you my GRANDFATHER ate Quint, not little bitty me."
5412,2313,0,1,8,9,1.1111111111111112,0.11785113019775792,508,Speilberg had it coming.
4299,2313,0,1,8,9,1.1111111111111112,0.11785113019775792,508,I'm course I'm sorry she's dead -- she was one of my chums.
2862,2313,0,1,8,9,1.1111111111111112,0.11785113019775792,508,Not gonna happen boys. I ain't no fin-k
4684,2313,0,1,8,9,1.1111111111111112,0.11785113019775792,508,"I don't recognize him, but let me chew on it a while."
2866,2313,0,1,8,9,1.1111111111111112,0.11785113019775792,508,"Jim, I don't think he's going to talk."
4635,2313,0,1,8,9,1.1111111111111112,0.11785113019775792,508,I don't know what your talking about....he practically swam into my mouth
5096,2313,0,1,8,9,1.1111111111111112,0.11785113019775792,508,"Look, all I know is that guy said he was looking for a loan!"
4708,2313,0,1,8,9,1.1111111111111112,0.11785113019775792,508,Now 'Cmon Sir you were seen on the corner of Broadway and Wall with a certain Mr. Trump
3679,2313,0,1,8,9,1.1111111111111112,0.11785113019775792,508,I don't have my glasses. You're gonna need a bigger photo.
3682,2313,0,1,8,9,1.1111111111111112,0.11785113019775792,508,"Listen, I knew him in school but I ain't seen him since!"
3685,2313,0,1,8,9,1.1111111111111112,0.11785113019775792,508,Nah.. he was big like my cousin whitey
3257,2313,0,1,8,9,1.1111111111111112,0.11785113019775792,508,"Way I see it: you got no body, you got no case."
3255,2313,0,1,8,9,1.1111111111111112,0.11785113019775792,508,I meet lots of tuna. This Charlie guy--who the hell remembers?
4957,2313,0,1,8,9,1.1111111111111112,0.11785113019775792,508,That's her! I'll never forget that overbite.
3693,2313,0,1,8,9,1.1111111111111112,0.11785113019775792,508,"I confess, i'mthe lone shark."
4950,2313,0,1,8,9,1.1111111111111112,0.11785113019775792,508,I'm going to ask you one more time; what did you do with the rest of him?
3247,2313,0,1,8,9,1.1111111111111112,0.11785113019775792,508,So I was down by the river. But I don't know no Lotte Lenya!
3704,2313,0,1,8,9,1.1111111111111112,0.11785113019775792,508,"I told you, I don't eat tuna!"
3705,2313,0,1,8,9,1.1111111111111112,0.11785113019775792,508,"And, I'm telling you again, that's not my signature!"
3716,2313,0,1,8,9,1.1111111111111112,0.11785113019775792,508,No... the guy looked a lot like Richard Dreyfus... a lot
3723,2313,0,1,8,9,1.1111111111111112,0.11785113019775792,508,No way that's the guy I ate.
3239,2313,0,1,8,9,1.1111111111111112,0.11785113019775792,508,No those are not my teeth marks on that person. I have two missing on the left side.
4935,2313,0,1,8,9,1.1111111111111112,0.11785113019775792,508,You call this a menu?
5161,2313,0,1,8,9,1.1111111111111112,0.11785113019775792,508,"Look, man, I don't care how many pictures you got. Those ain't my teeth marks."
3233,2313,0,1,8,9,1.1111111111111112,0.11785113019775792,508,"yeah, yeah, I know him. That's Mack the knife."
4963,2313,0,1,8,9,1.1111111111111112,0.11785113019775792,508,"Why do you keep showing me Candygrams? For the last time, I didn't kill Mrs. Arlsbergerhh!"
3668,2313,0,1,8,9,1.1111111111111112,0.11785113019775792,508,"I love your menu, but hate the service."
3292,2313,0,1,8,9,1.1111111111111112,0.11785113019775792,508,"I know you are trying to show me the legal justification for my arrest, but the simple fact is that sharks can't read."
3606,2313,0,1,8,9,1.1111111111111112,0.11785113019775792,508,"Besides, with hedge funds who needs usury?"
3607,2313,0,1,8,9,1.1111111111111112,0.11785113019775792,508,I told you before that loan had a fair interest rate. This is profiling!
4998,2313,0,1,8,9,1.1111111111111112,0.11785113019775792,508,I did not have sex with that barracuda.
3614,2313,0,1,8,9,1.1111111111111112,0.11785113019775792,508,Surfing?... I call it dinner.
4996,2313,0,1,8,9,1.1111111111111112,0.11785113019775792,508,I told you... I'm vegan!
5147,2313,0,1,8,9,1.1111111111111112,0.11785113019775792,508,"I already told you, I've never seen that foot before in my life."
4991,2313,0,1,8,9,1.1111111111111112,0.11785113019775792,508,"Yeah, great job. But our agreement was a new identity."
3626,2313,0,1,8,9,1.1111111111111112,0.11785113019775792,508,Are those Miranda rights or animal rights?
3642,2313,0,1,8,9,1.1111111111111112,0.11785113019775792,508,Yep. That's the eco-terrorist who tried to kill me.
3644,2313,0,1,8,9,1.1111111111111112,0.11785113019775792,508,I don't know anyone named Quint.
4978,2313,0,1,8,9,1.1111111111111112,0.11785113019775792,508,Sure I ate him. He was a chum of mine.
3651,2313,0,1,8,9,1.1111111111111112,0.11785113019775792,508,Do you recognize this surfer?
3653,2313,0,1,8,9,1.1111111111111112,0.11785113019775792,508,"Sure, that's him---and he was delicious!"
3274,2313,0,1,8,9,1.1111111111111112,0.11785113019775792,508,"Ah, you see, that's not me. What you're looking for is a 'loan' shark."
4968,2313,0,1,8,9,1.1111111111111112,0.11785113019775792,508,"Look here, Pal, I said 'dorsal'."
5175,2313,0,1,8,9,1.1111111111111112,0.11785113019775792,508,"Whaddaya mean 'phlegmatical one, pale sot of the Maldive sea?'"
5176,2313,0,1,8,9,1.1111111111111112,0.11785113019775792,508,"Gruesome, sure, but it's not me. I always floss."
3730,2313,0,1,8,9,1.1111111111111112,0.11785113019775792,508,"Nope, that's not me. I don't even shoot pool."
3774,2313,0,1,8,9,1.1111111111111112,0.11785113019775792,508,"If you think I'm going to take that bait, you're crazy."
3775,2313,0,1,8,9,1.1111111111111112,0.11785113019775792,508,I told you the guy we're looking for was wearing a Speedo.
3780,2313,0,1,8,9,1.1111111111111112,0.11785113019775792,508,"Bite me, copper"
3783,2313,0,1,8,9,1.1111111111111112,0.11785113019775792,508,Put it in a bowl of water.
3181,2313,0,1,8,9,1.1111111111111112,0.11785113019775792,508,"Wrong shark, dude. That's a Great White and I'm a Mako."
3180,2313,0,1,8,9,1.1111111111111112,0.11785113019775792,508,So tell me how I could have pulled a trigger
3788,2313,0,1,8,9,1.1111111111111112,0.11785113019775792,508,"I keep telling you, I'm Vegan !"
3789,2313,0,1,8,9,1.1111111111111112,0.11785113019775792,508,"Captain Quint, you say? No I haven't seen him. Never even heard of the guy."
4906,2313,0,1,8,9,1.1111111111111112,0.11785113019775792,508,"Yes, I remember him hanging around the school"
3795,2313,0,1,8,9,1.1111111111111112,0.11785113019775792,508,Charlie the Tuna? Never heard of him.
5211,2313,0,1,8,9,1.1111111111111112,0.11785113019775792,508,"No, he doesn't look familiar. I tell ya, it wasn't me. To you guys we all look alike."
3801,2313,0,1,8,9,1.1111111111111112,0.11785113019775792,508,Looks like a seal to me
3802,2313,0,1,8,9,1.1111111111111112,0.11785113019775792,508,"Yes, but she was the only bait in town."
3804,2313,0,1,8,9,1.1111111111111112,0.11785113019775792,508,You got it all wrong - he jumped ME.
4904,2313,0,1,8,9,1.1111111111111112,0.11785113019775792,508,"Yeah, that's the clown fish. He looked at me funny."
5203,2313,0,1,8,9,1.1111111111111112,0.11785113019775792,508,Surf 'n' Turf
5200,2313,0,1,8,9,1.1111111111111112,0.11785113019775792,508,Nope...never seen that one before either (burp) hehe.
5199,2313,0,1,8,9,1.1111111111111112,0.11785113019775792,508,We found your wife at the bottom of the ocean.
5198,2313,0,1,8,9,1.1111111111111112,0.11785113019775792,508,I'm telling you: I don't swim with them.
3222,2313,0,1,8,9,1.1111111111111112,0.11785113019775792,508,"Well, he shouldn't have been swimming with an open sore."
3737,2313,0,1,8,9,1.1111111111111112,0.11785113019775792,508,I told you. My name is not Mac and that's not my knife!
3217,2313,0,1,8,9,1.1111111111111112,0.11785113019775792,508,So how exactly did you escape from the 'Shark Tank'?
3739,2313,0,1,8,9,1.1111111111111112,0.11785113019775792,508,"No I don’t recognize her, but if you give me a little taste of what is left maybe I will."
3740,2313,0,1,8,9,1.1111111111111112,0.11785113019775792,508,I demand Miranda au souffle.
3745,2313,0,1,8,9,1.1111111111111112,0.11785113019775792,508,So what. Ain’t no law against eating a dead gangster on the bottom of the East River!
3748,2313,0,1,8,9,1.1111111111111112,0.11785113019775792,508,He caught my wife over the weekend. So I ate him.
5001,2313,0,1,8,9,1.1111111111111112,0.11785113019775792,508,"Alright, you caught me! I hooked up with her last night at the pier."
4925,2313,0,1,8,9,1.1111111111111112,0.11785113019775792,508,You're not in international waters anymore.
3757,2313,0,1,8,9,1.1111111111111112,0.11785113019775792,508,"Could I have some water, please!"
3759,2313,0,1,8,9,1.1111111111111112,0.11785113019775792,508,Why can't you believe that I'm a vegetarian?
3760,2313,0,1,8,9,1.1111111111111112,0.11785113019775792,508,I'll be representing myself.
4919,2313,0,1,8,9,1.1111111111111112,0.11785113019775792,508,"I'm tellin ya, I never seen dat arm before!"
5195,2313,0,1,8,9,1.1111111111111112,0.11785113019775792,508,You really think I had a hand in this?
3772,2313,0,1,8,9,1.1111111111111112,0.11785113019775792,508,Just cuz I seen him swimming with the fishes don't mean I know him
3197,2313,0,1,8,9,1.1111111111111112,0.11785113019775792,508,"Guys, she was on a line with a hook. Can say entrapment?"
3753,2313,0,1,8,9,1.1111111111111112,0.11785113019775792,508,What do you expect? There was blood in the water.
3169,2313,0,1,8,9,1.1111111111111112,0.11785113019775792,508,"I know I'm a shark, but I've always wanted to be a Jet."
3597,2313,0,1,8,9,1.1111111111111112,0.11785113019775792,508,"For the tenth time, I gave up Atkins years ago. I'm vegan now."
3301,2313,0,1,8,9,1.1111111111111112,0.11785113019775792,508,"Kill another shark? No way; what do you think I am, a lawyer?"
3383,2313,0,1,8,9,1.1111111111111112,0.11785113019775792,508,No! That is absolutely not who I had for dinner!
3382,2313,0,1,8,9,1.1111111111111112,0.11785113019775792,508,I told you that tuna was fine when I left.
5066,2313,0,1,8,9,1.1111111111111112,0.11785113019775792,508,. Free Willy
3475,2313,0,1,8,9,1.1111111111111112,0.11785113019775792,508,"Yes, that's the actor who jumped me!"
3477,2313,0,1,8,9,1.1111111111111112,0.11785113019775792,508,"I swear, it wasn't pre-marinated"
5060,2313,0,1,8,9,1.1111111111111112,0.11785113019775792,508,All I'm seein right now is your chubby little arm.
5059,2313,0,1,8,9,1.1111111111111112,0.11785113019775792,508,"Yeah, that's him. Lousy swimmer. Tasted a lot like chicken."
3369,2313,0,1,8,9,1.1111111111111112,0.11785113019775792,508,I recognize the torso. It tasted like garlic.
5120,2313,0,1,8,9,1.1111111111111112,0.11785113019775792,508,Of course I know Charlie the Tuna!
3362,2313,0,1,8,9,1.1111111111111112,0.11785113019775792,508,Fonzi? Yeah I know him.
5055,2313,0,1,8,9,1.1111111111111112,0.11785113019775792,508,Sharknado 13: The Interrogation
3361,2313,0,1,8,9,1.1111111111111112,0.11785113019775792,508,"Call that a likeness? I said extended caudal fin, not dorsal!!"
3360,2313,0,1,8,9,1.1111111111111112,0.11785113019775792,508,I've never seen that stump before.
5054,2313,0,1,8,9,1.1111111111111112,0.11785113019775792,508,"Yeah, he was my chum. So what of it?"
5051,2313,0,1,8,9,1.1111111111111112,0.11785113019775792,508,"It was a Jet, alright"
5109,2313,0,1,8,9,1.1111111111111112,0.11785113019775792,508,"I'm telling you, he's no chum of mine."
3352,2313,0,1,8,9,1.1111111111111112,0.11785113019775792,508,"OK, I'll bite. What's your evidence?"
3467,2313,0,1,8,9,1.1111111111111112,0.11785113019775792,508,"Not enough blood to finger me, looks like a dolphin did it"
5068,2313,0,1,8,9,1.1111111111111112,0.11785113019775792,508,Naw! And I ain't ever been to Amity Island.
3416,2313,0,1,8,9,1.1111111111111112,0.11785113019775792,508,"Oh come on, that doesn't even look like me. I'm not gold."
3409,2313,0,1,8,9,1.1111111111111112,0.11785113019775792,508,"I swear, that is not my chum."
3421,2313,0,1,8,9,1.1111111111111112,0.11785113019775792,508,I didn't know it was a mermaid
5092,2313,0,1,8,9,1.1111111111111112,0.11785113019775792,508,"It's not me, I was at a feeding frenzy"
3430,2313,0,1,8,9,1.1111111111111112,0.11785113019775792,508,I was in School at the time!
3431,2313,0,1,8,9,1.1111111111111112,0.11785113019775792,508,Maybe some electroshock therapy will help you think of somefin
5102,2313,0,1,8,9,1.1111111111111112,0.11785113019775792,508,I'm afraid it's back to 'Shark Tank' for you.
3433,2313,0,1,8,9,1.1111111111111112,0.11785113019775792,508,"Ahh, yes, I remember this one. A fish named Nemo; I caught him in late-2006. I ate his liver with some fava beans and a nice chianti."
5085,2313,0,1,8,9,1.1111111111111112,0.11785113019775792,508,"Told youse already, I ain't no loan shark!"
5083,2313,0,1,8,9,1.1111111111111112,0.11785113019775792,508,"I don't remember the floral tie, but that could be him."
5081,2313,0,1,8,9,1.1111111111111112,0.11785113019775792,508,Stop calling me Chum.
5076,2313,0,1,8,9,1.1111111111111112,0.11785113019775792,508,Hey! I am a lawyer
5075,2313,0,1,8,9,1.1111111111111112,0.11785113019775792,508,"For the last time, I don't talk until I can eat my lawyer."
3461,2313,0,1,8,9,1.1111111111111112,0.11785113019775792,508,"Yeah, but I want a lawyer that really is a shark!"
3391,2313,0,1,8,9,1.1111111111111112,0.11785113019775792,508,"For the last time, I didn't kill no one, I'm just'a loan shark!"
3464,2313,0,1,8,9,1.1111111111111112,0.11785113019775792,508,I really can’t say ‘cause I don’t know this chum.
3501,2313,0,1,8,9,1.1111111111111112,0.11785113019775792,508,"I swear, I've never seen this man you call 'Richard Dreyfuss'."
5049,2313,0,1,8,9,1.1111111111111112,0.11785113019775792,508,"I told you, I'm a lover not a biter."
3508,2313,0,1,8,9,1.1111111111111112,0.11785113019775792,508,"Hey, that's not my work, man! I don't have an overbite!"
5019,2313,0,1,8,9,1.1111111111111112,0.11785113019775792,508,"Officer, I just don´t see how I could possibly fit the profile!"
5018,2313,0,1,8,9,1.1111111111111112,0.11785113019775792,508,"For sure Mack, that's the knife!"
3316,2313,0,1,8,9,1.1111111111111112,0.11785113019775792,508,"No, that's not him. He had more of a hammer-shaped head."
3568,2313,0,1,8,9,1.1111111111111112,0.11785113019775792,508,"I'd talk, but I'm parched."
5140,2313,0,1,8,9,1.1111111111111112,0.11785113019775792,508,"Yea, I loaned him the money. It's what I do."
3570,2313,0,1,8,9,1.1111111111111112,0.11785113019775792,508,"I haven't seen her, but I'll keep my eyes open."
3574,2313,0,1,8,9,1.1111111111111112,0.11785113019775792,508,"I told you I was a loan shark, not a stool pigeon."
5013,2313,0,1,8,9,1.1111111111111112,0.11785113019775792,508,"Look, you break the rules of Marco Polo you pay the price."
3577,2313,0,1,8,9,1.1111111111111112,0.11785113019775792,508,My lawyer says you can't put me in the line-up with the dolphins again.
3580,2313,0,1,8,9,1.1111111111111112,0.11785113019775792,508,So you're saying you *don't* recognize this surfboard?
5011,2313,0,1,8,9,1.1111111111111112,0.11785113019775792,508,"Yeah that’s them, Red Fish, Blue Fish."
3304,2313,0,1,8,9,1.1111111111111112,0.11785113019775792,508,I'll have the tuna on rye.
5144,2313,0,1,8,9,1.1111111111111112,0.11785113019775792,508,"Yeah, I knew him. I wouldn't call him a chum if that's what you're askin.'"
5010,2313,0,1,8,9,1.1111111111111112,0.11785113019775792,508,Muscles Marinara. He's the enforcer for Clams Casino.
3585,2313,0,1,8,9,1.1111111111111112,0.11785113019775792,508,I've seen those cement shoes somewhere.
3318,2313,0,1,8,9,1.1111111111111112,0.11785113019775792,508,"I'm telling you, all the SeaWorld people look the same to me."
5023,2313,0,1,8,9,1.1111111111111112,0.11785113019775792,508,Never seen this Jet in my life
3320,2313,0,1,8,9,1.1111111111111112,0.11785113019775792,508,"Listen, Officer, this guy said he wanted to be my chum. And I never look a gift horse in the mouth."
3555,2313,0,1,8,9,1.1111111111111112,0.11785113019775792,508,"Yeah, that's the guy who jumped me. Said his name was Fonzie"
3511,2313,0,1,8,9,1.1111111111111112,0.11785113019775792,508,"Arms, legs, surf boards---they're all the same to me."
3514,2313,0,1,8,9,1.1111111111111112,0.11785113019775792,508,I tell ya I never ate him in my life.
5046,2313,0,1,8,9,1.1111111111111112,0.11785113019775792,508,"Henry Winkler? No, I don't know anybody named Henry Winkler. That guy told me his name was Fonzi."
3519,2313,0,1,8,9,1.1111111111111112,0.11785113019775792,508,You can't make me confess to being a Loan Shark!'
5044,2313,0,1,8,9,1.1111111111111112,0.11785113019775792,508,That's not a photograph of me. I never smile.
5039,2313,0,1,8,9,1.1111111111111112,0.11785113019775792,508,"Hey, I'm a businessman. I loaned him money, sure."
3337,2313,0,1,8,9,1.1111111111111112,0.11785113019775792,508,"Ok, ok, yeh, that's Mac the knife"
3298,2313,0,1,8,9,1.1111111111111112,0.11785113019775792,508,That's gotta be the work of 'No Fin Nicky'. No one ever sees him coming.
3336,2313,0,1,8,9,1.1111111111111112,0.11785113019775792,508,"Come clean, we know you ate Bobby Darin?"
3329,2313,0,1,8,9,1.1111111111111112,0.11785113019775792,508,"I swear, Sarg, I did not eat Bill Parcels!'"
5132,2313,0,1,8,9,1.1111111111111112,0.11785113019775792,508,"No, I am NOT making JAWS 5. It's more than I want to swallow!"
5033,2313,0,1,8,9,1.1111111111111112,0.11785113019775792,508,"I already told you, I am NOT a leg man."
5030,2313,0,1,8,9,1.1111111111111112,0.11785113019775792,508,See here... that guy ain't no chum of mine.
3548,2313,0,1,8,9,1.1111111111111112,0.11785113019775792,508,"I'm a shark, copper--not a rat."
3324,2313,0,1,8,9,1.1111111111111112,0.11785113019775792,508,"I've never seen this guy. I tell you, I'm vegan."
3551,2313,0,1,8,9,1.1111111111111112,0.11785113019775792,508,"Those are piranha bites, you fool!"
3331,2313,0,1,8,9,1.1111111111111112,0.11785113019775792,508,"Yeah, I know him. Name’s Mack … Mack the Knife."
2921,2313,0,1,8,9,1.1111111111111112,0.11785113019775792,508,He looked like a seal on that surfboard!
4903,2313,0,1,8,9,1.1111111111111112,0.11785113019775792,508,Stop showing me the same picture!
4901,2313,0,1,8,9,1.1111111111111112,0.11785113019775792,508,I didn't really get a good look at him. It was dark and murky.
5301,2313,0,1,8,9,1.1111111111111112,0.11785113019775792,508,"Yeah, that's him all right--the one we call 'the Goldfish.'"
2998,2313,0,1,8,9,1.1111111111111112,0.11785113019775792,508,What do I know - I'm just a fish out of water
5302,2313,0,1,8,9,1.1111111111111112,0.11785113019775792,508,"I swear, I never saw him before in his life"
5303,2313,0,1,8,9,1.1111111111111112,0.11785113019775792,508,"Yeah, that's the guy that tried to kill me. That's Captain Quint!"
4082,2313,0,1,8,9,1.1111111111111112,0.11785113019775792,508,I'll ask my client.
4767,2313,0,1,8,9,1.1111111111111112,0.11785113019775792,508,"OK, OK ... Just stop with the air-boarding already!"
4087,2313,0,1,8,9,1.1111111111111112,0.11785113019775792,508,That wasn't me. I was at the beach that day.
2991,2313,0,1,8,9,1.1111111111111112,0.11785113019775792,508,"Yes, that's me, but I'm guessin' he said 'SHARP-shooter', with a 'P'."
4765,2313,0,1,8,9,1.1111111111111112,0.11785113019775792,508,I'll make it easy for you - salt water only
5308,2313,0,1,8,9,1.1111111111111112,0.11785113019775792,508,"No, I don't recognize the dame. I'm not one of those morons who photographs every meal."
4095,2313,0,1,8,9,1.1111111111111112,0.11785113019775792,508,I already told ya: Last time I saw him he wuz sleeping wit da fishes.
2982,2313,0,1,8,9,1.1111111111111112,0.11785113019775792,508,I dunno. Mighta run into him. What's he taste like?
4762,2313,0,1,8,9,1.1111111111111112,0.11785113019775792,508,"No, this guy had concrete feet."
4097,2313,0,1,8,9,1.1111111111111112,0.11785113019775792,508,This the guy who represented you?
4761,2313,0,1,8,9,1.1111111111111112,0.11785113019775792,508,"Yeah, I know her. Her name is Hope. She's a Great White."
4079,2313,0,1,8,9,1.1111111111111112,0.11785113019775792,508,I already told you. I'm not a loaner!
2979,2313,0,1,8,9,1.1111111111111112,0.11785113019775792,508,I'll have the sushi.
4076,2313,0,1,8,9,1.1111111111111112,0.11785113019775792,508,"Hey, loan sharks can't be expected to remember every sucker they catch."
4065,2313,0,1,8,9,1.1111111111111112,0.11785113019775792,508,"Yeah, i ordered the caviar--wanna make something of it?"
3042,2313,0,1,8,9,1.1111111111111112,0.11785113019775792,508,"I really couldn't say,,I never saw his face"
5279,2313,0,1,8,9,1.1111111111111112,0.11785113019775792,508,Last I saw him was halftime of the Super Bowl.
4799,2313,0,1,8,9,1.1111111111111112,0.11785113019775792,508,I'm no stool pigeon!
4798,2313,0,1,8,9,1.1111111111111112,0.11785113019775792,508,I am calling my lawyer but I warn you; he's a shark!
4029,2313,0,1,8,9,1.1111111111111112,0.11785113019775792,508,"So what, now you guys are the only ones allowed to bare arms?"
4031,2313,0,1,8,9,1.1111111111111112,0.11785113019775792,508,"Yes, I shot the sheriff, but I did not shoot the deputy."
5288,2313,0,1,8,9,1.1111111111111112,0.11785113019775792,508,I ate him. So what?
4041,2313,0,1,8,9,1.1111111111111112,0.11785113019775792,508,"What, you think I was born under some seaweed? I'm not taking that bait."
4044,2313,0,1,8,9,1.1111111111111112,0.11785113019775792,508,"Yeaaah, I know him. He slept with the fishes."
4047,2313,0,1,8,9,1.1111111111111112,0.11785113019775792,508,I don't remember -- it was a feeding frenzy for chrissakes!
4052,2313,0,1,8,9,1.1111111111111112,0.11785113019775792,508,"Seen one fish, you've seen them all."
5290,2313,0,1,8,9,1.1111111111111112,0.11785113019775792,508,It was just a snack.
3016,2313,0,1,8,9,1.1111111111111112,0.11785113019775792,508,"Hey, I'm a shark! This is what I do for a living."
4061,2313,0,1,8,9,1.1111111111111112,0.11785113019775792,508,"I already told you: fish are friends, not food"
4062,2313,0,1,8,9,1.1111111111111112,0.11785113019775792,508,"That's him, the one who jumped me."
4066,2313,0,1,8,9,1.1111111111111112,0.11785113019775792,508,"C'mon Mack, I don't own a knife."
4108,2313,0,1,8,9,1.1111111111111112,0.11785113019775792,508,Your story doesn't add up... something's a little fishy.
4109,2313,0,1,8,9,1.1111111111111112,0.11785113019775792,508,'Shark Tank' escapee. What of it?
4116,2313,0,1,8,9,1.1111111111111112,0.11785113019775792,508,"He's a loan shark. Last time I seen him, he was sleepin' with the fishes."
5337,2313,0,1,8,9,1.1111111111111112,0.11785113019775792,508,"Yes, that is me at a Jimmy Buffett concert."
4725,2313,0,1,8,9,1.1111111111111112,0.11785113019775792,508,"Yeah, that's sharkskin, but it still isn't me....."
4182,2313,0,1,8,9,1.1111111111111112,0.11785113019775792,508,What if the Commissioner learns that you've jumped the shark?
5339,2313,0,1,8,9,1.1111111111111112,0.11785113019775792,508,"Why don't you ask a dolphin, I don't even know what a school looks like."
2933,2313,0,1,8,9,1.1111111111111112,0.11785113019775792,508,Can I borrow your glasses?
5340,2313,0,1,8,9,1.1111111111111112,0.11785113019775792,508,"He swam with the fishes, what do you expect?"
4183,2313,0,1,8,9,1.1111111111111112,0.11785113019775792,508,"I already told you, I can't see out of water."
4190,2313,0,1,8,9,1.1111111111111112,0.11785113019775792,508,"No, officer, I wouldn't eat him. He's my chum."
2930,2313,0,1,8,9,1.1111111111111112,0.11785113019775792,508,Can we move on to the cheek swab?
2928,2313,0,1,8,9,1.1111111111111112,0.11785113019775792,508,The food chain ain't about justice.
5342,2313,0,1,8,9,1.1111111111111112,0.11785113019775792,508,"Sure I know him, he was my chum"
4712,2313,0,1,8,9,1.1111111111111112,0.11785113019775792,508,Doesn't look familiar. Do you have a blood sample?
4710,2313,0,1,8,9,1.1111111111111112,0.11785113019775792,508,I've never even been to Sea World!
4205,2313,0,1,8,9,1.1111111111111112,0.11785113019775792,508,I want to call my brother; he's my lawyer.
5344,2313,0,1,8,9,1.1111111111111112,0.11785113019775792,508,"Yeah, I know the guy, but I didn't kill him - I only took off an arm."
4179,2313,0,1,8,9,1.1111111111111112,0.11785113019775792,508,"C'mon, copper, I can't read that. I'm a goddam shark."
2941,2313,0,1,8,9,1.1111111111111112,0.11785113019775792,508,"Yeah, he was an old chum of mine."
4733,2313,0,1,8,9,1.1111111111111112,0.11785113019775792,508,"Trust me, waterboarding isn’t going to get the results you want."
4734,2313,0,1,8,9,1.1111111111111112,0.11785113019775792,508,You really believe that I look like him?!
4123,2313,0,1,8,9,1.1111111111111112,0.11785113019775792,508,"Wasn't me, man. I'm vegan."
4748,2313,0,1,8,9,1.1111111111111112,0.11785113019775792,508,"Yeah, that's the guy without a bigger boat."
4747,2313,0,1,8,9,1.1111111111111112,0.11785113019775792,508,And when I woke up my cellmate was missing.
4745,2313,0,1,8,9,1.1111111111111112,0.11785113019775792,508,"Close, but he had shiftier eyes."
2962,2313,0,1,8,9,1.1111111111111112,0.11785113019775792,508,"I said I was a land shark, not a loan shark."
2959,2313,0,1,8,9,1.1111111111111112,0.11785113019775792,508,Yeah? Well let me tell YOU a thing or two about habeas corpus!
4138,2313,0,1,8,9,1.1111111111111112,0.11785113019775792,508,I demand the right to be represented by a dolphin.
3997,2313,0,1,8,9,1.1111111111111112,0.11785113019775792,508,You say they call him Ishmael? I didn't see him.
5320,2313,0,1,8,9,1.1111111111111112,0.11785113019775792,508,"No, I told you, I was to Katy Perry's right"
4744,2313,0,1,8,9,1.1111111111111112,0.11785113019775792,508,"Yea I bit him, he was in my ocean!"
4144,2313,0,1,8,9,1.1111111111111112,0.11785113019775792,508,"Who? Billy? Oh, yeah....tasted like chicken."
4147,2313,0,1,8,9,1.1111111111111112,0.11785113019775792,508,"Please, tell me that this is about more than diving without a passport."
4150,2313,0,1,8,9,1.1111111111111112,0.11785113019775792,508,That foot doesn't look familiar either.
4153,2313,0,1,8,9,1.1111111111111112,0.11785113019775792,508,"Listen, all I saw was breasts and thighs."
5330,2313,0,1,8,9,1.1111111111111112,0.11785113019775792,508,Shark or Jet?
4738,2313,0,1,8,9,1.1111111111111112,0.11785113019775792,508,"Uh oh, looks like Old Macky's back."
5325,2313,0,1,8,9,1.1111111111111112,0.11785113019775792,508,"No, sorry. Looks nice, but I've never, EVER been to Amity Island."
3167,2313,0,1,8,9,1.1111111111111112,0.11785113019775792,508,"Hey, she said she was into biting."
3993,2313,0,1,8,9,1.1111111111111112,0.11785113019775792,508,"Eh, she's not my type."
3988,2313,0,1,8,9,1.1111111111111112,0.11785113019775792,508,I wouldn't be here if I were a great white.
3876,2313,0,1,8,9,1.1111111111111112,0.11785113019775792,508,Yeah. Amity. Summer of '75. So what?
3878,2313,0,1,8,9,1.1111111111111112,0.11785113019775792,508,I may be a shark but I ain't no rat.
3879,2313,0,1,8,9,1.1111111111111112,0.11785113019775792,508,Can I at least get a glass of water first?
3885,2313,0,1,8,9,1.1111111111111112,0.11785113019775792,508,"I told you, I don't know any 'Quint.'"
3120,2313,0,1,8,9,1.1111111111111112,0.11785113019775792,508,"I'm a fish, not a fink."
3118,2313,0,1,8,9,1.1111111111111112,0.11785113019775792,508,The Shark Lives Matter movement isn't going to be very happy about this.
3887,2313,0,1,8,9,1.1111111111111112,0.11785113019775792,508,"No - that's Clouseau you're looking for, and I can't get you his autograph either."
3889,2313,0,1,8,9,1.1111111111111112,0.11785113019775792,508,Are you trying to tell me that this boy looks like a seal?!
3890,2313,0,1,8,9,1.1111111111111112,0.11785113019775792,508,Did you write this loan?
3114,2313,0,1,8,9,1.1111111111111112,0.11785113019775792,508,"It wasn't me, just ask any marine biologist - I'm a warm-blooded killer."
3892,2313,0,1,8,9,1.1111111111111112,0.11785113019775792,508,"“Nah, don’t recognize him. What does he smell like bleeding?"
5244,2313,0,1,8,9,1.1111111111111112,0.11785113019775792,508,I didn't know her name was Miranda
4855,2313,0,1,8,9,1.1111111111111112,0.11785113019775792,508,"Yeah, like I said, I went vegan."
5246,2313,0,1,8,9,1.1111111111111112,0.11785113019775792,508,"No sir, I did not have sex with this woman......."
3906,2313,0,1,8,9,1.1111111111111112,0.11785113019775792,508,"I didn't sign that loan doc, I was playing pool."
3874,2313,0,1,8,9,1.1111111111111112,0.11785113019775792,508,What do you expect? I don't like seafood.
3103,2313,0,1,8,9,1.1111111111111112,0.11785113019775792,508,"Yep, that's definitely the guy who jumped me."
3873,2313,0,1,8,9,1.1111111111111112,0.11785113019775792,508,I had to eat them because they're losers who aren't very good at their jobs.
3133,2313,0,1,8,9,1.1111111111111112,0.11785113019775792,508,I did not have sexual relations with that dolphin!
3165,2313,0,1,8,9,1.1111111111111112,0.11785113019775792,508,'His name was Spielberg. Ring any bells now?' (Ed.: the word 'now' should be italicized.)
3164,2313,0,1,8,9,1.1111111111111112,0.11785113019775792,508,I was at a feeding frenzy at least ten miles from there.
3812,2313,0,1,8,9,1.1111111111111112,0.11785113019775792,508,I said 'I hate her' not 'I ate her'....
3814,2313,0,1,8,9,1.1111111111111112,0.11785113019775792,508,You finless mammals all look alike to me.
3818,2313,0,1,8,9,1.1111111111111112,0.11785113019775792,508,"He looks like a seal I once knew, so what."
3820,2313,0,1,8,9,1.1111111111111112,0.11785113019775792,508,"Yes! Yes! There's gonna be a rumble with the Jets tonight, tonight!"
4897,2313,0,1,8,9,1.1111111111111112,0.11785113019775792,508,Johnny Tuna is a friend. Nothing more. We're from different schools.
5219,2313,0,1,8,9,1.1111111111111112,0.11785113019775792,508,I swear I've never seen that leg in my life.
3151,2313,0,1,8,9,1.1111111111111112,0.11785113019775792,508,' Have you ever seen this arm before'?
3145,2313,0,1,8,9,1.1111111111111112,0.11785113019775792,508,You're going to need a bigger pad.
5226,2313,0,1,8,9,1.1111111111111112,0.11785113019775792,508,She's lying. I didn't deliver a Candy Gram to that address.
3137,2313,0,1,8,9,1.1111111111111112,0.11785113019775792,508,Him? He hasn't got a leg to stand on.
4878,2313,0,1,8,9,1.1111111111111112,0.11785113019775792,508,"Yeah, that's him! Cuban...Mark Cuban. He's the one that took my place on the show!"
3865,2313,0,1,8,9,1.1111111111111112,0.11785113019775792,508,He's from the Dolphin Family.
4868,2313,0,1,8,9,1.1111111111111112,0.11785113019775792,508,I've never seen him before in my life. But his boat looks familiar.
3869,2313,0,1,8,9,1.1111111111111112,0.11785113019775792,508,Great whites matter.
3102,2313,0,1,8,9,1.1111111111111112,0.11785113019775792,508,"Look, I've already told you a thousand times, I had nothing to do with the making of 'Jaws 3D'."
3101,2313,0,1,8,9,1.1111111111111112,0.11785113019775792,508,Never smelled him.
3099,2313,0,1,8,9,1.1111111111111112,0.11785113019775792,508,Looks like a seal. The last one looked like a seal. They ALL look like seals when I'm hungry.
4819,2313,0,1,8,9,1.1111111111111112,0.11785113019775792,508,"I'm telling you, she was killed by the vending machine."
3964,2313,0,1,8,9,1.1111111111111112,0.11785113019775792,508,Nope. Don't recognize that limb either.
4818,2313,0,1,8,9,1.1111111111111112,0.11785113019775792,508,"Yea, that's him. That's the Jack of Clubs."
5273,2313,0,1,8,9,1.1111111111111112,0.11785113019775792,508,What's fishy?
3966,2313,0,1,8,9,1.1111111111111112,0.11785113019775792,508,"Yea, I saw him at the feeding frenzy last night."
4817,2313,0,1,8,9,1.1111111111111112,0.11785113019775792,508,Isn't this a little outside of your jurisdiction?
3969,2313,0,1,8,9,1.1111111111111112,0.11785113019775792,508,No cell can hold me. I eat Lox
3056,2313,0,1,8,9,1.1111111111111112,0.11785113019775792,508,I've never seen that surfer before
3971,2313,0,1,8,9,1.1111111111111112,0.11785113019775792,508,Is this your signature on the loan application ?
3975,2313,0,1,8,9,1.1111111111111112,0.11785113019775792,508,Looks like you've bitten off more than you can chew.
4814,2313,0,1,8,9,1.1111111111111112,0.11785113019775792,508,"Sure I know him, but I hear he's swimming with the fishes now."
3981,2313,0,1,8,9,1.1111111111111112,0.11785113019775792,508,And I suppose this photo of Abe Vagoda portraying Fish doesn't ring any bells either!
3987,2313,0,1,8,9,1.1111111111111112,0.11785113019775792,508,Why are you asking me? I'm the lawyer!
3051,2313,0,1,8,9,1.1111111111111112,0.11785113019775792,508,"Playing good cod, bad cod won't work on me."
5276,2313,0,1,8,9,1.1111111111111112,0.11785113019775792,508,"You need to warn the people on the beach, not me!"
4820,2313,0,1,8,9,1.1111111111111112,0.11785113019775792,508,That's him. Robert Shaw.
5270,2313,0,1,8,9,1.1111111111111112,0.11785113019775792,508,"My partner's now nigiri? Ok, I'll talk, but i want some water first."
3953,2313,0,1,8,9,1.1111111111111112,0.11785113019775792,508,"My brother, 'Shark Tooth', ate the guy in the photo--not me!"
3950,2313,0,1,8,9,1.1111111111111112,0.11785113019775792,508,I have NEVER seen this surfboard before.
3920,2313,0,1,8,9,1.1111111111111112,0.11785113019775792,508,Who's to say he wasn't dead already? After all it is the Jersey shore.
4845,2313,0,1,8,9,1.1111111111111112,0.11785113019775792,508,"No, his teeth weren't that pretty."
5253,2313,0,1,8,9,1.1111111111111112,0.11785113019775792,508,"I told ya already, I ain't never seen that swimmer before."
3093,2313,0,1,8,9,1.1111111111111112,0.11785113019775792,508,"Yeah, he's the one who jumped me. I'd recognize that jacket anywhere."
3089,2313,0,1,8,9,1.1111111111111112,0.11785113019775792,508,"Like I said, I thought he was a manatee. Look at the gut on him!"
4838,2313,0,1,8,9,1.1111111111111112,0.11785113019775792,508,"I admit that I am guilty...but, I keep telling you, there were no accomplices, I was a lone shark."
3935,2313,0,1,8,9,1.1111111111111112,0.11785113019775792,508,I swear I didn't write that loan.
3989,2313,0,1,8,9,1.1111111111111112,0.11785113019775792,508,Have you seen this boat?
3939,2313,0,1,8,9,1.1111111111111112,0.11785113019775792,508,"If you think I'm a shark, wait'll you meet my lawyer."
3944,2313,0,1,8,9,1.1111111111111112,0.11785113019775792,508,I'm not saying nothing 'til my 'Planet Earth' narrator gets here...
3068,2313,0,1,8,9,1.1111111111111112,0.11785113019775792,508,"How many times I gotta tell you guys? I'm salt water, I dunno anything about those Lake Trout."
3067,2313,0,1,8,9,1.1111111111111112,0.11785113019775792,508,"Where I'm from, welch on your loan and there's good chance you're gonna end up with buoy around your neck in a Jersey landfill."
4830,2313,0,1,8,9,1.1111111111111112,0.11785113019775792,508,"Look, Maria will vouch for me. You should be talking to a Jet."
4827,2313,0,1,8,9,1.1111111111111112,0.11785113019775792,508,"once again, just because i freaked when i smelled dori's blood doesn't mean i ate her."
3064,2313,0,1,8,9,1.1111111111111112,0.11785113019775792,508,The last time I saw him was in the shark tank.
5269,2313,0,1,8,9,1.1111111111111112,0.11785113019775792,508,Him I know. Got’m off Atlantic City.
4832,2313,0,1,8,9,1.1111111111111112,0.11785113019775792,508,He's swimming with the fishes.
3984,2313,0,1,8,9,1.1111111111111112,0.11785113019775792,508,"A seal okay! I told you, they all look like seals!"
2270,2313,0,1,8,9,1.1111111111111112,0.11785113019775792,508,I'll have the Tuna.
1059,2313,0,1,8,9,1.1111111111111112,0.11785113019775792,508,Don't worry -- it's kosher.
6106,2313,0,1,8,9,1.1111111111111112,0.11785113019775792,508,How would I know? Those mackerels all look the same to me.
6105,2313,0,1,8,9,1.1111111111111112,0.11785113019775792,508,"Huh, more blood and guts, you do get that I'm a shark right?"
457,2313,0,1,8,9,1.1111111111111112,0.11785113019775792,508,What part of 'I want to call my lawyer' don’t you understand?
5770,2313,0,1,8,9,1.1111111111111112,0.11785113019775792,508,"OK, so it wasn't a candy gram!"
1309,2313,0,1,8,9,1.1111111111111112,0.11785113019775792,508,They told me business was a sausagefest
877,2313,0,1,8,9,1.1111111111111112,0.11785113019775792,508,"I don't need a lawyer. Worst case scenario, Netflix proves me innocent"
1314,2313,0,1,8,9,1.1111111111111112,0.11785113019775792,508,"No, he looks more like a Jet."
472,2313,0,1,8,9,1.1111111111111112,0.11785113019775792,508,I got two words for youse: habeus corpus!
455,2313,0,1,8,9,1.1111111111111112,0.11785113019775792,508,Who sees faces? Show me arms or legs.
1911,2313,0,1,8,9,1.1111111111111112,0.11785113019775792,508,You have nothing on me your profiling ; it was the otter .
6518,2313,0,1,8,9,1.1111111111111112,0.11785113019775792,508,There's a lot of fish in the sea.
874,2313,0,1,8,9,1.1111111111111112,0.11785113019775792,508,Hey -- no one forced him to take the loan.
488,2313,0,1,8,9,1.1111111111111112,0.11785113019775792,508,You exceeded your annual catch limit under the Magnuson-Stevens Fishery Conservation and Management Act.
6513,2313,0,1,8,9,1.1111111111111112,0.11785113019775792,508,"I'm tellin' you, I was at a feeding frenzy all night."
1889,2313,0,1,8,9,1.1111111111111112,0.11785113019775792,508,"If I sign the confession, then can I get some water?"
5791,2313,0,1,8,9,1.1111111111111112,0.11785113019775792,508,"She was the 'Speciality of the Day', last Friday I think."
6330,2313,0,1,8,9,1.1111111111111112,0.11785113019775792,508,I'm not good at faces. Can you show me a toe?
6511,2313,0,1,8,9,1.1111111111111112,0.11785113019775792,508,"No, it's loan o-f-f-i-c-e-r."
6519,2313,0,1,8,9,1.1111111111111112,0.11785113019775792,508,Of course it looks like me. He's wearing a sharkskin suit.
6527,2313,0,1,8,9,1.1111111111111112,0.11785113019775792,508,"I already told you, I don't like the sound of that recipe at all."
452,2313,0,1,8,9,1.1111111111111112,0.11785113019775792,508,The story's the same. I didn't do Peter Benchly.
6327,2313,0,1,8,9,1.1111111111111112,0.11785113019775792,508,"You dummies, I'm a 'lone' shark, not a 'loan' shark."
420,2313,0,1,8,9,1.1111111111111112,0.11785113019775792,508,"He was a Wall Street trader, so can I go now?"
6119,2313,0,1,8,9,1.1111111111111112,0.11785113019775792,508,All these chums look the same.
5752,2313,0,1,8,9,1.1111111111111112,0.11785113019775792,508,"Alright, alright I ate the guy. What'd expect, its what I do...."
423,2313,0,1,8,9,1.1111111111111112,0.11785113019775792,508,"C'mon, you're squirming like a fish out of water."
1957,2313,0,1,8,9,1.1111111111111112,0.11785113019775792,508,"I don't even have pectoral fins, why would I steal pectoral fin jewelry? And how am I sitting in this chair right now? And speaking? Come to think of it, none of this makes any sense. I want my lawyer."
1956,2313,0,1,8,9,1.1111111111111112,0.11785113019775792,508,"I knew him, but he never borrowed any money. You've got the wrong fish."
6114,2313,0,1,8,9,1.1111111111111112,0.11785113019775792,508,Do you know how many other sharks have that same sailor tattooed on their fins?
426,2313,0,1,8,9,1.1111111111111112,0.11785113019775792,508,Yes. That's me befriending the cat on YouTube.
5757,2313,0,1,8,9,1.1111111111111112,0.11785113019775792,508,"I would never eat anything like that. I tell you, I'm a vegetarian."
428,2313,0,1,8,9,1.1111111111111112,0.11785113019775792,508,Did you have anything to do with the disappearance of Charlie The Tuna?
1948,2313,0,1,8,9,1.1111111111111112,0.11785113019775792,508,Miley's here.
6324,2313,0,1,8,9,1.1111111111111112,0.11785113019775792,508,Those are West Coast sharks in the photos. I have never run with them.
432,2313,0,1,8,9,1.1111111111111112,0.11785113019775792,508,What do I look like? A lawyer?
5759,2313,0,1,8,9,1.1111111111111112,0.11785113019775792,508,"Come on, man, I never lent him a cent."
1946,2313,0,1,8,9,1.1111111111111112,0.11785113019775792,508,Why am I in here? I'm the one who got jumped!
435,2313,0,1,8,9,1.1111111111111112,0.11785113019775792,508,"Look, man, she said she was 18."
6113,2313,0,1,8,9,1.1111111111111112,0.11785113019775792,508,"I'm sorry, from underneath he looked exactly like a seal"
445,2313,0,1,8,9,1.1111111111111112,0.11785113019775792,508,"You got the wrong Shark, I don't work on Wall Street"
446,2313,0,1,8,9,1.1111111111111112,0.11785113019775792,508,I have never seen this phytoplankton in my life.
1879,2313,0,1,8,9,1.1111111111111112,0.11785113019775792,508,I've never digested that girl in my life.
1878,2313,0,1,8,9,1.1111111111111112,0.11785113019775792,508,Does this look fishy to you?
6099,2313,0,1,8,9,1.1111111111111112,0.11785113019775792,508,I told you. We went to law school together!
503,2313,0,1,8,9,1.1111111111111112,0.11785113019775792,508,"For the hundredth time, that guy's legs were already missing when I found him!"
1823,2313,0,1,8,9,1.1111111111111112,0.11785113019775792,508,"Nope, she's too sugary for me."
6096,2313,0,1,8,9,1.1111111111111112,0.11785113019775792,508,You got the wrong guy...I'm a POND shark.
527,2313,0,1,8,9,1.1111111111111112,0.11785113019775792,508,"So, it's a picture of Luca Brasi. What makes you think I knew him?"
1820,2313,0,1,8,9,1.1111111111111112,0.11785113019775792,508,"Yep, that's the Shark Fin Soup Nazi!"
533,2313,0,1,8,9,1.1111111111111112,0.11785113019775792,508,I've never seen that surfboard in my life...
1813,2313,0,1,8,9,1.1111111111111112,0.11785113019775792,508,"' How was I suppose to know I ate Flipper, they all look alike to me '."
1812,2313,0,1,8,9,1.1111111111111112,0.11785113019775792,508,"Nah, not quite. The dude that bit me had a bushier mustache."
535,2313,0,1,8,9,1.1111111111111112,0.11785113019775792,508,"I see the charges,'Let me see my client!!"
6086,2313,0,1,8,9,1.1111111111111112,0.11785113019775792,508,"No, I already ate, thanks."
1804,2313,0,1,8,9,1.1111111111111112,0.11785113019775792,508,"Yeah, sure, that's Macheath. I sold him the knife."
1801,2313,0,1,8,9,1.1111111111111112,0.11785113019775792,508,No...I didn't bite off more than I can chew!
1796,2313,0,1,8,9,1.1111111111111112,0.11785113019775792,508,Eat another pizza delivery guy and we're revoking your immunity!
5833,2313,0,1,8,9,1.1111111111111112,0.11785113019775792,508,'But I still say that guy looks like a flounder'.
1790,2313,0,1,8,9,1.1111111111111112,0.11785113019775792,508,"Yeah I recognize them, they work for a soup company."
544,2313,0,1,8,9,1.1111111111111112,0.11785113019775792,508,I know it doesn't look good but I'm NOT the loan shark you're looking for.
6341,2313,0,1,8,9,1.1111111111111112,0.11785113019775792,508,Louie--now Louie was once a sharp shark with spark--but that's over. He's not your guy.
5836,2313,0,1,8,9,1.1111111111111112,0.11785113019775792,508,The home was not underwater when I provided the mortgage.
5837,2313,0,1,8,9,1.1111111111111112,0.11785113019775792,508,"I knew I would be caught one day, one way or the other."
1352,2313,0,1,8,9,1.1111111111111112,0.11785113019775792,508,"'Yeah, that's the guy who jumped me,' said the shark, when shown a picture of Donald Trump"
5816,2313,0,1,8,9,1.1111111111111112,0.11785113019775792,508,I nailed him in August.
1969,2313,0,1,8,9,1.1111111111111112,0.11785113019775792,508,I wasn't immigrating. I was migrating.
5815,2313,0,1,8,9,1.1111111111111112,0.11785113019775792,508,This isn't working. I need a leg lineup.
1830,2313,0,1,8,9,1.1111111111111112,0.11785113019775792,508,It wasn't me! That's not my bite mark.
1867,2313,0,1,8,9,1.1111111111111112,0.11785113019775792,508,"I told you already, I barely know the guy. I'm just his attorney."
1866,2313,0,1,8,9,1.1111111111111112,0.11785113019775792,508,I can't tell. You wouldn't happen to have a sample of his blood?
1865,2313,0,1,8,9,1.1111111111111112,0.11785113019775792,508,I ain't sayin' nuthin' without my remora.
504,2313,0,1,8,9,1.1111111111111112,0.11785113019775792,508,"Yeah, that's the guy... Mack the Knife."
866,2313,0,1,8,9,1.1111111111111112,0.11785113019775792,508,"If the loan shark says, put the bite on somebody, I put the bite on somebody."
6098,2313,0,1,8,9,1.1111111111111112,0.11785113019775792,508,"Sure, I've seen him. He sleeps with the fishes now."
6508,2313,0,1,8,9,1.1111111111111112,0.11785113019775792,508,Profiled again. Now who's the shark?
5808,2313,0,1,8,9,1.1111111111111112,0.11785113019775792,508,"Ok, Flatfoot, maybe I have seen those legs before."
1849,2313,0,1,8,9,1.1111111111111112,0.11785113019775792,508,Things were going along swimmingly till this masked man with a spear attacked me!
1848,2313,0,1,8,9,1.1111111111111112,0.11785113019775792,508,"Yeah, tasted like chicken, so what?"
5809,2313,0,1,8,9,1.1111111111111112,0.11785113019775792,508,Calm down: An interpreter is coming to translate your Miranda Rights right now
861,2313,0,1,8,9,1.1111111111111112,0.11785113019775792,508,"Hey, I was hungry, but I wasn't starving!"
1842,2313,0,1,8,9,1.1111111111111112,0.11785113019775792,508,Don't give us that fish out of water bit
6335,2313,0,1,8,9,1.1111111111111112,0.11785113019775792,508,"Yeah, that's him. The Fonz. He's the one who jumped me."
1839,2313,0,1,8,9,1.1111111111111112,0.11785113019775792,508,I told you before I never met Roy Scheider.
1836,2313,0,1,8,9,1.1111111111111112,0.11785113019775792,508,Peg leg! Gregory Peck look-a-like! That's HIM. I want a restraining order!
518,2313,0,1,8,9,1.1111111111111112,0.11785113019775792,508,"We've got bigger fish to fry, Doug"
521,2313,0,1,8,9,1.1111111111111112,0.11785113019775792,508,"'I keep telling youse guys. The term is 'card sharp,' not 'card shark.' Capische?"
1835,2313,0,1,8,9,1.1111111111111112,0.11785113019775792,508,That's all you got? A photo of blood in the water?
1328,2313,0,1,8,9,1.1111111111111112,0.11785113019775792,508,Is this about the loans?
1970,2313,0,1,8,9,1.1111111111111112,0.11785113019775792,508,"Yeah, well I ain't talkin' until my client gets here."
1288,2313,0,1,8,9,1.1111111111111112,0.11785113019775792,508,Accusing me of loan sharking is clearly ichthyoligical profiling.
5744,2313,0,1,8,9,1.1111111111111112,0.11785113019775792,508,I swear - I don't even know where Amity Island is!
316,2313,0,1,8,9,1.1111111111111112,0.11785113019775792,508,'So you're telling me you thought she as a seal'.
2078,2313,0,1,8,9,1.1111111111111112,0.11785113019775792,508,I didn't do anything wrong; I was just having lunch.
2076,2313,0,1,8,9,1.1111111111111112,0.11785113019775792,508,There's something fishy about your alibi
2075,2313,0,1,8,9,1.1111111111111112,0.11785113019775792,508,I keep telling you; he tasted like chicken. That's all I know.
2072,2313,0,1,8,9,1.1111111111111112,0.11785113019775792,508,That's not me! What? Do we all look the same to you guys?
917,2313,0,1,8,9,1.1111111111111112,0.11785113019775792,508,No! I told you already; it ain't my loan!!!
2070,2313,0,1,8,9,1.1111111111111112,0.11785113019775792,508,Pictures of dead guys just make me hungry. Why don't you try water boarding?
6589,2313,0,1,8,9,1.1111111111111112,0.11785113019775792,508,How would I know; he was wearing a mask.
6142,2313,0,1,8,9,1.1111111111111112,0.11785113019775792,508,"Sorry officer, my lips have been sealed."
5704,2313,0,1,8,9,1.1111111111111112,0.11785113019775792,508,So I eat low-energy losers for breakfast. Who cares?
6588,2313,0,1,8,9,1.1111111111111112,0.11785113019775792,508,Are you kidding? Do you have any idea what that town charges for a non-residential beach sticker?
2064,2313,0,1,8,9,1.1111111111111112,0.11785113019775792,508,"Don't look at me like that, those are perfectly reasonable terms for a 30-year fixed rate home loan."
332,2313,0,1,8,9,1.1111111111111112,0.11785113019775792,508,That's a mackerel. Do we All look alike to you guys?
912,2313,0,1,8,9,1.1111111111111112,0.11785113019775792,508,"I think you've got the wrong shark, that picture of 'me' looks a little fishy."
2055,2313,0,1,8,9,1.1111111111111112,0.11785113019775792,508,The swimmer filed a complaint. So what?
343,2313,0,1,8,9,1.1111111111111112,0.11785113019775792,508,"They all look alike to me, copper!"
344,2313,0,1,8,9,1.1111111111111112,0.11785113019775792,508,Is this the man who jumped you?
6576,2313,0,1,8,9,1.1111111111111112,0.11785113019775792,508,No aquarium can hold me
2050,2313,0,1,8,9,1.1111111111111112,0.11785113019775792,508,"never saw him, he was delicious"
315,2313,0,1,8,9,1.1111111111111112,0.11785113019775792,508,I've never seen that clownfish in my life.
2048,2313,0,1,8,9,1.1111111111111112,0.11785113019775792,508,"Yeah, I know him. Pretty tough customer. They call him the Hammerhead."
5701,2313,0,1,8,9,1.1111111111111112,0.11785113019775792,508,I'm a fish. I'm farsighted.
2082,2313,0,1,8,9,1.1111111111111112,0.11785113019775792,508,You've got the wrong guy. I'm not a card shark.
1237,2313,0,1,8,9,1.1111111111111112,0.11785113019775792,508,I'm telling you I wouldn't know that face if it bit me
1238,2313,0,1,8,9,1.1111111111111112,0.11785113019775792,508,I want to eat a lawyer.
2126,2313,0,1,8,9,1.1111111111111112,0.11785113019775792,508,I'm maybe a loan shark but I'm ain't stool pigeon.
923,2313,0,1,8,9,1.1111111111111112,0.11785113019775792,508,"Stop waving that damn thing in my face, or I'll bite your ass."
1241,2313,0,1,8,9,1.1111111111111112,0.11785113019775792,508,"I told you, I don't eat people. They have that peopley taste."
6604,2313,0,1,8,9,1.1111111111111112,0.11785113019775792,508,I ain't sayin' nonthin' till I get me a criminal.
2114,2313,0,1,8,9,1.1111111111111112,0.11785113019775792,508,"Yeah, we worked together but we never got chummy."
2102,2313,0,1,8,9,1.1111111111111112,0.11785113019775792,508,"Yeah, I recognize him. He always liked to bet on the Dolphins."
5690,2313,0,1,8,9,1.1111111111111112,0.11785113019775792,508,I didn't do it. I'm a vegetarian.
2096,2313,0,1,8,9,1.1111111111111112,0.11785113019775792,508,I never met that chum
1245,2313,0,1,8,9,1.1111111111111112,0.11785113019775792,508,"No, I don't know any Mack the Knife."
6602,2313,0,1,8,9,1.1111111111111112,0.11785113019775792,508,"Tommy the Tuna? Yeah, I knew him in his salad days."
299,2313,0,1,8,9,1.1111111111111112,0.11785113019775792,508,Homicide?! Lunch!!
5693,2313,0,1,8,9,1.1111111111111112,0.11785113019775792,508,You think I'd bite that?
5694,2313,0,1,8,9,1.1111111111111112,0.11785113019775792,508,By the 10th spinoff - Shark Victims Unit - Law and Order seemed to be going downhill.
2090,2313,0,1,8,9,1.1111111111111112,0.11785113019775792,508,I swear if I have to shred one more document I'm going to bite your cock off.
300,2313,0,1,8,9,1.1111111111111112,0.11785113019775792,508,"I wanna talk to my brother, he's a Lawyer."
6303,2313,0,1,8,9,1.1111111111111112,0.11785113019775792,508,"Remember, even the 'bad cop' can taste good."
5697,2313,0,1,8,9,1.1111111111111112,0.11785113019775792,508,"So, it was a bodycam that I had trouble passing!!!"
6592,2313,0,1,8,9,1.1111111111111112,0.11785113019775792,508,I don't mingle with those low-life bottom feeders.
5840,2313,0,1,8,9,1.1111111111111112,0.11785113019775792,508,Can I have a 200 gallon tank of water?
2045,2313,0,1,8,9,1.1111111111111112,0.11785113019775792,508,That's the guy. Name's Spielberg.
2041,2313,0,1,8,9,1.1111111111111112,0.11785113019775792,508,"Florida? Sure, I’ve got a timeshare down there. Why do you ask?"
389,2313,0,1,8,9,1.1111111111111112,0.11785113019775792,508,"Yeah, that's him—I've got to find a better circle of friends."
2004,2313,0,1,8,9,1.1111111111111112,0.11785113019775792,508,I could sure go for a lawyer right now.
6555,2313,0,1,8,9,1.1111111111111112,0.11785113019775792,508,"Rights, schmights, you're singling me out because you think I look guilty."
1278,2313,0,1,8,9,1.1111111111111112,0.11785113019775792,508,"Yeah, I knew him. Gave him a loan."
6550,2313,0,1,8,9,1.1111111111111112,0.11785113019775792,508,"First, let's be clear. Who's in the most danger here?"
6123,2313,0,1,8,9,1.1111111111111112,0.11785113019775792,508,Nice tits!
5738,2313,0,1,8,9,1.1111111111111112,0.11785113019775792,508,Could you hold it a little closer... closer... clo...
1285,2313,0,1,8,9,1.1111111111111112,0.11785113019775792,508,Just because he's a suspected loanshark doesn't mean I know him.
6548,2313,0,1,8,9,1.1111111111111112,0.11785113019775792,508,Because that's a Great White. I'm barely ordinary.
6121,2313,0,1,8,9,1.1111111111111112,0.11785113019775792,508,I'm not answering any more questions until I talk to myself.
1987,2313,0,1,8,9,1.1111111111111112,0.11785113019775792,508,"For the last time, I'm not a member of the Sharks or the Jets."
6546,2313,0,1,8,9,1.1111111111111112,0.11785113019775792,508,Can I go now? I have a feeding frenzy to get to.
6545,2313,0,1,8,9,1.1111111111111112,0.11785113019775792,508,That chunk there is from a freshwater kayak. Ya got nothin'.
6120,2313,0,1,8,9,1.1111111111111112,0.11785113019775792,508,"yeah, he's the rest of my dinner"
1981,2313,0,1,8,9,1.1111111111111112,0.11785113019775792,508,Seen him sneaking round the corner. Name's Mack. Has a knife. Keeps it it of sight.
900,2313,0,1,8,9,1.1111111111111112,0.11785113019775792,508,"I don't care for paper, but that arm sure looks juicy."
1979,2313,0,1,8,9,1.1111111111111112,0.11785113019775792,508,Is it such a crime to have the Mahi Mahi?
1977,2313,0,1,8,9,1.1111111111111112,0.11785113019775792,508,"Hey, you're looking in the wrong tank!"
1975,2313,0,1,8,9,1.1111111111111112,0.11785113019775792,508,Yeah? Like you remember what last night's lasagna looked like.
6557,2313,0,1,8,9,1.1111111111111112,0.11785113019775792,508,He was just lunch. I didn't know he was in the Witness Protection Program.
2042,2313,0,1,8,9,1.1111111111111112,0.11785113019775792,508,What do you mean Goldman Sachs says I haven't worked there in nearly eight year?
6127,2313,0,1,8,9,1.1111111111111112,0.11785113019775792,508,"I couldn't quite put my finger on it, but there was just something fishy about this case."
2010,2313,0,1,8,9,1.1111111111111112,0.11785113019775792,508,"I told you, there's a lot of fish in the sea!"
6574,2313,0,1,8,9,1.1111111111111112,0.11785113019775792,508,"For the last time, I was only out for a swim."
6572,2313,0,1,8,9,1.1111111111111112,0.11785113019775792,508,I've never heard of Amity Island.
356,2313,0,1,8,9,1.1111111111111112,0.11785113019775792,508,"His name's Quint, you say? I don't know no Quint!"
6309,2313,0,1,8,9,1.1111111111111112,0.11785113019775792,508,"We call this routine good cod, bad cod."
908,2313,0,1,8,9,1.1111111111111112,0.11785113019775792,508,"I told ya a hundred times, I ain't never seen that fish!"
2028,2313,0,1,8,9,1.1111111111111112,0.11785113019775792,508,You read it! My brain's the size of a golf ball.
365,2313,0,1,8,9,1.1111111111111112,0.11785113019775792,508,He tasted worse than he looked!
367,2313,0,1,8,9,1.1111111111111112,0.11785113019775792,508,Not so good. Next caption.
370,2313,0,1,8,9,1.1111111111111112,0.11785113019775792,508,Same as the last one. Delicious.
5724,2313,0,1,8,9,1.1111111111111112,0.11785113019775792,508,Anyone could've made those bite marks.
1260,2313,0,1,8,9,1.1111111111111112,0.11785113019775792,508,Have you seen this boy? No...but I've tasted him.
5726,2313,0,1,8,9,1.1111111111111112,0.11785113019775792,508,I keep on telling you I am a vegetarian!
5727,2313,0,1,8,9,1.1111111111111112,0.11785113019775792,508,So I swim with the sharks. So what?
6132,2313,0,1,8,9,1.1111111111111112,0.11785113019775792,508,How many times to I need to explain the difference between a loan shark and a lone shark?
2020,2313,0,1,8,9,1.1111111111111112,0.11785113019775792,508,"I gave her plenty of warning. I mean, how could she not hear the cello music!"
2019,2313,0,1,8,9,1.1111111111111112,0.11785113019775792,508,"No, he wasn't there. I was a lone shark."
2017,2313,0,1,8,9,1.1111111111111112,0.11785113019775792,508,How many times do I have to tell you? I'm vegan.
378,2313,0,1,8,9,1.1111111111111112,0.11785113019775792,508,Never seen her before....I'm a man eating shark
2016,2313,0,1,8,9,1.1111111111111112,0.11785113019775792,508,Name's Orca. But he's no killer.
1264,2313,0,1,8,9,1.1111111111111112,0.11785113019775792,508,Just because he's missing in the Marina does not mean I know where he is.
927,2313,0,1,8,9,1.1111111111111112,0.11785113019775792,508,Witness Protection relocation to Palm Springs doesn't work for me...
1777,2313,0,1,8,9,1.1111111111111112,0.11785113019775792,508,"Look, this is clearly you flying through the tornado biting people."
1774,2313,0,1,8,9,1.1111111111111112,0.11785113019775792,508,"Like I told you a million times, I ain't never seen that leg before!"
6046,2313,0,1,8,9,1.1111111111111112,0.11785113019775792,508,"So, you've never seen this leg before?"
1564,2313,0,1,8,9,1.1111111111111112,0.11785113019775792,508,"Ok, I loaned him money but I did not eat him"
5955,2313,0,1,8,9,1.1111111111111112,0.11785113019775792,508,How could you accuse me of loan sharking when Amex charges 24% interest.
6045,2313,0,1,8,9,1.1111111111111112,0.11785113019775792,508,"We are loners, man! I don't know nobody."
1560,2313,0,1,8,9,1.1111111111111112,0.11785113019775792,508,"Yep, that's the guy who took off with my suit!"
6044,2313,0,1,8,9,1.1111111111111112,0.11785113019775792,508,All those fish look alike to me.
731,2313,0,1,8,9,1.1111111111111112,0.11785113019775792,508,Why am I always the first one you bring in?
6043,2313,0,1,8,9,1.1111111111111112,0.11785113019775792,508,I'm telling you. . . I never loaned money to the guy.
1413,2313,0,1,8,9,1.1111111111111112,0.11785113019775792,508,"Well, it looks like a seal to me."
6411,2313,0,1,8,9,1.1111111111111112,0.11785113019775792,508,"Given this candidate lineup, I'd say they all jumped me."
5961,2313,0,1,8,9,1.1111111111111112,0.11785113019775792,508,Can't tell. Doesn't show his fin.
6409,2313,0,1,8,9,1.1111111111111112,0.11785113019775792,508,So you're saying this 35% annual interest rate and 10% prepayment penalty don't look familiar?!
6406,2313,0,1,8,9,1.1111111111111112,0.11785113019775792,508,"Oh,I have pretty teeth dear, but that's not my bite"
741,2313,0,1,8,9,1.1111111111111112,0.11785113019775792,508,"Damn, this does look fishy."
743,2313,0,1,8,9,1.1111111111111112,0.11785113019775792,508,Those could be anybody's 300 teeth marks.
6403,2313,0,1,8,9,1.1111111111111112,0.11785113019775792,508,It wasn't me. I took the wife to the Jersey shore for the weekend.
1424,2313,0,1,8,9,1.1111111111111112,0.11785113019775792,508,I guess The New Yorker finally jumped the shark.
5976,2313,0,1,8,9,1.1111111111111112,0.11785113019775792,508,"Once again, I'm not a loan shark."
1554,2313,0,1,8,9,1.1111111111111112,0.11785113019775792,508,"No, I've never seen that surfboard before."
5952,2313,0,1,8,9,1.1111111111111112,0.11785113019775792,508,I've told you a million times. I don't even know how to play pool.
1570,2313,0,1,8,9,1.1111111111111112,0.11785113019775792,508,"I swear Officer, I haven't seen him since Jaws 2."
5951,2313,0,1,8,9,1.1111111111111112,0.11785113019775792,508,There's a mouthful of evidence here.
1613,2313,0,1,8,9,1.1111111111111112,0.11785113019775792,508,I'll have the liver with a nice chianti.
6363,2313,0,1,8,9,1.1111111111111112,0.11785113019775792,508,"That's him, Mack the Knife!"
1405,2313,0,1,8,9,1.1111111111111112,0.11785113019775792,508,"He got a little chummy, what of it?"
696,2313,0,1,8,9,1.1111111111111112,0.11785113019775792,508,Your dental records match the bite marks on the Vic.
1603,2313,0,1,8,9,1.1111111111111112,0.11785113019775792,508,"you've really got me out on a limb, here."
1601,2313,0,1,8,9,1.1111111111111112,0.11785113019775792,508,That's not me it's my twin brother. Just ask Neptune.
1599,2313,0,1,8,9,1.1111111111111112,0.11785113019775792,508,Like I know every other shark. That’s just fishist.
700,2313,0,1,8,9,1.1111111111111112,0.11785113019775792,508,How many times do I have to tell you? I don't know anybody named Spielberg.
709,2313,0,1,8,9,1.1111111111111112,0.11785113019775792,508,"I'm telling you, I never saw that leg before in my life."
1409,2313,0,1,8,9,1.1111111111111112,0.11785113019775792,508,"That's some bad hat, Harry."
1594,2313,0,1,8,9,1.1111111111111112,0.11785113019775792,508,I never loaned a dime to that guy.
715,2313,0,1,8,9,1.1111111111111112,0.11785113019775792,508,Just because he's sleeping with the fishes doesn't mean I know him personally.
6048,2313,0,1,8,9,1.1111111111111112,0.11785113019775792,508,I deFINitely didn't do it. I wasn't even in town during Shark Week.
1581,2313,0,1,8,9,1.1111111111111112,0.11785113019775792,508,That's him. The guy with the peg leg.
1578,2313,0,1,8,9,1.1111111111111112,0.11785113019775792,508,"That's a motor propeller slash, not from shark teeth, you moron."
6047,2313,0,1,8,9,1.1111111111111112,0.11785113019775792,508,I told you. I have never seen that leg.
1576,2313,0,1,8,9,1.1111111111111112,0.11785113019775792,508,"That's not me. That's my cousin Vigorish. But, we all look the same to you."
806,2313,0,1,8,9,1.1111111111111112,0.11785113019775792,508,That's not my handwriting.
6416,2313,0,1,8,9,1.1111111111111112,0.11785113019775792,508,"Yeah, he goes by Mack the Knife."
1532,2313,0,1,8,9,1.1111111111111112,0.11785113019775792,508,"I'm sorry officer, but it looks like a red herring to me."
6037,2313,0,1,8,9,1.1111111111111112,0.11785113019775792,508,That's him--Santiago.
6036,2313,0,1,8,9,1.1111111111111112,0.11785113019775792,508,"Well, hell, he's in a sharkskin suit!"
1437,2313,0,1,8,9,1.1111111111111112,0.11785113019775792,508,You're gonna need a bigger cell
5998,2313,0,1,8,9,1.1111111111111112,0.11785113019775792,508,Not a representation! I am here to represent my client!
6385,2313,0,1,8,9,1.1111111111111112,0.11785113019775792,508,Fish all look the same to me.
1493,2313,0,1,8,9,1.1111111111111112,0.11785113019775792,508,"I'm telling you, the last time I saw Nemo he was alive."
1492,2313,0,1,8,9,1.1111111111111112,0.11785113019775792,508,I have no idea how my fin prints got there.
6000,2313,0,1,8,9,1.1111111111111112,0.11785113019775792,508,Spit him out! And we'll let you off the hook!
1486,2313,0,1,8,9,1.1111111111111112,0.11785113019775792,508,"She was jail bait, chum!"
800,2313,0,1,8,9,1.1111111111111112,0.11785113019775792,508,"Okay, okay. I seen her take a skinny dip now and then. Can I get some water now, please?"
1482,2313,0,1,8,9,1.1111111111111112,0.11785113019775792,508,What did you expect when you hired a sketch artist without hands?
793,2313,0,1,8,9,1.1111111111111112,0.11785113019775792,508,"Nope, never ate that one either."
6006,2313,0,1,8,9,1.1111111111111112,0.11785113019775792,508,I don't have to take this from another species!
778,2313,0,1,8,9,1.1111111111111112,0.11785113019775792,508,they were less hairy
6381,2313,0,1,8,9,1.1111111111111112,0.11785113019775792,508,"Nope. Never seen him. I'll bite, who is he?"
6373,2313,0,1,8,9,1.1111111111111112,0.11785113019775792,508,"You guys say I bit that guy and swam off?! Haha, that's a good one. First of all I'm a vegetarian, I can't swim and last week I was in Detroit."
1472,2313,0,1,8,9,1.1111111111111112,0.11785113019775792,508,"You're asking the wrong guy, dude. I'm a vegan."
6023,2313,0,1,8,9,1.1111111111111112,0.11785113019775792,508,"The floatation device rings a bell, but otherwise you people kind of blend together."
6015,2313,0,1,8,9,1.1111111111111112,0.11785113019775792,508,"just 'cause he signed an IOU, it don't mean am guilty !"
790,2313,0,1,8,9,1.1111111111111112,0.11785113019775792,508,"Like I told you, I just eat'em, I don't look at 'em!"
1461,2313,0,1,8,9,1.1111111111111112,0.11785113019775792,508,So.Spielberg is great at special effects.
6374,2313,0,1,8,9,1.1111111111111112,0.11785113019775792,508,"It was pitch black, man, I ain't seen nothing. I just kept moving along."
5996,2313,0,1,8,9,1.1111111111111112,0.11785113019775792,508,OK! So I ate 'em all. So what?
5927,2313,0,1,8,9,1.1111111111111112,0.11785113019775792,508,"I'm just a loan shark,not a killer."
772,2313,0,1,8,9,1.1111111111111112,0.11785113019775792,508,I'm a vegetarian.
770,2313,0,1,8,9,1.1111111111111112,0.11785113019775792,508,"That's right, buddy boy. Caught on camera. You AND your chum."
6033,2313,0,1,8,9,1.1111111111111112,0.11785113019775792,508,I'm an attorney. You'll need a doctor to read that scrawl.
5983,2313,0,1,8,9,1.1111111111111112,0.11785113019775792,508,"Nope, never tasted her, not my type."
1521,2313,0,1,8,9,1.1111111111111112,0.11785113019775792,508,Did you see this fish in the reef last Thursday?
5984,2313,0,1,8,9,1.1111111111111112,0.11785113019775792,508,"Okay, I'm gonna ask you one last time. Do you recognize this leg?"
5985,2313,0,1,8,9,1.1111111111111112,0.11785113019775792,508,You can't expect me to identify every meal I've eaten in the last 3 months?
6393,2313,0,1,8,9,1.1111111111111112,0.11785113019775792,508,"Gee, Officer Krumpke. You are so 20th Century."
6032,2313,0,1,8,9,1.1111111111111112,0.11785113019775792,508,"Sorry pal, I don't know any big fish."
6391,2313,0,1,8,9,1.1111111111111112,0.11785113019775792,508,That's one whale of a tale I am not a loan shark!
5989,2313,0,1,8,9,1.1111111111111112,0.11785113019775792,508,He says you promised him $300K for 15% of his business.
1512,2313,0,1,8,9,1.1111111111111112,0.11785113019775792,508,I keep telling you there are more fish in the sea.
1511,2313,0,1,8,9,1.1111111111111112,0.11785113019775792,508,Just another fish in the sea to me.
1443,2313,0,1,8,9,1.1111111111111112,0.11785113019775792,508,"Swimming in the ocean wearing that skin tight black outfit should be considered entrapment. If you ask me, I should be suing him."
764,2313,0,1,8,9,1.1111111111111112,0.11785113019775792,508,I'm not a loan shark and I have no idea who that is!
1508,2313,0,1,8,9,1.1111111111111112,0.11785113019775792,508,"We went out for one seal, and then he swam home and I never saw him again!"
6370,2313,0,1,8,9,1.1111111111111112,0.11785113019775792,508,Are you planning an attack?
1445,2313,0,1,8,9,1.1111111111111112,0.11785113019775792,508,He looks like lunch.
767,2313,0,1,8,9,1.1111111111111112,0.11785113019775792,508,Third one from the left; I'll never forget those trunks.
1503,2313,0,1,8,9,1.1111111111111112,0.11785113019775792,508,"OK Rorschach you see a surfer, I see a seal. It's only what the jury sees that matters."
1502,2313,0,1,8,9,1.1111111111111112,0.11785113019775792,508,How should I know; they all look alike!
5995,2313,0,1,8,9,1.1111111111111112,0.11785113019775792,508,"Miranda? Oh sure, try finding me a court-appointed shark."
1620,2313,0,1,8,9,1.1111111111111112,0.11785113019775792,508,I already told you... I'm a vegetarian.
5921,2313,0,1,8,9,1.1111111111111112,0.11785113019775792,508,"Not sure, after a while they all start to look the same"
6430,2313,0,1,8,9,1.1111111111111112,0.11785113019775792,508,I couldna been there. I was in the Bahamas.
1366,2313,0,1,8,9,1.1111111111111112,0.11785113019775792,508,You had a sea of opportunities!
830,2313,0,1,8,9,1.1111111111111112,0.11785113019775792,508,He was wearing a sharkskin suit if that helps.
579,2313,0,1,8,9,1.1111111111111112,0.11785113019775792,508,"'He baited me, I tell ya....chum and a blood trail....what's a shark to do?'"
580,2313,0,1,8,9,1.1111111111111112,0.11785113019775792,508,What kind of think tank is this?
6075,2313,0,1,8,9,1.1111111111111112,0.11785113019775792,508,How do you expect me to identify him? His head is missing!
582,2313,0,1,8,9,1.1111111111111112,0.11785113019775792,508,Have you seen this missing surfer?
1725,2313,0,1,8,9,1.1111111111111112,0.11785113019775792,508,"Well, last night the cops told me to keep moving. Keep moving."
1724,2313,0,1,8,9,1.1111111111111112,0.11785113019775792,508,I ain't sayin nothin' until I get a cigarette and a bucket of plankton.
1723,2313,0,1,8,9,1.1111111111111112,0.11785113019775792,508,"Yeah, I ate him. So what?"
5868,2313,0,1,8,9,1.1111111111111112,0.11785113019775792,508,"No I don’t recognize him, but then again, all surfers look like seals to me."
1714,2313,0,1,8,9,1.1111111111111112,0.11785113019775792,508,"Sorry, that license plate is not familiar."
1709,2313,0,1,8,9,1.1111111111111112,0.11785113019775792,508,"Alright, is this when you two do the 'Good Cop, Japanese Fisherman' routine?"
5875,2313,0,1,8,9,1.1111111111111112,0.11785113019775792,508,Never seen that surfer before in my life.
6473,2313,0,1,8,9,1.1111111111111112,0.11785113019775792,508,That arm had a mate and two legs at home!
1371,2313,0,1,8,9,1.1111111111111112,0.11785113019775792,508,"where I come from, a dead fish really is a gift, detective"
6471,2313,0,1,8,9,1.1111111111111112,0.11785113019775792,508,I told you I won't talk unless you give me imtunaty.
590,2313,0,1,8,9,1.1111111111111112,0.11785113019775792,508,"Nah, the guy I ate said he was fishing for ME!"
6073,2313,0,1,8,9,1.1111111111111112,0.11785113019775792,508,"I told you three times already, 'I'm a vegan!!'"
1696,2313,0,1,8,9,1.1111111111111112,0.11785113019775792,508,"I'm telling ya, the guy doesn't owe me a dime."
5860,2313,0,1,8,9,1.1111111111111112,0.11785113019775792,508,How many times do I have to tell you?! I didn't do that Tuna. Besides I was chasing chum that night.
593,2313,0,1,8,9,1.1111111111111112,0.11785113019775792,508,I don't have an alibi! I'm a loan shark.
573,2313,0,1,8,9,1.1111111111111112,0.11785113019775792,508,He asked me for a loan!
6077,2313,0,1,8,9,1.1111111111111112,0.11785113019775792,508,We met for a drink ... how was I supposed to know he was planning a sequel?
1772,2313,0,1,8,9,1.1111111111111112,0.11785113019775792,508,You got the wrong gang. That's definitely the Jets handiwork.
1771,2313,0,1,8,9,1.1111111111111112,0.11785113019775792,508,"Yeah I've seen that leg before, but it was attached to a body."
1769,2313,0,1,8,9,1.1111111111111112,0.11785113019775792,508,"Look at me, I ain't no rat."
1354,2313,0,1,8,9,1.1111111111111112,0.11785113019775792,508,Law & Order: Shark Victims Unit
6346,2313,0,1,8,9,1.1111111111111112,0.11785113019775792,508,How should I know? Do I look like a lawyer to you?
1766,2313,0,1,8,9,1.1111111111111112,0.11785113019775792,508,"Yes, he cut me off that wave, so I cut him off his leg."
6347,2313,0,1,8,9,1.1111111111111112,0.11785113019775792,508,I've never tasted that person before in my life.
1764,2313,0,1,8,9,1.1111111111111112,0.11785113019775792,508,I'm not saying another word until my documentary crew gets here.
550,2313,0,1,8,9,1.1111111111111112,0.11785113019775792,508,Quint? Never heard of him.
6081,2313,0,1,8,9,1.1111111111111112,0.11785113019775792,508,"Yeah, that's definitely Sharky's fin displayed on their Chinese soup menu."
553,2313,0,1,8,9,1.1111111111111112,0.11785113019775792,508,"How many times do I have to say it, 'I'm a land shark!'"
6487,2313,0,1,8,9,1.1111111111111112,0.11785113019775792,508,Yeah..that's him...looks like ol' Macky's back in town
5848,2313,0,1,8,9,1.1111111111111112,0.11785113019775792,508,"The last time I saw him he was with the fishes, but he wasn't sleeping."
1756,2313,0,1,8,9,1.1111111111111112,0.11785113019775792,508,I've never eaten her in my life!
1753,2313,0,1,8,9,1.1111111111111112,0.11785113019775792,508,It wasn't me. I HATE anchovies.
6486,2313,0,1,8,9,1.1111111111111112,0.11785113019775792,508,Why you would no go after bigger fish like J.P. Morgan or Goldman Sachs?
6079,2313,0,1,8,9,1.1111111111111112,0.11785113019775792,508,Not me! I never spend my summers in Montauk.
566,2313,0,1,8,9,1.1111111111111112,0.11785113019775792,508,Marco Rubio sleeps with the fishes
1745,2313,0,1,8,9,1.1111111111111112,0.11785113019775792,508,"I told you, to a shark, humans all look the same!"
6479,2313,0,1,8,9,1.1111111111111112,0.11785113019775792,508,"Never mind lunch, I don't like anything on the menu."
5841,2313,0,1,8,9,1.1111111111111112,0.11785113019775792,508,That guy gave me indigestion.
6071,2313,0,1,8,9,1.1111111111111112,0.11785113019775792,508,"First of all, I happen to be a vegan."
1688,2313,0,1,8,9,1.1111111111111112,0.11785113019775792,508,That's from Sharknado.
1653,2313,0,1,8,9,1.1111111111111112,0.11785113019775792,508,The only thing I'm guilty of is moving to Wisconsin in the first place!
661,2313,0,1,8,9,1.1111111111111112,0.11785113019775792,508,I swear I didn't know he was an endangered species
1651,2313,0,1,8,9,1.1111111111111112,0.11785113019775792,508,"Honest guys, I ain't seen ol' Quint since 1975."
5907,2313,0,1,8,9,1.1111111111111112,0.11785113019775792,508,Stop! I ain't sayin' nothin' more until I talk to my client.
665,2313,0,1,8,9,1.1111111111111112,0.11785113019775792,508,"Yeah, dat was my chum."
1646,2313,0,1,8,9,1.1111111111111112,0.11785113019775792,508,"No, officer, that's no chum of mine!"
1645,2313,0,1,8,9,1.1111111111111112,0.11785113019775792,508,I was just trying to take a bite out of crime.
667,2313,0,1,8,9,1.1111111111111112,0.11785113019775792,508,"That might be him, but I can't be sure. The guy who tried to spear me was wearing a mask."
674,2313,0,1,8,9,1.1111111111111112,0.11785113019775792,508,They all smell the same.
5912,2313,0,1,8,9,1.1111111111111112,0.11785113019775792,508,"I told you, not all sharks are loan sharks."
675,2313,0,1,8,9,1.1111111111111112,0.11785113019775792,508,"Yeah, I know 'em. That's Ivan 'The Great White' and his enforcer, Vinnie 'The Hammer.'"
676,2313,0,1,8,9,1.1111111111111112,0.11785113019775792,508,"No, he's not my chum!"
677,2313,0,1,8,9,1.1111111111111112,0.11785113019775792,508,Just a coincidence. You boys think I'm the only one who can leave teeth marks like those?
1396,2313,0,1,8,9,1.1111111111111112,0.11785113019775792,508,I can't breath.
1397,2313,0,1,8,9,1.1111111111111112,0.11785113019775792,508,"Yea, that's the guy. It's like he came out of nowhere...He jumped into my home, punched me in the face, and then swam away."
1634,2313,0,1,8,9,1.1111111111111112,0.11785113019775792,508,What? I thought he was a seal.
6053,2313,0,1,8,9,1.1111111111111112,0.11785113019775792,508,I'm not answering any questions until I can talk to my father.
1402,2313,0,1,8,9,1.1111111111111112,0.11785113019775792,508,"You've got the wrong guy. I'm tellin ya, I don't even DO loans."
686,2313,0,1,8,9,1.1111111111111112,0.11785113019775792,508,Shouldn't you be talking to the killer wales?
6360,2313,0,1,8,9,1.1111111111111112,0.11785113019775792,508,I agree it looks fishy!
1692,2313,0,1,8,9,1.1111111111111112,0.11785113019775792,508,You think I'm a shark......wait till you meet my lawyer!!
6449,2313,0,1,8,9,1.1111111111111112,0.11785113019775792,508,I want to see my burbot.
1659,2313,0,1,8,9,1.1111111111111112,0.11785113019775792,508,"I ain't sayin' nothing, till one of you dicks pretends to the 'good cop'."
1686,2313,0,1,8,9,1.1111111111111112,0.11785113019775792,508,We already know you weren't in school that day
596,2313,0,1,8,9,1.1111111111111112,0.11785113019775792,508,Never seen this 'Hoffa' fellow before.
6353,2313,0,1,8,9,1.1111111111111112,0.11785113019775792,508,"Yeah, that's the punk biker dude that jumped me."
601,2313,0,1,8,9,1.1111111111111112,0.11785113019775792,508,"Nope, if I ate a Shih Tzu I'd cough up hairballs for a month!"
823,2313,0,1,8,9,1.1111111111111112,0.11785113019775792,508,"Hey, Sarge, after this one, may I have a bite?"
822,2313,0,1,8,9,1.1111111111111112,0.11785113019775792,508,Yeah? He's a Jet. So what's it to me?
5893,2313,0,1,8,9,1.1111111111111112,0.11785113019775792,508,Listen......I tell you one more time; I never seen that surfer.
1384,2313,0,1,8,9,1.1111111111111112,0.11785113019775792,508,I ain't no killer whale!
6356,2313,0,1,8,9,1.1111111111111112,0.11785113019775792,508,I wasn't even close to The Cape this summer!
1671,2313,0,1,8,9,1.1111111111111112,0.11785113019775792,508,He is swimming with the fish now
621,2313,0,1,8,9,1.1111111111111112,0.11785113019775792,508,She was fat and juicy - what do you expect?
5895,2313,0,1,8,9,1.1111111111111112,0.11785113019775792,508,"Sorry, I've only seen the first Jaws."
623,2313,0,1,8,9,1.1111111111111112,0.11785113019775792,508,I told you before. I wasn't there. I was in school!
6459,2313,0,1,8,9,1.1111111111111112,0.11785113019775792,508,I can't believe I'm in the tank.
629,2313,0,1,8,9,1.1111111111111112,0.11785113019775792,508,What was I supposed to do? They jumped me first.
6357,2313,0,1,8,9,1.1111111111111112,0.11785113019775792,508,Call Spielberg. He’ll back me up. It was just a movie.
1667,2313,0,1,8,9,1.1111111111111112,0.11785113019775792,508,You can't fool me. That's a mug shot of a lawyer.
5899,2313,0,1,8,9,1.1111111111111112,0.11785113019775792,508,"I told ya already, I didn't do it on Porpoise."
1663,2313,0,1,8,9,1.1111111111111112,0.11785113019775792,508,That helicopter was photoshopped.
6451,2313,0,1,8,9,1.1111111111111112,0.11785113019775792,508,"He's an old poker buddy, who owed me an arm and a leg."
285,2313,0,1,8,9,1.1111111111111112,0.11785113019775792,508,And that's why we called him 'Chum.'
6376,2313,0,1,8,9,1.1111111111111112,0.11785113019775792,508,You can't pin this one on me copper. I've never seen those legs before in my life.
283,2313,0,1,8,9,1.1111111111111112,0.11785113019775792,508,Yeah I know that mug. He's slippery as an eel.
114,2313,0,1,8,9,1.1111111111111112,0.11785113019775792,508,Donald J. Trump. He also has angry issues.
5539,2313,0,1,8,9,1.1111111111111112,0.11785113019775792,508,You call 30% interest loan sharking?
2465,2313,0,1,8,9,1.1111111111111112,0.11785113019775792,508,Loan shark? Prove it!
2463,2313,0,1,8,9,1.1111111111111112,0.11785113019775792,508,I wasn't anywhere near that beach.
2462,2313,0,1,8,9,1.1111111111111112,0.11785113019775792,508,"I know Flipper, I am him for dinner, so what!"
2459,2313,0,1,8,9,1.1111111111111112,0.11785113019775792,508,"I'm telling you, I never went near that school."
119,2313,0,1,8,9,1.1111111111111112,0.11785113019775792,508,"Nah, he's not in my school."
2454,2313,0,1,8,9,1.1111111111111112,0.11785113019775792,508,I never saw that leg in my life...urp
6204,2313,0,1,8,9,1.1111111111111112,0.11785113019775792,508,"Accomplice? No, that's my lawyer!"
6203,2313,0,1,8,9,1.1111111111111112,0.11785113019775792,508,I never saw that license plate before in my life.
2449,2313,0,1,8,9,1.1111111111111112,0.11785113019775792,508,"Yeah, I may have advanced him few bucks here and there."
1134,2313,0,1,8,9,1.1111111111111112,0.11785113019775792,508,Like I can read.
6700,2313,0,1,8,9,1.1111111111111112,0.11785113019775792,508,I got nuth'in to say till I talk to my cousin Vinnie!
2443,2313,0,1,8,9,1.1111111111111112,0.11785113019775792,508,That wasn't me. Check my dental records.
2440,2313,0,1,8,9,1.1111111111111112,0.11785113019775792,508,"That's Him! I was hanging around the pier deciding on what to eat and the next thing I know, this guys pointing a rod in my face and says something about spilling my guts. I thought I was going to dehydrate on the spot!"
2437,2313,0,1,8,9,1.1111111111111112,0.11785113019775792,508,"I may look like a shark, but I'm just one of the 'small fry.'"
2436,2313,0,1,8,9,1.1111111111111112,0.11785113019775792,508,So what? That's what it takes to make the sea great again.
6706,2313,0,1,8,9,1.1111111111111112,0.11785113019775792,508,Wasn't me Tubbs.
2483,2313,0,1,8,9,1.1111111111111112,0.11785113019775792,508,"It's not my Rx, I don't do steroids."
1008,2313,0,1,8,9,1.1111111111111112,0.11785113019775792,508,"That's not me, haven't you ever seen a picture of a shark out of water?"
6709,2313,0,1,8,9,1.1111111111111112,0.11785113019775792,508,I don't eat vegans
1014,2313,0,1,8,9,1.1111111111111112,0.11785113019775792,508,"Oh, him! I wasn't THAT hungry."
6259,2313,0,1,8,9,1.1111111111111112,0.11785113019775792,508,You'll only find him over my dead body!
2512,2313,0,1,8,9,1.1111111111111112,0.11785113019775792,508,Nope. I'm Vegan!
99,2313,0,1,8,9,1.1111111111111112,0.11785113019775792,508,look..i'm like a fish outta water here. ' ' looks like every other fish in the ocean.
5525,2313,0,1,8,9,1.1111111111111112,0.11785113019775792,508,I won't wave my Miranda rights.
2502,2313,0,1,8,9,1.1111111111111112,0.11785113019775792,508,"I don't care what kind of proof you might have, I am NOT a loan shark"
102,2313,0,1,8,9,1.1111111111111112,0.11785113019775792,508,"Ya I shared the selfie, but he was delicious"
6713,2313,0,1,8,9,1.1111111111111112,0.11785113019775792,508,I'm innocent - I could never eat anybody that ugly.
2435,2313,0,1,8,9,1.1111111111111112,0.11785113019775792,508,It was all a red blur.
1113,2313,0,1,8,9,1.1111111111111112,0.11785113019775792,508,"That's Ahab, not Quint. Go ask the whale."
1117,2313,0,1,8,9,1.1111111111111112,0.11785113019775792,508,Amity Island? Never heard of it.
1009,2313,0,1,8,9,1.1111111111111112,0.11785113019775792,508,What's wrong with sleeping with the fishes?
6210,2313,0,1,8,9,1.1111111111111112,0.11785113019775792,508,I demand to speak to my client.
1121,2313,0,1,8,9,1.1111111111111112,0.11785113019775792,508,"It wasn't me, I was no where near the Jets territory"
1123,2313,0,1,8,9,1.1111111111111112,0.11785113019775792,508,"I'm not your suspect, dammit. I'm his attorney."
2494,2313,0,1,8,9,1.1111111111111112,0.11785113019775792,508,I am not responsible for Sharknado!
2491,2313,0,1,8,9,1.1111111111111112,0.11785113019775792,508,"No, I don't need a lawyer. Can't you see that I *am* one."
2490,2313,0,1,8,9,1.1111111111111112,0.11785113019775792,508,It's just a blurry picture of a fin. It could belong to anybody.
1010,2313,0,1,8,9,1.1111111111111112,0.11785113019775792,508,"Yeah, yeah, it's him. We were in law school together."
2430,2313,0,1,8,9,1.1111111111111112,0.11785113019775792,508,"That's Hammerhead. The guy you want is, Saw."
1138,2313,0,1,8,9,1.1111111111111112,0.11785113019775792,508,"Never saw him, never laid a tooth on him."
5559,2313,0,1,8,9,1.1111111111111112,0.11785113019775792,508,"That's the big tuna, alright."
2364,2313,0,1,8,9,1.1111111111111112,0.11785113019775792,508,It was an innocent swim between two consenting species.
5585,2313,0,1,8,9,1.1111111111111112,0.11785113019775792,508,Dare I say that your detective career has jumped the shark.
1158,2313,0,1,8,9,1.1111111111111112,0.11785113019775792,508,"I demand to see lawyer, preferably someone fatty."
158,2313,0,1,8,9,1.1111111111111112,0.11785113019775792,508,"Yeah, so, maybe I've seen him. I'm not sayin' nothin' till my lawyer's here. He's a real shark."
2353,2313,0,1,8,9,1.1111111111111112,0.11785113019775792,508,"OK! He has pretty, pearly white teeth. So what? We all do!"
6674,2313,0,1,8,9,1.1111111111111112,0.11785113019775792,508,"I'm sure he was a nice, tasty fat man, but for the last time, I was on a cleanse last week."
2350,2313,0,1,8,9,1.1111111111111112,0.11785113019775792,508,I need a break. Get me a glass of O Positive.
162,2313,0,1,8,9,1.1111111111111112,0.11785113019775792,508,Is this your chum?
2365,2313,0,1,8,9,1.1111111111111112,0.11785113019775792,508,I think you have grossly misunderstood what he meant by 'Tony now sleeps with the fishes'.
2344,2313,0,1,8,9,1.1111111111111112,0.11785113019775792,508,"Please, can we bring in the scent artist?"
6669,2313,0,1,8,9,1.1111111111111112,0.11785113019775792,508,I know him. He's just out there as bait. You guys gotta' go for the big fish
2338,2313,0,1,8,9,1.1111111111111112,0.11785113019775792,508,I never was and never will be a loan shark!
168,2313,0,1,8,9,1.1111111111111112,0.11785113019775792,508,'I would never loan money at those interest rates!'
2334,2313,0,1,8,9,1.1111111111111112,0.11785113019775792,508,I'm not saying another word without my client present.
2333,2313,0,1,8,9,1.1111111111111112,0.11785113019775792,508,We found your FIN-ger prints at the scene!
2332,2313,0,1,8,9,1.1111111111111112,0.11785113019775792,508,Have you seen this man? he might have looked like a turtle from a distance .
976,2313,0,1,8,9,1.1111111111111112,0.11785113019775792,508,"Jeez, I thought lawyers got professional courtesy!"
2328,2313,0,1,8,9,1.1111111111111112,0.11785113019775792,508,I told you already. He's sleeping with the fishes.
1162,2313,0,1,8,9,1.1111111111111112,0.11785113019775792,508,I told you; I am not a card shark!
2515,2313,0,1,8,9,1.1111111111111112,0.11785113019775792,508,"Yeah, that's him alright. He deserved it."
5583,2313,0,1,8,9,1.1111111111111112,0.11785113019775792,508,I didn't like him because was a bitter man and hard to swallow!
5579,2313,0,1,8,9,1.1111111111111112,0.11785113019775792,508,"I'll help, I'll help! Just don't throw me back in the tank!"
2417,2313,0,1,8,9,1.1111111111111112,0.11785113019775792,508,"Nice try, Columbo. Everyone knows that was a robot."
2416,2313,0,1,8,9,1.1111111111111112,0.11785113019775792,508,"Whadda ya expect? I'm a shark, not a rat!"
2413,2313,0,1,8,9,1.1111111111111112,0.11785113019775792,508,Let's just say she's swimming with the fishes.
932,2313,0,1,8,9,1.1111111111111112,0.11785113019775792,508,Your rights are offered in encrypted sonar.
2409,2313,0,1,8,9,1.1111111111111112,0.11785113019775792,508,I'm strictly on a Mediterranean Diet. That leg looks like it is from New Jersey.
2407,2313,0,1,8,9,1.1111111111111112,0.11785113019775792,508,I can't recognize a WHOLE sea lion!
1144,2313,0,1,8,9,1.1111111111111112,0.11785113019775792,508,Do you have any Rorschachs that don't look like scarlet billows starting to spread?
2401,2313,0,1,8,9,1.1111111111111112,0.11785113019775792,508,"I'll say it again, I ate dinner with her!"
6679,2313,0,1,8,9,1.1111111111111112,0.11785113019775792,508,"The press labels you a 'killing machine,' and suddenly you're wanted for all the line-ups."
143,2313,0,1,8,9,1.1111111111111112,0.11785113019775792,508,Hey! A leg is a leg.
2397,2313,0,1,8,9,1.1111111111111112,0.11785113019775792,508,"Dude, this is is cruel. You lock a predator up and then show him pictures of food? Could I at least get a donut?"
146,2313,0,1,8,9,1.1111111111111112,0.11785113019775792,508,I ain't never seen that seal in my life.
2390,2313,0,1,8,9,1.1111111111111112,0.11785113019775792,508,We have you cold on loan sharking!
2388,2313,0,1,8,9,1.1111111111111112,0.11785113019775792,508,"No, no! Ya got it wrong, I tell ya. You're lookin' for a card sharp, not a card shark!"
6683,2313,0,1,8,9,1.1111111111111112,0.11785113019775792,508,"I don't know nothin' about any missing diver in March '76! I'm tellin' ya, call my agent! We was out at the Oscars that night!"
6191,2313,0,1,8,9,1.1111111111111112,0.11785113019775792,508,It's like I told you. Luca Brazia sleeps with the fishes.
984,2313,0,1,8,9,1.1111111111111112,0.11785113019775792,508,The statute of limitations ran out on that 3 million years ago.
982,2313,0,1,8,9,1.1111111111111112,0.11785113019775792,508,Looks like Mackie's back in town.
6192,2313,0,1,8,9,1.1111111111111112,0.11785113019775792,508,"I told you he'd never take the bate, Johnson."
2521,2313,0,1,8,9,1.1111111111111112,0.11785113019775792,508,"Yeah I can read, kneehead. But I have the right to remain silent."
5518,2313,0,1,8,9,1.1111111111111112,0.11785113019775792,508,Still looks fishy to me.
6717,2313,0,1,8,9,1.1111111111111112,0.11785113019775792,508,I broke up with that mermaid two years ago and ain't seen her since.
2685,2313,0,1,8,9,1.1111111111111112,0.11785113019775792,508,I don't know. It all happened so fast.
1069,2313,0,1,8,9,1.1111111111111112,0.11785113019775792,508,"Of course he's not talking Dale, he's a shark."
5458,2313,0,1,8,9,1.1111111111111112,0.11785113019775792,508,Is this the guy you lent the money to?
2682,2313,0,1,8,9,1.1111111111111112,0.11785113019775792,508,"...and quit saying, 'That's a fish story.' For the 100th time, I'm a mammal!"
5460,2313,0,1,8,9,1.1111111111111112,0.11785113019775792,508,"If I give you the head of the EPA, who's going to protect me?"
1055,2313,0,1,8,9,1.1111111111111112,0.11785113019775792,508,'Who is this Miranda? Sounds fishy to me.
30,2313,0,1,8,9,1.1111111111111112,0.11785113019775792,508,"No, my wife and I only eat vegetarians."
1053,2313,0,1,8,9,1.1111111111111112,0.11785113019775792,508,"That's not my client, but if it is, he was just borrowing the car, and in any event he didn't cross state lines."
1065,2313,0,1,8,9,1.1111111111111112,0.11785113019775792,508,"Call my lawyer, he's the shark"
33,2313,0,1,8,9,1.1111111111111112,0.11785113019775792,508,"I told you guys, all those boats look the same to me. Although that one is a little on the small side."
2672,2313,0,1,8,9,1.1111111111111112,0.11785113019775792,508,I will ask you one more time do you recognize your dental records.
1075,2313,0,1,8,9,1.1111111111111112,0.11785113019775792,508,I swear I only tasted that guy
6752,2313,0,1,8,9,1.1111111111111112,0.11785113019775792,508,"No, but his arms and legs do ring a bell."
5469,2313,0,1,8,9,1.1111111111111112,0.11785113019775792,508,Bring me a photo of someone in a diving mask and just maybe I'll confess.
6751,2313,0,1,8,9,1.1111111111111112,0.11785113019775792,508,"That's my twin brother, the card shark."
6230,2313,0,1,8,9,1.1111111111111112,0.11785113019775792,508,"Frankly, they all taste like chicken"
2651,2313,0,1,8,9,1.1111111111111112,0.11785113019775792,508,"Yes,they are all sleeping with the fishes."
47,2313,0,1,8,9,1.1111111111111112,0.11785113019775792,508,"I swear, I've never seen that swimmer before in my life."
6231,2313,0,1,8,9,1.1111111111111112,0.11785113019775792,508,"I keep telling you, I don't know any loan sharks."
2648,2313,0,1,8,9,1.1111111111111112,0.11785113019775792,508,"What, is it a crime to take a selfie!? I did my best with the fin I have."
5456,2313,0,1,8,9,1.1111111111111112,0.11785113019775792,508,So I gave out a few bad loans. Bite me.
2689,2313,0,1,8,9,1.1111111111111112,0.11785113019775792,508,"Enough chumming, ok? I'll bite."
2744,2313,0,1,8,9,1.1111111111111112,0.11785113019775792,508,"I tell you, it was that remora. He set me up."
6774,2313,0,1,8,9,1.1111111111111112,0.11785113019775792,508,You're bluffing. You know those aren't my fingerprints.
6773,2313,0,1,8,9,1.1111111111111112,0.11785113019775792,508,You tell me that doesn't look like a seal to you!
6771,2313,0,1,8,9,1.1111111111111112,0.11785113019775792,508,Innocent on all eight counts . . . Haul in the octopus!
6238,2313,0,1,8,9,1.1111111111111112,0.11785113019775792,508,We know it was you; its your dental record.
2732,2313,0,1,8,9,1.1111111111111112,0.11785113019775792,508,Him? He sleeps with the fishes.
2731,2313,0,1,8,9,1.1111111111111112,0.11785113019775792,508,Stop grilling me.
1057,2313,0,1,8,9,1.1111111111111112,0.11785113019775792,508,22.86%? I would never make a loan at a rate that low.
5454,2313,0,1,8,9,1.1111111111111112,0.11785113019775792,508,"I don't care what it says, this shark ain't squealin'."
2726,2313,0,1,8,9,1.1111111111111112,0.11785113019775792,508,I'm not your guy. I don't do loans.
1064,2313,0,1,8,9,1.1111111111111112,0.11785113019775792,508,"Yeah, I ate that guy too, but that still doesn’t make me a serial killer...."
2718,2313,0,1,8,9,1.1111111111111112,0.11785113019775792,508,I haven't seen that hammerhead in years.
2702,2313,0,1,8,9,1.1111111111111112,0.11785113019775792,508,Yes! that was my dinner
2699,2313,0,1,8,9,1.1111111111111112,0.11785113019775792,508,The last time I saw him he was swimming with the fishes!
2696,2313,0,1,8,9,1.1111111111111112,0.11785113019775792,508,"What's it look like to you, chum?"
19,2313,0,1,8,9,1.1111111111111112,0.11785113019775792,508,Why isn't he responding?
20,2313,0,1,8,9,1.1111111111111112,0.11785113019775792,508,You are accused of predatory lending and are a subprime loan shark!
5453,2313,0,1,8,9,1.1111111111111112,0.11785113019775792,508,"No, sir, they were people-infested waters."
2725,2313,0,1,8,9,1.1111111111111112,0.11785113019775792,508,"Yeah, I saw him outside the school yesterday."
2324,2313,0,1,8,9,1.1111111111111112,0.11785113019775792,508,I told ya I never seen that worm before!
2646,2313,0,1,8,9,1.1111111111111112,0.11785113019775792,508,So what? Those board shorts could belong to anyone.
1080,2313,0,1,8,9,1.1111111111111112,0.11785113019775792,508,"If you think I'm a killer shark, just wait until you meet my lawyer."
2563,2313,0,1,8,9,1.1111111111111112,0.11785113019775792,508,How do I know ? It looks like any leg to me.
2562,2313,0,1,8,9,1.1111111111111112,0.11785113019775792,508,Aren't there laws against phylum profiling?
5505,2313,0,1,8,9,1.1111111111111112,0.11785113019775792,508,"Alright, you got me. Bring my client back into the room..."
2558,2313,0,1,8,9,1.1111111111111112,0.11785113019775792,508,That guy definitely ain't swimming with the fishes.
5506,2313,0,1,8,9,1.1111111111111112,0.11785113019775792,508,"Yeah, yeah-he likes to hang out near the beach."
2556,2313,0,1,8,9,1.1111111111111112,0.11785113019775792,508,"Look, I thought I had signed a Non-disclosure Agreement, not a 'Don't Eat Everyone In Your Department Agreement'"
2555,2313,0,1,8,9,1.1111111111111112,0.11785113019775792,508,"Okay, so I wasn't that great."
2554,2313,0,1,8,9,1.1111111111111112,0.11785113019775792,508,"I told you already, that's not me, it's my twin brother, Bruce."
2567,2313,0,1,8,9,1.1111111111111112,0.11785113019775792,508,That’s him- the Kintner boy. You wanna cut me open and see if he spills out all over the dock?
1022,2313,0,1,8,9,1.1111111111111112,0.11785113019775792,508,Can I use a bite mark?
2547,2313,0,1,8,9,1.1111111111111112,0.11785113019775792,508,Attorney.
2543,2313,0,1,8,9,1.1111111111111112,0.11785113019775792,508,"Don't know, all feet look alike to me."
2542,2313,0,1,8,9,1.1111111111111112,0.11785113019775792,508,I'll answer your questions as soon as I get some water.
2541,2313,0,1,8,9,1.1111111111111112,0.11785113019775792,508,Go ahead...knock my teeth out. I got another set.
2539,2313,0,1,8,9,1.1111111111111112,0.11785113019775792,508,I did NOT eat that swimmer!
2535,2313,0,1,8,9,1.1111111111111112,0.11785113019775792,508,Dunno... You got a blood sample?
5513,2313,0,1,8,9,1.1111111111111112,0.11785113019775792,508,"What about the presumption of innocence, detective?"
2530,2313,0,1,8,9,1.1111111111111112,0.11785113019775792,508,I'm not answering anything without an attorney and a bucket of chum.
6256,2313,0,1,8,9,1.1111111111111112,0.11785113019775792,508,"Pretty teeth, dear--even if I say so myself"
1051,2313,0,1,8,9,1.1111111111111112,0.11785113019775792,508,"Huh, uh. This guy had a smaller boat."
2569,2313,0,1,8,9,1.1111111111111112,0.11785113019775792,508,I know my rights. Don't I look like a lawyer?
2579,2313,0,1,8,9,1.1111111111111112,0.11785113019775792,508,"Well, it looks like a sea lion to me."
2635,2313,0,1,8,9,1.1111111111111112,0.11785113019775792,508,That guy is no chum of mine!
1039,2313,0,1,8,9,1.1111111111111112,0.11785113019775792,508,'What da ya think? All guys in a bathing suit look alike.'
2626,2313,0,1,8,9,1.1111111111111112,0.11785113019775792,508,"Fine, I admit it. That's me Donald Trump is jumping over in the photo."
68,2313,0,1,8,9,1.1111111111111112,0.11785113019775792,508,I'm not answering anymore questions without another shark present.
2625,2313,0,1,8,9,1.1111111111111112,0.11785113019775792,508,**SPOILER ALERT** I'm a shark.
6224,2313,0,1,8,9,1.1111111111111112,0.11785113019775792,508,"Just a little closer, my eyesight is poor...that's it...just a little closer."
6733,2313,0,1,8,9,1.1111111111111112,0.11785113019775792,508,Not sure what to tell ya... they all look like seals to me.
72,2313,0,1,8,9,1.1111111111111112,0.11785113019775792,508,That sketch clearly isn't me! We must all look alike to you.
2576,2313,0,1,8,9,1.1111111111111112,0.11785113019775792,508,"Alright, lawyer time!"
2600,2313,0,1,8,9,1.1111111111111112,0.11785113019775792,508,Kinda looks like him but all guys kinda look the same buddy
2594,2313,0,1,8,9,1.1111111111111112,0.11785113019775792,508,"These are your teeth marks at the bottom of this loan sheet, are they not?"
1028,2313,0,1,8,9,1.1111111111111112,0.11785113019775792,508,I've already told you. I'm not a rat.
1094,2313,0,1,8,9,1.1111111111111112,0.11785113019775792,508,I demand to see my client NOW!
1027,2313,0,1,8,9,1.1111111111111112,0.11785113019775792,508,"For the last time, I'm not a loan shark."
1095,2313,0,1,8,9,1.1111111111111112,0.11785113019775792,508,You're fishing.
2584,2313,0,1,8,9,1.1111111111111112,0.11785113019775792,508,"I told you, the guy that jumped me wore his hair like James Dean and a leather, biker jacket. Oh, and cried 'Ayyy...' mid-jump."
6221,2313,0,1,8,9,1.1111111111111112,0.11785113019775792,508,"Dat's Bennie the Shark, alright. I'd know that fin anywhere."
1024,2313,0,1,8,9,1.1111111111111112,0.11785113019775792,508,I will cooperate when I get my glass of water
1091,2313,0,1,8,9,1.1111111111111112,0.11785113019775792,508,Nope—I'm a pescetarian.
6667,2313,0,1,8,9,1.1111111111111112,0.11785113019775792,508,"No, I will not do a 'Land Shark' skit on SNL!"
6195,2313,0,1,8,9,1.1111111111111112,0.11785113019775792,508,"Listen, chum, I ain't takin' the bait."
196,2313,0,1,8,9,1.1111111111111112,0.11785113019775792,508,That's not what I said!
2185,2313,0,1,8,9,1.1111111111111112,0.11785113019775792,508,Don't tell me you lost that kid Nemo again.
947,2313,0,1,8,9,1.1111111111111112,0.11785113019775792,508,It says here you have a history of attacking schools. What do you have against education?
5624,2313,0,1,8,9,1.1111111111111112,0.11785113019775792,508,"Gimme a second to digest these, guys."
945,2313,0,1,8,9,1.1111111111111112,0.11785113019775792,508,"I told ya already, I ain't never been near no Amity Island!'"
4540,2313,0,1,8,9,1.1111111111111112,0.11785113019775792,508,Nope -- never made a loan to him either.
2271,2313,0,1,8,9,1.1111111111111112,0.11785113019775792,508,So what? It's a candygram ... doesn't prove anything.
241,2313,0,1,8,9,1.1111111111111112,0.11785113019775792,508,Yes! Empire's the one who jumped me.
6289,2313,0,1,8,9,1.1111111111111112,0.11785113019775792,508,When are you going to stop blaming me for all your missing swimmers.
1218,2313,0,1,8,9,1.1111111111111112,0.11785113019775792,508,Maybe I seen her. What's her feet look like?
2274,2313,0,1,8,9,1.1111111111111112,0.11785113019775792,508,"I keep telling you that I got nothing on him. Jaws ain't real, man."
2182,2313,0,1,8,9,1.1111111111111112,0.11785113019775792,508,I don't even like seafood.
245,2313,0,1,8,9,1.1111111111111112,0.11785113019775792,508,I thought it was a seal.
2278,2313,0,1,8,9,1.1111111111111112,0.11785113019775792,508,"I'm tellin' 'ya, I don't know nobody named Charlie."
6650,2313,0,1,8,9,1.1111111111111112,0.11785113019775792,508,Can't really tell without seeing his legs.
2284,2313,0,1,8,9,1.1111111111111112,0.11785113019775792,508,Yeah he looks familiar ... but I eat little fish like him for breakfast.
1221,2313,0,1,8,9,1.1111111111111112,0.11785113019775792,508,"For the last time I was in court, not at the beach."
5660,2313,0,1,8,9,1.1111111111111112,0.11785113019775792,508,Is there a law against eating people?
1223,2313,0,1,8,9,1.1111111111111112,0.11785113019775792,508,I would never make a loan like that.
944,2313,0,1,8,9,1.1111111111111112,0.11785113019775792,508,"Like I told ya'...that ain't no chum of mine, see?"
2175,2313,0,1,8,9,1.1111111111111112,0.11785113019775792,508,"Yeah, I seen that chum truck. I see a lotta chum trucks."
268,2313,0,1,8,9,1.1111111111111112,0.11785113019775792,508,I keep tellin' youse -- he ain't no chum of mine!
5665,2313,0,1,8,9,1.1111111111111112,0.11785113019775792,508,They all look the same to me. Who was wearing Chanel No. 5?
2169,2313,0,1,8,9,1.1111111111111112,0.11785113019775792,508,"Yeh, I did it, but I thought he was my chum."
940,2313,0,1,8,9,1.1111111111111112,0.11785113019775792,508,"I don't care what you think, that's not me. I was chewing on a surfboard off North Beach the day that photo was taken."
6612,2313,0,1,8,9,1.1111111111111112,0.11785113019775792,508,"Looks tasty, but I'm not talking about my diet until I have a lawyer."
6647,2313,0,1,8,9,1.1111111111111112,0.11785113019775792,508,I don't give a good goddamn whether you believe in climate change or not!
5625,2313,0,1,8,9,1.1111111111111112,0.11785113019775792,508,"Looks like a lawyer. We don't do lawyers...professional courtesy, you know?"
6293,2313,0,1,8,9,1.1111111111111112,0.11785113019775792,508,I'm not signing anything without my mouthpiece
6646,2313,0,1,8,9,1.1111111111111112,0.11785113019775792,508,No. I don't know anybody named Mack the Knife.
2236,2313,0,1,8,9,1.1111111111111112,0.11785113019775792,508,"I told ya, copper, 'That's not my handwriting.'"
2234,2313,0,1,8,9,1.1111111111111112,0.11785113019775792,508,"Okay, I'll tell you who was in on the frenzy, but only if you drop the shylocking charges."
1198,2313,0,1,8,9,1.1111111111111112,0.11785113019775792,508,So I lent him some money. I lend lots of people money. Is that a crime?
2245,2313,0,1,8,9,1.1111111111111112,0.11785113019775792,508,"Sure, maybe he's okay and maybe he sleeps with the fishes."
226,2313,0,1,8,9,1.1111111111111112,0.11785113019775792,508,"No, it was a bigger boat"
1202,2313,0,1,8,9,1.1111111111111112,0.11785113019775792,508,Spielberg? Never heard of him.
2248,2313,0,1,8,9,1.1111111111111112,0.11785113019775792,508,"Yeah, yeah, it's a crime scene. You call that blood?"
955,2313,0,1,8,9,1.1111111111111112,0.11785113019775792,508,"That's not me copper, I don't swim with hammerheads."
5601,2313,0,1,8,9,1.1111111111111112,0.11785113019775792,508,Ugh. There goes my beer endorsement.
5641,2313,0,1,8,9,1.1111111111111112,0.11785113019775792,508,I've never seen that torso before in my life.
5642,2313,0,1,8,9,1.1111111111111112,0.11785113019775792,508,"Like I said, I don't know what happened to my client, chum!"
5630,2313,0,1,8,9,1.1111111111111112,0.11785113019775792,508,"If you want to be waterboarded, you'd better cooperate."
2165,2313,0,1,8,9,1.1111111111111112,0.11785113019775792,508,Beats me. There are a lot of fish in the sea.
2223,2313,0,1,8,9,1.1111111111111112,0.11785113019775792,508,"Yes, under his blonde comb-over he is only another shark!"
5644,2313,0,1,8,9,1.1111111111111112,0.11785113019775792,508,Are you absolutely positive that's the man who jumped over you?
2252,2313,0,1,8,9,1.1111111111111112,0.11785113019775792,508,"Yep, she owned me money too"
229,2313,0,1,8,9,1.1111111111111112,0.11785113019775792,508,Was this the guy?
2254,2313,0,1,8,9,1.1111111111111112,0.11785113019775792,508,"I told you, I never loaned that guy a dime."
6634,2313,0,1,8,9,1.1111111111111112,0.11785113019775792,508,"So it's a smooth explanation: what do you want me to do, learn to stutter?"
6172,2313,0,1,8,9,1.1111111111111112,0.11785113019775792,508,I've never seen that fish in my life.
2257,2313,0,1,8,9,1.1111111111111112,0.11785113019775792,508,Never seen that tuna.
5627,2313,0,1,8,9,1.1111111111111112,0.11785113019775792,508,Ahhh.....could I have some water.
235,2313,0,1,8,9,1.1111111111111112,0.11785113019775792,508,Jonah? Never laid eyes on him.
2195,2313,0,1,8,9,1.1111111111111112,0.11785113019775792,508,THAT'S A LOUSY LAST MEAL MENU.
1187,2313,0,1,8,9,1.1111111111111112,0.11785113019775792,508,"His name was Bruce, and he was known as the jerk of Amity."
950,2313,0,1,8,9,1.1111111111111112,0.11785113019775792,508,"Listen, you can show me pictures of the same crime scene all day, but for the last time--I'm a fish and there's no way I held up a 7-11 in Hackensack. Now, either charge me with something, or let me go back to the ocean. I'm going to die soon."
227,2313,0,1,8,9,1.1111111111111112,0.11785113019775792,508,"I'm a loan shark, a lot of people owe me money. It doesn't mean I ate him."
274,2313,0,1,8,9,1.1111111111111112,0.11785113019775792,508,I don't have to answer any questions until my lobster lawyer gets here!
1201,2313,0,1,8,9,1.1111111111111112,0.11785113019775792,508,I already told you. I had some friends for dinner the night of the 13th.
2164,2313,0,1,8,9,1.1111111111111112,0.11785113019775792,508,"Yeah I took a bite of him, so what? Where I come from that ain't against the law pal!"
6659,2313,0,1,8,9,1.1111111111111112,0.11785113019775792,508,"Yeah, that's the guy, but I dont' know anything about the missing leg."
6180,2313,0,1,8,9,1.1111111111111112,0.11785113019775792,508,I loaned twenty grand to an escaped convict?
2312,2313,0,1,8,9,1.1111111111111112,0.11785113019775792,508,"I said, he said, 'Bite me.'"
5670,2313,0,1,8,9,1.1111111111111112,0.11785113019775792,508,"I told you, skinny dippers are not my thing."
2143,2313,0,1,8,9,1.1111111111111112,0.11785113019775792,508,"Yeah, made with the tuna family, but I got nothing to do with them."
6152,2313,0,1,8,9,1.1111111111111112,0.11785113019775792,508,I told you--I've never been to Phoenix.
187,2313,0,1,8,9,1.1111111111111112,0.11785113019775792,508,Oh sure....eat one swimmer and now I'M the bad guy!?
967,2313,0,1,8,9,1.1111111111111112,0.11785113019775792,508,"Don't show me the picture, show my client."
2311,2313,0,1,8,9,1.1111111111111112,0.11785113019775792,508,I don't know. One mackerel looks like another to me.
182,2313,0,1,8,9,1.1111111111111112,0.11785113019775792,508,You're just fishin'.
2293,2313,0,1,8,9,1.1111111111111112,0.11785113019775792,508,You wouldn't be keeping me here if i were a Great White.
5611,2313,0,1,8,9,1.1111111111111112,0.11785113019775792,508,"Officer, clearly that is not my writing."
181,2313,0,1,8,9,1.1111111111111112,0.11785113019775792,508,He sleeps with the fishes.
2147,2313,0,1,8,9,1.1111111111111112,0.11785113019775792,508,Never trust anyone.
180,2313,0,1,8,9,1.1111111111111112,0.11785113019775792,508,There's a big differerance between a card shark and a shark who plays cards.
5608,2313,0,1,8,9,1.1111111111111112,0.11785113019775792,508,Even I wouldn't charge vigorish like that!
2144,2313,0,1,8,9,1.1111111111111112,0.11785113019775792,508,"That's a dolphin, smart guy."
2306,2313,0,1,8,9,1.1111111111111112,0.11785113019775792,508,"You got to believe me, I did'nt do it. I'm a vegetarian now."
2146,2313,0,1,8,9,1.1111111111111112,0.11785113019775792,508,What do you think I am? A perfect engine? An eating machine?
5675,2313,0,1,8,9,1.1111111111111112,0.11785113019775792,508,"He's not in my food chain, I never laid an eye on the guy!"
176,2313,0,1,8,9,1.1111111111111112,0.11785113019775792,508,That's not my bite mark.
2155,2313,0,1,8,9,1.1111111111111112,0.11785113019775792,508,I Have Never Seen That Boat In My Life !
2314,2313,0,1,8,9,1.1111111111111112,0.11785113019775792,508,"Don't show me their heads, show me their feets."
2320,2313,0,1,8,9,1.1111111111111112,0.11785113019775792,508,"Yes, that is the man who cut off my pectoral fins."
5613,2313,0,1,8,9,1.1111111111111112,0.11785113019775792,508,"How many times do I have to tell you that I'm a vegetarian, huh?"
171,2313,0,1,8,9,1.1111111111111112,0.11785113019775792,508,"Yes, I do remember him, but I only scared him to death."
6656,2313,0,1,8,9,1.1111111111111112,0.11785113019775792,508,"Well, I can't deny that we look very similar. My lawyer's on his way."
2135,2313,0,1,8,9,1.1111111111111112,0.11785113019775792,508,We weren't chums and that ain't my bucket.
2163,2313,0,1,8,9,1.1111111111111112,0.11785113019775792,508,Back off or I will shark up.
6610,2313,0,1,8,9,1.1111111111111112,0.11785113019775792,508,"Smell fishy? For the last time, I can only smell real, actual fish"
1169,2313,0,1,8,9,1.1111111111111112,0.11785113019775792,508,"I want to see my lawyer, he is a real shark."
2299,2313,0,1,8,9,1.1111111111111112,0.11785113019775792,508,You can't bait me.
2162,2313,0,1,8,9,1.1111111111111112,0.11785113019775792,508,Your left or my left?
276,2313,0,1,8,9,1.1111111111111112,0.11785113019775792,508,"Yeah, yeah, that's Bobby Darin."
6177,2313,0,1,8,9,1.1111111111111112,0.11785113019775792,508,"Dude, it all looks like sushi to me."
2137,2313,0,1,8,9,1.1111111111111112,0.11785113019775792,508,You are profiling us based on our bite marks!
4572,3389,0,1,9,10,1.1,0.10540925533894598,508,"Not all killer sharks are killers,you know."
2131,3389,0,1,9,10,1.1,0.10540925533894598,508,I am tired of being your shredder.
5444,3389,0,1,9,10,1.1,0.10540925533894598,508,"I barely know her, we just had a bite together."
2516,3389,0,1,9,10,1.1,0.10540925533894598,508,"Based on the blood spatter, I'd say you're looking for a hammerhead."
6024,3389,0,1,9,10,1.1,0.10540925533894598,508,Hello! 29% interest is a good deal.
2213,3389,0,1,9,10,1.1,0.10540925533894598,508,Why don't you ask the swordfish?
3589,3389,0,1,9,10,1.1,0.10540925533894598,508,"Never ate him in my life, I swear."
5234,3389,0,1,9,10,1.1,0.10540925533894598,508,I'll tell you one last time: I've neither seen nor heard of Miss Lotte Lenya or old Lucy Brown.
2124,3389,0,1,9,10,1.1,0.10540925533894598,508,"cell phones are not allowed within the 3 mile limit,Mr. Great White!!!!!"
5440,3389,0,1,9,10,1.1,0.10540925533894598,508,I ate my alibi. So what?
5433,3389,0,1,9,10,1.1,0.10540925533894598,508,"Yeah, that's him; that's Mack the Knife."
4068,3389,0,1,9,10,1.1,0.10540925533894598,508,"I'd like a tall lawyer please, with anchovies on the side"
4035,3389,0,1,9,10,1.1,0.10540925533894598,508,"I already told you, I was playing cards."
6606,3389,0,1,9,10,1.1,0.10540925533894598,508,Check my dental records and you'll see that I'm innocent.
3189,3389,0,1,9,10,1.1,0.10540925533894598,508,How many times do I have to tell you the water was murky that day?
2845,3389,0,1,9,10,1.1,0.10540925533894598,508,"You got nothing on him, you're just fishing again"
4644,3389,0,1,9,10,1.1,0.10540925533894598,508,"David, What the hell is water?"
3616,3389,0,1,9,10,1.1,0.10540925533894598,508,' . . . you have a right to an attorney...' Do I really look like I need an 'attorney'.
4356,3389,0,1,9,10,1.1,0.10540925533894598,508,' I didn't do it. The white guy did it'.
6296,3389,0,1,9,10,1.1,0.10540925533894598,508,Do I look like a loan shark?
4548,3389,0,1,9,10,1.1,0.10540925533894598,508,"Sammy the Seal? Yeah, I knew him. He sleeps with the fishes now."
3613,3389,0,1,9,10,1.1,0.10540925533894598,508,I can't read it. Move closer.
3085,3389,0,1,9,10,1.1,0.10540925533894598,508,It's not a loan. It's a debenture.
2638,3389,0,1,9,10,1.1,0.10540925533894598,508,"No, I won't talk! I won't even emit low-frequency squawks!"
1675,3389,0,1,9,10,1.1,0.10540925533894598,508,"I've never bitten ..I mean seen,that person in my life!"
2667,3389,0,1,9,10,1.1,0.10540925533894598,508,could you be more pacific.
4756,3389,0,1,9,10,1.1,0.10540925533894598,508,Are you sure you don't recognize this swimmer.
1032,3389,0,1,9,10,1.1,0.10540925533894598,508,I already told ya I don't know no dolphins.
75,3389,0,1,9,10,1.1,0.10540925533894598,508,You got it all wrong. I'm a lone shark.
3097,3389,0,1,9,10,1.1,0.10540925533894598,508,"Word on the street says it was a jet, all the way."
5908,3389,0,1,9,10,1.1,0.10540925533894598,508,Never seen this I.O.U. before.
6019,3389,0,1,9,10,1.1,0.10540925533894598,508,"Talk first, then you can have your glass of water."
3736,3389,0,1,9,10,1.1,0.10540925533894598,508,"Sorry, all seals look alike to me."
3967,3389,0,1,9,10,1.1,0.10540925533894598,508,"Look, I already told you, I am not that type of card shark."
3639,3389,0,1,9,10,1.1,0.10540925533894598,508,"Yea that's him, he stole my chum!"
5925,3389,0,1,9,10,1.1,0.10540925533894598,508,"Yeah, that's the chef; did you happen to find my 2 fins in his soup?'"
4125,3389,0,1,9,10,1.1,0.10540925533894598,508,Need an interpreter?
3560,3389,0,1,9,10,1.1,0.10540925533894598,508,You were IDed wearing the same sharkskin suit you have on today!
6151,3389,0,1,9,10,1.1,0.10540925533894598,508,"No, that doesn't look like my bite radius."
2582,3389,0,1,9,10,1.1,0.10540925533894598,508,"Yeah, we chummed around together."
3562,3389,0,1,9,10,1.1,0.10540925533894598,508,"You say surfer, but to me that's clearly a seal."
3751,3389,0,1,9,10,1.1,0.10540925533894598,508,"Fish out of water, my ass. I know my rights. Lawyer."
6164,3389,0,1,9,10,1.1,0.10540925533894598,508,Do you expect me to believe that a person on a surfboard looks like a seal to you?
4849,3389,0,1,9,10,1.1,0.10540925533894598,508,He tasted good!
2038,3389,0,1,9,10,1.1,0.10540925533894598,508,You know I can only give you a 'fish eyewitness' account.
937,3389,0,1,9,10,1.1,0.10540925533894598,508,"Yeah, that could be me, so what, I dare you to put me in a line-up with other sharks."
6512,3389,0,1,9,10,1.1,0.10540925533894598,508,This week...on Jaw and Order
4664,3389,0,1,9,10,1.1,0.10540925533894598,508,What? A menu listing? My price is higher than you can afford.
3654,3389,0,1,9,10,1.1,0.10540925533894598,508,"My tale may appear fishy, but I am no loan shark!"
4006,3389,0,1,9,10,1.1,0.10540925533894598,508,"Even if I ate that guy from what I hear he was hunting for shark fins, so he had it coming. You humans kill us fish by the millions but one of you gets hurt. Next time you see a bunch of Tuna line fishing on Broadway let me know. Now call my lawyer."
3720,3389,0,1,9,10,1.1,0.10540925533894598,508,"Tell me Columbo, whaddya think Greenpeace is gonna say 'bout this?"
5139,3389,0,1,9,10,1.1,0.10540925533894598,508,"400 million years to create the perfect killing machine, and you think I'd leave my tooth at the scene of the crime?"
4409,3389,0,1,9,10,1.1,0.10540925533894598,508,That’s a Photoshopped fin if I ever saw one. My lawyer will eat you for breakfast.
561,3389,0,1,9,10,1.1,0.10540925533894598,508,"He may look scary, but he is largely misunderstood."
4426,3389,0,1,9,10,1.1,0.10540925533894598,508,"So according to you, this man was trapped in a cage? And you tried to get him out?"
1755,3389,0,1,9,10,1.1,0.10540925533894598,508,Not ringing a bell . Do you have a picture of the feet ?
3717,3389,0,1,9,10,1.1,0.10540925533894598,508,"Enough with the questions, officer. I feel like a fish out of water."
1326,3389,0,1,9,10,1.1,0.10540925533894598,508,"I'm a lawyer, I know my rights."
2283,3389,0,1,9,10,1.1,0.10540925533894598,508,"Yeah I lent him some money, but those aren't my teeth marks."
5156,3389,0,1,9,10,1.1,0.10540925533894598,508,"Sorry, I don't read Hammerhead cursive."
3931,3389,0,1,9,10,1.1,0.10540925533894598,508,I didn't eat him on porpoise.
183,3389,0,1,9,10,1.1,0.10540925533894598,508,"I told you already, I've never seen that swimmer before"
4225,3389,0,1,9,10,1.1,0.10540925533894598,508,One stupid shark movie and you think we're all guilty!
3938,3389,0,1,9,10,1.1,0.10540925533894598,508,It sure looks kosher to me dough?!
895,3389,0,1,9,10,1.1,0.10540925533894598,508,"Yep, I was in the 'seal pool'. They invited me over for dinner."
2379,3389,0,1,9,10,1.1,0.10540925533894598,508,Charging 17% interest on a personal loan. We've got a name for people like you.
6501,3389,0,1,9,10,1.1,0.10540925533894598,508,No! I never lent that guy any money.
2300,3389,0,1,9,10,1.1,0.10540925533894598,508,"I'm telling you, officer. I haven't seen Katy Perry since the Superbowl."
6322,3389,0,1,9,10,1.1,0.10540925533894598,508,"Without my dental records, you got nothing on me."
1331,3389,0,1,9,10,1.1,0.10540925533894598,508,Oh Yeah? Well my alibi has teeth!
3819,3389,0,1,9,10,1.1,0.10540925533894598,508,So maybe I loaned him the money. What about it?
6272,3389,0,1,9,10,1.1,0.10540925533894598,508,"My rights ?, I can't read"
6336,3389,0,1,9,10,1.1,0.10540925533894598,508,The tornado already signed this confession. We know you were working together.
2289,3389,0,1,9,10,1.1,0.10540925533894598,508,Fine. But I still say the Barracuda sideswiped the Stingray.
4804,3389,0,1,9,10,1.1,0.10540925533894598,508,"Yeah, ok, maybe. But maybe he shouldn't have been wearing my friend's teeth around his neck either."
5756,3389,0,1,9,10,1.1,0.10540925533894598,508,I don't know. You all look like fish to me.
5123,3389,0,1,9,10,1.1,0.10540925533894598,508,"His name's Finn, I'd put a tail on him."
1941,3389,0,1,9,10,1.1,0.10540925533894598,508,You're going to need a bigger note.
505,3389,0,1,9,10,1.1,0.10540925533894598,508,Do I look like a rat to you?
557,3389,0,1,9,10,1.1,0.10540925533894598,508,In scuba gear you all look the exact same.
5732,3389,0,1,9,10,1.1,0.10540925533894598,508,"Yeah, last I heard he was swimmin' with the fishes."
4416,3389,0,1,9,10,1.1,0.10540925533894598,508,Have I see him? No. Eat him? Very possibly.
2001,3389,0,1,9,10,1.1,0.10540925533894598,508,"Yeah, that my dentist, but what's that got to do with me?"
3035,3389,0,1,9,10,1.1,0.10540925533894598,508,That's him. They call him Mr. Wonderful
4732,3389,0,1,9,10,1.1,0.10540925533894598,508,'Like you've never looked at the swimsuit issue?' (note: 'you've' is italicized.)
3294,3389,0,1,9,10,1.1,0.10540925533894598,508,Look's like Tony the Tuna in hot water.
5178,3389,0,1,9,10,1.1,0.10540925533894598,508,You call those bite marks probable cause?
5734,3389,0,1,9,10,1.1,0.10540925533894598,508,Did you try to collect on this promissory note/
4168,3389,0,1,9,10,1.1,0.10540925533894598,508,So what? It's a loan. Doesn't prove anything.
1684,3389,0,1,9,10,1.1,0.10540925533894598,508,I ain't set foot in Boca...that's Uncle Charlie's territory.
2795,3479,0,1,10,11,1.0909090909090908,0.09534625892455922,508,What about my marine-da rights?
6020,3479,0,1,10,11,1.0909090909090908,0.09534625892455922,508,I don't mean to sound racist but frankly all humans look alike.
2948,3479,0,1,10,11,1.0909090909090908,0.09534625892455922,508,"I've never seen that guy before...besides, how could I possibly have the time to swim all the way to the Great Barrier Reef and be home in time for dinner?"
2497,3479,0,1,10,11,1.0909090909090908,0.09534625892455922,508,"Sure, I knew him...but he isn't sleeping with this fish."
4546,3479,0,1,10,11,1.0909090909090908,0.09534625892455922,508,'Hold that still! Is 'Deluxe' 'Fries or Slaw' or 'Fries AND Slaw''?
6165,3479,0,1,10,11,1.0909090909090908,0.09534625892455922,508,"Yeah...that's him, the little clown. He controls everything along the coast; he calls himself Nemo."
1411,3479,0,1,10,11,1.0909090909090908,0.09534625892455922,508,'No I have not seen a clown fish that looks like that'.
6247,3479,0,1,10,11,1.0909090909090908,0.09534625892455922,508,He in the can— aisle 4.
2157,3479,0,1,10,11,1.0909090909090908,0.09534625892455922,508,It is always hard questioning lawyers
529,3479,0,1,10,11,1.0909090909090908,0.09534625892455922,508,"'Yes, I was there and yes, I may have been humming the 'Jaws' music but after that, you got nothin' on me'."
2820,3479,0,1,10,11,1.0909090909090908,0.09534625892455922,508,That's a dolphin fin. I told you I was nowhere near the beach.
400,3479,0,1,10,11,1.0909090909090908,0.09534625892455922,508,Well.....I didn't see his face before I ate him!
4926,3479,0,1,10,11,1.0909090909090908,0.09534625892455922,508,"I don't care what Spielberg says, I didn't do it......"
1248,3479,0,1,10,11,1.0909090909090908,0.09534625892455922,508,"Never seen him. Like I said, I swim alone."
2585,3479,0,1,10,11,1.0909090909090908,0.09534625892455922,508,That's the guy! I'd recognise those board shorts anywhere.
3974,3479,0,1,10,11,1.0909090909090908,0.09534625892455922,508,I hear she was struck by lightning.
4026,3479,0,1,10,11,1.0909090909090908,0.09534625892455922,508,Did you underwrite this loan?
5508,3479,0,1,10,11,1.0909090909090908,0.09534625892455922,508,"In this instance, 'he sleeps with the fishes' is a factual statement rather than a turn of a phrase."
4531,3479,0,1,10,11,1.0909090909090908,0.09534625892455922,508,"Nah, never seen him before - - - oh, it's a mirror? Why did'n ya say so."
4912,3479,0,1,10,11,1.0909090909090908,0.09534625892455922,508,His boogie board was smaller with an orange stripe on it.
933,3499,0,1,11,12,1.0833333333333333,0.08703882797784893,508,"Yeah, so I have a taste for sushi, so what?"
2291,3499,0,1,11,12,1.0833333333333333,0.08703882797784893,508,I KEEP telling you!!That's a Shark!I'm a JET!!!
632,3499,0,1,11,12,1.0833333333333333,0.08703882797784893,508,I'm not talkin' 'til I speak to my Director
5138,3502,0,1,12,13,1.0769230769230769,0.08006407690254357,508,Big deal. So last month I lent him some money. And last week he turns up in pieces on some beach. What does any of that prove?
3799,3502,0,1,12,13,1.0769230769230769,0.08006407690254357,508,"Whaddya mean, 'loan shark.' I'm just a lone shark, me and my buddies."
4533,3502,0,1,12,13,1.0769230769230769,0.08006407690254357,508,You spelled my name backwards. It's KaRiSH in Hebrew.
3188,3502,0,1,12,13,1.0769230769230769,0.08006407690254357,508,"Sorry, but I'll only talk to Megyn Kelly."
3347,3502,0,1,12,13,1.0769230769230769,0.08006407690254357,508,I was at home. Asleep.
6029,3502,0,1,12,13,1.0769230769230769,0.08006407690254357,508,WAIT TILL THAT LOUD MOUTH TRIES TO WALK ON WATER!
3413,3508,0,1,14,15,1.0666666666666667,0.06900655593423542,508,Yeah I ate him too
6375,3509,0,0,7,7,1.0,0.1543033499620919,508,"I don't know what happened, officer. One week out of the year, I just go nuts."
6339,3509,0,0,7,7,1.0,0.1543033499620919,508,"Yeah, that's Macheath...I recognize the fancy gloves. Has our boy done something rash?"
4829,3509,0,0,7,7,1.0,0.1543033499620919,508,I'm the shark that bites. You're looking for Mack the Knife.
6338,3509,0,0,7,7,1.0,0.1543033499620919,508,Mack the Knife? Please! Move on.
6369,3509,0,0,7,7,1.0,0.1543033499620919,508,How should I know? Those klutzy hammerheads all look alike to me.
6304,3509,0,0,7,7,1.0,0.1543033499620919,508,"Yeah, but he was tasty"
6297,3509,0,0,7,7,1.0,0.1543033499620919,508,I esCHEW my Miranda rights!
4815,3509,0,0,7,7,1.0,0.1543033499620919,508,"No, I'm right shark. Left shark is the one you want."
4816,3509,0,0,7,7,1.0,0.1543033499620919,508,"Yeah, I made him a couple of loans, copper. Big Deal."
4810,3509,0,0,7,7,1.0,0.1543033499620919,508,"No, I havent given any loan."
6301,3509,0,0,7,7,1.0,0.1543033499620919,508,"I remember he said, 'I'm not afraid of Glug Glug Glug', and I said, 'Who's Glug Glug Glug?'"
6277,3509,0,0,7,7,1.0,0.1543033499620919,508,"If you think I'm going to show remorse, you're anthropomorphizing."
6332,3509,0,0,7,7,1.0,0.1543033499620919,508,No way - if had done that one you woulda seen scarlet billows start to spread.
6302,3509,0,0,7,7,1.0,0.1543033499620919,508,"Well, Mr. Fortinbras, word on the street is that you've sharked up a list of lawless resolutes. Is this it?"
4805,3509,0,0,9,9,1.0,0.11785113019775792,508,"I confess the waves were steep, the water a frigid minus below, and the kids were gnashing their teeth."
6242,3509,0,0,7,7,1.0,0.1543033499620919,508,"Grill shark 30 minutes until meat is firm, turning once."
6241,3509,0,0,8,8,1.0,0.1336306209562122,508,Uh Officer that looks like you because the person in the picture is bold in the middle!
6325,3509,0,0,7,7,1.0,0.1543033499620919,508,Nope. Never smelled him in my life.
6281,3509,0,0,8,8,1.0,0.1336306209562122,508,You expect me to sign a confession I can't even read? Seems fish-y to me!
4831,3509,0,0,7,7,1.0,0.1543033499620919,508,"Movies aren't real life, detective."
6328,3509,0,0,7,7,1.0,0.1543033499620919,508,It said B777. I don't know if it's from Malaysia.
6331,3509,0,0,7,7,1.0,0.1543033499620919,508,"Uh, oh. I better call Saul"
6279,3509,0,0,7,7,1.0,0.1543033499620919,508,The vig was an arm and a leg
6243,3509,0,0,7,7,1.0,0.1543033499620919,508,Are you telling me this is NOT you with Teresa Halbach?
6295,3509,0,0,7,7,1.0,0.1543033499620919,508,I need a blood sample.
6368,3509,0,0,7,7,1.0,0.1543033499620919,508,"I'm not sure. The pearly whites look familiar, but the scarlet billows obscure the details."
4840,3509,0,0,7,7,1.0,0.1543033499620919,508,"Yeah, OK, so the victim had bite marks. So what? What's that have to do with me?"
4792,3509,0,0,7,7,1.0,0.1543033499620919,508,I ain't answering no more questions till I get a big glass of water.
6349,3509,0,0,7,7,1.0,0.1543033499620919,508,"Hey, do I look like a victim to you?"
6351,3509,0,0,11,11,1.0,0.09534625892455922,508,'I already told you guys I broke up with that manatee broad months ago'.
4850,3509,0,0,7,7,1.0,0.1543033499620919,508,"This is because I'm not a great white, isn't it?"
6315,3509,0,0,7,7,1.0,0.1543033499620919,508,How many times I gotta tell you?' I know nuthin about this bum Macki and his scarlet billows'.
4800,3509,0,0,7,7,1.0,0.1543033499620919,508,Her name was Ariel.
6266,3509,0,0,7,7,1.0,0.1543033499620919,508,You'll get five years on probation and monthly check-ins with your dentist.
6352,3509,0,0,7,7,1.0,0.1543033499620919,508,That's NOT the boy I ate!
6290,3509,0,0,8,8,1.0,0.1336306209562122,508,"Look, just because one or two of us attack you every year doesn't mean we're all bad."
6265,3509,0,0,8,8,1.0,0.1336306209562122,508,"Well, we really jumped the shark with this one."
4797,3509,0,0,7,7,1.0,0.1543033499620919,508,Yes! That was him. Called himself Trump and I knew it was fishy
4843,3509,0,0,7,7,1.0,0.1543033499620919,508,They weighed into my eating contest moment by moment...I gotta say I responded in a very befitting manner.
4802,3509,0,0,7,7,1.0,0.1543033499620919,508,I know nothing of Miranda's Rights or his Leftovers
6292,3509,0,0,8,8,1.0,0.1336306209562122,508,"Yea, yea, that's the guy...Tommy 'the Whale' Marconi."
6264,3509,0,0,7,7,1.0,0.1543033499620919,508,How do I know if I ate him.....You all look alike
4847,3509,0,0,7,7,1.0,0.1543033499620919,508,Do you recognize this surfboard?
6361,3509,0,0,7,7,1.0,0.1543033499620919,508,But he was just a snack.
4824,3509,0,0,9,9,1.0,0.11785113019775792,508,Benchley? Spielberg? Never heard of them...
6358,3509,0,0,7,7,1.0,0.1543033499620919,508,It was all Fonzie's idea.
6313,3509,0,0,7,7,1.0,0.1543033499620919,508,Seriously? You think I was the trigger man?
4794,3509,0,0,7,7,1.0,0.1543033499620919,508,"No, I said Roy Shark…but if you squint that does kinda look like him."
6312,3509,0,0,7,7,1.0,0.1543033499620919,508,My dorsal fin still hurts from the ride here.
6258,3509,0,0,7,7,1.0,0.1543033499620919,508,So what? I ate him. Is that a crime?
6311,3509,0,0,6,6,1.0,0.18257418583505536,508,You pulled me away from a delicious lunch with a blonde in a red two-piece for this? How many times have I told you that I never loan anything to a Swordfish? It's a sure way to get stabbed in the back.
4846,3509,0,0,7,7,1.0,0.1543033499620919,508,I told you. I don't look before I eat.
6291,3509,0,0,8,8,1.0,0.1336306209562122,508,This is proof that you ate the panel on 'Shark Tank'.
4795,3509,0,0,7,7,1.0,0.1543033499620919,508,So I slipped again. Let's just say I wear a pacemaker and thought it was my last supper.
4844,3509,0,0,7,7,1.0,0.1543033499620919,508,I told ya man....I never saw that pool hall
4828,3509,0,0,8,8,1.0,0.1336306209562122,508,He called me mum a bitch. Wanted me to smile about it ...I'd say he had it coming.
4839,3509,0,0,7,7,1.0,0.1543033499620919,508,"I told you, I was asleep at the time."
4851,3509,0,0,7,7,1.0,0.1543033499620919,508,That client got what he deserved.
6367,3509,0,0,7,7,1.0,0.1543033499620919,508,"No, that could not be a photo of one of my teeth at the crime scene. I still have all my teeth. If you don't believe me, feel free to count the teeth in my mouth. Go ahead. I'll let you look reeeeeealy close."
6285,3509,0,0,9,9,1.0,0.11785113019775792,508,"Either pay your bii, or we will send you to the SHARK TANK!"
4786,3509,0,0,7,7,1.0,0.1543033499620919,508,I'm FINished with this... Who you callin' 'CHUM?
4803,3509,0,0,6,6,1.0,0.18257418583505536,508,Don't pretend you can't read. !
4859,3509,0,0,7,7,1.0,0.1543033499620919,508,Even loan sharks have Miranda rights.
6275,3509,0,0,7,7,1.0,0.1543033499620919,508,"Yeah, yeah...it's a usurious loan....so what makes you think I had anything to do with it."
6273,3509,0,0,7,7,1.0,0.1543033499620919,508,"Yeah, he jumped me."
4857,3509,0,0,8,8,1.0,0.1336306209562122,508,"Okay so the cement shoes look familiar, but I don't swim with those fish."
6323,3509,0,0,7,7,1.0,0.1543033499620919,508,If you really want to know want to know what happened to Charlie the Tuna... ask the dolphins.
4836,3509,0,0,7,7,1.0,0.1543033499620919,508,"Officer, that's a mammal, and I'm a vegetarian."
6245,3509,0,0,7,7,1.0,0.1543033499620919,508,I'm not saying anything until my client gets here!
4787,3509,0,0,7,7,1.0,0.1543033499620919,508,"Stop playing dumb, Doris, or you'll wind up in hot water."
4812,3509,0,0,7,7,1.0,0.1543033499620919,508,"Yeah, I know the guy. He borrowed ten grand."
4790,3509,0,0,7,7,1.0,0.1543033499620919,508,I already know the rules.
6249,3509,0,0,7,7,1.0,0.1543033499620919,508,Can you undo the cuff. My glasses are in my pocket.
4854,3509,0,0,7,7,1.0,0.1543033499620919,508,"Trump may have asked me for some advice on his campaign, when I was beached in Atlantic City, but I didn't do anything illegal!"
4853,3509,0,0,7,7,1.0,0.1543033499620919,508,Never lent him a dime!
6294,3509,0,0,8,8,1.0,0.1336306209562122,508,"Yeah, that's Augie. He sleeps with the fishes."
4788,3509,0,0,7,7,1.0,0.1543033499620919,508,"I know we made a deal, but I thought you wanted him dead or alive."
6342,3509,0,0,7,7,1.0,0.1543033499620919,508,I'm tellinyu - I don't know nothin' about no Nemo! No clownfish has ever passed over these pearly whites.
6365,3509,0,0,7,7,1.0,0.1543033499620919,508,I'll tell you what: either they are on the endangered species list or I am.
4813,3509,0,0,7,7,1.0,0.1543033499620919,508,"Okay I did it, but I was just trying to get a leg up on Ralph."
6253,3509,0,0,7,7,1.0,0.1543033499620919,508,I dunno. All them Great Whites look alike.
6305,3509,0,0,8,8,1.0,0.1336306209562122,508,"Do you know this character, he's been seen in your neighborhood?"
6254,3509,0,0,8,8,1.0,0.1336306209562122,508,"You'll never break me, copper, I'm a hundred percent cartilage."
6270,3509,0,0,8,8,1.0,0.1336306209562122,508,Yes that is a selfie I took during lunch.
6288,3509,0,0,7,7,1.0,0.1543033499620919,508,He doesn't smell familiar.
6364,3509,0,0,7,7,1.0,0.1543033499620919,508,I never even nibbled on him.
6250,3509,0,0,7,7,1.0,0.1543033499620919,508,I don't care if it is Shark week. You are not leaving here until you confess!
6308,3509,0,0,7,7,1.0,0.1543033499620919,508,"'Maybe he is sleeping with the fishes now, but I'm telling you I've never seen the guy."
5432,3509,0,0,7,7,1.0,0.1543033499620919,508,Look closer. Doesn't it look fishy?
4777,3509,0,0,7,7,1.0,0.1543033499620919,508,"I see. I see, Cee Cee ... See if you can see me back to to sea, see?"
6654,3509,0,0,8,8,1.0,0.1336306209562122,508,I told you last year. The last time I saw the whole NCIS cast they were flying over my back!
4611,3509,0,0,7,7,1.0,0.1543033499620919,508,What's this! Every time one of these start-ups go belly up I get called in?
6653,3509,0,0,7,7,1.0,0.1543033499620919,508,"I'm telling ya, I didn't chomp down on anything!"
6648,3509,0,0,7,7,1.0,0.1543033499620919,508,I wanna see a Netflix rep.
4615,3509,0,0,7,7,1.0,0.1543033499620919,508,"Ya, Louie Miller, so what?"
6643,3509,0,0,8,8,1.0,0.1336306209562122,508,You can't pin this one on me. I was in the tank that night.
6655,3509,0,0,8,8,1.0,0.1336306209562122,508,"That's him, the one with the harpoon."
6642,3509,0,0,7,7,1.0,0.1543033499620919,508,"I'll take the 5th on the fur seal, but I've been trying to get that Trump guy all my life!"
6637,3509,0,0,7,7,1.0,0.1543033499620919,508,There's always been something fishy about you.
6636,3509,0,0,7,7,1.0,0.1543033499620919,508,I ain't talkin till I've seen my shark.
6635,3509,0,0,7,7,1.0,0.1543033499620919,508,That couldn't be me. I don't even like sushi.
4617,3509,0,0,7,7,1.0,0.1543033499620919,508,No.... It was a YELLOW submarine that stole my lunch
4618,3509,0,0,7,7,1.0,0.1543033499620919,508,"It's not Rorshark, you idiot."
4620,3509,0,0,7,7,1.0,0.1543033499620919,508,Where were you the last night of shark week?
6639,3509,0,0,7,7,1.0,0.1543033499620919,508,Forget it—I ain’t no great white nark.
6631,3509,0,0,7,7,1.0,0.1543033499620919,508,I didn't write that ransom note--that's not my handwriting.
4609,3509,0,0,7,7,1.0,0.1543033499620919,508,You're looking for Mac the Knife.
6661,3509,0,0,7,7,1.0,0.1543033499620919,508,"A traffic ticket ! I was fishtailing , not speeding.''"
6685,3509,0,0,8,8,1.0,0.1336306209562122,508,"That, my dorsal finned friend, was the Presidential Seal!!!"
6682,3509,0,0,8,8,1.0,0.1336306209562122,508,I refuse to answer any questions without my lawyer and my lamprey present.
4594,3509,0,0,7,7,1.0,0.1543033499620919,508,It shouldn't matter WHAT toothpaste I use; I don't know any Dentist Five.
6680,3509,0,0,8,8,1.0,0.1336306209562122,508,"You're not in Hollywood anymore, punk."
4595,3509,0,0,7,7,1.0,0.1543033499620919,508,"Yes, I can, and if you look closely, Sherlock, it says 'L-o-n-e' Shark, not 'L-o-a-n' Shark."
4596,3509,0,0,7,7,1.0,0.1543033499620919,508,"I demand my right to an attorney for consultation, representation, ingestion, and digestion."
6660,3509,0,0,7,7,1.0,0.1543033499620919,508,"Yeah, that's my chum. What of it?"
6676,3509,0,0,7,7,1.0,0.1543033499620919,508,You were ice fishing without a permit.
4601,3509,0,0,8,8,1.0,0.1336306209562122,508,Alright already! They put me on Shark Tank. What was I supposed to do?
4602,3509,0,0,7,7,1.0,0.1543033499620919,508,"I already told you, it wasn't me who peed in the pool............"
6666,3509,0,0,7,7,1.0,0.1543033499620919,508,I've never seen that human's appendage.
6665,3509,0,0,7,7,1.0,0.1543033499620919,508,I was on vacation at Seal Island!
4606,3509,0,0,8,8,1.0,0.1336306209562122,508,"Yes, I identify that man as Damien Hirst."
6664,3509,0,0,7,7,1.0,0.1543033499620919,508,I never saw that fish in my life.
4598,3509,0,0,7,7,1.0,0.1543033499620919,508,"Yhat's correct officer. This new, environmentally friendly program endorsed by the U S Fish and Wildlife Service is called 'Catch and Release'."
6630,3509,0,0,7,7,1.0,0.1543033499620919,508,Yeah and I bet you're both vegans right ?
4621,3509,0,0,7,7,1.0,0.1543033499620919,508,Never ate 'em
4622,3509,0,0,7,7,1.0,0.1543033499620919,508,"Wad data think, I'm a dolphin?"
4639,3509,0,0,10,10,1.0,0.10540925533894598,508,E fp toz?
4640,3509,0,0,7,7,1.0,0.1543033499620919,508,Recognize this arm???
4641,3509,0,0,7,7,1.0,0.1543033499620919,508,Could I get a glass of water?
4642,3509,0,0,9,9,1.0,0.11785113019775792,508,"You might want to pick another disguise, Mr. Madoff."
4643,3509,0,0,7,7,1.0,0.1543033499620919,508,Blackfish lives matter.
6605,3509,0,0,7,7,1.0,0.1543033499620919,508,What S.U.I.? That's my normal mercury level!
4637,3509,0,0,8,8,1.0,0.1336306209562122,508,So what? I got a good deal on cartilage implants from Dr. Zizmor.
4646,3509,0,0,7,7,1.0,0.1543033499620919,508,"Well, it sure looks like a boating accident to me."
4648,3509,0,0,7,7,1.0,0.1543033499620919,508,You think I'm a barracuda?
6603,3509,0,0,8,8,1.0,0.1336306209562122,508,"Listen you Coppers. I ain't heard of no Louie Miller, and I ain't done nothing rash."
6600,3509,0,0,7,7,1.0,0.1543033499620919,508,I was just a loan shark
6596,3509,0,0,7,7,1.0,0.1543033499620919,508,Yeah; that's Jacues.
6595,3509,0,0,7,7,1.0,0.1543033499620919,508,"You can set me up with a Mako artist, but they all look alike to me."
4654,3509,0,0,7,7,1.0,0.1543033499620919,508,That's not me! Anyone can see that's a mako!
4647,3509,0,0,7,7,1.0,0.1543033499620919,508,"Chinese is fine by me. I'll have the General Tso’s Chicken, with a side of fried rice, and no chop sticks."
6607,3509,0,0,7,7,1.0,0.1543033499620919,508,"What are you, some kind of animal rights activist?"
6608,3509,0,0,8,8,1.0,0.1336306209562122,508,I ain't sayin' nonthin' till I get me a perp.
6609,3509,0,0,9,9,1.0,0.11785113019775792,508,How many time do I have to tell you that I am not the loan shark you are looking for!
4623,3509,0,0,7,7,1.0,0.1543033499620919,508,Oh no--Macheath is back in town!
6629,3509,0,0,7,7,1.0,0.1543033499620919,508,"Like I told ya, it's a legitimate prescription from my doctor."
4624,3509,0,0,7,7,1.0,0.1543033499620919,508,Not her. She's just jail bait.
6628,3509,0,0,7,7,1.0,0.1543033499620919,508,"Yeah, that's the killer, he was a trained grey nurse."
6627,3509,0,0,7,7,1.0,0.1543033499620919,508,The only tuna I eat is Dolphin safe
6626,3509,0,0,7,7,1.0,0.1543033499620919,508,"I want a lawyer, preferably a shark."
6624,3509,0,0,7,7,1.0,0.1543033499620919,508,I told you I've never been to Amity Island !
6621,3509,0,0,7,7,1.0,0.1543033499620919,508,I don't have an overbite!
6617,3509,0,0,7,7,1.0,0.1543033499620919,508,I lost my taste for arms and legs long ago!
6614,3509,0,0,7,7,1.0,0.1543033499620919,508,"I wore braces back then, so it couldn't have been me."
4628,3509,0,0,7,7,1.0,0.1543033499620919,508,There is no 'good cop' or 'bad cop'-- only 'cop tartare'.
4630,3509,0,0,7,7,1.0,0.1543033499620919,508,"...yeah,yeah,it's starting to come back to me. Now, how 'bout that glass of salt water?"
4631,3509,0,0,7,7,1.0,0.1543033499620919,508,"If that's your alibi, it's pretty fishy. It won't hold water."
4632,3509,0,0,7,7,1.0,0.1543033499620919,508,"I already told yooz guys, Mac ain't sleeping with any of us fishes!'"
4633,3509,0,0,7,7,1.0,0.1543033499620919,508,Are you trying to take the Minke?
4592,3509,0,0,7,7,1.0,0.1543033499620919,508,He was my chum. Why would I eat him?
6594,3509,0,0,7,7,1.0,0.1543033499620919,508,That ain't my fin!
4591,3509,0,0,7,7,1.0,0.1543033499620919,508,"747, no doubt."
4590,3509,0,0,7,7,1.0,0.1543033499620919,508,How come every guy you show me is wearing a sharkskin suit?
6742,3509,0,0,7,7,1.0,0.1543033499620919,508,Do you recognize this mackerel?
6740,3509,0,0,7,7,1.0,0.1543033499620919,508,"I'm tellin' ya, I wasn't even around that day. I was up at Martha's Vineyard."
6738,3509,0,0,7,7,1.0,0.1543033499620919,508,That welsher? Never so much as lent 'im a fin.
4554,3509,0,0,7,7,1.0,0.1543033499620919,508,"I didn't eat her either. I'm telling you, you've got the wrong Land Shark!"
6737,3509,0,0,7,7,1.0,0.1543033499620919,508,You’re not an entrepreneur; you’re a want-repreneur.
6735,3509,0,0,7,7,1.0,0.1543033499620919,508,Did you or did you not write these words to this criminal song Mack the Knife?
4550,3509,0,0,8,8,1.0,0.1336306209562122,508,did you cause the shark-nato ??
4557,3509,0,0,8,8,1.0,0.1336306209562122,508,"OH yea,tasted like chicken"
4560,3509,0,0,7,7,1.0,0.1543033499620919,508,"OK, I confess. I ate him but he was a loan shark!"
4562,3509,0,0,7,7,1.0,0.1543033499620919,508,I'm concerned with our cultures fast food upgrade vulnerabilities.
6730,3509,0,0,7,7,1.0,0.1543033499620919,508,But these are all mug shots.
4563,3509,0,0,7,7,1.0,0.1543033499620919,508,I'm not the one you want because I would never eat anyone that skinny.
6729,3509,0,0,7,7,1.0,0.1543033499620919,508,"I’m getting a little light-headed, when do we get to the water-boarding?"
6728,3509,0,0,7,7,1.0,0.1543033499620919,508,"Good luck finding that clown. Yeah, I worked with him before. Until he blew up on me. Is this a joke, I thought that clown was found back in '03."
6734,3509,0,0,7,7,1.0,0.1543033499620919,508,"No, I have never seen the missing tuna."
6727,3509,0,0,7,7,1.0,0.1543033499620919,508,Do you confess to know these words from the song Mack the Knight?
6743,3509,0,0,6,6,1.0,0.18257418583505536,508,I won't rat on no shark's kin. Take yours to a laudromat!
6745,3509,0,0,7,7,1.0,0.1543033499620919,508,Shark fin? Looks like chicken noodle to me.
6770,3509,0,0,7,7,1.0,0.1543033499620919,508,I didn't notice who killed the coral reefs. I was too busy eating a swimmer.
6766,3509,0,0,7,7,1.0,0.1543033499620919,508,"I told you, I'm just a loan shark!"
6765,3509,0,0,7,7,1.0,0.1543033499620919,508,I recognize the flippers. But I could say that about so many meals.
6764,3509,0,0,7,7,1.0,0.1543033499620919,508,"I told you already, the tornado threw me into him."
6763,3509,0,0,7,7,1.0,0.1543033499620919,508,Are you denying that you were born in Canada?
4544,3509,0,0,7,7,1.0,0.1543033499620919,508,Those aren't my teeth. I want my lawyer!
6744,3509,0,0,7,7,1.0,0.1543033499620919,508,"How many times do I have to say it, I'm vegan now."
6761,3509,0,0,7,7,1.0,0.1543033499620919,508,Wouldn't this fall under species profiling?
6758,3509,0,0,7,7,1.0,0.1543033499620919,508,"My entry, Sir/Madam, 'Yeah, that's him, we were in Torts together.'"
6755,3509,0,0,7,7,1.0,0.1543033499620919,508,I've never seen that pilot fish in my life.
6753,3509,0,0,7,7,1.0,0.1543033499620919,508,I said I don't know him. I don't hang with bottom-feeders!
6750,3509,0,0,7,7,1.0,0.1543033499620919,508,I’ve heard that it’s much more likely to be a killed by a dog or a snake—or even by a bee sting.
6749,3509,0,0,7,7,1.0,0.1543033499620919,508,I didn't do it. I haven't had money to loan since the Democrats took over.
6746,3509,0,0,8,8,1.0,0.1336306209562122,508,"When the judge sees this, you're finnished."
6759,3509,0,0,7,7,1.0,0.1543033499620919,508,Less facial hair.
6726,3509,0,0,7,7,1.0,0.1543033499620919,508,I already told ya--they all look like seals to me.
6723,3509,0,0,7,7,1.0,0.1543033499620919,508,The polling numbers came back on your new attack ads
6722,3509,0,0,7,7,1.0,0.1543033499620919,508,What did I do? Killed them all of course. I'm a goddam shark Poindexter.
6704,3509,0,0,7,7,1.0,0.1543033499620919,508,'I told him being he didn't want to grow up to be a loan shark'
4584,3509,0,0,7,7,1.0,0.1543033499620919,508,"I tell ya, he answered to old chum !"
4585,3509,0,0,7,7,1.0,0.1543033499620919,508,I have been a vegetarian for 14 months-if you pump my stomach all you'll get is kelp.
6703,3509,0,0,7,7,1.0,0.1543033499620919,508,"Spielberg, Schmeilberg! I don't remember!"
6702,3509,0,0,7,7,1.0,0.1543033499620919,508,"ya, that's the one. he was swimming with the sharks."
6701,3509,0,0,7,7,1.0,0.1543033499620919,508,You can threaten disbarment all you want. I still don't know him.
6705,3509,0,0,7,7,1.0,0.1543033499620919,508,This is the last time you intimidate the jury pool.
4586,3509,0,0,7,7,1.0,0.1543033499620919,508,Yes I recognize her. She had great legs.
6694,3509,0,0,7,7,1.0,0.1543033499620919,508,Yeah.. that's Al Dente. Last time I saw him he was swimmen with the fishes
6693,3509,0,0,7,7,1.0,0.1543033499620919,508,That was my twin brother.
6692,3509,0,0,7,7,1.0,0.1543033499620919,508,"Can I have some water? I mean, a lot of water."
4588,3509,0,0,9,9,1.0,0.11785113019775792,508,"All fin and well, I'm not in the soup yet. Just table that until I get a lawyer from the pool, somebody who speaks my language."
6691,3509,0,0,7,7,1.0,0.1543033499620919,508,My name is Mr. Wonderful and I'm just a shark trying to make a buck.
6688,3509,0,0,7,7,1.0,0.1543033499620919,508,You're confusing me with Ted Cruz.
6698,3509,0,0,7,7,1.0,0.1543033499620919,508,"Gentlemen, your case has officially jumped the me."
4581,3509,0,0,7,7,1.0,0.1543033499620919,508,It wasn't murder. it was sushicide.
6707,3509,0,0,7,7,1.0,0.1543033499620919,508,"Yeah, I took a bite out of him...eh crime."
4580,3509,0,0,7,7,1.0,0.1543033499620919,508,Does this look like sustainable tuna to you?
6721,3509,0,0,7,7,1.0,0.1543033499620919,508,No I don't 'recognize him'. I'm a shark; I can't see an inch past my snout. You have a blood sample I can sniff?
4566,3509,0,0,7,7,1.0,0.1543033499620919,508,That's not what they taught me at Harvard
6720,3509,0,0,7,7,1.0,0.1543033499620919,508,"You'd better look at that menu again, grilled shark isn't on there."
6719,3509,0,0,7,7,1.0,0.1543033499620919,508,"Can this shark really read, or am I just really over my head with my imagination?"
4569,3509,0,0,8,8,1.0,0.1336306209562122,508,Recognize Gilda Radner now?
6718,3509,0,0,10,10,1.0,0.10540925533894598,508,Profiling.
6716,3509,0,0,7,7,1.0,0.1543033499620919,508,I will never forget that hook
4571,3509,0,0,7,7,1.0,0.1543033499620919,508,I want a second opinion.
6715,3509,0,0,7,7,1.0,0.1543033499620919,508,That is also a jet. What are you getting at?
4575,3509,0,0,8,8,1.0,0.1336306209562122,508,"Does that look like seaweed? How many times do I have to tell you, I'm a vegetarian!"
4576,3509,0,0,7,7,1.0,0.1543033499620919,508,"I told you, 'you are after the wrong sharks!'"
4577,3509,0,0,7,7,1.0,0.1543033499620919,508,"Hard to tell its a red herring all right, but but it might not be THE red herring"
4578,3509,0,0,7,7,1.0,0.1543033499620919,508,I'm not the loan guy!
6711,3509,0,0,7,7,1.0,0.1543033499620919,508,"Ok, ok, ok – Maybe I know someone who knows someone who MAYBE got a piece of Mr. Wonderful and Mr. Cuban, but nobody in MY tank would touch the FUBU guy, y'know, Mr. John. I mean c'mon - y'think we don't know Black Lives Matter?"
6710,3509,0,0,7,7,1.0,0.1543033499620919,508,Yeah.....I seen him. He sleeps with the fishes.
6687,3509,0,0,7,7,1.0,0.1543033499620919,508,"I ain't never seen that leg before. You got nothin', chum."
4778,3509,0,0,7,7,1.0,0.1543033499620919,508,Why 'ya showin' me small fry?
6590,3509,0,0,7,7,1.0,0.1543033499620919,508,"Looks like the boxer's work, if you ask me"
6586,3509,0,0,7,7,1.0,0.1543033499620919,508,"I told you, I've never even seen that haddock!"
4743,3509,0,0,7,7,1.0,0.1543033499620919,508,"Nah, not our guy. He's a Jet."
6456,3509,0,0,7,7,1.0,0.1543033499620919,508,Yo! Vinnie the Gil - rumor has it this here floater owed you some major clam!
6448,3509,0,0,7,7,1.0,0.1543033499620919,508,"Yo, Dude. I'm a lover, not a fighter !"
6447,3509,0,0,7,7,1.0,0.1543033499620919,508,"Ok, he owed me loan money, but I didn't eat him."
6442,3509,0,0,7,7,1.0,0.1543033499620919,508,"Okay, I ate my lawyer, but ain't I got my rights?"
6436,3509,0,0,7,7,1.0,0.1543033499620919,508,I want to speak with my remora
6458,3509,0,0,7,7,1.0,0.1543033499620919,508,"'Yea, I know him. His nickname is 'Landshark'."
6434,3509,0,0,7,7,1.0,0.1543033499620919,508,"Look, I didn't Eat Miss Tidwell . . . I'm a Mer-shark!"
6432,3509,0,0,7,7,1.0,0.1543033499620919,508,That one tasted like chicken.
4750,3509,0,0,7,7,1.0,0.1543033499620919,508,"I'm telling you guys, I was at a feeding frenzy that night."
6429,3509,0,0,7,7,1.0,0.1543033499620919,508,"Doofus, I got no hands to sign it."
4751,3509,0,0,7,7,1.0,0.1543033499620919,508,"You've got the wrong guy, I'm Great Whitey Bulger"
6428,3509,0,0,7,7,1.0,0.1543033499620919,508,That's not me. I don't have a moustache or propeller beanie.
4752,3509,0,0,7,7,1.0,0.1543033499620919,508,"Yeah, that may be my rap sheet, but that's not the guy who's look in' at you now."
6433,3509,0,0,7,7,1.0,0.1543033499620919,508,So they're pearly white. That doesn't prove a thing.
6424,3509,0,0,7,7,1.0,0.1543033499620919,508,For a smart fish like you this letter stinks!
6461,3509,0,0,7,7,1.0,0.1543033499620919,508,Do I LOOK like The Chicken of the Sea?
4741,3509,0,0,7,7,1.0,0.1543033499620919,508,"What? I said he was sleeping with the fishes, didn't I?"
6480,3509,0,0,7,7,1.0,0.1543033499620919,508,"No, I'm good shark. You're looking for bad shark."
4726,3509,0,0,8,8,1.0,0.1336306209562122,508,"Ok, Brendan, we want you to tell the truth now..."
6478,3509,0,0,8,8,1.0,0.1336306209562122,508,That looks nothing like me. My eyes are dead; those are hazel.
6477,3509,0,0,7,7,1.0,0.1543033499620919,508,What makes you think I had anything to do with the missing mermaid?
6476,3509,0,0,7,7,1.0,0.1543033499620919,508,"How many times I gotta tell yez, flatfoot; I was down in da Gulf that month!"
6474,3509,0,0,7,7,1.0,0.1543033499620919,508,"We know this fish was a regular at your restaurant. I just learned that you can feed a fish to death, but you already knew that didn't you?"
6462,3509,0,0,7,7,1.0,0.1543033499620919,508,You've got the wrong fish! I look nothing like the guy who has stuck fish-with-legs stickers on cars.
4731,3509,0,0,7,7,1.0,0.1543033499620919,508,it's nothing I could sink my teeth into.
6468,3509,0,0,7,7,1.0,0.1543033499620919,508,I didnt see anyone at lunch that day. My eyes roll back when I'm eating.
4737,3509,0,0,7,7,1.0,0.1543033499620919,508,"Sure, I seen 'em...he sleeps with the fishes."
6467,3509,0,0,7,7,1.0,0.1543033499620919,508,Do you recognize this mammal?
6466,3509,0,0,9,9,1.0,0.11785113019775792,508,I never saw that fish before.
6465,3509,0,0,7,7,1.0,0.1543033499620919,508,"I'm many things, but I'm not a loan shark."
6463,3509,0,0,7,7,1.0,0.1543033499620919,508,You got the wrong big fish
6472,3509,0,0,7,7,1.0,0.1543033499620919,508,"Officer, I think this falls squarely under the castle doctrine."
6420,3509,0,0,8,8,1.0,0.1336306209562122,508,"Yeah, That's Mackie Messer for sure but he's calling himself Mac the Knife now!"
4753,3509,0,0,7,7,1.0,0.1543033499620919,508,what do you know about this missing lawyer?
6419,3509,0,0,7,7,1.0,0.1543033499620919,508,"Whatever, there have been amazing advances in prosthetics."
6396,3509,0,0,7,7,1.0,0.1543033499620919,508,"I would demand to call my lawyer, but I just ate him for breakfast."
6394,3509,0,0,7,7,1.0,0.1543033499620919,508,"Yeah...yeah, I've seen him sleeping with the fishes."
4770,3509,0,0,8,8,1.0,0.1336306209562122,508,Ok. So I eat my losses!
4771,3509,0,0,7,7,1.0,0.1543033499620919,508,"Yeah, well this remorseless eating machine doesn't like anything on your cafeteria menu."
6387,3509,0,0,8,8,1.0,0.1336306209562122,508,I can't read your writing.
6386,3509,0,0,7,7,1.0,0.1543033499620919,508,I think I would remember eating a guy that ugly.
4768,3509,0,0,7,7,1.0,0.1543033499620919,508,Impossible! I'm vegan.
6384,3509,0,0,6,6,1.0,0.18257418583505536,508,Fine--I admit it! You caught me! I'm a lone shark!
4775,3509,0,0,7,7,1.0,0.1543033499620919,508,I keep telling you I'm the lawyer!
6380,3509,0,0,7,7,1.0,0.1543033499620919,508,"DO YOU KNOW WHAT THIS SAYS?' 'Ah yes, Trump wins by a landslide!"
6379,3509,0,0,7,7,1.0,0.1543033499620919,508,"Yeah, that's Jaws, but who's the tasty dish?"
6378,3509,0,0,9,9,1.0,0.11785113019775792,508,"It's irrelevant whether you were undercover or underwater, you were caught on photo-radar."
6377,3509,0,0,10,10,1.0,0.10540925533894598,508,It's not my fault! He knew his boat was too small.
4776,3509,0,0,7,7,1.0,0.1543033499620919,508,"I keep telling you, the guy who jumped me had a leather jacket and a quiff."
6383,3509,0,0,7,7,1.0,0.1543033499620919,508,"Without a body, that could be anybody's foot!"
6397,3509,0,0,8,8,1.0,0.1336306209562122,508,It'd probably be easier to ID the guy if we used taste tests instead.
6400,3509,0,0,7,7,1.0,0.1543033499620919,508,No! Don't waterboard me!
6401,3509,0,0,7,7,1.0,0.1543033499620919,508,I didn't commit the crime outlined in your document!
4754,3509,0,0,7,7,1.0,0.1543033499620919,508,I'd like to speak with a lawyer!!!!
4755,3509,0,0,8,8,1.0,0.1336306209562122,508,"Hey, why pick on me? My loans HELP people!"
6418,3509,0,0,7,7,1.0,0.1543033499620919,508,"Yeah, they call him Mac the Knife."
6417,3509,0,0,7,7,1.0,0.1543033499620919,508,"He was my Chum, but that is not my handwriting!"
4757,3509,0,0,7,7,1.0,0.1543033499620919,508,"No, I've never seen him before, and I'm serious: I Can't Breathe!"
6414,3509,0,0,7,7,1.0,0.1543033499620919,508,I've never seen that flounder before.
4758,3509,0,0,7,7,1.0,0.1543033499620919,508,"Charlie Tuna? Nah, never heard of him."
4759,3509,0,0,7,7,1.0,0.1543033499620919,508,"I'm telling you, I don't know how that leg got in my stomach."
4760,3509,0,0,7,7,1.0,0.1543033499620919,508,"He swims, I snap. Hey, it's what I do, copper!"
6412,3509,0,0,8,8,1.0,0.1336306209562122,508,That's the work of the Old School Gang. They never liked farm raised.
6410,3509,0,0,7,7,1.0,0.1543033499620919,508,I exercise my right to a fellow lawyer before answering any questions.
6407,3509,0,0,7,7,1.0,0.1543033499620919,508,Alibi sounds a bit fishy - whad'ya think Joe?
6405,3509,0,0,7,7,1.0,0.1543033499620919,508,"Okay, okay. I'll have the sole."
6402,3509,0,0,7,7,1.0,0.1543033499620919,508,"I already told 'ya, I ain't been near freshwater in years."
4766,3509,0,0,7,7,1.0,0.1543033499620919,508,Jonah? Jonah who? Nope. Sorry... (burp) Never seen the guy.
6482,3509,0,0,7,7,1.0,0.1543033499620919,508,You crazy bro! I'm a breast man.
4657,3509,0,0,7,7,1.0,0.1543033499620919,508,I am not the one responsible for Sharknado
6485,3509,0,0,7,7,1.0,0.1543033499620919,508,Do you know if they do gluten free?
4720,3509,0,0,7,7,1.0,0.1543033499620919,508,They all taste the same to me.
6544,3509,0,0,7,7,1.0,0.1543033499620919,508,"I'm telling you just one more time: I never met that guy, I found the ATM card in the pocket of a speedo"
6543,3509,0,0,7,7,1.0,0.1543033499620919,508,"I dunno, he tasted like chicken."
4674,3509,0,0,7,7,1.0,0.1543033499620919,508,I'm only talking to Detective Sgt. Fish.
6542,3509,0,0,7,7,1.0,0.1543033499620919,508,"Yeah, that's Luca Brasi, so what of it?"
6541,3509,0,0,7,7,1.0,0.1543033499620919,508,But I've never even been to Manitowoc County!
6540,3509,0,0,7,7,1.0,0.1543033499620919,508,"'Ace Ventura', never heard of him."
6547,3509,0,0,8,8,1.0,0.1336306209562122,508,"No, that's not me, but I was his stunt double in Jaws."
4676,3509,0,0,9,9,1.0,0.11785113019775792,508,I did not swallow the guy to let him speak with you!
4678,3509,0,0,7,7,1.0,0.1543033499620919,508,"For the last time, I haven't been to Martha's Vineyard, and I don't know Steven Spielberg."
6539,3509,0,0,7,7,1.0,0.1543033499620919,508,"He offered me fifty thousand for half of my business, so I ate him."
4679,3509,0,0,7,7,1.0,0.1543033499620919,508,"'is this steven spielberg, or nt?????"
6536,3509,0,0,7,7,1.0,0.1543033499620919,508,Can I get a glass of salt water?
6531,3509,0,0,7,7,1.0,0.1543033499620919,508,"But officer, I'm a pescatarian."
4681,3509,0,0,7,7,1.0,0.1543033499620919,508,Not until you apologize!
4677,3509,0,0,7,7,1.0,0.1543033499620919,508,"Of course you owe me. Remember, I'm a lone shark."
6529,3509,0,0,7,7,1.0,0.1543033499620919,508,"You've got it all wrong, I'm a philanthropic porpoise not a loan shark."
6549,3509,0,0,7,7,1.0,0.1543033499620919,508,"Slow, boring, tasteless"
4671,3509,0,0,7,7,1.0,0.1543033499620919,508,He's swimming with us.
6585,3509,0,0,7,7,1.0,0.1543033499620919,508,How was I supposed to know he was a cop? They all look the same from below.
6582,3509,0,0,8,8,1.0,0.1336306209562122,508,"Oh, the poor creature--what a terrible overbite."
6579,3509,0,0,7,7,1.0,0.1543033499620919,508,Saturday? I was in all night watching tv in bed...with your sister.
4662,3509,0,0,7,7,1.0,0.1543033499620919,508,What can I tell you? The system is still trying to keep me down!
6571,3509,0,0,8,8,1.0,0.1336306209562122,508,"You think I'll take the bait, don't you chum?"
6570,3509,0,0,9,9,1.0,0.11785113019775792,508,"We know its you, we saw you on shark week."
4672,3509,0,0,7,7,1.0,0.1543033499620919,508,"I'll sign anything. Just no more water boarding, okay?"
6565,3509,0,0,7,7,1.0,0.1543033499620919,508,"No, I make shark loans – very different from loan sharking."
4666,3509,0,0,7,7,1.0,0.1543033499620919,508,I agree. Idris Elba deserved an Oscar nod. What?
6562,3509,0,0,7,7,1.0,0.1543033499620919,508,I've never seen that carcharodon carcharias before in my life.
6560,3509,0,0,7,7,1.0,0.1543033499620919,508,I told you. I'm not black.
6556,3509,0,0,7,7,1.0,0.1543033499620919,508,Give me a break-he looked like a SEAL to me!
6554,3509,0,0,7,7,1.0,0.1543033499620919,508,That's Mack the Knife all right.
6552,3509,0,0,7,7,1.0,0.1543033499620919,508,So it's a photo of me attacking the sushi buffet. It proves nothing!
6564,3509,0,0,8,8,1.0,0.1336306209562122,508,"We can't 'stop and frisk' anymore, but we can still 'stop and fin.'"
6526,3509,0,0,7,7,1.0,0.1543033499620919,508,Look closely ... it can't be me ... the fin is missing!
4685,3509,0,0,7,7,1.0,0.1543033499620919,508,I have a brother who will represent me.
6524,3509,0,0,7,7,1.0,0.1543033499620919,508,Your accusations jump the shark.
4706,3509,0,0,7,7,1.0,0.1543033499620919,508,"I told you, I don't swim in those waters. And what's with the Food Warmer lamp?"
6498,3509,0,0,7,7,1.0,0.1543033499620919,508,Since when is 100% interest on a loan a crime?
6496,3509,0,0,7,7,1.0,0.1543033499620919,508,I'd recognize that plankton anywhere.
6495,3509,0,0,8,8,1.0,0.1336306209562122,508,"You'll never fool me, detective---I'm a card shark."
4709,3509,0,0,8,8,1.0,0.1336306209562122,508,No problem on rights at a fresh meal with dessert.
4711,3509,0,0,8,8,1.0,0.1336306209562122,508,Vegan sharks eat only seaweed and seagrass.
6500,3509,0,0,7,7,1.0,0.1543033499620919,508,that is no way to treat a fellow mammal
6493,3509,0,0,8,8,1.0,0.1336306209562122,508,I knew I shouldn't have given that Discovery Channel camera crew unrestricted access into my personal life.
6490,3509,0,0,7,7,1.0,0.1543033499620919,508,"No, that is not my piece of paper."
4713,3509,0,0,7,7,1.0,0.1543033499620919,508,To catch a predator
4714,3509,0,0,6,6,1.0,0.18257418583505536,508,"I'll ask you one last time. Were you, or were you not, the one on the left?"
4715,3509,0,0,8,8,1.0,0.1336306209562122,508,I'd spit on your evidence if I had a tongue.
6489,3509,0,0,7,7,1.0,0.1543033499620919,508,"Now, detective, may I remind you of your 'Catch and Release' obligations?"
6488,3509,0,0,7,7,1.0,0.1543033499620919,508,For a bad cop your handwriting is esquisite.
6491,3509,0,0,9,9,1.0,0.11785113019775792,508,"Well, for one thing shark's are color blind. But what was that school of tuna doing in the crosswalk anyway?"
4703,3509,0,0,7,7,1.0,0.1543033499620919,508,"'O.K., so bring me a nice fat attorney; I'm hungry."
4701,3509,0,0,8,8,1.0,0.1336306209562122,508,"OK, his teeth are shiny white. But I'm tellin' ya - I've never seen or heard of this Mack the Knife guy."
6503,3509,0,0,8,8,1.0,0.1336306209562122,508,"So maybe I've given out a few loans at interest rates that were a little too high, and maybe I have tricked a few card players, but I could never do something like THAT!"
6523,3509,0,0,7,7,1.0,0.1543033499620919,508,look at my nudes bitch
6522,3509,0,0,7,7,1.0,0.1543033499620919,508,I'm innocent I tell ya. I'm a vegetarian.
6521,3509,0,0,7,7,1.0,0.1543033499620919,508,"Trust me, this grilling can get a lot worse if you don't cooperate."
6517,3509,0,0,8,8,1.0,0.1336306209562122,508,"Sorry, I'm a vegan."
6516,3509,0,0,7,7,1.0,0.1543033499620919,508,"For the last time, I never loaned that guy nothin!"
4692,3509,0,0,7,7,1.0,0.1543033499620919,508,I'm a humanist. I confess.
6510,3509,0,0,7,7,1.0,0.1543033499620919,508,Look again! Are you trying to tell me there's two of you?
4693,3509,0,0,8,8,1.0,0.1336306209562122,508,I want to call my lawyer. He's my brother.
4694,3509,0,0,7,7,1.0,0.1543033499620919,508,"I keep telling ya, I don't know nothing about a bad loan from Mr. Remora."
4695,3509,0,0,7,7,1.0,0.1543033499620919,508,No that is NOT me with a detective in my teeth!!
4697,3509,0,0,8,8,1.0,0.1336306209562122,508,"I'm telling you guyses, I ain't takin the bait......See!"
4698,3509,0,0,7,7,1.0,0.1543033499620919,508,"Yeah, that's the guy Detective, with his leather jacket and slicked back hair. Some big TV star, I hear. But, I tell you, I had to do it. Nobody does that to a shark!"
4861,3509,0,0,7,7,1.0,0.1543033499620919,508,That's not left shark.
4700,3509,0,0,7,7,1.0,0.1543033499620919,508,"Suke Tawdry? Jennie Diver? Sweet Lucy Brown? I don't know, ask Mack!"
6504,3509,0,0,7,7,1.0,0.1543033499620919,508,"Look, your alibi about being an extra on the set of 'Sharknado' just doesn't hold water."
4723,3509,0,0,7,7,1.0,0.1543033499620919,508,Hey! Installing a one-way mirror on a glass bottom boat is a violation of my civil rights.
6506,3509,0,0,7,7,1.0,0.1543033499620919,508,'All sharks look alike to humans' does not give you an alibi for the vicious attack last week.
4979,3509,0,0,8,8,1.0,0.1336306209562122,508,Say what you want – all I see is a duck.
6239,3509,0,0,7,7,1.0,0.1543033499620919,508,Another 'Great White Hope.'
5216,3509,0,0,7,7,1.0,0.1543033499620919,508,AHHHH!!! Get me in the water! I'm dying!! I need water to survive!!!
5217,3509,0,0,7,7,1.0,0.1543033499620919,508,Mick Fanning? Sorry Never heard of him!
5700,3509,0,0,7,7,1.0,0.1543033499620919,508,Is this another Discovery Channel set-up?
5699,3509,0,0,7,7,1.0,0.1543033499620919,508,It was an honest mistake I tell ya. He was doing a really good dolphin kick.
5698,3509,0,0,8,8,1.0,0.1336306209562122,508,"I see a resemblance, but that ain’t me."
5696,3509,0,0,7,7,1.0,0.1543033499620919,508,It was a hate crime; those bums said they were gonna jump the shark.
5223,3509,0,0,7,7,1.0,0.1543033499620919,508,"I told you guys twice already, you got the wrong dorsal."
5702,3509,0,0,7,7,1.0,0.1543033499620919,508,"I don't recognize her,do you have a shot of just her legs?"
5695,3509,0,0,7,7,1.0,0.1543033499620919,508,You were seen in the Guantanamo Bay last Friday. Do you have an alibi?
5225,3509,0,0,7,7,1.0,0.1543033499620919,508,"Yes, those do look like my bite marks, but you have to believe me, I'm a pescetarian."
5691,3509,0,0,7,7,1.0,0.1543033499620919,508,I would like to see this picture under water
5227,3509,0,0,9,9,1.0,0.11785113019775792,508,"He wasn't even that good, too salty."
5228,3509,0,0,7,7,1.0,0.1543033499620919,508,Sorry. It's just so dark & murky down there it hard to tell who's who and what's what. Have you got a Tums?
5683,3509,0,0,7,7,1.0,0.1543033499620919,508,"Hey, what happens in SeaWorld stays in SeaWorld."
5230,3509,0,0,8,8,1.0,0.1336306209562122,508,"Yeah, that's my client. Where do you have him?"
5681,3509,0,0,7,7,1.0,0.1543033499620919,508,"I promise you, he was already a one-armed man."
5692,3509,0,0,7,7,1.0,0.1543033499620919,508,"No, no, no. You've got it all wrong. It's Mark Cuban."
5232,3509,0,0,7,7,1.0,0.1543033499620919,508,"I know my rights, but I can't call anybody under water!"
5214,3509,0,0,7,7,1.0,0.1543033499620919,508,"I am NOT a great white collar criminal, officer."
5705,3509,0,0,7,7,1.0,0.1543033499620919,508,"August 9,4:30? I was at Fire Island happy hour."
5201,3509,0,0,7,7,1.0,0.1543033499620919,508,I ain't sayin' nuttin' til I know you guys ain't Latin Rite Catholics'
5202,3509,0,0,7,7,1.0,0.1543033499620919,508,Your finprints are all over this letter.
5720,3509,0,0,9,9,1.0,0.11785113019775792,508,Were these the terms of your loan?
5204,3509,0,0,7,7,1.0,0.1543033499620919,508,"So, what do you'se guys want with me, anyway ? You want a confession? Hey! I'm nothing but a two-bit 'Loan-Shark', on the Lower South Side, see? Yea-a-a-a-a-h ! ? !"
5719,3509,0,0,8,8,1.0,0.1336306209562122,508,Calling yourself a 'Great White' in public can give others the wrong idea.
5206,3509,0,0,8,8,1.0,0.1336306209562122,508,"Mick Fanning is mistaken, I was nowhere near South Africa at that time."
5717,3509,0,0,7,7,1.0,0.1543033499620919,508,Of course my story is fishy!
5703,3509,0,0,7,7,1.0,0.1543033499620919,508,"No, it's the RIGHT leg that's wooden!"
5209,3509,0,0,7,7,1.0,0.1543033499620919,508,Macheath? Never heard of him.
5715,3509,0,0,8,8,1.0,0.1336306209562122,508,RAWR RAH RAWH RAWHR RAW.
5714,3509,0,0,8,8,1.0,0.1336306209562122,508,"That's him, Steven Spielberg. He directed the movie that killed my mother."
5713,3509,0,0,7,7,1.0,0.1543033499620919,508,No wonder I don't feel well.
5712,3509,0,0,9,9,1.0,0.11785113019775792,508,Wallstreet? Never heard of the place?
5710,3509,0,0,7,7,1.0,0.1543033499620919,508,There's no way you're gonna pin that on me.
5709,3509,0,0,8,8,1.0,0.1336306209562122,508,I told you already I ain't know no Jaws.
5213,3509,0,0,7,7,1.0,0.1543033499620919,508,"Whaddaya mean, a Moving Violation?"
5210,3509,0,0,7,7,1.0,0.1543033499620919,508,I am telling you that is not me....are you sure that is not Johnny Manziel in disguise?
5680,3509,0,0,8,8,1.0,0.1336306209562122,508,He's shark turds. And I don't mean that's his name. Catch my drift?
5233,3509,0,0,7,7,1.0,0.1543033499620919,508,"But, look, that guy's got a gold tooth. It ain't me!"
5236,3509,0,0,7,7,1.0,0.1543033499620919,508,"Yeah, I loaned him money, so what?"
5258,3509,0,0,7,7,1.0,0.1543033499620919,508,NO! I did NOT know that email was Top Secret when I sent it from my front yard!!!
5664,3509,0,0,6,6,1.0,0.18257418583505536,508,Yeah I'm on Plenty of Fish but I don't recognize all of them.
5663,3509,0,0,8,8,1.0,0.1336306209562122,508,"Hey, sharks are not known for their eyesight."
5662,3509,0,0,7,7,1.0,0.1543033499620919,508,"That's him, but he was wearing concrete shoes when I saw him."
5661,3509,0,0,8,8,1.0,0.1336306209562122,508,That isn't me! I was circling the Walmart parking lot that night!
5261,3509,0,0,7,7,1.0,0.1543033499620919,508,"Yeah, I recognize him. And where I come from we don't refer to them as `loan sharks!'"
5262,3509,0,0,7,7,1.0,0.1543033499620919,508,I keep telling ya I never heard of no Mack the Knife!
5666,3509,0,0,7,7,1.0,0.1543033499620919,508,I can honestly say he has never been a member of my POD.
5659,3509,0,0,7,7,1.0,0.1543033499620919,508,"No, I don't know a guy named Quint."
5265,3509,0,0,9,9,1.0,0.11785113019775792,508,"If it read 'natural born killer', I could make America great again."
5266,3509,0,0,7,7,1.0,0.1543033499620919,508,Stop stalling and tell us the last time you saw Nemo!
5658,3509,0,0,8,8,1.0,0.1336306209562122,508,Last I saw of him he was sleeping with fishes.
5657,3509,0,0,8,8,1.0,0.1336306209562122,508,That is not my school! I told you ... I've always been a loner!
5268,3509,0,0,7,7,1.0,0.1543033499620919,508,I'm exercising my right to run silent.
5656,3509,0,0,8,8,1.0,0.1336306209562122,508,You call that bait?
5655,3509,0,0,7,7,1.0,0.1543033499620919,508,"That don't prove notin. I told yaz before, I can't tolerate blood unless it's gluten-free."
5264,3509,0,0,7,7,1.0,0.1543033499620919,508,Witnesses place you at the medieval castle at the time of the incident
5257,3509,0,0,7,7,1.0,0.1543033499620919,508,"Guys, I'm just his attorney."
5256,3509,0,0,7,7,1.0,0.1543033499620919,508,"We are just checking your dental records, sir!"
5255,3509,0,0,7,7,1.0,0.1543033499620919,508,"Look, I told ya...I don't know this 'Mack the Knife' guy."
5237,3509,0,0,7,7,1.0,0.1543033499620919,508,I can't tell who jumped me without my glasses.
5238,3509,0,0,7,7,1.0,0.1543033499620919,508,"Call me racist, detective, but all these lousy sardines look the same."
5239,3509,0,0,7,7,1.0,0.1543033499620919,508,'That dirty little stool-penguin'.
5678,3509,0,0,7,7,1.0,0.1543033499620919,508,He punched me first...
5240,3509,0,0,7,7,1.0,0.1543033499620919,508,I knew one day she would end up on a body bag. Poor Ariel.
5241,3509,0,0,7,7,1.0,0.1543033499620919,508,He says the porpoises and dolphins all look the same!
5242,3509,0,0,7,7,1.0,0.1543033499620919,508,"Yeah, that's Spielberg. Looks like I wasn't the only one who thought they got shafted on a residual deal."
5677,3509,0,0,7,7,1.0,0.1543033499620919,508,And that loan your mother wanted? Forget about it!
5245,3509,0,0,7,7,1.0,0.1543033499620919,508,I will confess if we can swim out to my domain and spend some quality time together....we can 'snak on the chum'....xoxo
5248,3509,0,0,7,7,1.0,0.1543033499620919,508,Sea this guy before?
5673,3509,0,0,7,7,1.0,0.1543033499620919,508,I'm a down-to-earth loan shark. I don't need a lawyer!
5672,3509,0,0,7,7,1.0,0.1543033499620919,508,He might be in my stomach. I don't know ...
5671,3509,0,0,7,7,1.0,0.1543033499620919,508,These tough ones never talk.
5250,3509,0,0,7,7,1.0,0.1543033499620919,508,I can't tell. The water was too murky.
5669,3509,0,0,7,7,1.0,0.1543033499620919,508,What can I say? He got a little too chummy.
5252,3509,0,0,8,8,1.0,0.1336306209562122,508,"I don' know nothin', but 'e could be somethin' I ate."
5254,3509,0,0,7,7,1.0,0.1543033499620919,508,"Fine, I'll give you a loan for your donut shop -- usual rates. Now get me back to the tank."
5722,3509,0,0,6,6,1.0,0.18257418583505536,508,That one's also sleeping with the fishes.
5725,3509,0,0,7,7,1.0,0.1543033499620919,508,"Yeah, I only voted for white actors, so?"
5728,3509,0,0,7,7,1.0,0.1543033499620919,508,"If you’ve seen one minnow, you’ve seen them all."
5196,3509,0,0,7,7,1.0,0.1543033499620919,508,What do you think I am? A Loan Shark?
5783,3509,0,0,7,7,1.0,0.1543033499620919,508,"Yes, I recognise him. He's a lawyer, just like me."
5780,3509,0,0,7,7,1.0,0.1543033499620919,508,"Yeah, I know him. He's a big fish."
5148,3509,0,0,7,7,1.0,0.1543033499620919,508,"Like I said, I don't know no killer whales"
5778,3509,0,0,7,7,1.0,0.1543033499620919,508,Yeah--I totally got schooled.
5775,3509,0,0,7,7,1.0,0.1543033499620919,508,That's him all right: Arthur Herbert Fonzarelli.
5774,3509,0,0,9,9,1.0,0.11785113019775792,508,"Ok, ok, ok – Maybe I know someone who knows someone who got a little piece of Mr. Wonderful and Mr. Cuban, but nobody in MY circle would touch Mr. John – ya' know, the FUBU guy. Ya' think we don't know Black Lives Matter?"
5773,3509,0,0,8,8,1.0,0.1336306209562122,508,"This paper proves you have been extradited to land. Now, let me read you your rights."
5784,3509,0,0,7,7,1.0,0.1543033499620919,508,"He bit me from behind, I tell you. I never saw his pearly whites."
5771,3509,0,0,7,7,1.0,0.1543033499620919,508,"Guys, ...there is 'a' correct environment and, then, there is 'the' correct environment for memory-retrieval."
5152,3509,0,0,7,7,1.0,0.1543033499620919,508,"Sorry, you all look alike to me."
5769,3509,0,0,8,8,1.0,0.1336306209562122,508,"Save your breath, my cousin's a lawyer."
5768,3509,0,0,7,7,1.0,0.1543033499620919,508,"I know you're trying to scare me, but it looks just delicious."
5767,3509,0,0,8,8,1.0,0.1336306209562122,508,"C'mon, not exactly what I'd call 'Fine Dining"
5154,3509,0,0,7,7,1.0,0.1543033499620919,508,Steven who?
5155,3509,0,0,7,7,1.0,0.1543033499620919,508,Those are not my teeth marks! I have an underbite.
5157,3509,0,0,7,7,1.0,0.1543033499620919,508,"It's your Miranda Rights, Mr Shark."
5151,3509,0,0,6,6,1.0,0.18257418583505536,508,"Yes, the loan rate is of interest, but, no, that's not my signature!"
5785,3509,0,0,8,8,1.0,0.1336306209562122,508,He tasted like chicken too
5789,3509,0,0,7,7,1.0,0.1543033499620919,508,NAH! His feet were bigger.
5792,3509,0,0,7,7,1.0,0.1543033499620919,508,It's not easy looking for a hit and run surfer all you humans look the same
5134,3509,0,0,7,7,1.0,0.1543033499620919,508,Aw damn. That was my lawyer?
5135,3509,0,0,7,7,1.0,0.1543033499620919,508,I suppose this is another loan you don't know nothing about.
5136,3509,0,0,8,8,1.0,0.1336306209562122,508,"Yes, I ate all five of those smug, arrogant bastards in 'The Tank'!"
5811,3509,0,0,7,7,1.0,0.1543033499620919,508,"No, I haven't seen her. You know how many fish there are in the sea?"
5810,3509,0,0,7,7,1.0,0.1543033499620919,508,"Yeah I know him, we want to the same school."
5807,3509,0,0,7,7,1.0,0.1543033499620919,508,That's a valid contract!
5806,3509,0,0,8,8,1.0,0.1336306209562122,508,"Nope...can't say I know da guy, but I heard da rumor he's swimmin' wid da fishes."
5805,3509,0,0,7,7,1.0,0.1543033499620919,508,"It wasn't me, bub. For your information, there are a lot of fish in the sea."
5804,3509,0,0,7,7,1.0,0.1543033499620919,508,"Sorry, pal We've got your teethprint in the leg."
5803,3509,0,0,7,7,1.0,0.1543033499620919,508,It was 'Shark Week'! I'm white and entitled.
5800,3509,0,0,7,7,1.0,0.1543033499620919,508,"If you think I'm a Great White Shark, just wait until my lawyer gets here."
5142,3509,0,0,7,7,1.0,0.1543033499620919,508,"Well he looks like a squirrel, but I guess that's my uncle..."
5799,3509,0,0,7,7,1.0,0.1543033499620919,508,"Loan Shark, Schmo Shark, I want to call my lawyer."
5797,3509,0,0,7,7,1.0,0.1543033499620919,508,"I'm telling you I don't remember it was shark week, me and a couple hammerheads ate a boogeyboarder and things got a little merky after that"
5794,3509,0,0,8,8,1.0,0.1336306209562122,508,I suppose you never ate your chum.
5793,3509,0,0,7,7,1.0,0.1543033499620919,508,"Like I keep telling you, I'm just a regular, law-abiding dolphin."
5145,3509,0,0,6,6,1.0,0.18257418583505536,508,Would you recognize the last cheeseburger you ate?
5158,3509,0,0,8,8,1.0,0.1336306209562122,508,"Yes, I chewed off that leg, but I didn't swallow."
5652,3509,0,0,7,7,1.0,0.1543033499620919,508,"I don't care if you are a lawyer, these are your rights"
5766,3509,0,0,7,7,1.0,0.1543033499620919,508,"That's ridiculous, you've got the wrong guy. I never even saw that schlock Jaws 3-D, let alone starred in it."
5763,3509,0,0,7,7,1.0,0.1543033499620919,508,"You're dead meat buddy, that's your fin floating in the soup."
5179,3509,0,0,7,7,1.0,0.1543033499620919,508,Delicious fresh taste...but I didn't catch the name.
5180,3509,0,0,7,7,1.0,0.1543033499620919,508,"No body, no crime."
5182,3509,0,0,7,7,1.0,0.1543033499620919,508,I didn't steal anyone's invention. What shark tank are you talking about?
5737,3509,0,0,7,7,1.0,0.1543033499620919,508,I'd need to see a leg shot.
5183,3509,0,0,8,8,1.0,0.1336306209562122,508,I told you. I don't even like little boys.
5184,3509,0,0,7,7,1.0,0.1543033499620919,508,"I don't care what Old MacHeath says, I didn't bite any body."
5735,3509,0,0,7,7,1.0,0.1543033499620919,508,I think you're trying to bait me.
5740,3509,0,0,10,10,1.0,0.10540925533894598,508,"What, Stephen Spielberg? Jaws was a long time ago buddy!"
5185,3509,0,0,8,8,1.0,0.1336306209562122,508,They call me 'The Man Eater.' That's a woman. Think about it.
5733,3509,0,0,8,8,1.0,0.1336306209562122,508,"No, I told you before... The guy I ate had Auburn hair and no glasses. I don't know who This guy is..."
5188,3509,0,0,7,7,1.0,0.1543033499620919,508,You've got the wrong guy - I don't even work in loans.
5189,3509,0,0,7,7,1.0,0.1543033499620919,508,Recognize this dolphin?
5190,3509,0,0,7,7,1.0,0.1543033499620919,508,"O.K. it was me that crapped in the Mayor's yard. It was dark, I was in a hurry, I didn't know it was his yard."
5191,3509,0,0,7,7,1.0,0.1543033499620919,508,You don't have to read me my rights. Can't you see straight? I AM an attorney.
5731,3509,0,0,7,7,1.0,0.1543033499620919,508,2017 #oscarssogreatwhite
5194,3509,0,0,7,7,1.0,0.1543033499620919,508,"I told you already, that's not my card..."
5187,3509,0,0,7,7,1.0,0.1543033499620919,508,"I dunno, it coulda been him. All's I remember is that he tasted like chicken."
5741,3509,0,0,7,7,1.0,0.1543033499620919,508,It's like I told you already... Shark Week Sucks.
5742,3509,0,0,7,7,1.0,0.1543033499620919,508,"I told ya ,,, I'm going to fall for that line again."
5174,3509,0,0,7,7,1.0,0.1543033499620919,508,Talk or you're finished.
5760,3509,0,0,7,7,1.0,0.1543033499620919,508,Just because he got bit don't mean he was swimming with me. Have you really never heard of the fallacy of the converse?
5163,3509,0,0,7,7,1.0,0.1543033499620919,508,"Either I need my glasses, or you're gonna need a bigger note."
5164,3509,0,0,7,7,1.0,0.1543033499620919,508,Not my finwriting.
5758,3509,0,0,7,7,1.0,0.1543033499620919,508,"That's not me, mine was a sharkwaterspout."
5166,3509,0,0,7,7,1.0,0.1543033499620919,508,I want a lawyer. Let me call my uncle Finny.
5755,3509,0,0,7,7,1.0,0.1543033499620919,508,I don't like t talk out of school
5754,3509,0,0,7,7,1.0,0.1543033499620919,508,So he sleeps with the fishes.....doesn't mean I did it.
5753,3509,0,0,7,7,1.0,0.1543033499620919,508,All you've got is circumstantial and my lawyer's a real shark.
5750,3509,0,0,7,7,1.0,0.1543033499620919,508,That's a stereotype. I don't even like meat.
5749,3509,0,0,7,7,1.0,0.1543033499620919,508,"Well a lot of sharks have that bite size to snack on. Me, just a nibble."
5748,3509,0,0,7,7,1.0,0.1543033499620919,508,You've got the wrong guy. I've never even been to Amity Island.
5747,3509,0,0,7,7,1.0,0.1543033499620919,508,I dunno. That might be him. They all look the same in goggles and a wettie.
5169,3509,0,0,7,7,1.0,0.1543033499620919,508,"Yes, that's my brother, the loan shark."
5170,3509,0,0,7,7,1.0,0.1543033499620919,508,Why would I eat a lawyer?
5172,3509,0,0,7,7,1.0,0.1543033499620919,508,"Hey man, I had no part of that!"
5173,3509,0,0,8,8,1.0,0.1336306209562122,508,I told ya. I'm afraid of pit bulls and won't finger him.
5743,3509,0,0,7,7,1.0,0.1543033499620919,508,O.K. Read me my rights.
5159,3509,0,0,7,7,1.0,0.1543033499620919,508,I don't know. This Wall Street people all look the same...
5650,3509,0,0,7,7,1.0,0.1543033499620919,508,I want my flounder.
5649,3509,0,0,7,7,1.0,0.1543033499620919,508,"Left Shark, how do you explain this?"
5272,3509,0,0,7,7,1.0,0.1543033499620919,508,"For the last time, I don't know where my kid brother is, and I've never seen the ORCA before."
5507,3509,0,0,7,7,1.0,0.1543033499620919,508,That's a Chanel sneaker! Spit it out!!!
5379,3509,0,0,7,7,1.0,0.1543033499620919,508,Your charging me for being a card shark?
5383,3509,0,0,8,8,1.0,0.1336306209562122,508,So x-ray me! All I got was a shoe!
5384,3509,0,0,7,7,1.0,0.1543033499620919,508,"You've got the wrong fish, Mac. Sharks don't squeal."
5499,3509,0,0,7,7,1.0,0.1543033499620919,508,"'What does it say? I forgot my contacts on the boat.' (Of course I mean to say contact lenses but think contacts flows better for the caption. Regards,VB)"
5498,3509,0,0,8,8,1.0,0.1336306209562122,508,I don't know what he looked like. I just remember smelling blood.
5387,3509,0,0,7,7,1.0,0.1543033499620919,508,Sea food is enchanting but lacks a certain nutritional balance when unaccompanied by good vegetables.
5510,3509,0,0,7,7,1.0,0.1543033499620919,508,Shark's don't deliver and I don't like Candy!
5388,3509,0,0,7,7,1.0,0.1543033499620919,508,So I'm a loan shark....at least I didn't add my loans together and sell tranches to the banks!
5496,3509,0,0,7,7,1.0,0.1543033499620919,508,How many times do I need to tell you: I don't know this Trump guy!
5495,3509,0,0,7,7,1.0,0.1543033499620919,508,This whale looks like every other whale.
5491,3509,0,0,7,7,1.0,0.1543033499620919,508,You could've just told me she wanted a divorce.
5488,3509,0,0,7,7,1.0,0.1543033499620919,508,Louie Miller disappeared. Macky's back in town. Sell it on Broadway.
5487,3509,0,0,7,7,1.0,0.1543033499620919,508,Don't Miranda me.
5486,3509,0,0,8,8,1.0,0.1336306209562122,508,"Show it to my lawyers @ Sharkey, Cheatum & Good"
5485,3509,0,0,7,7,1.0,0.1543033499620919,508,Notice anything fishy?
5389,3509,0,0,7,7,1.0,0.1543033499620919,508,It is not me--You are looking for a Patent Shark!
5511,3509,0,0,8,8,1.0,0.1336306209562122,508,I'm telling you that's not one of my loans.
5514,3509,0,0,7,7,1.0,0.1543033499620919,508,"And I say it's privileged information, as to whether or not I ate my client."
5517,3509,0,0,7,7,1.0,0.1543033499620919,508,I told you. I was out swimming alone. And...I love lawyers.
5355,3509,0,0,7,7,1.0,0.1543033499620919,508,For cryin' out loud.. I got caught up in your dragnet 'cause of that little reefer?
5530,3509,0,0,7,7,1.0,0.1543033499620919,508,There's no crime here! Haven't you guys ever heard of the natural food chain?
5529,3509,0,0,7,7,1.0,0.1543033499620919,508,All I saw was his fin.
5527,3509,0,0,7,7,1.0,0.1543033499620919,508,"Can the fish story, pal. We've been tracking your every move."
5358,3509,0,0,7,7,1.0,0.1543033499620919,508,This license plate you coughed up is evidence you were at the scene!
5359,3509,0,0,7,7,1.0,0.1543033499620919,508,"Ok, Ok, so I ate him but he tasted awful and I had indigestion. I only turned myself in to get some Alkaselstser."
5526,3509,0,0,7,7,1.0,0.1543033499620919,508,"Pearly White never done that, Babe. You want Mack the Knife."
5360,3509,0,0,7,7,1.0,0.1543033499620919,508,Never saw it before!
5361,3509,0,0,7,7,1.0,0.1543033499620919,508,He said if I didn't help I'd end up swimming with the fishes
5362,3509,0,0,8,8,1.0,0.1336306209562122,508,Showing me a card doesn't make me a card shark.
5363,3509,0,0,6,6,1.0,0.18257418583505536,508,I did it in cold blood.
5364,3509,0,0,8,8,1.0,0.1336306209562122,508,I have the bite evidence back!' 'Duunnn dunnn dun dun dun don't know what your talking about.
5523,3509,0,0,8,8,1.0,0.1336306209562122,508,"As a matter of fact we DID run that license plate number, so start talking..."
5521,3509,0,0,7,7,1.0,0.1543033499620919,508,Do you recognize this torso?
5369,3509,0,0,8,8,1.0,0.1336306209562122,508,Your shell phone records show you were the last one to talk to Charlie Tuna before he was killed.
5370,3509,0,0,8,8,1.0,0.1336306209562122,508,"Yeah, that's Charlie. I'm just sorry I didn't get to him first."
5372,3509,0,0,7,7,1.0,0.1543033499620919,508,"Like I said, I only like dark meat."
5483,3509,0,0,7,7,1.0,0.1543033499620919,508,"I keep telling you, I don't know nothing about no scarlet billows !"
5534,3509,0,0,7,7,1.0,0.1543033499620919,508,"Nope, I never made him a loan."
5393,3509,0,0,7,7,1.0,0.1543033499620919,508,And what are you going to do if I refuse a DNA swab?
5395,3509,0,0,8,8,1.0,0.1336306209562122,508,"O.K,it's a autopsy photo of the Director of JAWS 3,so what?"
5461,3509,0,0,8,8,1.0,0.1336306209562122,508,Is there a picture of his belly button?
5414,3509,0,0,7,7,1.0,0.1543033499620919,508,"I'm tellin' ya, I don't care what da song says, it ain't my knife, Mack."
5457,3509,0,0,7,7,1.0,0.1543033499620919,508,It ain't me. I ain't no loan shark.
5417,3509,0,0,7,7,1.0,0.1543033499620919,508,"Yeah, so what? Nowadays everyone takes pics of their food."
5418,3509,0,0,7,7,1.0,0.1543033499620919,508,"Nah, that's not the guy. He had one arm and a scared look on his face."
5452,3509,0,0,7,7,1.0,0.1543033499620919,508,"I told you. I'm vegan, can't you tell?"
5450,3509,0,0,7,7,1.0,0.1543033499620919,508,"No, I don't recognize him; all human heads look the same to me."
5462,3509,0,0,7,7,1.0,0.1543033499620919,508,".....its 's .......It's the standard aquarium hiring contract., just sign, ok...'"
5446,3509,0,0,10,10,1.0,0.10540925533894598,508,"Wow, Shark Sally's teeth marks"
5442,3509,0,0,7,7,1.0,0.1543033499620919,508,That was our Company picnic!
5439,3509,0,0,7,7,1.0,0.1543033499620919,508,"For the last time, I you can't make me finger anyone!"
5437,3509,0,0,7,7,1.0,0.1543033499620919,508,"It's sonar, dude!'"
5436,3509,0,0,7,7,1.0,0.1543033499620919,508,I'm not signing that confession. I keep telling you I'm a shark not a killer whale.
5435,3509,0,0,7,7,1.0,0.1543033499620919,508,I only saw that the shark was big and white.
5434,3509,0,0,7,7,1.0,0.1543033499620919,508,I was disrespected. He called me Charlie Tuna.
5428,3509,0,0,7,7,1.0,0.1543033499620919,508,Quint ! He was warned that he needed a bigger boat.
5443,3509,0,0,7,7,1.0,0.1543033499620919,508,"He jumped me, I didn't jump him."
5463,3509,0,0,7,7,1.0,0.1543033499620919,508,Did he look anything like this picture of Luca Brasi.
5413,3509,0,0,7,7,1.0,0.1543033499620919,508,Me? A loan shark? Now you're just profiling!
5466,3509,0,0,7,7,1.0,0.1543033499620919,508,I don't care what your red light camera shows. I am not the tiburon driving that Tiburon.
5396,3509,0,0,7,7,1.0,0.1543033499620919,508,"I don't care what the photo shows, I never slept with Luca Brazzi"
5397,3509,0,0,7,7,1.0,0.1543033499620919,508,"You do know sharks can't talk, right?"
5398,3509,0,0,7,7,1.0,0.1543033499620919,508,"Now, don't you try getting all chummy with me - I already ate."
5482,3509,0,0,7,7,1.0,0.1543033499620919,508,An arm? A leg? It was only a loan!
5481,3509,0,0,7,7,1.0,0.1543033499620919,508,I know my rights! I want to speak to a dentist!
5480,3509,0,0,8,8,1.0,0.1336306209562122,508,"You realize, of course, that if we arrest the jumper that you will have to move to Australia."
5402,3509,0,0,7,7,1.0,0.1543033499620919,508,What were their last words?
5477,3509,0,0,8,8,1.0,0.1336306209562122,508,I couldn't have killed the tourist. I only eat local.
5404,3509,0,0,7,7,1.0,0.1543033499620919,508,"How many times must I tell you, 'I don't make loans!'"
5405,3509,0,0,7,7,1.0,0.1543033499620919,508,I never lent a cent to that guy or anyone else.
5476,3509,0,0,7,7,1.0,0.1543033499620919,508,"You can grill me all you want, copper!"
5472,3509,0,0,7,7,1.0,0.1543033499620919,508,I have an alibi. I was on Shark Tank.
5470,3509,0,0,7,7,1.0,0.1543033499620919,508,"Look, I'm a shark. So what are we doing here?"
5408,3509,0,0,7,7,1.0,0.1543033499620919,508,"I already told you, I never ate him before!"
5468,3509,0,0,7,7,1.0,0.1543033499620919,508,Recognize him? I never even saw Roy Scheider!
5410,3509,0,0,7,7,1.0,0.1543033499620919,508,"You're asking the wrong guy, coppers. I ain't a squealer."
5467,3509,0,0,7,7,1.0,0.1543033499620919,508,What overbite?
5394,3509,0,0,8,8,1.0,0.1336306209562122,508,"Do you think I need a surfboard? Ok, I took a bite out of it. So what?"
5814,3509,0,0,7,7,1.0,0.1543033499620919,508,That ain't my mark
5536,3509,0,0,7,7,1.0,0.1543033499620919,508,Who says she didn't mean 'lone'?
5540,3509,0,0,7,7,1.0,0.1543033499620919,508,You're charged with shark loaning.
5294,3509,0,0,7,7,1.0,0.1543033499620919,508,"Reel yourself in, Sarge. I may smell fishy, but I'm not rising to your cheesy bait."
5295,3509,0,0,7,7,1.0,0.1543033499620919,508,"It's not me. You know, there's a lot of sharks out there ..."
5296,3509,0,0,7,7,1.0,0.1543033499620919,508,"I keep telling you guys, I don't know any Mack the Knife!"
5297,3509,0,0,7,7,1.0,0.1543033499620919,508,He jumped me first.
5612,3509,0,0,5,5,1.0,0.22360679774997896,508,"I wouldn't exactly call offering $200,000 for a 30% stake a bribe."
5299,3509,0,0,8,8,1.0,0.1336306209562122,508,"Yeah, he was sleeping with the fishes before I ate him, ok?"
5300,3509,0,0,7,7,1.0,0.1543033499620919,508,Looks like a Japanese fishing boat to me.
5293,3509,0,0,7,7,1.0,0.1543033499620919,508,No. I don't remember eating him.
5610,3509,0,0,8,8,1.0,0.1336306209562122,508,It said all-you-can-eat buffet.
5607,3509,0,0,7,7,1.0,0.1543033499620919,508,No one ever told me flash photography wasn't permitted.
5606,3509,0,0,7,7,1.0,0.1543033499620919,508,Don't need no stinkin' lawyer!
5304,3509,0,0,7,7,1.0,0.1543033499620919,508,Let me see the sushi menu.
5605,3509,0,0,7,7,1.0,0.1543033499620919,508,I never wrote that loan!!!
5305,3509,0,0,7,7,1.0,0.1543033499620919,508,You're lucky I already know my Miranda rights because I can't read.
5603,3509,0,0,7,7,1.0,0.1543033499620919,508,"That's my fin in that bowl of soup officer, yup."
5602,3509,0,0,7,7,1.0,0.1543033499620919,508,Not my work. Looks like Macky's back in town.
5609,3509,0,0,7,7,1.0,0.1543033499620919,508,"Yeah, that's Left Shark alright!"
5615,3509,0,0,8,8,1.0,0.1336306209562122,508,I never bit her in my life.
5292,3509,0,0,7,7,1.0,0.1543033499620919,508,Of course he owed me. Who's gonna borrow money from a flounder?
5291,3509,0,0,7,7,1.0,0.1543033499620919,508,"I didn't kill that man, Detective! I am just a loan shark!"
5645,3509,0,0,8,8,1.0,0.1336306209562122,508,That's the yacht alright - I'd know that keel anywhere!
5275,3509,0,0,8,8,1.0,0.1336306209562122,508,"'To you it's a surfer, to me it's bait."
5640,3509,0,0,7,7,1.0,0.1543033499620919,508,"Yeah, that's the mugger who jumped the shark."
5639,3509,0,0,7,7,1.0,0.1543033499620919,508,You've got the wrong shark. Im a vegetarian.
5636,3509,0,0,7,7,1.0,0.1543033499620919,508,I told you. You've got the wrong guy. I'm a vegan.
5635,3509,0,0,7,7,1.0,0.1543033499620919,508,"Yeah, I went out once on a date with that mermaid. What of it?"
5633,3509,0,0,7,7,1.0,0.1543033499620919,508,You lower it to manslaughter and I'll sing like a whale.
5631,3509,0,0,9,9,1.0,0.11785113019775792,508,Don't blame me. They should have known they'd need a bigger boat.
5629,3509,0,0,7,7,1.0,0.1543033499620919,508,I may have tasted him but I never ate him!
5282,3509,0,0,7,7,1.0,0.1543033499620919,508,You know I keep kosher
5283,3509,0,0,7,7,1.0,0.1543033499620919,508,"Nah. Tony's a Jet, not a Shark."
5626,3509,0,0,9,9,1.0,0.11785113019775792,508,"'Yes, officer -- he's the one who said 'Smile you son-of-a-bitch,'' then shot my boyfriend."
5284,3509,0,0,7,7,1.0,0.1543033499620919,508,"I told you already, that's not me - that's my twin brother the lawyer."
5621,3509,0,0,8,8,1.0,0.1336306209562122,508,"Yeah? Well, he bumped into me one too many times, so I had to eat him."
5619,3509,0,0,7,7,1.0,0.1543033499620919,508,I think we're gonna need a bigger cell.
5618,3509,0,0,7,7,1.0,0.1543033499620919,508,What does that say? i can not read your writing
5617,3509,0,0,7,7,1.0,0.1543033499620919,508,Do you have any inside information about this missing person last seen surfing? What's your gut feeling?
5307,3509,0,0,7,7,1.0,0.1543033499620919,508,FYI: I'm getting hangry.
5538,3509,0,0,7,7,1.0,0.1543033499620919,508,I KNOW I have the right to an attorney. I AM an attorney.
5600,3509,0,0,7,7,1.0,0.1543033499620919,508,"But I have an alibi - I was on Shark Tank......, I want a lawyer."
5596,3509,0,0,7,7,1.0,0.1543033499620919,508,"OK.OK. I ate him, but tried to spear me first."
5566,3509,0,0,7,7,1.0,0.1543033499620919,508,"Look, I know you're trying to find alternate suspects in the Making a Murderer case, but this is getting ridiculous."
5564,3509,0,0,8,8,1.0,0.1336306209562122,508,They say his attorney is a real shark.
5562,3509,0,0,7,7,1.0,0.1543033499620919,508,Is this your dentist bill?
5560,3509,0,0,7,7,1.0,0.1543033499620919,508,We found your prints on this bloody hammerhead.
5341,3509,0,0,7,7,1.0,0.1543033499620919,508,"I dont wanna play the blame game, but I saw a dolphin do it"
5557,3509,0,0,7,7,1.0,0.1543033499620919,508,"Excuse me! I asked for tuna, not a piece of paper!"
5554,3509,0,0,7,7,1.0,0.1543033499620919,508,"That's him. One critique of Across the River and into the Trees, and I'm the bad guy!"
5336,3509,0,0,7,7,1.0,0.1543033499620919,508,You got the wrong guy. My name is L-O-N-E shark!
5552,3509,0,0,7,7,1.0,0.1543033499620919,508,"No, actually, I don't recognize that dorsal fin."
5549,3509,0,0,7,7,1.0,0.1543033499620919,508,So another TV series went bad. Why you blaming me?
5346,3509,0,0,7,7,1.0,0.1543033499620919,508,"That Diver had it coming... and YOU do too Baldy, I'll eat you, your gun, your family AND your stinkin boat!!"
5546,3509,0,0,7,7,1.0,0.1543033499620919,508,You guys trying to bait me again?
5348,3509,0,0,8,8,1.0,0.1336306209562122,508,This paper shredder leaves no trace.
5545,3509,0,0,7,7,1.0,0.1543033499620919,508,We know he's hiding out somewhere in the Atlantic.
5544,3509,0,0,7,7,1.0,0.1543033499620919,508,I told you. I haven't seen my brother Stan in over a year.
5542,3509,0,0,7,7,1.0,0.1543033499620919,508,Are these the rival Jets in question?
5550,3509,0,0,7,7,1.0,0.1543033499620919,508,Those could be anybody's dental records.
5335,3509,0,0,7,7,1.0,0.1543033499620919,508,And what else can you tell us beside the fact that he always wears a sharkskin suit?
5333,3509,0,0,7,7,1.0,0.1543033499620919,508,"Oh this is what you've 'written' for me? OK, so, let's see: 'I'm fifty yards from the shoreline, hungry and I sees this human-looking seal - Oh, come on! Gimme a break.'"
5331,3509,0,0,7,7,1.0,0.1543033499620919,508,Big deal. The product deserved to die.
5311,3509,0,0,7,7,1.0,0.1543033499620919,508,Tuna?! I told you I'm a vegetarian!
5595,3509,0,0,8,8,1.0,0.1336306209562122,508,But It's TRUE . ABC IS looking for a new shark.
5594,3509,0,0,8,8,1.0,0.1336306209562122,508,"Go fish, Fuzz."
5591,3509,0,0,7,7,1.0,0.1543033499620919,508,I'm gonna need a bigger pic
5590,3509,0,0,7,7,1.0,0.1543033499620919,508,"Is that Donald Trump? You can pump my stomach, it wasn't me. I'll eat anyone, but I that guy turns my stomach and toupees give me indigestion."
5589,3509,0,0,7,7,1.0,0.1543033499620919,508,"Tell us about this guy, 'Mack the knife' and we'll let you go."
5588,3509,0,0,7,7,1.0,0.1543033499620919,508,"Yeah Mack, that might be the Knife but that don't mean the shark knows, dig?"
5317,3509,0,0,8,8,1.0,0.1336306209562122,508,"'No, I've never seen that leg before. Burp.'"
5587,3509,0,0,7,7,1.0,0.1543033499620919,508,"Yeah, that's him. He looked like a fish out of water."
5581,3509,0,0,7,7,1.0,0.1543033499620919,508,I don't think he's the card shark we're after
5322,3509,0,0,11,11,1.0,0.09534625892455922,508,You wanna move that a little closer? I could use an arm right now.
5578,3509,0,0,7,7,1.0,0.1543033499620919,508,Do you recognize any of these Cod?
5577,3509,0,0,7,7,1.0,0.1543033499620919,508,Don't believe everything the parrot fish says.
5575,3509,0,0,7,7,1.0,0.1543033499620919,508,"Yeah, that's Rick 'the swingin' Dick' Snyder, I last saw him hanging around Flint's water supply."
5572,3509,0,0,7,7,1.0,0.1543033499620919,508,"'Well, I just needed some water, so I jumped in the fountain.' Gemma Parnell-Richardson, age 6 3/4"
5328,3509,0,0,7,7,1.0,0.1543033499620919,508,Has this Damien Hirst guy ever tried to contact you?
5569,3509,0,0,7,7,1.0,0.1543033499620919,508,Leave me a loan.
5310,3509,0,0,7,7,1.0,0.1543033499620919,508,Looks like a recipe for broiled shark.
6240,3509,0,0,7,7,1.0,0.1543033499620919,508,Damn Emails!
5818,3509,0,0,8,8,1.0,0.1336306209562122,508,That's the one! The one with the wooden leg who kept calling me Moby Dick! See how he squints? I just know he needs glasses.
5131,3509,0,0,7,7,1.0,0.1543033499620919,508,"Uh oh. They're pulling the good cop, bad cop routine."
6118,3509,0,0,7,7,1.0,0.1543033499620919,508,I ain't sayin' a word until I talk to my ahi tuna.
6117,3509,0,0,7,7,1.0,0.1543033499620919,508,"Yeh..yeh...yeh...two guys, one dinghy. Whatcha want wit me?"
6115,3509,0,0,7,7,1.0,0.1543033499620919,508,"Listen pal, I meet a lot of remoras, okay? Can't remember all their dorsal fins."
4943,3509,0,0,7,7,1.0,0.1543033499620919,508,"Of course he's swimming with the fishes, he's a shark"
6110,3509,0,0,7,7,1.0,0.1543033499620919,508,"Fine, I admit to following her around. But I didn't maul anyone. I'm a loan shark. The orcas are the killers in that neighborhood!"
6107,3509,0,0,7,7,1.0,0.1543033499620919,508,He couldn't pay back his loan so I ate him.
6104,3509,0,0,8,8,1.0,0.1336306209562122,508,"No, he was missing his two front teeth."
4939,3509,0,0,7,7,1.0,0.1543033499620919,508,I'm off the hook! I would never harm a little koi.
6103,3509,0,0,7,7,1.0,0.1543033499620919,508,"Look, I keep telling you -- large-mouth, not small-mouth"
6101,3509,0,0,7,7,1.0,0.1543033499620919,508,You ain't gettin' anything out me unless I get immunity from the E. P. A.
6100,3509,0,0,7,7,1.0,0.1543033499620919,508,Yeah I've seen him before. He sleeps with da fishes.
4949,3509,0,0,7,7,1.0,0.1543033499620919,508,"No, officer, I don't know him. We don't all know each other."
4951,3509,0,0,8,8,1.0,0.1336306209562122,508,The dirty Rat's trying to frame me.! I haven't worked that beach for years...
4952,3509,0,0,8,8,1.0,0.1336306209562122,508,Recognize that leg?
4953,3509,0,0,6,6,1.0,0.18257418583505536,508,Dead fish
6097,3509,0,0,8,8,1.0,0.1336306209562122,508,"Detective, this evidence won't hold up in the court of jaws"
6102,3509,0,0,7,7,1.0,0.1543033499620919,508,I'm not fallin' for the old bait and snitch.
4956,3509,0,0,7,7,1.0,0.1543033499620919,508,The dame is Lucy Brown and the guy with the knife is 'Mack'.
4938,3509,0,0,7,7,1.0,0.1543033499620919,508,"Look, for the 100th time, Mr Limpet got it all wrong. I was nowhere Cape Cod last week."
6125,3509,0,0,8,8,1.0,0.1336306209562122,508,"If you think I'll flip back to Sea World for raw tuna in olive oil and chanterelles, think again."
6147,3509,0,0,8,8,1.0,0.1336306209562122,508,You betcha he's guilty! Book him!
6146,3509,0,0,7,7,1.0,0.1543033499620919,508,Great White?! That can't be me. I'm barely mediocre.
4924,3509,0,0,7,7,1.0,0.1543033499620919,508,"Look, I see a lotta guys swimming everyday. Maybe I saw him. But that don't mean I ate him!"
6145,3509,0,0,8,8,1.0,0.1336306209562122,508,"Them amateurs?? Don't play no cards with 'em, and don't loan no dough to 'em neither."
4927,3509,0,0,7,7,1.0,0.1543033499620919,508,How could I ever get my fins on a weapon like that?
6143,3509,0,0,7,7,1.0,0.1543033499620919,508,I said no shark fin soup with my steamed rice
4928,3509,0,0,9,9,1.0,0.11785113019775792,508,I’m not *that* kind of predator!
6124,3509,0,0,7,7,1.0,0.1543033499620919,508,I know a card shark when I see one.
4929,3509,0,0,7,7,1.0,0.1543033499620919,508,Yeah I ate the damn penguin!!!! Showing me a picture of it doesn't do crap. They all look the same. That's why they mate for life.
6140,3509,0,0,7,7,1.0,0.1543033499620919,508,"Of course I can prove I didn't shoot him, you idiot. I'm a shark"
4931,3509,0,0,7,7,1.0,0.1543033499620919,508,"Give me the dolphin, I talk."
6138,3509,0,0,7,7,1.0,0.1543033499620919,508,I don't know nothing 'bout no sharknado.
6137,3509,0,0,7,7,1.0,0.1543033499620919,508,"Never seen him. Like I said, I just do loans."
6136,3509,0,0,7,7,1.0,0.1543033499620919,508,"That's an orca, not a shark, you nitwit."
6128,3509,0,0,7,7,1.0,0.1543033499620919,508,"Those damn lifeguards, monsters, am I right?"
6126,3509,0,0,7,7,1.0,0.1543033499620919,508,I need to have something in the foreground to give it some scale.
6141,3509,0,0,8,8,1.0,0.1336306209562122,508,Yeah! I know that guy;it's Mac the Knife.
6094,3509,0,0,7,7,1.0,0.1543033499620919,508,No. Trump.
6092,3509,0,0,7,7,1.0,0.1543033499620919,508,"Don't worry, he's just sleeping with the fishes."
6090,3509,0,0,7,7,1.0,0.1543033499620919,508,"No way my client goes for that deal, copper."
6056,3509,0,0,7,7,1.0,0.1543033499620919,508,"That's no chum of mine, I tell ya!"
6055,3509,0,0,7,7,1.0,0.1543033499620919,508,"That's him, the one they called Brodie."
5431,3509,0,0,7,7,1.0,0.1543033499620919,508,I'm nearsighted. I thought the snorkeler was a submarine.
4980,3509,0,0,7,7,1.0,0.1543033499620919,508,"Nah, his boat was smaller."
6054,3509,0,0,7,7,1.0,0.1543033499620919,508,"Despite the evidence against me, I did not use performance enhancing drugs !"
6052,3509,0,0,7,7,1.0,0.1543033499620919,508,You're gonna need a bigger piece of paper
6051,3509,0,0,7,7,1.0,0.1543033499620919,508,I keep telling you guys I never bit that crazy old man with the harpoon gun before. So can you please get chief Brody in here cause he's the only one who'll understand!
6060,3509,0,0,6,6,1.0,0.18257418583505536,508,Sorry officer but I can't read without my contacts.
6050,3509,0,0,8,8,1.0,0.1336306209562122,508,I ain't never seen that clownfish.
4985,3509,0,0,7,7,1.0,0.1543033499620919,508,"You're saying this man, Mark Cuban, is the one who attacked you?"
4986,3509,0,0,7,7,1.0,0.1543033499620919,508,"It could have possibly been done by lions, tigers, or bears."
4987,3509,0,0,8,8,1.0,0.1336306209562122,508,I can take your taste detector test.
4989,3509,0,0,8,8,1.0,0.1336306209562122,508,Yeah I know him - he's my chum. What of it?
4993,3509,0,0,8,8,1.0,0.1336306209562122,508,"Yeah, yeah. She hangs around the Blue Reef."
4994,3509,0,0,7,7,1.0,0.1543033499620919,508,No. He's a little more hammer headed.
6042,3509,0,0,7,7,1.0,0.1543033499620919,508,"You got the wrong guy, it was Charlie the tuna. You think we all look alike."
4984,3509,0,0,7,7,1.0,0.1543033499620919,508,A fish out of water deserves better treatment!
6061,3509,0,0,7,7,1.0,0.1543033499620919,508,I'm tired of being pulled in every time a surfer goes missing.
4977,3509,0,0,7,7,1.0,0.1543033499620919,508,"I'm on a diet, just coffee."
6067,3509,0,0,7,7,1.0,0.1543033499620919,508,That's all the tanks I get?
6089,3509,0,0,7,7,1.0,0.1543033499620919,508,You ain't got nuttin on me! A fin in the water? You coppers make me laugh!
6085,3509,0,0,9,9,1.0,0.11785113019775792,508,"Take a hike, copper, those bite marks look nothing like mine."
6082,3509,0,0,7,7,1.0,0.1543033499620919,508,Are you telling me you've never seen this fish before
4962,3509,0,0,8,8,1.0,0.1336306209562122,508,"I don't recognize that leg, or any of the others. You pigs aren't pinning this rap on 'ol Clark here!"
4964,3509,0,0,7,7,1.0,0.1543033499620919,508,Is this the witch that cast the spell?
4965,3509,0,0,7,7,1.0,0.1543033499620919,508,Are my eyes really brown?
4966,3509,0,0,7,7,1.0,0.1543033499620919,508,I keep telling you guys - that beach is totally safe!
4967,3509,0,0,7,7,1.0,0.1543033499620919,508,"Occasionally I'll eat someone alive, so sue me....at least I don't randomly shoot people on 5 th avenue!"
6080,3509,0,0,7,7,1.0,0.1543033499620919,508,I can't really see without my glasses.
4969,3509,0,0,7,7,1.0,0.1543033499620919,508,"I'm innocent, I tell you. That's Robert, not me!"
6078,3509,0,0,7,7,1.0,0.1543033499620919,508,I didn't say he was my friend. I said he was my chum.
4970,3509,0,0,8,8,1.0,0.1336306209562122,508,Never ate him before.
4971,3509,0,0,7,7,1.0,0.1543033499620919,508,He was moving too fast to see his face but I'd recognise his tail anywhere!
4972,3509,0,0,7,7,1.0,0.1543033499620919,508,"When I last saw him, he was swimming with the fishes."
6074,3509,0,0,8,8,1.0,0.1336306209562122,508,You tell me you've never seen this fish before
6068,3509,0,0,7,7,1.0,0.1543033499620919,508,"No, the surfboard I saw had two legs."
4976,3509,0,0,7,7,1.0,0.1543033499620919,508,The fifth and final suspect was brought in for jumping the shark.
4922,3509,0,0,7,7,1.0,0.1543033499620919,508,"No, I don't know what 'vig' means!"
6148,3509,0,0,7,7,1.0,0.1543033499620919,508,This is the $3000 Rolex that was on the surfer's arm you swallowed. Either you cough it up or we cut you open
6149,3509,0,0,7,7,1.0,0.1543033499620919,508,I want my underwater lawyer.
6150,3509,0,0,7,7,1.0,0.1543033499620919,508,"I don't care where he's sleeping, I've never seen Luca Brasi."
6219,3509,0,0,7,7,1.0,0.1543033499620919,508,I'm not saying a word without my NRDC rep.
6218,3509,0,0,7,7,1.0,0.1543033499620919,508,He used to be a waiter at the Feeding Frenzy.
4881,3509,0,0,7,7,1.0,0.1543033499620919,508,"I didn't take anyone's leg. The guy you're looking for weighs 40 tons, is white and has a harpoon sticking out of his kidney."
6217,3509,0,0,7,7,1.0,0.1543033499620919,508,Enough with the stupid questions. I plan to invoke the 'evolutionary biology' defense.
6216,3509,0,0,7,7,1.0,0.1543033499620919,508,I never had sex in that aquarium.
4884,3509,0,0,8,8,1.0,0.1336306209562122,508,"I already told ya, I've never seen that leg before."
6215,3509,0,0,9,9,1.0,0.11785113019775792,508,Don't even think about asking for a lawyer. (Authored by Thomas Healy.)
4879,3509,0,0,7,7,1.0,0.1543033499620919,508,He'll never surface
4886,3509,0,0,7,7,1.0,0.1543033499620919,508,"I'm innocent, but it smells kind of fishy."
4888,3509,0,0,8,8,1.0,0.1336306209562122,508,"If you cooperate, I may be able to convince the judge to let you keep your week."
6213,3509,0,0,7,7,1.0,0.1543033499620919,508,"Yeah, that's Mikey Minnow. I ate him. Is there a law against that?"
4890,3509,0,0,7,7,1.0,0.1543033499620919,508,"So, the Shark Club had some Fin Soup made for me!"
6207,3509,0,0,7,7,1.0,0.1543033499620919,508,"What, 'Charlie the Tuna' never heard of him, ya can't pin that on me!!"
4892,3509,0,0,7,7,1.0,0.1543033499620919,508,"Of course I’m a predator, but I’ve never seen that school of fish."
6206,3509,0,0,7,7,1.0,0.1543033499620919,508,I'll have the tuna rare and a Bloody Mary.
4893,3509,0,0,8,8,1.0,0.1336306209562122,508,You got me confused for a loan shark who gives a damn
4887,3509,0,0,8,8,1.0,0.1336306209562122,508,"18% What do you mean 'is that your card' ? I told you, I am NOT a card shark."
6222,3509,0,0,8,8,1.0,0.1336306209562122,508,"He's in the business all right, but he's not an enforcer."
4877,3509,0,0,8,8,1.0,0.1336306209562122,508,"He threatened to break every bone on my body. Obviously, he didn't know me very well."
4875,3509,0,0,7,7,1.0,0.1543033499620919,508,Give a man to a fish and you feed him for a lifetime.
4862,3509,0,0,7,7,1.0,0.1543033499620919,508,You look like that O'Leary guy I just wasted.
4864,3509,0,0,7,7,1.0,0.1543033499620919,508,You're going to need a bigger bluff.
6234,3509,0,0,7,7,1.0,0.1543033499620919,508,Bite her? I don't even know her.
6233,3509,0,0,8,8,1.0,0.1336306209562122,508,"This must be a case of mistaken identity. I'm a land shark, not a loan shark."
6228,3509,0,0,9,9,1.0,0.11785113019775792,508,I was just being chummy with her.
4866,3509,0,0,7,7,1.0,0.1543033499620919,508,For the eighth time if he does not have gills I do not know him.
4867,3509,0,0,7,7,1.0,0.1543033499620919,508,I swear I've never seen those toes before!
6227,3509,0,0,8,8,1.0,0.1336306209562122,508,Don't get snarky with me.
6226,3509,0,0,7,7,1.0,0.1543033499620919,508,"That's the manatee, officer."
4869,3509,0,0,8,8,1.0,0.1336306209562122,508,You don't know Moby Dick from a pool shark?
4870,3509,0,0,7,7,1.0,0.1543033499620919,508,How do my teeth look?
6225,3509,0,0,7,7,1.0,0.1543033499620919,508,What do you mean I jumped the shark?
4871,3509,0,0,7,7,1.0,0.1543033499620919,508,That's her! Always surfing topless and reeking of booze. Your mom was delicious.
4872,3509,0,0,7,7,1.0,0.1543033499620919,508,You obviously don't know much about sharks. I am a hammerhead nor a great white that you are looking for.
4873,3509,0,0,7,7,1.0,0.1543033499620919,508,"I was a lone that night, not a loan shark!"
4874,3509,0,0,7,7,1.0,0.1543033499620919,508,"You never read my client his rights, that confession's worthless."
6223,3509,0,0,7,7,1.0,0.1543033499620919,508,"'That proves nothing, I got new set of teeth.'–"
6205,3509,0,0,7,7,1.0,0.1543033499620919,508,Murder? I think this Marine Sanctuary thing has gone a bit too far!
6041,3509,0,0,7,7,1.0,0.1543033499620919,508,I'm telling you I didn't loan any money to him either. I'm a shark. I ain't even got POCKETS.
4894,3509,0,0,8,8,1.0,0.1336306209562122,508,"How may times do I have to tell you? That's Charlie the Tuna, not me!"
6202,3509,0,0,8,8,1.0,0.1336306209562122,508,Not 'friend'--chum.
6171,3509,0,0,7,7,1.0,0.1543033499620919,508,Would you like me to suck on that paper cut for you?
6169,3509,0,0,7,7,1.0,0.1543033499620919,508,"I am telling you the perpetrator is known as Mr. Jaws, that's J.A.W.S."
6167,3509,0,0,7,7,1.0,0.1543033499620919,508,"Luca Brasi? Yeah, I saw him last night."
6166,3509,0,0,7,7,1.0,0.1543033499620919,508,Confess? Bite me!
4913,3509,0,0,7,7,1.0,0.1543033499620919,508,We're not baiting you. We seriously think this chum did it.
6161,3509,0,0,7,7,1.0,0.1543033499620919,508,We're gonna use you as bait to capture this big fish!
6160,3509,0,0,7,7,1.0,0.1543033499620919,508,"It's time fish or cut bait, the name Spielberg sounds fishy!"
4910,3509,0,0,7,7,1.0,0.1543033499620919,508,I want to speak to my anchovy.
6159,3509,0,0,7,7,1.0,0.1543033499620919,508,You must be kidding. After two painful years of inconvenient monthly orthodontist appointments there's no way I could make such impressions.
4914,3509,0,0,7,7,1.0,0.1543033499620919,508,"Yea, we spawned. So what?"
4915,3509,0,0,7,7,1.0,0.1543033499620919,508,I am Lone Shark not Loan Shark.
4916,3509,0,0,7,7,1.0,0.1543033499620919,508,Stop it--I've watched 'Making a Murderer.'
4917,3509,0,0,7,7,1.0,0.1543033499620919,508,"Yea, that's the guy who jumped me. He wasn't so tough. A little chewy maybe."
4918,3509,0,0,8,8,1.0,0.1336306209562122,508,We know you're guilty the evidence is in the films
6155,3509,0,0,7,7,1.0,0.1543033499620919,508,"Yeah, that's the guy. Attacked me with an eight-foot surfboard!"
6153,3509,0,0,7,7,1.0,0.1543033499620919,508,"Come on guys, you know me - I wouldn't go near a leg that looked like that."
6156,3509,0,0,7,7,1.0,0.1543033499620919,508,Looks fishy to me-any relation to me is just a fluke
4909,3509,0,0,7,7,1.0,0.1543033499620919,508,"Seriously, do I look like a predator to you?"
4908,3509,0,0,7,7,1.0,0.1543033499620919,508,"Try matching the teeth marks, I dare ya!"
4907,3509,0,0,8,8,1.0,0.1336306209562122,508,"Yeah, I know da dame; she use 'ta swim here every summer with her family. Yeah, dame's got only one leg. So what?"
6201,3509,0,0,7,7,1.0,0.1543033499620919,508,"Get off it, buddy. When it comes to pearly whites, Macheath ain't got nutting' on me!"
6200,3509,0,0,8,8,1.0,0.1336306209562122,508,"Yeh, that's Lou Miller all right, but last I saw saw him he was slam'in 'em back with Ol' MacHeath."
6199,3509,0,0,10,10,1.0,0.10540925533894598,508,I am an alcoholic.
4899,3509,0,0,6,6,1.0,0.18257418583505536,508,"Yeah, that's the Jet that started it."
6197,3509,0,0,7,7,1.0,0.1543033499620919,508,"Yeah, I know who he is. He's in the No Swim List."
6196,3509,0,0,7,7,1.0,0.1543033499620919,508,How can I read when your arm is making me drool!
4900,3509,0,0,7,7,1.0,0.1543033499620919,508,"It's upside down dummy, and you're holding it a little too close to my blind spot!!"
6188,3509,0,0,7,7,1.0,0.1543033499620919,508,Something fishy about that one
4902,3509,0,0,7,7,1.0,0.1543033499620919,508,"Nope, not my work. Paleo makes me gassy."
6186,3509,0,0,8,8,1.0,0.1336306209562122,508,I tell you he was AT LEAST three inches over the limit.
6185,3509,0,0,7,7,1.0,0.1543033499620919,508,"So Joey had a royal flush, whaddya expect?"
6184,3509,0,0,7,7,1.0,0.1543033499620919,508,"Yes I know Charlie the Tuna, but I didn’t eat him"
6183,3509,0,0,7,7,1.0,0.1543033499620919,508,I'm trying really hard to eat a healthy balanced meal!
6182,3509,0,0,9,9,1.0,0.11785113019775792,508,Aren't you supposed to read me my rights?
4905,3509,0,0,7,7,1.0,0.1543033499620919,508,"So what am I looking at here, chum?"
6175,3509,0,0,7,7,1.0,0.1543033499620919,508,Is this the guy that tried to spear you? Not sure? You guys all look alike.
6173,3509,0,0,7,7,1.0,0.1543033499620919,508,Cross-species eyewitness identification evidence is notoriously unreliable.
4896,3509,0,0,7,7,1.0,0.1543033499620919,508,Is the suspect a member of the Jets or the Sharks?
6030,3509,0,0,7,7,1.0,0.1543033499620919,508,How should I know if that's the person I attacked? You all look the same!
6028,3509,0,0,7,7,1.0,0.1543033499620919,508,"I told you, it's hard to identify 'em without the cement blocks!"
6027,3509,0,0,8,8,1.0,0.1336306209562122,508,"I'm telling you man, I would NOT invest in that product."
5889,3509,0,0,7,7,1.0,0.1543033499620919,508,"You're wasting your time officer, you guys all look like seals to me."
5888,3509,0,0,8,8,1.0,0.1336306209562122,508,He's not even in my food chain.
5087,3509,0,0,9,9,1.0,0.11785113019775792,508,I told you already--I don't recognize that smell.
5088,3509,0,0,7,7,1.0,0.1543033499620919,508,"Nah, man. I only eat organic, sustainable, wild fish."
5089,3509,0,0,7,7,1.0,0.1543033499620919,508,Not me. I'm a card shark not a pool shark.
5091,3509,0,0,7,7,1.0,0.1543033499620919,508,"Not that it's any of your business, but ladyfish don't do it for me."
5883,3509,0,0,8,8,1.0,0.1336306209562122,508,"He was wearing mask,but,i am sure he was an orca!"
5892,3509,0,0,8,8,1.0,0.1336306209562122,508,The guy was in a dolphin suit. Enough said!
5879,3509,0,0,8,8,1.0,0.1336306209562122,508,So I bundled a bunch of small IOUs into a CDO and shorted it. There ain’t no law against that!
5878,3509,0,0,8,8,1.0,0.1336306209562122,508,"I told you, card games aren't my thing!"
5877,3509,0,0,7,7,1.0,0.1543033499620919,508,"I don't recognize this fish, I'm vegan..."
5876,3509,0,0,9,9,1.0,0.11785113019775792,508,We found the leg...where is the rest of him?
5097,3509,0,0,7,7,1.0,0.1543033499620919,508,So what you're telling me is that you have a blind spot AND a fishy alibi?
5874,3509,0,0,7,7,1.0,0.1543033499620919,508,All I know is that he was washed-up.
5099,3509,0,0,7,7,1.0,0.1543033499620919,508,"No, that one already sleeps with my buddies too..."
5867,3509,0,0,7,7,1.0,0.1543033499620919,508,I don't know nuthin' about any surfer. Us sharks call it seal on a stick.
5094,3509,0,0,5,5,1.0,0.22360679774997896,508,"Off limits, that's dorsal profiling if you ask me."
5086,3509,0,0,7,7,1.0,0.1543033499620919,508,Looks like him---I thought it was a stupid idea.
5084,3509,0,0,7,7,1.0,0.1543033499620919,508,Those teeth marks could have come from anywhere.
5894,3509,0,0,7,7,1.0,0.1543033499620919,508,I'm not surprised. They needed a bigger boat.
5911,3509,0,0,8,8,1.0,0.1336306209562122,508,This is a bunch of bullshark!
5910,3509,0,0,7,7,1.0,0.1543033499620919,508,What do you think? I’ve been sitting on my fin all day.
5069,3509,0,0,7,7,1.0,0.1543033499620919,508,So you're telling me we've got the wrong shark?
5906,3509,0,0,7,7,1.0,0.1543033499620919,508,"Yeah, that's Kelly Slater. I was watching him at Jaws this past week. But I swear I didn't touch him!"
5905,3509,0,0,7,7,1.0,0.1543033499620919,508,I tell ya that ain't me; we all wear sharkskin.
5904,3509,0,0,7,7,1.0,0.1543033499620919,508,Got any pics of that babe from Jaws?
5070,3509,0,0,8,8,1.0,0.1336306209562122,508,"Well, I wouldn't have eaten him had I known he was your chum."
5071,3509,0,0,7,7,1.0,0.1543033499620919,508,"No, that's not him. He had more life in the eyes. Just creepy."
5072,3509,0,0,9,9,1.0,0.11785113019775792,508,Do you recognize this caviar in this photo?
5903,3509,0,0,7,7,1.0,0.1543033499620919,508,It's grand theft; you may want to bring in the octopus.
5074,3509,0,0,7,7,1.0,0.1543033499620919,508,Fressluenza.
5898,3509,0,0,7,7,1.0,0.1543033499620919,508,"I'd say I thought he was a seal, but the seal police are even worse."
5077,3509,0,0,7,7,1.0,0.1543033499620919,508,"Look, you think I don't know genuine salt water mahi-mahi when I see it? I'm not biting on that old trick."
5078,3509,0,0,8,8,1.0,0.1336306209562122,508,She's a real beauty...are those fins from reconstructive surgery?
5896,3509,0,0,6,6,1.0,0.18257418583505536,508,Confess? For What? A higher porpoise?
5080,3509,0,0,7,7,1.0,0.1543033499620919,508,Nope. All those suckers look the same to me!
5082,3509,0,0,7,7,1.0,0.1543033499620919,508,No matter what that says; I'm no loan shark.
5100,3509,0,0,7,7,1.0,0.1543033499620919,508,I need my glasses.
5065,3509,0,0,7,7,1.0,0.1543033499620919,508,This proves you're the loan shark we've been looking for!
5101,3509,0,0,7,7,1.0,0.1543033499620919,508,"Yeah, that's Louie Miller alright, but don't pin this on me. Five'll get ya ten old Macky's back in town."
5865,3509,0,0,7,7,1.0,0.1543033499620919,508,"I keep telling you, I'm a vegetarian."
5843,3509,0,0,7,7,1.0,0.1543033499620919,508,"Stupid cops, do all sharks look the same to you?"
5119,3509,0,0,7,7,1.0,0.1543033499620919,508,Bite Marks ? Not mine.
5839,3509,0,0,8,8,1.0,0.1336306209562122,508,"Sure it's a tragedy, but I can produce ten witnesses who will tell you that I was at a totally different feeding frenzy off of Fire Island at that time."
5835,3509,0,0,7,7,1.0,0.1543033499620919,508,All that proves is you hauled me in for swimming while shark.
5122,3509,0,0,7,7,1.0,0.1543033499620919,508,I could never confuse a garish tattoo like that with real food.
5834,3509,0,0,8,8,1.0,0.1336306209562122,508,I name names without that 'endangered species' designation and I'm dead in the water.
5831,3509,0,0,6,6,1.0,0.18257418583505536,508,"I swear. I've eaten thousands of groupers in my life, but not that one."
5844,3509,0,0,7,7,1.0,0.1543033499620919,508,We have witnesses.
5827,3509,0,0,7,7,1.0,0.1543033499620919,508,"Third time, never saw him. Now can I get some water?"
5125,3509,0,0,7,7,1.0,0.1543033499620919,508,How could I plug a freeloader like Joey Remora with no trigger finger?
5126,3509,0,0,7,7,1.0,0.1543033499620919,508,I’m tellin’ ya for the last time I ain’t never seen that kid or his raft in my life!
5127,3509,0,0,7,7,1.0,0.1543033499620919,508,"I don't swim in that part of the water. Those aren't my (tooth) prints, and you can never prove otherwise."
5823,3509,0,0,9,9,1.0,0.11785113019775792,508,That's not me. My ocean days are behind me.
5129,3509,0,0,7,7,1.0,0.1543033499620919,508,"Yes, that's him! He's the real shark!"
5822,3509,0,0,7,7,1.0,0.1543033499620919,508,Well... Sure. He looks a lot less like a seal in THAT picture.
5820,3509,0,0,7,7,1.0,0.1543033499620919,508,That's not me. Do all land sharks look alike to you?
5825,3509,0,0,7,7,1.0,0.1543033499620919,508,It couldn't have been me. I have been a Vegan for years!
5117,3509,0,0,7,7,1.0,0.1543033499620919,508,Impossible! I'm a Vegetarian!
5846,3509,0,0,7,7,1.0,0.1543033499620919,508,"Not me, I'm missing a top front tooth!"
5847,3509,0,0,7,7,1.0,0.1543033499620919,508,I demand to swim with my lawyer.
5103,3509,0,0,7,7,1.0,0.1543033499620919,508,You get one phone call. Here's the menu for Sushi Delight.
5864,3509,0,0,7,7,1.0,0.1543033499620919,508,"Enough with the picture. I told ya, I SMELLED him a mile away."
5105,3509,0,0,7,7,1.0,0.1543033499620919,508,"Yeah, that's him alright- the only surviving witness to the cold-blooded attack on my good pal Moby. They call him Ishmael"
5856,3509,0,0,7,7,1.0,0.1543033499620919,508,Do you mean to tell me this isn't you in the no wake camera?
5855,3509,0,0,8,8,1.0,0.1336306209562122,508,Can you hurry this up? I'm due on the 'Happy Days' set in 20 minutes.
5854,3509,0,0,6,6,1.0,0.18257418583505536,508,And how confused are you now?
5852,3509,0,0,8,8,1.0,0.1336306209562122,508,The Jaws look familiar but his ears didn't stick out like that!
5851,3509,0,0,7,7,1.0,0.1543033499620919,508,"Badges, to god-damned hell with badges! ... I don't have to show you any stinking badges."
5106,3509,0,0,7,7,1.0,0.1543033499620919,508,"Nah, the guy I had was skinnier."
5107,3509,0,0,7,7,1.0,0.1543033499620919,508,"Hey, I ain't talkin' even if you waterboard me!"
5850,3509,0,0,8,8,1.0,0.1336306209562122,508,You think I'm a a shark. Wait till my lawyer gets here.
5849,3509,0,0,8,8,1.0,0.1336306209562122,508,He was just asking for a loan.
5110,3509,0,0,8,8,1.0,0.1336306209562122,508,"Again, my name's not Miranda!"
5111,3509,0,0,8,8,1.0,0.1336306209562122,508,Our X-Ray of your stomach proves my point.
5112,3509,0,0,7,7,1.0,0.1543033499620919,508,Don't think that you can threaten me with a Shark fin soup recipe.
5113,3509,0,0,7,7,1.0,0.1543033499620919,508,Surfer... surf & turf... whatever.
5114,3509,0,0,7,7,1.0,0.1543033499620919,508,"Oh, I get it, good cop/bad cop, right? He says he'll put me in an aquarium and you say you will turn me into harkarl if I don't confess."
5866,3509,0,0,7,7,1.0,0.1543033499620919,508,"I understand the loansharking charge, but bookmaking too?"
5819,3509,0,0,7,7,1.0,0.1543033499620919,508,I demand to speak to my attorney in the Indian Ocean.
5913,3509,0,0,7,7,1.0,0.1543033499620919,508,That's right. I've never even seen The Little Mermaid.
5914,3509,0,0,7,7,1.0,0.1543033499620919,508,"Like I told ya, I never met this 'Jet'."
5021,3509,0,0,7,7,1.0,0.1543033499620919,508,"I don't care what the evidence shows, my client didn't do it."
5022,3509,0,0,7,7,1.0,0.1543033499620919,508,"Look buddy, sharks don't have Miranda rights!"
5992,3509,0,0,7,7,1.0,0.1543033499620919,508,You were seen near the school right before the incident!
5025,3509,0,0,7,7,1.0,0.1543033499620919,508,"The longer you Coppers grill me, the tougher I'm gonna get, see!"
5990,3509,0,0,7,7,1.0,0.1543033499620919,508,Have you swallowed this guy recently?
5988,3509,0,0,7,7,1.0,0.1543033499620919,508,"Yup, that's the guy who jumped me alright."
5029,3509,0,0,7,7,1.0,0.1543033499620919,508,"Sorry, I can’t remember past five seconds ago."
5994,3509,0,0,7,7,1.0,0.1543033499620919,508,This man was last seen with you
5986,3509,0,0,7,7,1.0,0.1543033499620919,508,Five will get you ten...Mack is back in town.
5982,3509,0,0,7,7,1.0,0.1543033499620919,508,"I told you, they picked the wrong shark in the lineup."
5981,3509,0,0,7,7,1.0,0.1543033499620919,508,"You say chump, I hear chum."
5980,3509,0,0,7,7,1.0,0.1543033499620919,508,"Yeah, I know that surfer. And yeah, he did blow gas bubbles at me last week. But that don't mean I ate him."
5978,3509,0,0,7,7,1.0,0.1543033499620919,508,Left Shark? I know him.
5974,3509,0,0,7,7,1.0,0.1543033499620919,508,Are you kidding me.? Can I identify the victim? .....it all looks like chum to me!
5036,3509,0,0,10,10,1.0,0.10540925533894598,508,"You guys aren´t used to interrogating sharks, are you? Hold the photo where I can see it! And loosen my handcuffs, buddy!"
5970,3509,0,0,8,8,1.0,0.1336306209562122,508,Ok so you're telling me in this town fleet week great shark week bad?
5032,3509,0,0,7,7,1.0,0.1543033499620919,508,I saw her with a suspicious looking white whale.
5017,3509,0,0,9,9,1.0,0.11785113019775792,508,I was nowhere near that bloodbath.
5999,3509,0,0,7,7,1.0,0.1543033499620919,508,That ain't me flatfoot. That's a production still from Sharnado.
5014,3509,0,0,7,7,1.0,0.1543033499620919,508,"According to the Urban Dictionary, Party Sharking is not crashing little kids sand castles on the beach."
6025,3509,0,0,7,7,1.0,0.1543033499620919,508,"Here's the address for the dentist - an agent will escort you. Once we've got the caps, you'll be apprised of your next location."
5002,3509,0,0,7,7,1.0,0.1543033499620919,508,I ate him years ago.
6021,3509,0,0,7,7,1.0,0.1543033499620919,508,Loansharking? Never! I'm a whale!
5003,3509,0,0,7,7,1.0,0.1543033499620919,508,"I told you, it was self-defence. That guy was after my fin."
5004,3509,0,0,7,7,1.0,0.1543033499620919,508,Yer gonna need a bigger bad cop.
6018,3509,0,0,7,7,1.0,0.1543033499620919,508,not until I get my glass of water
5006,3509,0,0,7,7,1.0,0.1543033499620919,508,Sure. I played a couple of games of 8 Ball with him. But he said he had to be moving on. Why?
6017,3509,0,0,6,6,1.0,0.18257418583505536,508,"Yeah, it looks like my trainer but, uh.. I haven't seen her lately."
6016,3509,0,0,7,7,1.0,0.1543033499620919,508,'I swear it looked like a turtle'.
5009,3509,0,0,7,7,1.0,0.1543033499620919,508,The fava beans and chianti prove nothing.
6011,3509,0,0,7,7,1.0,0.1543033499620919,508,"READ YOUR REPORT CARD, OR ELSE!"
6010,3509,0,0,7,7,1.0,0.1543033499620919,508,Sharks don't have Miranda rights?
5012,3509,0,0,7,7,1.0,0.1543033499620919,508,This was in the 'Shark Tank.' I plead extenuating circumstances!
6009,3509,0,0,9,9,1.0,0.11785113019775792,508,You have to throw out a bigger minnow.
6005,3509,0,0,7,7,1.0,0.1543033499620919,508,"Yeah, all us Sharks have always been a bit slippery."
6004,3509,0,0,7,7,1.0,0.1543033499620919,508,"I'm innocent, y'see? Those ain't my fingerprints."
6001,3509,0,0,7,7,1.0,0.1543033499620919,508,"Talk, or we'll throw you back in the tank."
5969,3509,0,0,7,7,1.0,0.1543033499620919,508,"It jumped me, got canceled, and nobody saw it again. So what?"
5064,3509,0,0,7,7,1.0,0.1543033499620919,508,Sharks don't snitch!
5968,3509,0,0,7,7,1.0,0.1543033499620919,508,"$100,000 for 30% equity! That's my final offer! Take it or leave it, and I want your answer immediately!"
5967,3509,0,0,8,8,1.0,0.1336306209562122,508,"Yes...I ate him, so what! I'm a man eater, it's what we do."
5052,3509,0,0,7,7,1.0,0.1543033499620919,508,Here's the sushi menu.
5936,3509,0,0,7,7,1.0,0.1543033499620919,508,Read the memo: All new recruits get dental checks.
5935,3509,0,0,7,7,1.0,0.1543033499620919,508,Kiss my flippers coppers! You guys can't tell a shark from a dolphin! This is genetic profiling and you know it!
5934,3509,0,0,8,8,1.0,0.1336306209562122,508,Mack the Knife? Never met the guy!
5933,3509,0,0,7,7,1.0,0.1543033499620919,508,Worthless! I'd confess to anything to get off the hook.
5932,3509,0,0,7,7,1.0,0.1543033499620919,508,"No, I did not attack him to be my supper. I just asked Mr. Trump a political question."
5929,3509,0,0,9,9,1.0,0.11785113019775792,508,Odds of be doing it are lower than winning the powerball
5937,3509,0,0,7,7,1.0,0.1543033499620919,508,Let me redeem myself in The Donald's pool.
5928,3509,0,0,7,7,1.0,0.1543033499620919,508,"Yes, I am interested in my Miranda rights."
5058,3509,0,0,9,9,1.0,0.11785113019775792,508,I keep telling you guys I'm a committed Vegan!
5924,3509,0,0,8,8,1.0,0.1336306209562122,508,That was just a dramatic reenactment.
5920,3509,0,0,7,7,1.0,0.1543033499620919,508,Your hunting licence is out of date.
5919,3509,0,0,10,10,1.0,0.10540925533894598,508,So someone lost an arm at Rockaway Beach. What makes you think I know anything about it?
5918,3509,0,0,7,7,1.0,0.1543033499620919,508,He hangs around south of Boston
5917,3509,0,0,7,7,1.0,0.1543033499620919,508,"She was just some woebegone wobbegong, OK?"
5915,3509,0,0,7,7,1.0,0.1543033499620919,508,"Picture or no picture, my client's innocent, I'm telling ya."
5057,3509,0,0,7,7,1.0,0.1543033499620919,508,He'd still be alive if he hadn't called me 'a great honky shark.'
5939,3509,0,0,7,7,1.0,0.1543033499620919,508,You must be the bad cop. Unless that's fish flavored I don't want it.
5944,3509,0,0,8,8,1.0,0.1336306209562122,508,I don't recognize that bank account.
5946,3509,0,0,7,7,1.0,0.1543033499620919,508,Better fess up fella 'cause it's sink or swim time.
5966,3509,0,0,7,7,1.0,0.1543033499620919,508,Yeah! That's the guy who tried to choke me.
5964,3509,0,0,7,7,1.0,0.1543033499620919,508,She was my law professor and I loved her. But I didn't kill her!
5040,3509,0,0,8,8,1.0,0.1336306209562122,508,"No, I keep telling youse, the guy who jumped me was on a motorcycle."
5041,3509,0,0,7,7,1.0,0.1543033499620919,508,"I've already told you, I can't read."
5043,3509,0,0,7,7,1.0,0.1543033499620919,508,"No, I've never seen that dentist in my life."
5960,3509,0,0,7,7,1.0,0.1543033499620919,508,"No, I haven't seen Nemo. Don't you remember Bruce? We're all vegetarians now."
5958,3509,0,0,7,7,1.0,0.1543033499620919,508,Nice legs. Do you always shave them?
5957,3509,0,0,8,8,1.0,0.1336306209562122,508,Did you not realize that we can all see your dorsal fin?
5956,3509,0,0,8,8,1.0,0.1336306209562122,508,I ain't going to be part or your shark fink soup.
5045,3509,0,0,7,7,1.0,0.1543033499620919,508,Maybe Mackie's back in town -- didja think of that?
5047,3509,0,0,7,7,1.0,0.1543033499620919,508,It's Jack The Knife
5953,3509,0,0,7,7,1.0,0.1543033499620919,508,"I told you, my partner is a lawyer and I want him here now."
5950,3509,0,0,6,6,1.0,0.18257418583505536,508,'That's not my bite. I'm a vegan'.
5949,3509,0,0,7,7,1.0,0.1543033499620919,508,The forensic report confirms your tooth marks.
5948,3509,0,0,7,7,1.0,0.1543033499620919,508,I'm fin-ished.
5048,3509,0,0,7,7,1.0,0.1543033499620919,508,SHE WAS SOME PIECE OF TUNA
5947,3509,0,0,6,6,1.0,0.18257418583505536,508,So it was a feeding frenzy - is that a crime?
5038,3509,0,0,7,7,1.0,0.1543033499620919,508,Give him the deep end.
0,3509,0,0,7,7,1.0,0.1543033499620919,508,Boss said he was in the mood for a big lunch.
3388,3509,0,0,7,7,1.0,0.1543033499620919,508,"Dummy, ya nabbed the wrong loan shark!"
4534,3509,0,0,7,7,1.0,0.1543033499620919,508,"The money he bought that with was a gift, not a loan."
1425,3509,0,0,7,7,1.0,0.1543033499620919,508,We're gonna need a bigger investigation room.
1427,3509,0,0,7,7,1.0,0.1543033499620919,508,"It's clear, Mack. That's you on the tugboat down by the river, don'tcha know, with Louie Miller and Sukey Tawdry."
1428,3509,0,0,7,7,1.0,0.1543033499620919,508,"Come closer, and I'll fess up."
1429,3509,0,0,7,7,1.0,0.1543033499620919,508,"I told ya already, I ain't seen her. I am a land shark not a loan shark."
1430,3509,0,0,7,7,1.0,0.1543033499620919,508,"The latest twist on phishing is spear phishing. It's not a sport, it's a scam and I'm the target."
1431,3509,0,0,7,7,1.0,0.1543033499620919,508,Left shark just can't make things right.
1432,3509,0,0,7,7,1.0,0.1543033499620919,508,"Like I said, I never played blackjack before."
1439,3509,0,0,7,7,1.0,0.1543033499620919,508,"I have a watertight alibi, and You Can't Stand the 'Tooth!'"
1441,3509,0,0,7,7,1.0,0.1543033499620919,508,Never eaten that tatoo before in my life.
1442,3509,0,0,7,7,1.0,0.1543033499620919,508,"Damn it, I already told you, I'm a shark, not a rat!"
1444,3509,0,0,7,7,1.0,0.1543033499620919,508,"Let me get this straight. All I have to say is 'you look good enough to eat in that swimsuit,' and I'm free to go?"
1446,3509,0,0,7,7,1.0,0.1543033499620919,508,"For the last time, I'm right shark. You are looking for left shark, he's the one out of sync in life."
1447,3509,0,0,7,7,1.0,0.1543033499620919,508,"Nah, I'm not in any Gang; I'm a lone shark."
1448,3509,0,0,7,7,1.0,0.1543033499620919,508,"It's your FaceBook post from the 21st: 'If it's got 2 legs and in the H2O, it's a meal 2 me :) I"
1422,3509,0,0,7,7,1.0,0.1543033499620919,508,Who are you calling 'chum'?
1449,3509,0,0,7,7,1.0,0.1543033499620919,508,OK you've got your guns and you've got the list of rules - so you think there's something 'fishy' going on ?!
1451,3509,0,0,8,8,1.0,0.1336306209562122,508,That picture? You got me stumped copper.
1452,3509,0,0,7,7,1.0,0.1543033499620919,508,"No, he didn't drive a Sting-Ray."
1453,3509,0,0,7,7,1.0,0.1543033499620919,508,What can I tell ya? Maybe he shoulda gone to The Money Store.
1454,3509,0,0,7,7,1.0,0.1543033499620919,508,"Typical species profiling, I give out some money and you jump to conclusions."
1455,3509,0,0,7,7,1.0,0.1543033499620919,508,"Please, no questions until my seagull counsel arrives."
1456,3509,0,0,7,7,1.0,0.1543033499620919,508,"I know those scarlet billows look bad, but I did not kill old Lucy Brown!"
1457,3509,0,0,7,7,1.0,0.1543033499620919,508,Wouldn't know. He's a Jet.
1459,3509,0,0,7,7,1.0,0.1543033499620919,508,Blue striped surfboard. Don't remember seeing on that day.
1462,3509,0,0,7,7,1.0,0.1543033499620919,508,"No, I'm not a rat."
1463,3509,0,0,7,7,1.0,0.1543033499620919,508,Spielberg's given me a bum rap!
1465,3509,0,0,7,7,1.0,0.1543033499620919,508,"The water wasn't so clear, but I think I saw Nemo swimming by in a funny way."
1468,3509,0,0,7,7,1.0,0.1543033499620919,508,"I was home alone yesterday and an intruder came in, so I ate him."
1471,3509,0,0,7,7,1.0,0.1543033499620919,508,Spielberg made me do it.
1473,3509,0,0,7,7,1.0,0.1543033499620919,508,"Officer it's him, Mack the Knife."
1450,3509,0,0,8,8,1.0,0.1336306209562122,508,"Ahab?? Ya got me, detective. Ahab who?"
1421,3509,0,0,7,7,1.0,0.1543033499620919,508,I told you already – he fell and landed in two halves like that.
1420,3509,0,0,7,7,1.0,0.1543033499620919,508,"I think you will need to talk to my friend, the hammer head shark, about this situation in order to hit the nail on the head."
1419,3509,0,0,7,7,1.0,0.1543033499620919,508,He defaulted on the loan and got what he deserved.
1369,3509,0,0,7,7,1.0,0.1543033499620919,508,"Mack the Knife... maybe I recognize him, maybe I don't."
1370,3509,0,0,7,7,1.0,0.1543033499620919,508,Seriously? Write down my statement?
1372,3509,0,0,7,7,1.0,0.1543033499620919,508,You shouldn't jump to conclusions.
1373,3509,0,0,7,7,1.0,0.1543033499620919,508,That's Bruce....we used to chum around together....
1374,3509,0,0,7,7,1.0,0.1543033499620919,508,Is this the guy you we're getting chummy with?
1375,3509,0,0,7,7,1.0,0.1543033499620919,508,Last time I saw her she was going to meet Spielberg for a remake!
1376,3509,0,0,7,7,1.0,0.1543033499620919,508,That's octopus ink. I did not eat the octopus!
1377,3509,0,0,8,8,1.0,0.1336306209562122,508,This isn't what I meant when I said I want to see a lawyer
1379,3509,0,0,7,7,1.0,0.1543033499620919,508,At least you gave me a Miranda warning.
1380,3509,0,0,7,7,1.0,0.1543033499620919,508,I ain't no cardshark. You got the wrong guy.
1381,3509,0,0,8,8,1.0,0.1336306209562122,508,I was just trying to get the human out of his cage
1382,3509,0,0,7,7,1.0,0.1543033499620919,508,"Look, I may have loaned this guy money but I ain't no killer whale!"
1383,3509,0,0,7,7,1.0,0.1543033499620919,508,"You're wastin you're time boys, old Jimmy's swimmin with the fishes."
1385,3509,0,0,7,7,1.0,0.1543033499620919,508,"Until I speak with my attorney, I'm pleading the fish."
1386,3509,0,0,8,8,1.0,0.1336306209562122,508,"Yes, that is Jerry Tarkanian."
1387,3509,0,0,7,7,1.0,0.1543033499620919,508,"And what do we have here?' 'Look, I just want my food. I don't care what you have to do to get that, just give it to me.' 'Hey I just want my money that you owe me."
1388,3509,0,0,7,7,1.0,0.1543033499620919,508,"I don't know Aqua Man, it was murky down there."
1416,3509,0,0,7,7,1.0,0.1543033499620919,508,I'll rot in Monterey before I give yous'e anything.
1415,3509,0,0,7,7,1.0,0.1543033499620919,508,I'm not interested in faces.
1412,3509,0,0,7,7,1.0,0.1543033499620919,508,"No, I did not eat Nemo"
1410,3509,0,0,7,7,1.0,0.1543033499620919,508,This is water.
1407,3509,0,0,7,7,1.0,0.1543033499620919,508,"Yeah, that's him. That's the guy I ate."
1406,3509,0,0,8,8,1.0,0.1336306209562122,508,"Looks like a Hook, Line, and Sinker!"
1475,3509,0,0,7,7,1.0,0.1543033499620919,508,I never put a finger on that swimmer.
1404,3509,0,0,8,8,1.0,0.1336306209562122,508,How should I know who that is? There are lots of fish in the sea.
1400,3509,0,0,8,8,1.0,0.1336306209562122,508,"Listen dude,I ain't seen no Nemo!"
1395,3509,0,0,7,7,1.0,0.1543033499620919,508,My only regret is that he wasn't fatter.
1394,3509,0,0,7,7,1.0,0.1543033499620919,508,i swear that guy just fell into my mouth
1393,3509,0,0,7,7,1.0,0.1543033499620919,508,"Yes, I know Nemo. But fish are friends not food"
1392,3509,0,0,7,7,1.0,0.1543033499620919,508,I can't always remember what I ate. So how do you expect me to identify it?
1389,3509,0,0,7,7,1.0,0.1543033499620919,508,Boating accident.
1403,3509,0,0,7,7,1.0,0.1543033499620919,508,"Yes, he's the one who stole my sharkskin purse."
1476,3509,0,0,8,8,1.0,0.1336306209562122,508,"I keep telling you, that's not me. We DO all look alike."
1477,3509,0,0,8,8,1.0,0.1336306209562122,508,You are nothing but a two-bit loan shark
1478,3509,0,0,7,7,1.0,0.1543033499620919,508,Can you just move that over to my left a bit?...
1541,3509,0,0,7,7,1.0,0.1543033499620919,508,I swear I've never seen that surfboard before!
1542,3509,0,0,8,8,1.0,0.1336306209562122,508,"Yeah, that's my cousin Eddy. You say he ate Spielberg?"
1544,3509,0,0,7,7,1.0,0.1543033499620919,508,But you said to really 'hotdog it' on this contract!
1545,3509,0,0,7,7,1.0,0.1543033499620919,508,I've already told you; I was with left shark.
1546,3509,0,0,7,7,1.0,0.1543033499620919,508,I am a L-O-N-E shark!
1547,3509,0,0,7,7,1.0,0.1543033499620919,508,"Yeah, I know him. Did you think building a wall would keep him out?"
1549,3509,0,0,8,8,1.0,0.1336306209562122,508,You can't make me say anything about my client. Its all attorney client privilege.
1550,3509,0,0,7,7,1.0,0.1543033499620919,508,"Yeah, so what? He still looks like a seal to me."
1551,3509,0,0,8,8,1.0,0.1336306209562122,508,"'Sir is this criminal fine for the dinner'. the shark says 'I want the fat person, not like skinny as him.'!:)"
1552,3509,0,0,8,8,1.0,0.1336306209562122,508,"Greg? Sure, he's an old chum of mine."
1553,3509,0,0,7,7,1.0,0.1543033499620919,508,I already told you officer. Those puffer fish aren't mine!
1556,3509,0,0,7,7,1.0,0.1543033499620919,508,"That's road kill, you think I take a lot of midnight strolls?"
1557,3509,0,0,7,7,1.0,0.1543033499620919,508,"I keep telling you, I've never been to Amity!"
1558,3509,0,0,7,7,1.0,0.1543033499620919,508,"Yea, Yea!! That's the guy who bit me!"
1559,3509,0,0,8,8,1.0,0.1336306209562122,508,You insult me. Only amateurs leave raggedy edges like that.
1561,3509,0,0,7,7,1.0,0.1543033499620919,508,Didn't anyone ever tell you that sharks don't have binocular vision?
1563,3509,0,0,7,7,1.0,0.1543033499620919,508,I didn't know it was a baby seal.
1587,3509,0,0,7,7,1.0,0.1543033499620919,508,I never seen that tuna before.
1586,3509,0,0,7,7,1.0,0.1543033499620919,508,"No Sir, that is NOT the leg I ate."
1585,3509,0,0,7,7,1.0,0.1543033499620919,508,"Yeah, that's my cousin, Vinny -with some guy's foot in his mouth . . . So what? You got nothin' on me, copper."
1583,3509,0,0,8,8,1.0,0.1336306209562122,508,"No, I don’t recognize him, but the teeth look like those of the very big man in a James Bond movie."
1582,3509,0,0,8,8,1.0,0.1336306209562122,508,"I admit that I took a little bite, but I really was just there to deliver a candygram."
1579,3509,0,0,8,8,1.0,0.1336306209562122,508,What is the nature of your relationship with this attorney?
1538,3509,0,0,7,7,1.0,0.1543033499620919,508,See this? The polyethylene found at the crime scene matches your DNA.
1577,3509,0,0,7,7,1.0,0.1543033499620919,508,Is this the idiot that borrowed money off of you?
1573,3509,0,0,7,7,1.0,0.1543033499620919,508,It was self defense. The swimmer was armed.
1572,3509,0,0,7,7,1.0,0.1543033499620919,508,I would never eat something that looks like THAT!
1571,3509,0,0,7,7,1.0,0.1543033499620919,508,In my defense he was wearing a 'Pepperidge Farms' t-shirt.
1568,3509,0,0,7,7,1.0,0.1543033499620919,508,What do you mean all human torsos look alike? This one has a Sugar Ray tattoo!
1567,3509,0,0,7,7,1.0,0.1543033499620919,508,"'Not me, thats my brother Clyde"
1566,3509,0,0,8,8,1.0,0.1336306209562122,508,Nah that ain't him. That's just a big tuna.
1575,3509,0,0,7,7,1.0,0.1543033499620919,508,I'm farsighted. You're gonna need bigger note.
1367,3509,0,0,7,7,1.0,0.1543033499620919,508,When you have to investigate a shark and hear nothing but the shark's tail ;)
1537,3509,0,0,7,7,1.0,0.1543033499620919,508,No Way! Not my handwriting!
1534,3509,0,0,7,7,1.0,0.1543033499620919,508,That's not me...I was an extra on shark week that day.
1479,3509,0,0,7,7,1.0,0.1543033499620919,508,I never eat and tell.
1480,3509,0,0,8,8,1.0,0.1336306209562122,508,He was bald and fat and gave me a bad case of indigestion.
1481,3509,0,0,7,7,1.0,0.1543033499620919,508,I'll say it again: he's no chum of mine!
1483,3509,0,0,7,7,1.0,0.1543033499620919,508,Yes you have the right to an attorney but if you've eaten that attorney you're on your own now
1484,3509,0,0,7,7,1.0,0.1543033499620919,508,I haven't seen Katy Perry since that night.
1485,3509,0,0,7,7,1.0,0.1543033499620919,508,"It's not on this menu, but I believe I'll have the Good Cop/Bad Cop Sushi."
1491,3509,0,0,7,7,1.0,0.1543033499620919,508,But I don't even work at Seaworld.
1494,3509,0,0,7,7,1.0,0.1543033499620919,508,This page intentionally left blank.
1496,3509,0,0,7,7,1.0,0.1543033499620919,508,"Damn it, I told you! Those aren't my selfies!"
1497,3509,0,0,7,7,1.0,0.1543033499620919,508,I swear that is the suicide note I was handed before that guy jumped into my mouth.
1498,3509,0,0,7,7,1.0,0.1543033499620919,508,"He's at 42 Wallaby Way, Sydney."
1499,3509,0,0,8,8,1.0,0.1336306209562122,508,"I wasn't even near that beach and besides, I'm avoiding anyone who still consumes GMO's"
1500,3509,0,0,7,7,1.0,0.1543033499620919,508,He's guilty. He's even wearing my tooth as a necklace.
1505,3509,0,0,7,7,1.0,0.1543033499620919,508,I don't know anything about that!
1506,3509,0,0,7,7,1.0,0.1543033499620919,508,"Those could be anyone's tooth impressions on that surfboard, how do you know their mine?!"
1507,3509,0,0,7,7,1.0,0.1543033499620919,508,"That's not my handwriting, copper. That's some tuna's handwriting."
1510,3509,0,0,7,7,1.0,0.1543033499620919,508,"Holy mackerel, I know him!"
1533,3509,0,0,7,7,1.0,0.1543033499620919,508,"No, Officers I told you a hundred times, I'm not investing in your side projects. Now put me back in the tank."
1531,3509,0,0,7,7,1.0,0.1543033499620919,508,I'm not talking until my brother the lawyer gets here.
1529,3509,0,0,7,7,1.0,0.1543033499620919,508,Those guys are a bunch of chumbags
1528,3509,0,0,8,8,1.0,0.1336306209562122,508,It shows he was killed by a blunt instrument. Do I look like a hammerhead?
1527,3509,0,0,7,7,1.0,0.1543033499620919,508,I'm only talking to Brody!
1526,3509,0,0,7,7,1.0,0.1543033499620919,508,Could you pick out this leg in a lineup?
1535,3509,0,0,7,7,1.0,0.1543033499620919,508,"I haven't seen Willy, I swear. Not since he was freed."
1525,3509,0,0,7,7,1.0,0.1543033499620919,508,"Hey, go easy. I'm having a hard time breathing."
1520,3509,0,0,7,7,1.0,0.1543033499620919,508,And I'm telling you I've never been to the Great Barrier Reef!
1519,3509,0,0,7,7,1.0,0.1543033499620919,508,Not all sharks will take the bait.
1518,3509,0,0,7,7,1.0,0.1543033499620919,508,If you would please since I have issues with the postal service.
1517,3509,0,0,7,7,1.0,0.1543033499620919,508,Your pictures of soup don't scare me
1515,3509,0,0,7,7,1.0,0.1543033499620919,508,No jail bait.
1514,3509,0,0,7,7,1.0,0.1543033499620919,508,That shark fin soup recipe doesn't scare me.
1524,3509,0,0,9,9,1.0,0.11785113019775792,508,"You can't make me bite, Sarge."
1365,3509,0,0,7,7,1.0,0.1543033499620919,508,"Hey man, I didn't force you to take out those student loans."
1364,3509,0,0,7,7,1.0,0.1543033499620919,508,"Nope, never seen that orca before in my life . . . can I go now?"
1363,3509,0,0,7,7,1.0,0.1543033499620919,508,I said I had no remoras.
1173,3509,0,0,6,6,1.0,0.18257418583505536,508,"Yea,That's him ! I'd recognize Jacques Cousteau any where even without the bubbles."
1176,3509,0,0,7,7,1.0,0.1543033499620919,508,"you can play white cop black cop all you want, but I never saw that propose before."
1179,3509,0,0,7,7,1.0,0.1543033499620919,508,Not my style. I always eat the Fitbit.
1180,3509,0,0,7,7,1.0,0.1543033499620919,508,They all look the same to me. Just tasty morsels!
1181,3509,0,0,7,7,1.0,0.1543033499620919,508,Forensics shmorensics. I floss after every meal.
1182,3509,0,0,7,7,1.0,0.1543033499620919,508,The last time we saw each other was on the set of Jaws 3.
1184,3509,0,0,7,7,1.0,0.1543033499620919,508,"I don't care how many pictures you show me, it's like I keep telling you, everybody is my chum."
1185,3509,0,0,7,7,1.0,0.1543033499620919,508,"Yeah, that's the guppy."
1188,3509,0,0,7,7,1.0,0.1543033499620919,508,Is this you? Looks just like you sunning yourself on the beach. You know you don't belong there with people.You are goingstraight back to the water.
1189,3509,0,0,7,7,1.0,0.1543033499620919,508,I guess we have a Shark Tale to talk about!
1193,3509,0,0,7,7,1.0,0.1543033499620919,508,How Jaws really ended...
1197,3509,0,0,7,7,1.0,0.1543033499620919,508,"Look, even if your right about me swallowing an AK-47, there's no way it's coming up."
1199,3509,0,0,7,7,1.0,0.1543033499620919,508,"No sir, that’s not my fin in that soup."
1204,3509,0,0,7,7,1.0,0.1543033499620919,508,"No, I was not at the beach and yes this is profiling..."
1206,3509,0,0,7,7,1.0,0.1543033499620919,508,This is our mutual professional courtesy agreement.
1207,3509,0,0,7,7,1.0,0.1543033499620919,508,Look somewhere else. I have better taste than that.
1209,3509,0,0,9,9,1.0,0.11785113019775792,508,"Jeez, my fin looks big. I need to lay off the sushi."
1233,3509,0,0,7,7,1.0,0.1543033499620919,508,Keep Talking!
1232,3509,0,0,7,7,1.0,0.1543033499620919,508,I'm tellin' ya for the last time. I'm a vegan!
1231,3509,0,0,7,7,1.0,0.1543033499620919,508,Ever loan this guy any money?
1230,3509,0,0,7,7,1.0,0.1543033499620919,508,I've never been To New England and my names not Bruce!
1228,3509,0,0,7,7,1.0,0.1543033499620919,508,I'm only talking to my attorney and he's a real shark.
1227,3509,0,0,7,7,1.0,0.1543033499620919,508,"Go ahead, check my stomach for her"
1172,3509,0,0,7,7,1.0,0.1543033499620919,508,"Yeah, I recognize the punk. Name's 'MacHeath,' carries a jackknife."
1226,3509,0,0,7,7,1.0,0.1543033499620919,508,Yeah? Well I say I've never heard of Amity Island.
1224,3509,0,0,7,7,1.0,0.1543033499620919,508,WHAT DO YOU MEAN YOU NEVER SEEN ANYBODY THAT LOOKED LIKE THAT
1216,3509,0,0,7,7,1.0,0.1543033499620919,508,I wasn't there that night! That's Flipper!
1215,3509,0,0,7,7,1.0,0.1543033499620919,508,Is this you with Kevin's chum?
1214,3509,0,0,8,8,1.0,0.1336306209562122,508,"Nice try, but that's from 'Jaws'. Get me a lawyer and a Netflix deal, now."
1212,3509,0,0,7,7,1.0,0.1543033499620919,508,The Jets framed us.
1210,3509,0,0,7,7,1.0,0.1543033499620919,508,Yeah. I know him. He sleeps with the fish.
1225,3509,0,0,7,7,1.0,0.1543033499620919,508,"Sure, I made a loan to that dirty mackerel. But I didn't whack him. I'm a legitimate business fish."
1234,3509,0,0,7,7,1.0,0.1543033499620919,508,Read this and we won't have to stay here all day!
1171,3509,0,0,7,7,1.0,0.1543033499620919,508,"Yeah, that's the guy. He said if I endorsed Trump he'd put me on the staff."
1166,3509,0,0,7,7,1.0,0.1543033499620919,508,'I swear..I've never seen that fin before'!
1107,3509,0,0,7,7,1.0,0.1543033499620919,508,"I told you before, I did NOT make that loan!"
1109,3509,0,0,7,7,1.0,0.1543033499620919,508,I prefer 'loans advisor'.
1114,3509,0,0,7,7,1.0,0.1543033499620919,508,I didn't realize it was a school of fish zone.
1115,3509,0,0,8,8,1.0,0.1336306209562122,508,Was this guy last night's dinner Was this guy last night's dinner? /
1116,3509,0,0,7,7,1.0,0.1543033499620919,508,"That's not me. I don't eat humans anymore! They are too fatty, and bad for my cholesterol."
1119,3509,0,0,7,7,1.0,0.1543033499620919,508,You got a bone to pick with me?!?
1122,3509,0,0,8,8,1.0,0.1336306209562122,508,"So, just because I'm a shark, you think I ate the surfer."
1124,3509,0,0,6,6,1.0,0.18257418583505536,508,I've never seen those legs in my life.
1125,3509,0,0,7,7,1.0,0.1543033499620919,508,Shark Face nothing. I look better than that. It wasn't me. Your not putting me in the can!
1127,3509,0,0,7,7,1.0,0.1543033499620919,508,Bland and stringy....
1129,3509,0,0,7,7,1.0,0.1543033499620919,508,"I already told you, I didn't bite her, so I have no idea what she tastes like."
1131,3509,0,0,8,8,1.0,0.1336306209562122,508,"You're not going back to sea, Fin Fin, until you confess!"
1132,3509,0,0,8,8,1.0,0.1336306209562122,508,"That's not a person, I didn't bite him, and if I did he didn't taste good -- so why would I bite him?"
1135,3509,0,0,7,7,1.0,0.1543033499620919,508,HARD TO RECOGNIZE WITH BOTH ARMS AND LEGS IN TACK  !
1136,3509,0,0,7,7,1.0,0.1543033499620919,508,"Yeah, my wife's on that menu. You still got nothin on me."
1137,3509,0,0,7,7,1.0,0.1543033499620919,508,Super-size... Why not?!
1139,3509,0,0,9,9,1.0,0.11785113019775792,508,"You've got the wrong guy, I'm a white shark."
1165,3509,0,0,7,7,1.0,0.1543033499620919,508,Me? A bank robbery? You guys are bad at this profiling thing.
1161,3509,0,0,8,8,1.0,0.1336306209562122,508,You know I'm color blind. Go fish.
1159,3509,0,0,7,7,1.0,0.1543033499620919,508,That's not my seaweed.
1156,3509,0,0,9,9,1.0,0.11785113019775792,508,"No, that is not my ticket. My ticket was for Delta flight 645 to Atlanta."
1152,3509,0,0,7,7,1.0,0.1543033499620919,508,I was just trying to break him out of the underwater jail officer
1151,3509,0,0,7,7,1.0,0.1543033499620919,508,"Yes, but the old ones don't taste so good."
1170,3509,0,0,7,7,1.0,0.1543033499620919,508,"Sorry, have never been in a musical."
1149,3509,0,0,7,7,1.0,0.1543033499620919,508,"I wasn't trying to terrorize anyone. Yeah, sure I bumped into him a few times, but I wasn't trying to scare him. They just taste better."
1147,3509,0,0,8,8,1.0,0.1336306209562122,508,Never saw that loan in my life.
1146,3509,0,0,7,7,1.0,0.1543033499620919,508,"Be a buddy, not a bully."
1143,3509,0,0,7,7,1.0,0.1543033499620919,508,"Guy knocks on my door, says 'candy-gram' -- I had to."
1142,3509,0,0,7,7,1.0,0.1543033499620919,508,"Read him his rights, Murphy, he's a real killer. How do we handcuff him?"
1141,3509,0,0,7,7,1.0,0.1543033499620919,508,"Yep I know him he's one of Mussels Marinara's boys, small fish floats down near pier 17 or where ever the current takes em."
1140,3509,0,0,7,7,1.0,0.1543033499620919,508,"Do I recognize the body parts? No, that's no chum of mine..."
1148,3509,0,0,8,8,1.0,0.1336306209562122,508,"Buddy, I don't even sleep with the fishes."
1590,3509,0,0,8,8,1.0,0.1336306209562122,508,"Don't give me the old all-phytoplankton-look-alike routine, Buddy."
1236,3509,0,0,8,8,1.0,0.1336306209562122,508,"It was 'loan shark, pool shark, then Shark Week.' I just couldn't take it any more!"
1240,3509,0,0,8,8,1.0,0.1336306209562122,508,"Never saw him, besides, I was at my baby mama shark house."
1303,3509,0,0,7,7,1.0,0.1543033499620919,508,"I'll wear a wire, but I ain't wearing it under a shark skin suit."
1304,3509,0,0,7,7,1.0,0.1543033499620919,508,That's not a very good picture of me.
1305,3509,0,0,7,7,1.0,0.1543033499620919,508,"That's the bloody leg, alright, but it was an accident."
1306,3509,0,0,8,8,1.0,0.1336306209562122,508,"Yeah, that's the guy I ate, he invaded my personal space."
1307,3509,0,0,7,7,1.0,0.1543033499620919,508,"I'd like to speak to my shark, er, lawyer."
1308,3509,0,0,7,7,1.0,0.1543033499620919,508,These silly pictures serve absolutely no porpoise.
1310,3509,0,0,7,7,1.0,0.1543033499620919,508,That's not my chum.
1311,3509,0,0,7,7,1.0,0.1543033499620919,508,"Yeah I seen him down by da pool, he's a pool shark."
1315,3509,0,0,7,7,1.0,0.1543033499620919,508,"I'm not that kind of predator, I tell you!"
1318,3509,0,0,7,7,1.0,0.1543033499620919,508,I never touched THAT harbor seal.
1319,3509,0,0,7,7,1.0,0.1543033499620919,508,My 'alibi' is shark week.
1323,3509,0,0,7,7,1.0,0.1543033499620919,508,One more time: where's the swim team ?
1324,3509,0,0,8,8,1.0,0.1336306209562122,508,"I'm telling you, I'm a victim of profiling."
1325,3509,0,0,7,7,1.0,0.1543033499620919,508,"No, I'm not Moby Dick."
1330,3509,0,0,8,8,1.0,0.1336306209562122,508,I don't know that hammerhead
1333,3509,0,0,7,7,1.0,0.1543033499620919,508,"Nobody actually says, 'sleeping with the fishes.'"
1334,3509,0,0,7,7,1.0,0.1543033499620919,508,"I told you, some of my best friends are surfers, but I don't know this guy."
1359,3509,0,0,7,7,1.0,0.1543033499620919,508,"Yeah, I heard he was sleeping with the fishes"
1358,3509,0,0,7,7,1.0,0.1543033499620919,508,Please take another look at the numbers Jawrome. Are you sure you don't want to fund my startup idea for organic hair restoration?
1351,3509,0,0,9,9,1.0,0.11785113019775792,508,"What is this, a roar-shark test?"
1350,3509,0,0,7,7,1.0,0.1543033499620919,508,How am I going to read that? I am a Shark hello!
1347,3509,0,0,7,7,1.0,0.1543033499620919,508,"Yeah, I've made some loans."
1346,3509,0,0,8,8,1.0,0.1336306209562122,508,"Sure I know Marlin, he's Nemo dad, what's it to ya"
1302,3509,0,0,7,7,1.0,0.1543033499620919,508,"It possibly could be Greg Norman, why do you ask?"
1345,3509,0,0,7,7,1.0,0.1543033499620919,508,"Yeah, it could be the guy that I ate but it was really dark and I had been out with the guys, you guys understand? Late night snack and he looked like a seal."
1341,3509,0,0,7,7,1.0,0.1543033499620919,508,See... Even the fact checker says this statement is inaccurate.
1340,3509,0,0,7,7,1.0,0.1543033499620919,508,"No, they did not jump over me."
1338,3509,0,0,8,8,1.0,0.1336306209562122,508,"Yes, I gave that man a loan. But what you called me is offensive - I'm a predatory lender."
1337,3509,0,0,7,7,1.0,0.1543033499620919,508,I have no connection to that chum.
1336,3509,0,0,7,7,1.0,0.1543033499620919,508,Have you not figured out that all sockeye salmon look alike?
1335,3509,0,0,7,7,1.0,0.1543033499620919,508,"It wasn't me, I'm telling you! I work the Blue Horizon Show, everyday at Sea World, 10:00 AM, 1:00 PM, and 4:00 PM. Call my boss if you don't believe me."
1343,3509,0,0,7,7,1.0,0.1543033499620919,508,Do you recognize the teeth marks on this surfboard?
1239,3509,0,0,7,7,1.0,0.1543033499620919,508,Making A Carnivore
1301,3509,0,0,7,7,1.0,0.1543033499620919,508,"She had eyes like strange sins...Sorry, fellas - big fan of Raymond Chandler"
1299,3509,0,0,8,8,1.0,0.1336306209562122,508,Take a look at this leg and tell me where you were Thursday night.
1243,3509,0,0,9,9,1.0,0.11785113019775792,508,"I keep telling you, it was the Jets who pulled off the west side job."
1244,3509,0,0,7,7,1.0,0.1543033499620919,508,"Yeah, I know him, my brother-in-law, I tried to dissuade him but he wanted to swim in their Shark Tank!"
1247,3509,0,0,8,8,1.0,0.1336306209562122,508,Shark: I sea nothing. What is this? Officer: This what you're fin-ed for.
1249,3509,0,0,7,7,1.0,0.1543033499620919,508,Spielberg.
1250,3509,0,0,7,7,1.0,0.1543033499620919,508,Lots of people swim with the fishes. I can't remember them all.
1251,3509,0,0,7,7,1.0,0.1543033499620919,508,I never lent him a nickel.
1252,3509,0,0,7,7,1.0,0.1543033499620919,508,Are these really the FINished blueprints? They look like a child's JAWing!
1253,3509,0,0,7,7,1.0,0.1543033499620919,508,"You say I wrote that? I say its fishy. Sharks are elasmobranchii, not fish. That has nothing to do with me."
1254,3509,0,0,7,7,1.0,0.1543033499620919,508,This one seems kinda fishy
1255,3509,0,0,7,7,1.0,0.1543033499620919,508,I'm a shark not a rat detective.
1259,3509,0,0,7,7,1.0,0.1543033499620919,508,"Yeah, I've seen that blood in the water. So what?"
1261,3509,0,0,7,7,1.0,0.1543033499620919,508,I told you! He was trespassing on MY BEACH!
1262,3509,0,0,7,7,1.0,0.1543033499620919,508,Ok. Yeah. I know him. Steven Spielberg. May I go now?
1263,3509,0,0,10,10,1.0,0.10540925533894598,508,"Ok show me the picture for the The New Yorker caption contest, two detectives showing a shark a picture hmm, sorry officers I got nothing."
1265,3509,0,0,7,7,1.0,0.1543033499620919,508,I didn't make no loans.
1266,3509,0,0,7,7,1.0,0.1543033499620919,508,"I told you, officer, I'm not a killer whale"
1268,3509,0,0,7,7,1.0,0.1543033499620919,508,Killed by a blunt instrument? Sounds like the work of Hector the hammerhead.
1298,3509,0,0,8,8,1.0,0.1336306209562122,508,That's me and the grandkids at the beach.
1297,3509,0,0,7,7,1.0,0.1543033499620919,508,The sashimi special looks nice.
1292,3509,0,0,9,9,1.0,0.11785113019775792,508,"Is this some kind of trick? This one looks like lunch, too."
1291,3509,0,0,7,7,1.0,0.1543033499620919,508,"Listen, I'm a shark. I can't remember what I ate for breakfast this morning, never mind a day at the beach last week."
1289,3509,0,0,8,8,1.0,0.1336306209562122,508,He was a lone shark.
1287,3509,0,0,7,7,1.0,0.1543033499620919,508,I've never seen that sea lion in my life.
1300,3509,0,0,7,7,1.0,0.1543033499620919,508,I swim and I eat. Will that help me either either?
1286,3509,0,0,9,9,1.0,0.11785113019775792,508,"I see a Guy Fawkes mask, and I see a hoodie that, okay, doesn't fit so well. That all you got?"
1283,3509,0,0,7,7,1.0,0.1543033499620919,508,"OK, I confess! I'm a serial killer and I eat my victims!"
1282,3509,0,0,7,7,1.0,0.1543033499620919,508,Luca Brasi? Never heard of him.
1277,3509,0,0,8,8,1.0,0.1336306209562122,508,I never bite canvas rafts !
1274,3509,0,0,7,7,1.0,0.1543033499620919,508,I didn't get a very good look--he was standing still.
1272,3509,0,0,7,7,1.0,0.1543033499620919,508,I'm more statistically likely to be your father.
1270,3509,0,0,8,8,1.0,0.1336306209562122,508,I just posted it. How many likes do I have?
1284,3509,0,0,7,7,1.0,0.1543033499620919,508,What do you want me to do? It's not my fault your lunch fell into the ocean.
1106,3509,0,0,7,7,1.0,0.1543033499620919,508,"You see one surfer, you've seen them all."
1591,3509,0,0,7,7,1.0,0.1543033499620919,508,"Hard to tell, could be Jimmy The Squid on da left? Like I said, I don't mix with these types no more. I'm on the up and up. I'm legit! I'm a licensed property appraiser!"
1593,3509,0,0,7,7,1.0,0.1543033499620919,508,"i aint gonna sign nuttin, ya know why?--cause i aint got no hands...."
1943,3509,0,0,7,7,1.0,0.1543033499620919,508,"Listen copper, I keep telling you -- I'm no rat!"
1944,3509,0,0,7,7,1.0,0.1543033499620919,508,What's a 'swimmer'?
1947,3509,0,0,7,7,1.0,0.1543033499620919,508,"You can trust me, I'm a lawyer."
1949,3509,0,0,8,8,1.0,0.1336306209562122,508,"Alibi? Sorry, the remora is already cooperating with us."
1953,3509,0,0,7,7,1.0,0.1543033499620919,508,I dunno -- you gotta picture of just his bottom half?
1954,3509,0,0,7,7,1.0,0.1543033499620919,508,The glass you're holding has a crooked bottom. You'll thank me for that later...
1955,3509,0,0,7,7,1.0,0.1543033499620919,508,Sure I know him I had him for breakfast.
1958,3509,0,0,7,7,1.0,0.1543033499620919,508,They don't call me hammerhead for nothing!
1960,3509,0,0,8,8,1.0,0.1336306209562122,508,"Vegans, Yes! Vegan, NO!"
1961,3509,0,0,7,7,1.0,0.1543033499620919,508,I thought this was 'Shark Tank'!
1963,3509,0,0,7,7,1.0,0.1543033499620919,508,I didn't eat him; I'm a diabetic.
1964,3509,0,0,7,7,1.0,0.1543033499620919,508,"Have I seen this person before? I can't remember what I had for supper last night, never mind a month ago."
1965,3509,0,0,7,7,1.0,0.1543033499620919,508,"Unless you come clean, you're going upriver to an aquarium for the rest of your life."
1967,3509,0,0,6,6,1.0,0.18257418583505536,508,Officer that's not my dorsal fin. I stopped going to the Hamptons years ago.
1942,3509,0,0,7,7,1.0,0.1543033499620919,508,"I told you, I don't remember anything from that night. I was tanked."
1968,3509,0,0,7,7,1.0,0.1543033499620919,508,"So what, his legs are broke. I'm a SAND shark."
1972,3509,0,0,7,7,1.0,0.1543033499620919,508,"C'mon, stop jerking us around...we found his leg in your freezer...what did you do with the rest of him?"
1973,3509,0,0,7,7,1.0,0.1543033499620919,508,"Nice try, but I know shark bait when I see it."
1980,3509,0,0,7,7,1.0,0.1543033499620919,508,"I'm telling you, that's not me. I'm just a loan shark......."
1984,3509,0,0,7,7,1.0,0.1543033499620919,508,"Listen, I only saw his legs and Speedo. I never got a look at his face."
1985,3509,0,0,7,7,1.0,0.1543033499620919,508,It's that damn music!
1988,3509,0,0,7,7,1.0,0.1543033499620919,508,Not me. Looks like it's just some dude in a shark skin suit.
1989,3509,0,0,7,7,1.0,0.1543033499620919,508,Finicky doesn't mean what you think.
1992,3509,0,0,8,8,1.0,0.1336306209562122,508,True or False: Did you loan him this much??
1993,3509,0,0,7,7,1.0,0.1543033499620919,508,Do you have any sufishings.
1995,3509,0,0,7,7,1.0,0.1543033499620919,508,Some loan shark! You signed a note!
1996,3509,0,0,7,7,1.0,0.1543033499620919,508,"'yes, I am..... :( .......sharcula'!!!!!!! 'I knew it'."
1998,3509,0,0,7,7,1.0,0.1543033499620919,508,I told ya! I didn't loan anybody anything!
2005,3509,0,0,9,9,1.0,0.11785113019775792,508,Oh sure...blame it on the White Shark...
2008,3509,0,0,7,7,1.0,0.1543033499620919,508,Tom the shark got arrested for eating people on the beaches of Redondo. The police arrested him and interrogated him and plead guilty to 1st degree murder.
1971,3509,0,0,7,7,1.0,0.1543033499620919,508,"MacHeath? Nah, never heard of him."
1938,3509,0,0,7,7,1.0,0.1543033499620919,508,Them loans was all within government guidelines.
1937,3509,0,0,7,7,1.0,0.1543033499620919,508,"I suggested take-out, but no one ever listens to me."
1936,3509,0,0,7,7,1.0,0.1543033499620919,508,I swear I've never seen that surfboard before in my life.
1873,3509,0,0,9,9,1.0,0.11785113019775792,508,We have your fin print at the aquarium. Just give up the dolphins and we can all go home.
1874,3509,0,0,7,7,1.0,0.1543033499620919,508,I am my own attorney
1877,3509,0,0,7,7,1.0,0.1543033499620919,508,That's not me! And this is nothing but species profiling.
1882,3509,0,0,8,8,1.0,0.1336306209562122,508,"I ate Trump's peruke, I certainly didn't have room for yours."
1883,3509,0,0,7,7,1.0,0.1543033499620919,508,Your alibi is pretty fishy.
1884,3509,0,0,7,7,1.0,0.1543033499620919,508,"Mack the Knife? Never heard of him, and besides I'm off the paleo diet these days!"
1885,3509,0,0,7,7,1.0,0.1543033499620919,508,"You're crazy. That looks nothing like me, copper."
1886,3509,0,0,7,7,1.0,0.1543033499620919,508,A word of advice. Don't jump me.
1887,3509,0,0,7,7,1.0,0.1543033499620919,508,"I'm a LOAN shark, I tell ya. A LOAN shark..."
1893,3509,0,0,7,7,1.0,0.1543033499620919,508,"I already told you, I victims all look the same: white, small fish."
1895,3509,0,0,7,7,1.0,0.1543033499620919,508,He sure didn't taste that fatty.
1898,3509,0,0,8,8,1.0,0.1336306209562122,508,"I've already had some, thank you."
1899,3509,0,0,7,7,1.0,0.1543033499620919,508,"For the last time, I did not give him a loan."
1901,3509,0,0,7,7,1.0,0.1543033499620919,508,"I have never, nor would I ever loan that guy money."
1903,3509,0,0,7,7,1.0,0.1543033499620919,508,I've never seen that thing I thought was a seal before in my life.
1904,3509,0,0,7,7,1.0,0.1543033499620919,508,"Don't know the name, just know he was a Jet."
1905,3509,0,0,7,7,1.0,0.1543033499620919,508,Sign the confession now or I'll get Orca to persuade you.
1935,3509,0,0,7,7,1.0,0.1543033499620919,508,"I Know I have aright to an attorney, but No Tanks."
1933,3509,0,0,8,8,1.0,0.1336306209562122,508,you have never seen shark tank!!
1930,3509,0,0,8,8,1.0,0.1336306209562122,508,Wanna prove I did it? Try matching the bite mark.
1929,3509,0,0,8,8,1.0,0.1336306209562122,508,Answers to the name of Nemo. Last seen heading toward the surface.
1928,3509,0,0,7,7,1.0,0.1543033499620919,508,Eat me.
1925,3509,0,0,7,7,1.0,0.1543033499620919,508,Ahab? never heard of him. How should I know why he's missing a leg?
2009,3509,0,0,7,7,1.0,0.1543033499620919,508,You're going to need a bigger picture.
1924,3509,0,0,7,7,1.0,0.1543033499620919,508,One bloody arm looks much like another.
1916,3509,0,0,7,7,1.0,0.1543033499620919,508,So what. You think I'm the only one who leaves bite marks like that?
1913,3509,0,0,7,7,1.0,0.1543033499620919,508,"J-E-T-S, Jets, Jets, Jets. Are you happy now?"
1912,3509,0,0,7,7,1.0,0.1543033499620919,508,"Nope, I can't say I recognize your chum...'"
1910,3509,0,0,7,7,1.0,0.1543033499620919,508,"Pompadour. Leather jacket. Yeah, that's the punk that jumped me."
1908,3509,0,0,7,7,1.0,0.1543033499620919,508,"Sir, this is your third citation for public urination on our beach."
1907,3509,0,0,9,9,1.0,0.11785113019775792,508,I don't know nothin' about that loan.
1923,3509,0,0,7,7,1.0,0.1543033499620919,508,"You keep the land, I keep the water -- and we say this accident never happened."
2011,3509,0,0,7,7,1.0,0.1543033499620919,508,"'Jaws??' Yeah, I seen him swimming around Provincetown, like he was Cod of the Walk. Had an obsession for boats, and that what's done 'im in."
2018,3509,0,0,7,7,1.0,0.1543033499620919,508,"Ya, that's me."
2021,3509,0,0,8,8,1.0,0.1336306209562122,508,I guess this means that house arrest is off the table?
2093,3509,0,0,9,9,1.0,0.11785113019775792,508,I'm not saying another word until I talk to a lure.
2095,3509,0,0,7,7,1.0,0.1543033499620919,508,You should be looking for a white whale.
2097,3509,0,0,8,8,1.0,0.1336306209562122,508,I already told you....I can't make a positive ID without a blood sample.
2098,3509,0,0,7,7,1.0,0.1543033499620919,508,"Yeah, that's my lawyer - why?"
2101,3509,0,0,7,7,1.0,0.1543033499620919,508,I'm not that kind of loan shark.
2103,3509,0,0,8,8,1.0,0.1336306209562122,508,That's the Jet that killed Bernardo!
2105,3509,0,0,7,7,1.0,0.1543033499620919,508,Never seen da guy. Don't know any smuck Named ' Mack the Knife '
2108,3509,0,0,7,7,1.0,0.1543033499620919,508,"I told you pretty teeth, pearly white."
2112,3509,0,0,7,7,1.0,0.1543033499620919,508,"Never seen her before, but you can open up my stomach and check."
2115,3509,0,0,8,8,1.0,0.1336306209562122,508,"So what, it was a no swim zone"
2117,3509,0,0,8,8,1.0,0.1336306209562122,508,"Sorry, I don't have my contacts in"
2118,3509,0,0,8,8,1.0,0.1336306209562122,508,So you've got a picture of me when I was by myself. That doesn't prove that I'm a loan shark.
2120,3509,0,0,7,7,1.0,0.1543033499620919,508,"Yeah, that's the guy, MacHeath, they call him Mack."
2125,3509,0,0,7,7,1.0,0.1543033499620919,508,"Yeah, I'm sure that's not him. Don't you think I'd recognize my own breakfast?"
2130,3509,0,0,7,7,1.0,0.1543033499620919,508,"It's not me, I was busy filming Sharknado that day, you can ask my agent."
2133,3509,0,0,7,7,1.0,0.1543033499620919,508,"Never saw her before. I told you, I'm a LONE shark."
2136,3509,0,0,7,7,1.0,0.1543033499620919,508,I swear I've never seen that surfer before!
2178,3509,0,0,7,7,1.0,0.1543033499620919,508,So? I was hungry!
2176,3509,0,0,7,7,1.0,0.1543033499620919,508,Do you recognize this victim Jaws?
2174,3509,0,0,8,8,1.0,0.1336306209562122,508,"They asked him if he was fishing around in the crime scene, but we see hes trying to think of somefin."
2170,3509,0,0,8,8,1.0,0.1336306209562122,508,"Go ahead, put me in a line up...what, more than one of us too scary for you? Whose the tough guy now"
2166,3509,0,0,8,8,1.0,0.1336306209562122,508,I knew I shouldn't have filled out that Shark Week consent form.
2161,3509,0,0,7,7,1.0,0.1543033499620919,508,Have you seen this movie!
2092,3509,0,0,7,7,1.0,0.1543033499620919,508,How the heck would I know? Every striped bass looks the same to me...
2159,3509,0,0,7,7,1.0,0.1543033499620919,508,"It was the tuna, not me!"
2154,3509,0,0,7,7,1.0,0.1543033499620919,508,"Yeah, that's me in Chatham last summer, what does that prove?"
2152,3509,0,0,8,8,1.0,0.1336306209562122,508,That's him. Used to stalk a whale I knew. Now he's after me.
2151,3509,0,0,7,7,1.0,0.1543033499620919,508,That confession looks fishy to me!
2148,3509,0,0,8,8,1.0,0.1336306209562122,508,I'm not answering any questions without my Koi-yer present.
2145,3509,0,0,7,7,1.0,0.1543033499620919,508,I swear I didn't bite him - I always take my dentures out at night.
2141,3509,0,0,10,10,1.0,0.10540925533894598,508,I told you my name is Abe Vigoda.
2158,3509,0,0,9,9,1.0,0.11785113019775792,508,"Yeah, I ate that one, and he had a lot of fat!"
1871,3509,0,0,7,7,1.0,0.1543033499620919,508,Of course I don't recognize the victim ...how can I without a head..And no you can't get a DNA sample
2091,3509,0,0,7,7,1.0,0.1543033499620919,508,"Do I like the kind of person who would rob a bank, officer?"
2086,3509,0,0,8,8,1.0,0.1336306209562122,508,His name is Charlie Tuna!!
2022,3509,0,0,7,7,1.0,0.1543033499620919,508,I doubt your sketch artist's drawing of a triangle will hold up in court.
2023,3509,0,0,7,7,1.0,0.1543033499620919,508,Looks like Charlie the Tuna. What of it?
2024,3509,0,0,9,9,1.0,0.11785113019775792,508,"Yeah, that's the guy that took my fins."
2025,3509,0,0,7,7,1.0,0.1543033499620919,508,I thought she was 19! How was I supposed to know she was shark bait??
2026,3509,0,0,7,7,1.0,0.1543033499620919,508,"What, you think I'm the only land shark in Brooklyn?"
2027,3509,0,0,7,7,1.0,0.1543033499620919,508,"Yes, yes, yes I said your idea looks great on paper but I'm NOT one of those sharks!"
2031,3509,0,0,7,7,1.0,0.1543033499620919,508,Definitely not me.
2033,3509,0,0,7,7,1.0,0.1543033499620919,508,"Ok, Sharkie, you might be a Great White, but you ain't JAWS!"
2037,3509,0,0,7,7,1.0,0.1543033499620919,508,Sneak attack? Who do you take me for....Donald Trump?
2039,3509,0,0,8,8,1.0,0.1336306209562122,508,"I don’t need to see a photo, I already told you I don’t know anyone named 'Quint'."
2040,3509,0,0,7,7,1.0,0.1543033499620919,508,"Yeah, that's the one...that's the show that jumped me."
2049,3509,0,0,7,7,1.0,0.1543033499620919,508,Never seen that person before! Never seen that person before! Never seen that person before!
2051,3509,0,0,7,7,1.0,0.1543033499620919,508,"You're holding it in my blind spot, Officer."
2052,3509,0,0,7,7,1.0,0.1543033499620919,508,I hope you know that i can't read
2054,3509,0,0,8,8,1.0,0.1336306209562122,508,"No, officer, I've never been to that casino. Not all sharks are card sharks."
2056,3509,0,0,7,7,1.0,0.1543033499620919,508,"Law and Order SVU is over in studio B, guys...now let me get back to my contestants..."
2057,3509,0,0,8,8,1.0,0.1336306209562122,508,It's like I told you already - I needed a bigger boat.
2085,3509,0,0,8,8,1.0,0.1336306209562122,508,That's my son and......my girlfriend!!!! What the HELL!?!?
2083,3509,0,0,8,8,1.0,0.1336306209562122,508,"Ok, if I'm NOT a mammal, why haven't I laid an egg in, like, 3 days?"
2081,3509,0,0,8,8,1.0,0.1336306209562122,508,"Detective, that's just a bucket of chum."
2080,3509,0,0,7,7,1.0,0.1543033499620919,508,Kinda looks like your mother.
2079,3509,0,0,7,7,1.0,0.1543033499620919,508,"Can't read the large print, but the small print says I will not see water again."
2071,3509,0,0,7,7,1.0,0.1543033499620919,508,It wasn't me. I'm just a pool shark.
2087,3509,0,0,11,11,1.0,0.09534625892455922,508,"Yeah, that's the guy from Coast Guard Beach that'claims' I took his leg off."
2069,3509,0,0,7,7,1.0,0.1543033499620919,508,"Yeah, that's him. The wiseguy saw me, says, 'Looks like we'll need a smaller boat.' So I took a piece out of his stern."
2065,3509,0,0,8,8,1.0,0.1336306209562122,508,I know my rights; I've got lots of lawyer friends.
2063,3509,0,0,7,7,1.0,0.1543033499620919,508,You call that proof? That dorsal fin could be anybody's.
2062,3509,0,0,7,7,1.0,0.1543033499620919,508,"Well, he asked for it. He called me a lawyer."
2061,3509,0,0,7,7,1.0,0.1543033499620919,508,You guys have more pictures of people with missing body parts than I do.
2060,3509,0,0,7,7,1.0,0.1543033499620919,508,This is the worst school massacre I've ever seen.
2058,3509,0,0,8,8,1.0,0.1336306209562122,508,How should I know? They all look the same when they fall into the tank.
2067,3509,0,0,7,7,1.0,0.1543033499620919,508,"When that shark bites with his teeth babe, scarlet billows start to spread. But those ain't my scarlet billows."
1869,3509,0,0,10,10,1.0,0.10540925533894598,508,Just wait till my lawyer gets here. He's a REAL shark!
1864,3509,0,0,7,7,1.0,0.1543033499620919,508,"How would I know, Krupke? Those Jets all look alike to me!"
1863,3509,0,0,7,7,1.0,0.1543033499620919,508,"Yeah, he sleeps with the fishes. But I don't judge lifestyle choices."
1661,3509,0,0,7,7,1.0,0.1543033499620919,508,"For the last time, I'm telling you I can't sign that confession."
1662,3509,0,0,8,8,1.0,0.1336306209562122,508,This proves you're nothing but a born killer.
1664,3509,0,0,7,7,1.0,0.1543033499620919,508,Of course I know my rights. I've been a lawyer since you were in diapers.
1665,3509,0,0,7,7,1.0,0.1543033499620919,508,I went swimming with her once but I never touched her.
1668,3509,0,0,7,7,1.0,0.1543033499620919,508,"'Sorry, to me all Tilapia look the same.'"
1669,3509,0,0,7,7,1.0,0.1543033499620919,508,This interrogation can only go on for so long until I can't breathe anymore!
1670,3509,0,0,7,7,1.0,0.1543033499620919,508,"How am I going eat a sandwich? I have fins, you idiot."
1673,3509,0,0,8,8,1.0,0.1336306209562122,508,I never saw that arm before.
1674,3509,0,0,7,7,1.0,0.1543033499620919,508,You think so? Wait'll you meet my lawyer.
1676,3509,0,0,7,7,1.0,0.1543033499620919,508,is this the guy that poisoned the water?
1677,3509,0,0,7,7,1.0,0.1543033499620919,508,I've never seen that loan application before.
1678,3509,0,0,7,7,1.0,0.1543033499620919,508,"I told you, I've never seen that dolphin before."
1679,3509,0,0,7,7,1.0,0.1543033499620919,508,"I'm not your man, coppers. I suggest you talk to Mack the knife."
1681,3509,0,0,7,7,1.0,0.1543033499620919,508,"Don't prove nothing, Office Krupke. Jets got fins too."
1682,3509,0,0,7,7,1.0,0.1543033499620919,508,"Yeah, it's like I told ya. I don't know the dude. Cold be anyone. There's a lot of fish in the sea...."
1685,3509,0,0,7,7,1.0,0.1543033499620919,508,Is that a mug shot or a menu?
1687,3509,0,0,8,8,1.0,0.1336306209562122,508,"I know your a lawyer, but I still have to read you your rights!"
1715,3509,0,0,7,7,1.0,0.1543033499620919,508,Nope...never seen the guy. Oh! Wait. Yes...he tasted like chicken. Oops! Did I say that out loud?
1713,3509,0,0,7,7,1.0,0.1543033499620919,508,That's you stealing that shark skin suit! You're under arrest. Fins behind your back.
1711,3509,0,0,7,7,1.0,0.1543033499620919,508,You've got the wrong shark . . . I'm a Sea World entertainer.
1708,3509,0,0,7,7,1.0,0.1543033499620919,508,I want to talk to my lawyer. He's a hammerhead.
1706,3509,0,0,7,7,1.0,0.1543033499620919,508,300 percent interest ain't legal in this state.
1705,3509,0,0,8,8,1.0,0.1336306209562122,508,How am I supposed to tell? You all look alike to me!
1660,3509,0,0,8,8,1.0,0.1336306209562122,508,Of course her interest is high - I am the lone shark here!
1703,3509,0,0,7,7,1.0,0.1543033499620919,508,"So Sharky, what time was it?"
1701,3509,0,0,7,7,1.0,0.1543033499620919,508,The writers have really jumped the shark this season.
1700,3509,0,0,7,7,1.0,0.1543033499620919,508,Of course I know him that's my cousin Finnie
1699,3509,0,0,7,7,1.0,0.1543033499620919,508,I literally can't sign my confession!
1697,3509,0,0,7,7,1.0,0.1543033499620919,508,"No, I've told you guys already, that is not my handwriting."
1693,3509,0,0,7,7,1.0,0.1543033499620919,508,I agree your photo fit of the lone shark does look somewhat like me ?
1690,3509,0,0,9,9,1.0,0.11785113019775792,508,"Remember these words: 'If it doesn't fit, you must acquit.'"
1702,3509,0,0,7,7,1.0,0.1543033499620919,508,Your motha's ugly.
1718,3509,0,0,7,7,1.0,0.1543033499620919,508,"Yes, I confess. He is my distant relative, but I have nothing to do with his menaces."
1658,3509,0,0,7,7,1.0,0.1543033499620919,508,Bug fixes and performance improvements.
1654,3509,0,0,7,7,1.0,0.1543033499620919,508,Did I sign for that fin? You're profiling.
1596,3509,0,0,7,7,1.0,0.1543033499620919,508,Never seen him - way too many of us in that tornado.
1597,3509,0,0,7,7,1.0,0.1543033499620919,508,I don't have any oxygen left in my bloodstream but it's...gasp...actually kind of cool. It's kind of like tripping balls while having a giant orgasm...unh....tell my wife I always loved her...gasp...all is one and none of it mattered...
1598,3509,0,0,7,7,1.0,0.1543033499620919,508,This X-Ray containing scuba diving gear in your stomach doesn't look too promising for your homicide case.
1602,3509,0,0,7,7,1.0,0.1543033499620919,508,"Yeah, I gave him a loan too"
1604,3509,0,0,7,7,1.0,0.1543033499620919,508,"Well, I really couldn't say - do you have any pictures of her from the neck down in a swimsuit?"
1608,3509,0,0,7,7,1.0,0.1543033499620919,508,I have not seen that surfbord
1609,3509,0,0,9,9,1.0,0.11785113019775792,508,We don't 'ALL' look alike.
1610,3509,0,0,7,7,1.0,0.1543033499620919,508,"Every time you time you find a dead Jet in an alley, I get Dragnetted in here. Just you wait my lawyer will have me off the hook in no time."
1611,3509,0,0,7,7,1.0,0.1543033499620919,508,Jaws 3: Apprehended
1618,3509,0,0,7,7,1.0,0.1543033499620919,508,You're looking at three counts of Approach Without Saying 'Da-Duh'
1622,3509,0,0,9,9,1.0,0.11785113019775792,508,Okay. Maybe it does look like me. But Goldie will swear I was back in the tank by midnight.
1623,3509,0,0,7,7,1.0,0.1543033499620919,508,"C'mon, a Jet will say anything to get a Shark in trouble."
1624,3509,0,0,7,7,1.0,0.1543033499620919,508,I want a kiddie pool and a lawyer. In that order.
1625,3509,0,0,7,7,1.0,0.1543033499620919,508,"Yes, yes okay, yes. Off the coast of Martha's Vineyard, summer of '98, I think."
1626,3509,0,0,7,7,1.0,0.1543033499620919,508,He punched me in the nose.Can't a shark defend himself ?
1627,3509,0,0,7,7,1.0,0.1543033499620919,508,I have NO idea who that is !....We all look alike !
1628,3509,0,0,7,7,1.0,0.1543033499620919,508,You know I can't breathe on land right?
1652,3509,0,0,7,7,1.0,0.1543033499620919,508,How did you make detective? Obviously I work on 'K' Street.
1647,3509,0,0,7,7,1.0,0.1543033499620919,508,"Look, I told you a thousand, I'm innocent, I had nothing to do with Jaws 3."
1644,3509,0,0,7,7,1.0,0.1543033499620919,508,"You're way off the mark, officer. How the hell would I get to Salt Lake anyway?"
1643,3509,0,0,8,8,1.0,0.1336306209562122,508,"Have you seen these painted toes recently? Where were you yesterday afternoon? You better cooperate now, while we can still help you!"
1642,3509,0,0,7,7,1.0,0.1543033499620919,508,Just wait til we tell the Japanese we got you.
1641,3509,0,0,8,8,1.0,0.1336306209562122,508,"Stop hammer pounding me, you got the wrong shark!"
1655,3509,0,0,8,8,1.0,0.1336306209562122,508,"I was nowhere near that school of fish or that coral reef on Monday.” “Am I free to go or do I need to call my attorney from the law firm of Mako, Tiger, Whale and Hammerhead LLP?"
1639,3509,0,0,7,7,1.0,0.1543033499620919,508,I'm gonna take The Fifth ... and your forearm.
1637,3509,0,0,7,7,1.0,0.1543033499620919,508,So you're the big tuna around here?
1635,3509,0,0,7,7,1.0,0.1543033499620919,508,I never loaned that guy any money!
1633,3509,0,0,7,7,1.0,0.1543033499620919,508,Four Words: 'Netlix And My Lawyer'
1632,3509,0,0,7,7,1.0,0.1543033499620919,508,I told you I don't remember! Long time no sea.
1631,3509,0,0,7,7,1.0,0.1543033499620919,508,That's the guy. I'd recognize the leather jacket anywhere.
1629,3509,0,0,7,7,1.0,0.1543033499620919,508,"Yeah, I was 3,000 nautical miles from here, but you said I was under house arrest."
1638,3509,0,0,8,8,1.0,0.1336306209562122,508,"As I told you before, I'm not related to Bruce from Jaws."
1592,3509,0,0,7,7,1.0,0.1543033499620919,508,S-H-A-R-K b-a-i-t
1721,3509,0,0,7,7,1.0,0.1543033499620919,508,"Yeah sure, it's almost lunch time, and you guys decide 'Hey, let's grill the shark!'"
1726,3509,0,0,7,7,1.0,0.1543033499620919,508,"You can't pin it on me, I only ate the left leg, not the rest of him."
1798,3509,0,0,8,8,1.0,0.1336306209562122,508,Forget it. I'm not a blubberer.
1800,3509,0,0,9,9,1.0,0.11785113019775792,508,"To chum it up, I gave the source of that hand writing sample a digestive leave."
1802,3509,0,0,7,7,1.0,0.1543033499620919,508,"That's Fonzi alright, the guy who jumped me."
1805,3509,0,0,7,7,1.0,0.1543033499620919,508,What does Steven Avery have to do with this?
1806,3509,0,0,7,7,1.0,0.1543033499620919,508,To hell with a lawyer. Give me Jimmy Buffett.
1808,3509,0,0,7,7,1.0,0.1543033499620919,508,"Okay, that's a surveillance photo of me in the water with the dude who died. So what? There's no blood in the water. Everyone knows that's my trigger."
1810,3509,0,0,7,7,1.0,0.1543033499620919,508,You call that evidence? That's not evidence. I eat guys like you for breakfast.
1811,3509,0,0,7,7,1.0,0.1543033499620919,508,"That arrest warrant is bogus. I swear I'm NOT a loan shark, merely a shark alone!"
1815,3509,0,0,7,7,1.0,0.1543033499620919,508,"So let me get this straight, I was somehow able to spin with this tornado, and kill from within?"
1816,3509,0,0,7,7,1.0,0.1543033499620919,508,I do not recognize that dealer.
1818,3509,0,0,7,7,1.0,0.1543033499620919,508,"I'm Innocent, I swear!"
1819,3509,0,0,7,7,1.0,0.1543033499620919,508,"What do you think this is, West Side Story? The Jets have been, shall we say, digested."
1821,3509,0,0,7,7,1.0,0.1543033499620919,508,"Have you heard the term, 'dorsal profiling?'"
1822,3509,0,0,7,7,1.0,0.1543033499620919,508,"So, is this the victim or what's on the menu for lunch?"
1826,3509,0,0,7,7,1.0,0.1543033499620919,508,You're the one that needs the warning; your fingers smell like tuna fish.
1827,3509,0,0,7,7,1.0,0.1543033499620919,508,"Look, I already told ya ten times that I don't see so good. How about getting me a whiff of him?"
1828,3509,0,0,7,7,1.0,0.1543033499620919,508,Do you recognize this shadow?
1862,3509,0,0,7,7,1.0,0.1543033499620919,508,I'm not saying a word until I eat my lawyer.
1861,3509,0,0,7,7,1.0,0.1543033499620919,508,...And I promise to stay out of shallow waters..
1858,3509,0,0,7,7,1.0,0.1543033499620919,508,I'm telling you. I don't know no Arthur Fonzarelli.
1857,3509,0,0,7,7,1.0,0.1543033499620919,508,Vhat ? No Calimari ?
1856,3509,0,0,7,7,1.0,0.1543033499620919,508,Well we heard you graduated from pool shark to manslaughter.
1854,3509,0,0,7,7,1.0,0.1543033499620919,508,"If you don't tell us what we want to know, you're gonna be swimming with the fishes !"
1795,3509,0,0,7,7,1.0,0.1543033499620919,508,"I told him upfront what the interest rate was- he's lucky I didn't collect his leg, too!"
1853,3509,0,0,7,7,1.0,0.1543033499620919,508,The radius of those bite marks don't match mine.
1845,3509,0,0,7,7,1.0,0.1543033499620919,508,What Polar Plunge Massacre? I'm off Hilton Head by Thanksgiving.
1844,3509,0,0,7,7,1.0,0.1543033499620919,508,"Pippet, Alex Kintner, Ben Gardner, Quint . . . the list goes on and on. Were you or were you not living in and around Amity Island in 1975?"
1840,3509,0,0,8,8,1.0,0.1336306209562122,508,The only way you'll get my cooperation is by water boarding.
1837,3509,0,0,7,7,1.0,0.1543033499620919,508,So Riff's gone missing. What are you harassing me for?
1831,3509,0,0,7,7,1.0,0.1543033499620919,508,"Sure, that's Luca Brasi. We went swimming together just last week."
1829,3509,0,0,6,6,1.0,0.18257418583505536,508,Hammerhead? Do I look like a hammerhead? You're a hammerhead!
1851,3509,0,0,7,7,1.0,0.1543033499620919,508,"I never tasted, I mean saw that seal before."
1722,3509,0,0,8,8,1.0,0.1336306209562122,508,"OK, but I never did do the combined part, dude."
1792,3509,0,0,7,7,1.0,0.1543033499620919,508,I never wanted biting a human. The man in speedo invaded my space. I claim self-defense under the stand your ground law.
1787,3509,0,0,8,8,1.0,0.1336306209562122,508,Yeah she tried to chum my pants off but I wouldn't take the bait
1727,3509,0,0,7,7,1.0,0.1543033499620919,508,"Exasperatedly, she threw her martini straight at the suspect's head."
1729,3509,0,0,7,7,1.0,0.1543033499620919,508,"Dolphins are actually really sexual beings and wil even solicit humans for sex. It's a two-sided coin, though. They can also be racist."
1730,3509,0,0,8,8,1.0,0.1336306209562122,508,I swear I now nothing about that Fish Bowls gang you're talking about.
1734,3509,0,0,7,7,1.0,0.1543033499620919,508,Whoever did that had a severe overbite!
1735,3509,0,0,7,7,1.0,0.1543033499620919,508,"This won't stick, it's nothing more than abalone dragnet."
1736,3509,0,0,8,8,1.0,0.1336306209562122,508,The mayor used to box.
1737,3509,0,0,7,7,1.0,0.1543033499620919,508,"Yeah, yeah . . . anyone I bite can be held against me."
1738,3509,0,0,7,7,1.0,0.1543033499620919,508,Don't tell me that happened; it is blatantly photoshopped.
1739,3509,0,0,8,8,1.0,0.1336306209562122,508,"Now, that is a bigger boat!"
1740,3509,0,0,7,7,1.0,0.1543033499620919,508,Do you recognize this air mattress?
1741,3509,0,0,7,7,1.0,0.1543033499620919,508,Maybe... there's a lot of fish in the sea.
1743,3509,0,0,7,7,1.0,0.1543033499620919,508,Your idea doesn't even qualify for the $75 Third Prize. Next!
1744,3509,0,0,7,7,1.0,0.1543033499620919,508,Da Da Da Da...Yes. I admit it. That's my signature theme.
1746,3509,0,0,7,7,1.0,0.1543033499620919,508,"Kiss my dorsal fin, copper."
1748,3509,0,0,8,8,1.0,0.1336306209562122,508,Do you recognize this Mako?' 'I don't see color man. Sharks say I'm a Great White and I let them.
1750,3509,0,0,7,7,1.0,0.1543033499620919,508,"Yeah. That's the fella, but without the concrete overshoes."
1751,3509,0,0,7,7,1.0,0.1543033499620919,508,So you're telling me this isn't one of your chums?
1786,3509,0,0,8,8,1.0,0.1336306209562122,508,He was that short when I met him.
1784,3509,0,0,7,7,1.0,0.1543033499620919,508,Last place I saw him was in a dive bar
1783,3509,0,0,7,7,1.0,0.1543033499620919,508,I thought he was chum
1782,3509,0,0,7,7,1.0,0.1543033499620919,508,I keep telling you I ain't no loan shark!
1778,3509,0,0,7,7,1.0,0.1543033499620919,508,Don't recognize him. It was a big school.
1776,3509,0,0,7,7,1.0,0.1543033499620919,508,The first ingredient in that recipe is wrong.
1788,3509,0,0,7,7,1.0,0.1543033499620919,508,"No, that's not a picture of my buddy, it's a picture of my chum."
1773,3509,0,0,7,7,1.0,0.1543033499620919,508,Can I have a glass of water first?
1767,3509,0,0,7,7,1.0,0.1543033499620919,508,"That's 'Shark-S**t', I was nowhere near Coney Island!"
1765,3509,0,0,7,7,1.0,0.1543033499620919,508,Records show the victim had an outstanding loan with you.
1763,3509,0,0,7,7,1.0,0.1543033499620919,508,nomnomnomnomnom
1761,3509,0,0,7,7,1.0,0.1543033499620919,508,This autopsy report clearly shows bite marks consistent with YOUR dental records.
1758,3509,0,0,8,8,1.0,0.1336306209562122,508,"I never ate, um, saw those legs before."
1754,3509,0,0,7,7,1.0,0.1543033499620919,508,Read my teeth!
1768,3509,0,0,7,7,1.0,0.1543033499620919,508,You all look the same to me - I go only by flavor!
1105,3509,0,0,7,7,1.0,0.1543033499620919,508,"That's not even a shark, you profilers, it's a dolphin!"
1100,3509,0,0,7,7,1.0,0.1543033499620919,508,It was the barracuda I tell you.
1098,3509,0,0,7,7,1.0,0.1543033499620919,508,"Bond, you have a license to kill!"
301,3509,0,0,7,7,1.0,0.1543033499620919,508,I don't remember
302,3509,0,0,7,7,1.0,0.1543033499620919,508,At least last year's bonus came with condiments
303,3509,0,0,7,7,1.0,0.1543033499620919,508,Does this fat ass look like chicken tenders?
304,3509,0,0,7,7,1.0,0.1543033499620919,508,"Yeah, yeah, I know, I see the Miranda Card. But I will never get a Lawyer here because they stay away because of Professional Courtesy!"
305,3509,0,0,7,7,1.0,0.1543033499620919,508,You must be mistaking me for some other lawyer.
306,3509,0,0,8,8,1.0,0.1336306209562122,508,I never loaned that guy nothin
307,3509,0,0,8,8,1.0,0.1336306209562122,508,Never swam with 'em. May I rub your scalp?
309,3509,0,0,7,7,1.0,0.1543033499620919,508,"Smile, you son of a .... stop quoting Jaws and answer the question!"
311,3509,0,0,7,7,1.0,0.1543033499620919,508,"For the last time, I don't know any Nemo."
319,3509,0,0,7,7,1.0,0.1543033499620919,508,"Never ate 'im before in my life, buddy"
320,3509,0,0,7,7,1.0,0.1543033499620919,508,It's well documented. I never actually hurt that clown fish!
322,3509,0,0,7,7,1.0,0.1543033499620919,508,Your whole case sounds fishy to me.
323,3509,0,0,7,7,1.0,0.1543033499620919,508,'Fifty percent......whats wrong with 50 percent?
326,3509,0,0,7,7,1.0,0.1543033499620919,508,I want my lawyer
297,3509,0,0,7,7,1.0,0.1543033499620919,508,Steven Avery?
329,3509,0,0,7,7,1.0,0.1543033499620919,508,I know my bites.
335,3509,0,0,7,7,1.0,0.1543033499620919,508,I ain't talking until I eat a lawyer.
336,3509,0,0,7,7,1.0,0.1543033499620919,508,That's Carlino the Fin... Last I heard he was swimming with the fishies!
339,3509,0,0,7,7,1.0,0.1543033499620919,508,"Yes, he's one of my chums."
341,3509,0,0,6,6,1.0,0.18257418583505536,508,I used that guy as my safety net.
342,3509,0,0,7,7,1.0,0.1543033499620919,508,'Eat or die' is no defense.
346,3509,0,0,7,7,1.0,0.1543033499620919,508,Jumping me was Fonzie's idea!
348,3509,0,0,7,7,1.0,0.1543033499620919,508,He is missing an arm now.
349,3509,0,0,8,8,1.0,0.1336306209562122,508,"You say Australia, but your cell phone is pinging off a tower in Hawaii."
350,3509,0,0,7,7,1.0,0.1543033499620919,508,Was that your bite marks?
353,3509,0,0,8,8,1.0,0.1336306209562122,508,Do you recognize this leg?
354,3509,0,0,7,7,1.0,0.1543033499620919,508,I have an alibi I was at home watching Shark Tank.
355,3509,0,0,7,7,1.0,0.1543033499620919,508,"The teeth are all right, but the gums will have to go"
357,3509,0,0,7,7,1.0,0.1543033499620919,508,"Yes, I've seen that man. Everyone my age has seen Mr. Holland's Opus."
358,3509,0,0,7,7,1.0,0.1543033499620919,508,"Teeth marks, yeah I see 'em. That doesn't prove nothin'."
330,3509,0,0,7,7,1.0,0.1543033499620919,508,D E F P O T E C
296,3509,0,0,7,7,1.0,0.1543033499620919,508,I guess all sharks look the same to you.
295,3509,0,0,7,7,1.0,0.1543033499620919,508,"Hey, chumming channels my inner-shark."
291,3509,0,0,7,7,1.0,0.1543033499620919,508,"Yeah, that's him. Well what would you do if some guy in a speedo invaded your home?"
230,3509,0,0,7,7,1.0,0.1543033499620919,508,I dare you guys to start the waterboarding.
232,3509,0,0,9,9,1.0,0.11785113019775792,508,"He sleeps with the fishes, are you serious! I think you are profiling me. I want my lawyer."
234,3509,0,0,7,7,1.0,0.1543033499620919,508,I keep tellin' ya - I was with Spielberg. Just ask him - he'll back me up.
236,3509,0,0,7,7,1.0,0.1543033499620919,508,Yeah...that one was my lunch today.
238,3509,0,0,7,7,1.0,0.1543033499620919,508,"It's not me, it just looks like me."
240,3509,0,0,7,7,1.0,0.1543033499620919,508,"Yeah, that's him. Calls himself the Lone Shark."
244,3509,0,0,7,7,1.0,0.1543033499620919,508,Can't you tell that I'm not a tiger shark?
246,3509,0,0,8,8,1.0,0.1336306209562122,508,There's no way you can prove that's my dorsal fin - it looks like a fake!
248,3509,0,0,8,8,1.0,0.1336306209562122,508,"Katy Perry? Never heard of her, Officer"
250,3509,0,0,7,7,1.0,0.1543033499620919,508,This sketch matches you bite radius exactly
251,3509,0,0,7,7,1.0,0.1543033499620919,508,C'mon buddy I'm just tryna swim over here.
253,3509,0,0,7,7,1.0,0.1543033499620919,508,But I'm not in a gang! I'm a lone shark!
254,3509,0,0,7,7,1.0,0.1543033499620919,508,I tell you I didn't do it! I think you are confusing me with a Miami dolphin.
256,3509,0,0,7,7,1.0,0.1543033499620919,508,"I told you, I didn't make that loan!"
257,3509,0,0,7,7,1.0,0.1543033499620919,508,"I told you before...that ain't no promissory note, and I ain't no loan shark."
259,3509,0,0,7,7,1.0,0.1543033499620919,508,That's not me. I don't know nothin' about no loans.
260,3509,0,0,7,7,1.0,0.1543033499620919,508,Do you recall seeing this surfboard last night?
289,3509,0,0,7,7,1.0,0.1543033499620919,508,So dark-skinned fish are all endangered now; is that what you are telling me?
288,3509,0,0,7,7,1.0,0.1543033499620919,508,"I just keep saying, 'Stop hitting yourself.' He gets it."
287,3509,0,0,7,7,1.0,0.1543033499620919,508,Looks like every other seal.
284,3509,0,0,7,7,1.0,0.1543033499620919,508,"Sharks don't eat lawyers. You should know that, officer."
282,3509,0,0,7,7,1.0,0.1543033499620919,508,Little mermaid- big mermaid. What's the difference?
281,3509,0,0,7,7,1.0,0.1543033499620919,508,Your victim just picked you out of a lineup!
359,3509,0,0,7,7,1.0,0.1543033499620919,508,"Oh, we all look alike, right? We all know each other?"
278,3509,0,0,7,7,1.0,0.1543033499620919,508,I ain't seen Charlie since our school days.
273,3509,0,0,7,7,1.0,0.1543033499620919,508,I am my own lawyer and I ain't sayin' nothing.
270,3509,0,0,8,8,1.0,0.1336306209562122,508,I tell ya I ain't heard uh no 'Fonzi' and he wasn't da guy who jumped me!
269,3509,0,0,7,7,1.0,0.1543033499620919,508,I confess. Sharknado made me do it.
266,3509,0,0,8,8,1.0,0.1336306209562122,508,"Sure, I know him. We schooled together. But I had nothing to do with that business with Quint."
265,3509,0,0,7,7,1.0,0.1543033499620919,508,You see anything fishy about this photograph?
262,3509,0,0,7,7,1.0,0.1543033499620919,508,From the place down the street - it's called the 'Freudian 6-ft. Long'.
277,3509,0,0,7,7,1.0,0.1543033499620919,508,That there is The Ace of Spades.
362,3509,0,0,7,7,1.0,0.1543033499620919,508,I know gouging when I see it.
363,3509,0,0,7,7,1.0,0.1543033499620919,508,"That's not me, that's a mammal! Do you know how offensive that is?"
368,3509,0,0,8,8,1.0,0.1336306209562122,508,"Naw, I never saw dat surfer before."
443,3509,0,0,7,7,1.0,0.1543033499620919,508,"This good ichthyologist, bad ichthyologist routine isn't going to work."
449,3509,0,0,7,7,1.0,0.1543033499620919,508,Two words: chewable mugshots.
450,3509,0,0,7,7,1.0,0.1543033499620919,508,I've never seen that chum before in my life.
454,3509,0,0,7,7,1.0,0.1543033499620919,508,You're gonna be swimming with the fishes.
456,3509,0,0,7,7,1.0,0.1543033499620919,508,"Yeah, okay....That's a loan agreement but that's NOT my signature!"
460,3509,0,0,7,7,1.0,0.1543033499620919,508,"I'm a pescatarian so, no, I did not eat that person."
463,3509,0,0,7,7,1.0,0.1543033499620919,508,That's no chum of mine.
466,3509,0,0,7,7,1.0,0.1543033499620919,508,"Yeah, he owed me on a loan. An arm and a leg. But that doesn't mean I put the bite on him. Quit trying to bait me, chum."
468,3509,0,0,7,7,1.0,0.1543033499620919,508,I've never seen that swimmer before but I think you're wearing my cousin as a belt.
470,3509,0,0,7,7,1.0,0.1543033499620919,508,I won't confirm or deny that I ate him.
473,3509,0,0,7,7,1.0,0.1543033499620919,508,You all look like chum to me.
477,3509,0,0,7,7,1.0,0.1543033499620919,508,I'm a vegan.
480,3509,0,0,7,7,1.0,0.1543033499620919,508,"I keep trying to tell you guys, I have lousy eyesight. I can only ID him by smell and taste."
481,3509,0,0,7,7,1.0,0.1543033499620919,508,He stole my pinger .
482,3509,0,0,7,7,1.0,0.1543033499620919,508,Tell us or you'll swim with the fish!
484,3509,0,0,7,7,1.0,0.1543033499620919,508,Have you seen this arm before?
485,3509,0,0,7,7,1.0,0.1543033499620919,508,Do I look like a rat?
530,3509,0,0,7,7,1.0,0.1543033499620919,508,Of course I bit him. He's a Jet.
525,3509,0,0,7,7,1.0,0.1543033499620919,508,"Before I ate him, I warned him that I was not a pool shark."
523,3509,0,0,8,8,1.0,0.1336306209562122,508,"Lifeless, doll eyes or not, is this the guy?"
522,3509,0,0,7,7,1.0,0.1543033499620919,508,I am not biting. I demand to see a shark.
517,3509,0,0,7,7,1.0,0.1543033499620919,508,Do I look like a mole to you?
516,3509,0,0,7,7,1.0,0.1543033499620919,508,No. I will not put my fin of approval on that!
442,3509,0,0,7,7,1.0,0.1543033499620919,508,"I demand my right to 1/2 cup soy sauce, 1/2 cup fresh orange juice, 2 tablespoons fresh lemon juice, 1 teaspoon freshly ground black pepper and 2 large cloves garlic, pressed"
515,3509,0,0,7,7,1.0,0.1543033499620919,508,I'm a blood thirsty predator and the ocean's harbinger of death. Wait until you meet my lawyer.
506,3509,0,0,7,7,1.0,0.1543033499620919,508,Your fingers are in the way of several of the mug shots.
501,3509,0,0,7,7,1.0,0.1543033499620919,508,What can I say... he was jumping the shark.
500,3509,0,0,7,7,1.0,0.1543033499620919,508,"I'm feeling a bit dry, would you put me in a water holding tank and get me my attorney, he's a shark."
498,3509,0,0,7,7,1.0,0.1543033499620919,508,This is the third time you've pulled me in for loan sharking. I'm beginning to think that I'm the victim of species profiling.
497,3509,0,0,7,7,1.0,0.1543033499620919,508,Never seen him! . . . though sharks are known to have poor eyesight.
491,3509,0,0,7,7,1.0,0.1543033499620919,508,"No, I will not sign a confession. First of all, I don't have hands."
510,3509,0,0,7,7,1.0,0.1543033499620919,508,You're angling for a confession. I won't sign it!
225,3509,0,0,7,7,1.0,0.1543033499620919,508,"Yea, I had him for dinner last Tuesday."
439,3509,0,0,7,7,1.0,0.1543033499620919,508,"Yeah, I know that school. What's it to you?"
436,3509,0,0,7,7,1.0,0.1543033499620919,508,"Spill it jaws! Is this you having lunch with Presidential hopeful-Donald Trump at Cheeseless,Crustless,Sauceless and tasteless Pizzaless Restaurant?"
372,3509,0,0,7,7,1.0,0.1543033499620919,508,Going on the Shark Tank solo. Compared to you guy's I'm a Goldfish
374,3509,0,0,7,7,1.0,0.1543033499620919,508,"For the last time, did you or did not violently consume Marlin Anemone's son?"
375,3509,0,0,7,7,1.0,0.1543033499620919,508,"Like I said before, those aren't my teeth marks"
380,3509,0,0,7,7,1.0,0.1543033499620919,508,"The guy in the leather jacket. Yeah, what about him?"
383,3509,0,0,8,8,1.0,0.1336306209562122,508,This is special profiling!
385,3509,0,0,7,7,1.0,0.1543033499620919,508,"'Sorry, but I'm a bit of a fetishist. Got any foot or leg pictures?"
386,3509,0,0,7,7,1.0,0.1543033499620919,508,"I admit it, but what would you do if someone kept giving chum to your kids?"
387,3509,0,0,7,7,1.0,0.1543033499620919,508,I didn't eat him either...where's my lawyer?
388,3509,0,0,7,7,1.0,0.1543033499620919,508,"I told you already, I'm not into biting off legs anymore."
394,3509,0,0,6,6,1.0,0.18257418583505536,508,Shark bait...
395,3509,0,0,7,7,1.0,0.1543033499620919,508,Good luck finding that plankton amongst the muddle.
396,3509,0,0,7,7,1.0,0.1543033499620919,508,"I swear, I didn't know the interest rate was that high."
397,3509,0,0,7,7,1.0,0.1543033499620919,508,"I ain't afraid of soup, copper."
398,3509,0,0,7,7,1.0,0.1543033499620919,508,"OK, so I know Mark Cuban, what of it?"
399,3509,0,0,7,7,1.0,0.1543033499620919,508,Yummy.
403,3509,0,0,7,7,1.0,0.1543033499620919,508,"Yah, I know the guy - that's Louie Miller. Heard he disappeared after our poker game Friday night at Mack's."
404,3509,0,0,7,7,1.0,0.1543033499620919,508,"Alright, I did it! Are you happy? I killed him. And not just him – go to my house, 242 Lawndale, and look in the crawl space. You’ll find all my victims, 17 in all. I gnawed on their bones and devoured their flesh. What did you expect? I’m a shark."
433,3509,0,0,7,7,1.0,0.1543033499620919,508,Chum? Never met him.
430,3509,0,0,7,7,1.0,0.1543033499620919,508,"I'm sharked, sharked!"
429,3509,0,0,7,7,1.0,0.1543033499620919,508,All suspects look tasty to him.
427,3509,0,0,7,7,1.0,0.1543033499620919,508,"Frankie sleeps with the fishes. His wife, Jackie, she's an eel."
424,3509,0,0,7,7,1.0,0.1543033499620919,508,You got it wrong. I never ate that guy before in my life!
419,3509,0,0,7,7,1.0,0.1543033499620919,508,"I seen her around, hot little piece of tuna if you ask me."
437,3509,0,0,7,7,1.0,0.1543033499620919,508,You're breathing abnormally. Tell us what you know!
418,3509,0,0,7,7,1.0,0.1543033499620919,508,"If he ain't got gills, I don't care who he is."
415,3509,0,0,7,7,1.0,0.1543033499620919,508,"Yeah, I see the confession, but, I'm telling you, my client did not do it."
410,3509,0,0,7,7,1.0,0.1543033499620919,508,It wasn't me. I'm allergic to O Negative.
409,3509,0,0,7,7,1.0,0.1543033499620919,508,Am here to fish out criminals
407,3509,0,0,7,7,1.0,0.1543033499620919,508,Confess? I swim with them. I'm not one of them.
406,3509,0,0,7,7,1.0,0.1543033499620919,508,This has not been my week.
405,3509,0,0,8,8,1.0,0.1336306209562122,508,Don't get chummy with me. You think I'm dumb enough to seal my own fate? Go fish!
416,3509,0,0,7,7,1.0,0.1543033499620919,508,I have never seen him swimming with the fishes.
223,3509,0,0,7,7,1.0,0.1543033499620919,508,"I'm out of here, that guy is Irish and I only dine Kosher."
222,3509,0,0,7,7,1.0,0.1543033499620919,508,"It's getting hot in here, can I get a glass of water and some salt?"
221,3509,0,0,7,7,1.0,0.1543033499620919,508,I wanna speak with ... my brother.
62,3509,0,0,7,7,1.0,0.1543033499620919,508,"Okay, I did it. With lips like that you can't blame me for mistaking him for a pufferfish."
64,3509,0,0,7,7,1.0,0.1543033499620919,508,"Why the hell am I being interrogated. I'm not black, you dumb cop"
65,3509,0,0,7,7,1.0,0.1543033499620919,508,"Yeah, that's the guy I said was going to sleep with the fishes."
66,3509,0,0,7,7,1.0,0.1543033499620919,508,You expect me to remember the face of every seal I ever ate?
69,3509,0,0,7,7,1.0,0.1543033499620919,508,I demand to speak to my shark!
70,3509,0,0,7,7,1.0,0.1543033499620919,508,"Yes, that's the guy who called me a fishie and threw a man on my head."
71,3509,0,0,7,7,1.0,0.1543033499620919,508,And don't think you can fool us by not blinking!
73,3509,0,0,7,7,1.0,0.1543033499620919,508,I would be more helpful if you let me take this suit off.
78,3509,0,0,7,7,1.0,0.1543033499620919,508,Oy gevalt
79,3509,0,0,7,7,1.0,0.1543033499620919,508,"Don't play good carp, bad carp with me."
80,3509,0,0,7,7,1.0,0.1543033499620919,508,'I'm a respectable lone shark and I don't care what your spell check says.'
81,3509,0,0,7,7,1.0,0.1543033499620919,508,Never heard of Mickey Finn.
82,3509,0,0,7,7,1.0,0.1543033499620919,508,Nice bulge on grampa.
83,3509,0,0,7,7,1.0,0.1543033499620919,508,That's not one of my loans.
84,3509,0,0,8,8,1.0,0.1336306209562122,508,He went to sleep with the fishes.
85,3509,0,0,7,7,1.0,0.1543033499620919,508,"Dude, he's not gonna take the bait, again."
87,3509,0,0,7,7,1.0,0.1543033499620919,508,He swims with the fishes.
108,3509,0,0,8,8,1.0,0.1336306209562122,508,"I was basking, I tell ya."
107,3509,0,0,7,7,1.0,0.1543033499620919,508,I'm not admitting anything until I get water-boarded.
106,3509,0,0,6,6,1.0,0.18257418583505536,508,I swear I know nothing about any loans.
105,3509,0,0,7,7,1.0,0.1543033499620919,508,"Nice drawing, now where's my client?"
103,3509,0,0,7,7,1.0,0.1543033499620919,508,This one makes me think of the meal I'm missing.
100,3509,0,0,7,7,1.0,0.1543033499620919,508,have you seen this rip?—an urchin went missing prior to seizing you in ebb.
61,3509,0,0,7,7,1.0,0.1543033499620919,508,Don't lie. We know you took the bait.
98,3509,0,0,7,7,1.0,0.1543033499620919,508,So what? That could be anyone. I Instagram all my meals.
94,3509,0,0,7,7,1.0,0.1543033499620919,508,"I'll take a large #5, the vegan pizza."
93,3509,0,0,7,7,1.0,0.1543033499620919,508,"Yeah, that's the one who jumped me."
92,3509,0,0,7,7,1.0,0.1543033499620919,508,"Okay I was there, and I'm a shark. But you still don't have a motive."
91,3509,0,0,7,7,1.0,0.1543033499620919,508,"C'mon, do I look like a 'lone wolf' terrorist?"
90,3509,0,0,7,7,1.0,0.1543033499620919,508,"Like I told you, man, somebody jumped the shark, but that ain't him!"
88,3509,0,0,7,7,1.0,0.1543033499620919,508,Ehhhhh...maybe. You're gonna have to tear open my stomach to find out.
97,3509,0,0,7,7,1.0,0.1543033499620919,508,"Yeah, that's the one. If I knew how bad he was going to taste, I wouldn't have bothered."
110,3509,0,0,7,7,1.0,0.1543033499620919,508,"Yes, that's my handwriting. Why?"
59,3509,0,0,7,7,1.0,0.1543033499620919,508,Admit it. You wrote out these loan papers.
55,3509,0,0,7,7,1.0,0.1543033499620919,508,"Looks delicious, but I've never seen him."
1,3509,0,0,7,7,1.0,0.1543033499620919,508,"I wish the cafeteria food were lighter, and not so heavily Freud."
2,3509,0,0,7,7,1.0,0.1543033499620919,508,hotdogism Doug you wouldn't understand
3,3509,0,0,7,7,1.0,0.1543033499620919,508,R&D thinks they've finally found an answer to the Big Mac.
4,3509,0,0,7,7,1.0,0.1543033499620919,508,At least I'M sticking to my New Year's resolution.
5,3509,0,0,8,8,1.0,0.1336306209562122,508,Send an email: I bought everyone a hot dog for lunch.
9,3509,0,0,7,7,1.0,0.1543033499620919,508,There is still one more left in the break room
10,3509,0,0,7,7,1.0,0.1543033499620919,508,No. I've never seen those legs before.
13,3509,0,0,7,7,1.0,0.1543033499620919,508,"No, that picture does not refresh my recollection and your good cop/bad cop routine just jumped the shark."
15,3509,0,0,7,7,1.0,0.1543033499620919,508,"Yeah, that's my pool. So what?"
17,3509,0,0,7,7,1.0,0.1543033499620919,508,"I said loans, not cards."
18,3509,0,0,6,6,1.0,0.18257418583505536,508,You'll never get me to talk
21,3509,0,0,7,7,1.0,0.1543033499620919,508,"You know I can't tell you what he said. After all, attorney-client privilege."
22,3509,0,0,7,7,1.0,0.1543033499620919,508,"I haven't seen Left Shark since the last Super Bowl. But is 'stealing the show' really a thing, anyway?"
25,3509,0,0,7,7,1.0,0.1543033499620919,508,"Enough good carp, bad carp. I want a lawyer, even though that seems redundant."
26,3509,0,0,7,7,1.0,0.1543033499620919,508,My defense will be I thought the leg was a toy.
28,3509,0,0,7,7,1.0,0.1543033499620919,508,Remember when you asked for a bigger weiner?
31,3509,0,0,7,7,1.0,0.1543033499620919,508,"Nope, dunno 'em. Must be one of the little fish."
54,3509,0,0,8,8,1.0,0.1336306209562122,508,Ok......is this or this not ur bite mark?!
52,3509,0,0,7,7,1.0,0.1543033499620919,508,Jaws up .. Did you eat this?
51,3509,0,0,7,7,1.0,0.1543033499620919,508,I already told you: I'm not a card shark.
50,3509,0,0,7,7,1.0,0.1543033499620919,508,"’I’m telling you, I didn’t do it. I can’t even swim."
49,3509,0,0,7,7,1.0,0.1543033499620919,508,Do your worst... I'm not taking the bait...
45,3509,0,0,8,8,1.0,0.1336306209562122,508,"Yup, that's him. Steven Spielberg."
58,3509,0,0,7,7,1.0,0.1543033499620919,508,"Yeah, it's him on the left that did it."
44,3509,0,0,7,7,1.0,0.1543033499620919,508,"Yeah, that's Remoras, the dirty sharksucker!"
40,3509,0,0,7,7,1.0,0.1543033499620919,508,"I haven't seen him before. I told you I wasn't there. I was home watching TV, it was 'Human Week'."
39,3509,0,0,7,7,1.0,0.1543033499620919,508,"Hell, I can't read your writing. Get a bigger pen."
37,3509,0,0,7,7,1.0,0.1543033499620919,508,"I'm tellin' ya, Flipper framed me!"
36,3509,0,0,7,7,1.0,0.1543033499620919,508,It wasn't me! It was the one armed man!
35,3509,0,0,7,7,1.0,0.1543033499620919,508,"That looks like him, but I swear I never took the first bite."
32,3509,0,0,7,7,1.0,0.1543033499620919,508,"We know you ingested her, who ordered the eat?"
43,3509,0,0,7,7,1.0,0.1543033499620919,508,I've never seen that chum in my life.
531,3509,0,0,7,7,1.0,0.1543033499620919,508,I couldn't have done it. I was at the World Series of Poker.
111,3509,0,0,7,7,1.0,0.1543033499620919,508,"Ah, you're looking for Hammerhead Lecter?"
115,3509,0,0,8,8,1.0,0.1336306209562122,508,It's hard when you have to keep moving!
165,3509,0,0,8,8,1.0,0.1336306209562122,508,"You've got the wrong guy. I'm a pool shark, not a loan shark."
166,3509,0,0,7,7,1.0,0.1543033499620919,508,I need some water!
169,3509,0,0,7,7,1.0,0.1543033499620919,508,"Holy mackerel, it's one of my schoolmates."
174,3509,0,0,7,7,1.0,0.1543033499620919,508,You're on the no-swim list.
175,3509,0,0,7,7,1.0,0.1543033499620919,508,My lawyer says I don't have to answer any more questions. He's a shark by the way.
177,3509,0,0,7,7,1.0,0.1543033499620919,508,Everyone I ate was already sleeping with the fishes!
179,3509,0,0,7,7,1.0,0.1543033499620919,508,After you show me the specials I'd like a wine list.
185,3509,0,0,7,7,1.0,0.1543033499620919,508,"You must be mistaken officer, I've never seen that delectable morsel in my life."
186,3509,0,0,7,7,1.0,0.1543033499620919,508,This is the last selfie she shared from inside you. I have ten more here!
189,3509,0,0,8,8,1.0,0.1336306209562122,508,"You’ll get nothing out of me, carp-er."
190,3509,0,0,7,7,1.0,0.1543033499620919,508,"I told ya, I don't see color so well."
191,3509,0,0,7,7,1.0,0.1543033499620919,508,Mrs. Claus told him he needed to drop a few pounds. Suddenly he's not so jolly.
192,3509,0,0,7,7,1.0,0.1543033499620919,508,"You can't pin his murder on me, there was a feeding frenzy on."
193,3509,0,0,7,7,1.0,0.1543033499620919,508,"yeah I know him, he was a chum of mine. Can I get some water please?"
194,3509,0,0,7,7,1.0,0.1543033499620919,508,We'll see whose big dog around here!
195,3509,0,0,7,7,1.0,0.1543033499620919,508,Miranda-shmiranda
197,3509,0,0,7,7,1.0,0.1543033499620919,508,"Yeah, I know the guy; he’s just a chum…er, chump."
220,3509,0,0,7,7,1.0,0.1543033499620919,508,How many times do I have to tell you? I only saw their legs.
217,3509,0,0,7,7,1.0,0.1543033499620919,508,"Hmm, it could be him, but there a lot of fish in the sea, you know?"
215,3509,0,0,7,7,1.0,0.1543033499620919,508,Obama made me eat him.
214,3509,0,0,7,7,1.0,0.1543033499620919,508,"It could be him, I guess. There a lot of fish in the see, you know?"
213,3509,0,0,7,7,1.0,0.1543033499620919,508,"I tell ya, I wasn't at Nantucket. Why go all that way when Fire Island is just as nice?"
212,3509,0,0,7,7,1.0,0.1543033499620919,508,Never tasted an arm like that in my life.
164,3509,0,0,7,7,1.0,0.1543033499620919,508,"I will say it again copper, this is a dog eat dog world..... But a shark's got to eat too !"
208,3509,0,0,7,7,1.0,0.1543033499620919,508,Slip me another fin and I'll give you another name.
206,3509,0,0,7,7,1.0,0.1543033499620919,508,Who Miranda? Isn't she the one I just ate?
204,3509,0,0,7,7,1.0,0.1543033499620919,508,Looks like he's sleeping with the fishes. What of it?
203,3509,0,0,7,7,1.0,0.1543033499620919,508,And you claim you have never seen this baby seal?
201,3509,0,0,7,7,1.0,0.1543033499620919,508,"You got nuttin, cops, but if you want a shark, wait till my lawyer gets here."
199,3509,0,0,7,7,1.0,0.1543033499620919,508,looks like Charlie the tuna
198,3509,0,0,7,7,1.0,0.1543033499620919,508,Never heard of this 'Quint'.
207,3509,0,0,7,7,1.0,0.1543033499620919,508,"I'm tellin' ya, copper, I was only basking."
113,3509,0,0,8,8,1.0,0.1336306209562122,508,Just cut me loose and let me collect my bag of chum already.
163,3509,0,0,7,7,1.0,0.1543033499620919,508,"Yeah, he sticks around."
160,3509,0,0,7,7,1.0,0.1543033499620919,508,Don't know him. He's surely a small fish
118,3509,0,0,7,7,1.0,0.1543033499620919,508,"Well, it looks like a reasonable rate of interest to me."
120,3509,0,0,7,7,1.0,0.1543033499620919,508,"He tasted like lamb, rosemary, garlic, Camembert, and petit pois."
121,3509,0,0,8,8,1.0,0.1336306209562122,508,You'll never prove it; my lawyer's a shark.
122,3509,0,0,7,7,1.0,0.1543033499620919,508,Look; I told you I never ate the guy.
123,3509,0,0,7,7,1.0,0.1543033499620919,508,This number says you're going in the drunk tank.
125,3509,0,0,7,7,1.0,0.1543033499620919,508,"Hey, it wasn't me! He jumped someone else!"
127,3509,0,0,7,7,1.0,0.1543033499620919,508,We'll need you to cough up the license plate.
129,3509,0,0,7,7,1.0,0.1543033499620919,508,Don't try so hard! There's absolutely nothing fishy about my behavior.
131,3509,0,0,7,7,1.0,0.1543033499620919,508,How do you like my 'Louis the Fish' disguise?
132,3509,0,0,7,7,1.0,0.1543033499620919,508,I was in school that day.
133,3509,0,0,7,7,1.0,0.1543033499620919,508,"I'm just a loan shark on borrowed time, don't you have sumfin better to do?"
136,3509,0,0,7,7,1.0,0.1543033499620919,508,"'Yes that's them, they would not let me on Shark Tank'."
137,3509,0,0,7,7,1.0,0.1543033499620919,508,"Yes,yes,yes.I ate him ."
138,3509,0,0,7,7,1.0,0.1543033499620919,508,YES!! I ate her too... Just like all the rest...
139,3509,0,0,7,7,1.0,0.1543033499620919,508,That's signed by Charlie Tuna. I'm Sam the Shark.
140,3509,0,0,7,7,1.0,0.1543033499620919,508,You mean the finger food?
141,3509,0,0,7,7,1.0,0.1543033499620919,508,I won't say anything until I have seen my environmental lawyer.
159,3509,0,0,5,5,1.0,0.22360679774997896,508,Does this surfer look familiar?
157,3509,0,0,7,7,1.0,0.1543033499620919,508,"I know whose dorsal fin that is, but I ain't telling you."
156,3509,0,0,7,7,1.0,0.1543033499620919,508,I'd rather be on Shark Tank.
155,3509,0,0,8,8,1.0,0.1336306209562122,508,That doesn't even look like me.
154,3509,0,0,5,5,1.0,0.22360679774997896,508,"Of course, I ran the stop sign. Sharks never stop moving."
152,3509,0,0,7,7,1.0,0.1543033499620919,508,"He said 'the', not 'a' - get Donald Trump on the phone ASAP!"
161,3509,0,0,8,8,1.0,0.1336306209562122,508,"Hey, we wuz just exercising our constitutional right to piece-ful assembly."
151,3509,0,0,7,7,1.0,0.1543033499620919,508,I work on Wall Street. Never go near the water.
149,3509,0,0,7,7,1.0,0.1543033499620919,508,Not good. My eyes are closed.
148,3509,0,0,7,7,1.0,0.1543033499620919,508,That's not North Carolina!
147,3509,0,0,7,7,1.0,0.1543033499620919,508,It's hard to tell from the whole picture -- could you tear it up into smaller bits?
145,3509,0,0,6,6,1.0,0.18257418583505536,508,I never expected to get caught.
144,3509,0,0,7,7,1.0,0.1543033499620919,508,"It looks like the bigger boat, yeah."
142,3509,0,0,7,7,1.0,0.1543033499620919,508,'The Fonz?'..never heard of him...
150,3509,0,0,7,7,1.0,0.1543033499620919,508,"Yeah. I ate Robert Shaw 40 years ago, but you won't pin that on me copper."
534,3509,0,0,7,7,1.0,0.1543033499620919,508,They all look the same to me. This one tasted like Chicken
536,3509,0,0,8,8,1.0,0.1336306209562122,508,I needed another lawyer.
541,3509,0,0,8,8,1.0,0.1336306209562122,508,"Look, yes, I ate the girl swimming by the buoy, but I didn't kill Alex Kintner. I would never eat a kid on a raft."
889,3509,0,0,7,7,1.0,0.1543033499620919,508,It's got your fin-prints all over it.
891,3509,0,0,7,7,1.0,0.1543033499620919,508,"I got sick of hearing, 'the check's in the mail'..."
894,3509,0,0,7,7,1.0,0.1543033499620919,508,"I'd demand a lawyer, but that seems redundant."
896,3509,0,0,7,7,1.0,0.1543033499620919,508,You've got the wrong guy! I swear! You must be confusing me with another school of fish!
898,3509,0,0,7,7,1.0,0.1543033499620919,508,I've never even been to Manitowoc County
899,3509,0,0,7,7,1.0,0.1543033499620919,508,"Fugettaboudit. I ain't a rat, see."
902,3509,0,0,7,7,1.0,0.1543033499620919,508,Clearly it wasn't a great white. No self-respecting great white needs a second bite.
903,3509,0,0,7,7,1.0,0.1543033499620919,508,"You know, I never see any great whites in here. Why's that?"
904,3509,0,0,7,7,1.0,0.1543033499620919,508,I swear it was Flipper!
906,3509,0,0,7,7,1.0,0.1543033499620919,508,"Yes, that's you...you're next"
907,3509,0,0,7,7,1.0,0.1543033499620919,508,Law & Order: APU (Apex Predators Unit)
910,3509,0,0,7,7,1.0,0.1543033499620919,508,I didn't get a good look at him. He said he was Jimmy Hoffa just as I swallowed him.
911,3509,0,0,7,7,1.0,0.1543033499620919,508,"Obviously not my work, man. I'm an artist. That's just random gore and surfboards."
913,3509,0,0,7,7,1.0,0.1543033499620919,508,"You have it all wrong, I told you I am a 'lone shark.'"
915,3509,0,0,7,7,1.0,0.1543033499620919,508,"Yea, I remember him. Believe he was lunch."
916,3509,0,0,7,7,1.0,0.1543033499620919,508,Is this the guy you put the bite on or not?
919,3509,0,0,7,7,1.0,0.1543033499620919,508,"Sure i recognize her; seen her two or three times but, how could i know that pilot fish was a minor?"
957,3509,0,0,7,7,1.0,0.1543033499620919,508,That's my bar license you idiot! Where is my client?
953,3509,0,0,8,8,1.0,0.1336306209562122,508,Jaws? Never heard of him
952,3509,0,0,7,7,1.0,0.1543033499620919,508,"Yeah, that's Mr Wonderful"
948,3509,0,0,7,7,1.0,0.1543033499620919,508,That's not my doing. I've got an overbite.
943,3509,0,0,7,7,1.0,0.1543033499620919,508,"No, not that one, you're gonna need a bigger boat."
941,3509,0,0,7,7,1.0,0.1543033499620919,508,Could you tell the 'bad cop' to get off my tail with his golf cleats.
886,3509,0,0,7,7,1.0,0.1543033499620919,508,It wasn't me - I've never seen him before.
939,3509,0,0,6,6,1.0,0.18257418583505536,508,"I don't recognize him, but his bathing suit looks familiar."
935,3509,0,0,7,7,1.0,0.1543033499620919,508,"that doesn't look like me, you hammerhead!"
931,3509,0,0,7,7,1.0,0.1543033499620919,508,"No, I've never seen that blot; and his name is Rorshack with an R!"
925,3509,0,0,7,7,1.0,0.1543033499620919,508,"Don't give us the business. This is NOT a case of mistaken identity: This is a picture of Bernardo, the head of the Sharks in 'West Side Story'. There is absolutely no resemblance."
924,3509,0,0,7,7,1.0,0.1543033499620919,508,Alright. I admit it. I did it.
921,3509,0,0,7,7,1.0,0.1543033499620919,508,"I told you, strangulation isn't our thing."
920,3509,0,0,7,7,1.0,0.1543033499620919,508,Nothing on the menu pleases you?
936,3509,0,0,7,7,1.0,0.1543033499620919,508,Does this look the sea captain who is stalking you?
958,3509,0,0,8,8,1.0,0.1336306209562122,508,"He's the killer man, I just helped eat the body!"
885,3509,0,0,7,7,1.0,0.1543033499620919,508,That's not me. The night of the 23rd I was in the middle of a feeding frenzy.
882,3509,0,0,7,7,1.0,0.1543033499620919,508,"I'm a shark, not a pigeon!"
825,3509,0,0,7,7,1.0,0.1543033499620919,508,I guess YOU never got carried away with Snapchat.
828,3509,0,0,7,7,1.0,0.1543033499620919,508,You are so bad that they named an attack after sharks
829,3509,0,0,7,7,1.0,0.1543033499620919,508,"I would ask for an attorney, but I obviously am one."
832,3509,0,0,7,7,1.0,0.1543033499620919,508,"O.K., I admit it, and he gave me indigestion!"
833,3509,0,0,7,7,1.0,0.1543033499620919,508,His frown gave it away - You're the 'good cop' Right?
834,3509,0,0,7,7,1.0,0.1543033499620919,508,I'm not talking unless you can guarantee that I'm not going back to the aquarium.
835,3509,0,0,7,7,1.0,0.1543033499620919,508,"Honestly, I have never seen that fish before in my life."
836,3509,0,0,7,7,1.0,0.1543033499620919,508,"For the last time, I was never a loan shark!"
837,3509,0,0,8,8,1.0,0.1336306209562122,508,"That's not me, it's my cousin Jaws."
839,3509,0,0,7,7,1.0,0.1543033499620919,508,"I haven't ate any humans, I'm a bottomfeeder."
842,3509,0,0,7,7,1.0,0.1543033499620919,508,That man had one arm & one leg when he entered the water.
845,3509,0,0,7,7,1.0,0.1543033499620919,508,That's not me. It's my cousin Vito the loan shark.
846,3509,0,0,7,7,1.0,0.1543033499620919,508,"I DON'T HAVE ANY MONEY, HOW COULD BE A LOAN SHARK?"
847,3509,0,0,7,7,1.0,0.1543033499620919,508,"Look, you can either do time for dismembering a surfer or you can tell us where to find this killer whale."
848,3509,0,0,7,7,1.0,0.1543033499620919,508,The goal is to illustrate inflation. This is my wurst idea.
850,3509,0,0,7,7,1.0,0.1543033499620919,508,Special order for an 'Oscar Mayer'.
851,3509,0,0,6,6,1.0,0.18257418583505536,508,That's my fish face selfie.
881,3509,0,0,7,7,1.0,0.1543033499620919,508,Put your mirror down....I confess to loan sharking.
879,3509,0,0,7,7,1.0,0.1543033499620919,508,Do you recognize this dolphin?
878,3509,0,0,7,7,1.0,0.1543033499620919,508,"Yeah, I lent him money--but at the legal interest rate."
875,3509,0,0,7,7,1.0,0.1543033499620919,508,"I'll have the spicy salmon maki and the dragon maki. Thanks, Good Cop."
873,3509,0,0,7,7,1.0,0.1543033499620919,508,I'll say it again... I don't attack humans!
872,3509,0,0,8,8,1.0,0.1336306209562122,508,Haven't you got bigger fish to fry?
884,3509,0,0,7,7,1.0,0.1543033499620919,508,I'm ready for my phone call and i need someone to help me dial
871,3509,0,0,7,7,1.0,0.1543033499620919,508,"I wouldn't have gotten called in, if I was a Great White Shark..."
863,3509,0,0,7,7,1.0,0.1543033499620919,508,"Look boys, the only 'Killer Shark' in this room, will be my lawyer when he gets here."
862,3509,0,0,8,8,1.0,0.1336306209562122,508,"I'm not sure, that cold be the guy but like I told your partner, It was a dark and stormy night"
859,3509,0,0,7,7,1.0,0.1543033499620919,508,I have an alibi; I was spawning.
856,3509,0,0,7,7,1.0,0.1543033499620919,508,Yes it looks like me but I was filming Jaws XXI and have 200 people who can alibi me.
855,3509,0,0,7,7,1.0,0.1543033499620919,508,How did you get hold of my fish gape?
852,3509,0,0,7,7,1.0,0.1543033499620919,508,I swear he did break all my teeth.
868,3509,0,0,7,7,1.0,0.1543033499620919,508,We nailed you via your dental records.
821,3509,0,0,7,7,1.0,0.1543033499620919,508,"I'm telling you, I've never seen that delicious-looking man."
960,3509,0,0,7,7,1.0,0.1543033499620919,508,"You have to believe me, copper. I don't eat meat!"
963,3509,0,0,7,7,1.0,0.1543033499620919,508,You all look alike to me.
1034,3509,0,0,7,7,1.0,0.1543033499620919,508,"Yeah, I seen her around. Sleeps with all the fishes."
1035,3509,0,0,7,7,1.0,0.1543033499620919,508,Is that your tooth mark on the top line of this loan agreement?
1038,3509,0,0,7,7,1.0,0.1543033499620919,508,That was years ago - you'll have to ask a dolphin.
1042,3509,0,0,7,7,1.0,0.1543033499620919,508,Do you have a shot of his legs?
1044,3509,0,0,7,7,1.0,0.1543033499620919,508,We called him 'The Knife...AKA Mack...'
1047,3509,0,0,7,7,1.0,0.1543033499620919,508,"Nah, he ain't the one. Never laid a tooth on him."
1050,3509,0,0,7,7,1.0,0.1543033499620919,508,"'Left shark', 'right shark', whatever. I've never seen him before in my life!"
1052,3509,0,0,7,7,1.0,0.1543033499620919,508,Not MY signature!
1056,3509,0,0,8,8,1.0,0.1336306209562122,508,"Officer, you've got to believe me that it was self-defense. That surfer punched me in the nose before I even thought about taking a bite."
1058,3509,0,0,7,7,1.0,0.1543033499620919,508,"Yea, we were swimming together. I turned around and he was gone. I don't know where he went."
1060,3509,0,0,7,7,1.0,0.1543033499620919,508,Do you happen to recognize this leg?
1061,3509,0,0,7,7,1.0,0.1543033499620919,508,"The Shark Tank used to be my favorite show, until now."
1062,3509,0,0,7,7,1.0,0.1543033499620919,508,"You realize that 'Sharknado' is just a movie, right?"
1063,3509,0,0,7,7,1.0,0.1543033499620919,508,We know this is your marker—LOAN SHARK!
1066,3509,0,0,7,7,1.0,0.1543033499620919,508,I thought it was an eel. How was I supposed to know it was Bethany Hamilton's arm.
1068,3509,0,0,7,7,1.0,0.1543033499620919,508,What's it to ya chrome dome?
1070,3509,0,0,7,7,1.0,0.1543033499620919,508,I don't know Officer Krupke. A jet is a jet.
1097,3509,0,0,7,7,1.0,0.1543033499620919,508,"Never been to Grand Cayman. Besides, I cannot read."
1096,3509,0,0,7,7,1.0,0.1543033499620919,508,"No, he doesn't swim with the sharks."
1093,3509,0,0,7,7,1.0,0.1543033499620919,508,"So? You take another look at the lyric... as you can see, my teeth are not 'pearly-white.'"
1089,3509,0,0,7,7,1.0,0.1543033499620919,508,Detective Murphy caught me single-handed. Burrrp! He had no choice!
1088,3509,0,0,7,7,1.0,0.1543033499620919,508,You have the best menus...
1087,3509,0,0,7,7,1.0,0.1543033499620919,508,It's CGI.
1033,3509,0,0,7,7,1.0,0.1543033499620919,508,I don't have a lying bone in my body.
1086,3509,0,0,7,7,1.0,0.1543033499620919,508,"Yeah, I know Shamu. So what? I know lots of predators."
1079,3509,0,0,7,7,1.0,0.1543033499620919,508,"Can't tell you that. If I do, they'll can me."
1078,3509,0,0,7,7,1.0,0.1543033499620919,508,Like I told your partner: I don't know nothin' 'bout no missing swimmers.
1077,3509,0,0,7,7,1.0,0.1543033499620919,508,Does this blood type smell familiar?
1073,3509,0,0,7,7,1.0,0.1543033499620919,508,Yeah sure that's Quint...we once worked together back in the day. Haven't seen 'em since.
1072,3509,0,0,7,7,1.0,0.1543033499620919,508,"I'm innocent, I tell you. Don't put me back in the tank!"
1071,3509,0,0,7,7,1.0,0.1543033499620919,508,I know my rights; I'm a lawyer!
1081,3509,0,0,7,7,1.0,0.1543033499620919,508,Dolphin? Porpoise? They all look alike to me.
962,3509,0,0,7,7,1.0,0.1543033499620919,508,I refuse to say anything without my lawyer present. He's the real shark here.
1031,3509,0,0,7,7,1.0,0.1543033499620919,508,"No guns in the interrogation room, smart guy."
1029,3509,0,0,7,7,1.0,0.1543033499620919,508,I thought it was the lamp from 'The Christmas Story.'
964,3509,0,0,7,7,1.0,0.1543033499620919,508,"I'm a loan shark, not a killer whale."
966,3509,0,0,7,7,1.0,0.1543033499620919,508,I won't talk until I am assigned a client.
970,3509,0,0,7,7,1.0,0.1543033499620919,508,'Doesn't look familiar but all sushi looks alike to me.
971,3509,0,0,7,7,1.0,0.1543033499620919,508,"Swimming at the beach and singing 'Duh, duh, Duh, duh' is within my First Amendment rights."
972,3509,0,0,7,7,1.0,0.1543033499620919,508,"Nah, tattoos are a turn off and there is the risk of HIV, hepatitis and prions!"
973,3509,0,0,7,7,1.0,0.1543033499620919,508,"Hey, surfer - sea lion, they all look the same."
977,3509,0,0,7,7,1.0,0.1543033499620919,508,"I'm Mr. Wonderful, I had nothing to do with it. You should be grilling Mark Cuban!"
979,3509,0,0,7,7,1.0,0.1543033499620919,508,This photo places you at Amity Island on the night of the attack.
980,3509,0,0,7,7,1.0,0.1543033499620919,508,"Now look, see. You can't pin that on me, see. I've got an alibi, see. I was in the sea, see."
983,3509,0,0,7,7,1.0,0.1543033499620919,508,Another seal.
985,3509,0,0,7,7,1.0,0.1543033499620919,508,"No, I do not recognize those teeth marks!"
987,3509,0,0,7,7,1.0,0.1543033499620919,508,I have an alibi. I was eating a diver at the time.
988,3509,0,0,8,8,1.0,0.1336306209562122,508,"That ain't my mug, Copper, it's Mack the Knife."
989,3509,0,0,7,7,1.0,0.1543033499620919,508,Not that kind of pool!
990,3509,0,0,7,7,1.0,0.1543033499620919,508,No way I can ID any one perp; they're smelts for cryin' out loud!
993,3509,0,0,7,7,1.0,0.1543033499620919,508,Finding post adolescent Nemo.
994,3509,0,0,7,7,1.0,0.1543033499620919,508,What!? She volunteered for 'Shark Tank'... Don't blame me for her being confused...
1025,3509,0,0,7,7,1.0,0.1543033499620919,508,"Enough with the deep-six references, already."
1020,3509,0,0,8,8,1.0,0.1336306209562122,508,I'm innocent. I'm a vegan.
1017,3509,0,0,7,7,1.0,0.1543033499620919,508,"Alright, I'll pass the headshot along to Speilberg. Now let me go!"
1016,3509,0,0,7,7,1.0,0.1543033499620919,508,I've got an alibi... check with Spielberg.
1013,3509,0,0,8,8,1.0,0.1336306209562122,508,Don't know 'em. But he does resemble I guy I know that's missing an arm and a leg.
1011,3509,0,0,7,7,1.0,0.1543033499620919,508,There sure is something fishy about this case.
1030,3509,0,0,7,7,1.0,0.1543033499620919,508,"Move that Miranda list a little closer, buddy, and I'll exercise my right to bite your arm off."
1007,3509,0,0,8,8,1.0,0.1336306209562122,508,Well what do they call it 'SHARK WEEK' for then anyway?
1004,3509,0,0,7,7,1.0,0.1543033499620919,508,"You got the wrong guy, I'm not the shark from THAT movie."
1003,3509,0,0,7,7,1.0,0.1543033499620919,508,"Yea, I'm known by the name Charlie the tuna, what about it?"
1001,3509,0,0,7,7,1.0,0.1543033499620919,508,You're guilty - that arm you swallowed has DNA.
999,3509,0,0,7,7,1.0,0.1543033499620919,508,Why you gotta shove that in my face? I LIKED Aquaman.
997,3509,0,0,8,8,1.0,0.1336306209562122,508,"Yea, that's one, just out for money but claiming to be a shark !"
996,3509,0,0,7,7,1.0,0.1543033499620919,508,never saw him before and anyway too skinny for my taste.
1005,3509,0,0,7,7,1.0,0.1543033499620919,508,Don't blame me. People at Sea World taught me to eat little fish.
2179,3509,0,0,7,7,1.0,0.1543033499620919,508,Can you hurry this up? I'm late for Shark Week.
820,3509,0,0,7,7,1.0,0.1543033499620919,508,"I'm not talking until my shark--er,lawyer--gets here."
818,3509,0,0,7,7,1.0,0.1543033499620919,508,I think we have different definitions of 'chummy'.
624,3509,0,0,8,8,1.0,0.1336306209562122,508,"I can't makes heads or tails this way. He didn't bleed anywhere, did he?"
627,3509,0,0,7,7,1.0,0.1543033499620919,508,"Here's the writ, produce the body."
630,3509,0,0,7,7,1.0,0.1543033499620919,508,"Like I told you already, those Happy Days guys jumped me! I was just minding my own business!"
631,3509,0,0,7,7,1.0,0.1543033499620919,508,We've been tracking your every move for years.
634,3509,0,0,7,7,1.0,0.1543033499620919,508,"I told you already, that is not the same arm"
636,3509,0,0,8,8,1.0,0.1336306209562122,508,"That's Marco Polo. Oh, I get it. Good one."
637,3509,0,0,8,8,1.0,0.1336306209562122,508,I'm swear I haven't even seen Richard Dreyfuss in years!
638,3509,0,0,7,7,1.0,0.1543033499620919,508,"I tell ya, I never seen that seal before. Now either charge me or cut me loose!"
639,3509,0,0,7,7,1.0,0.1543033499620919,508,I just can't tell. To me all hominids look the same.
640,3509,0,0,7,7,1.0,0.1543033499620919,508,I already told ya. I've never seen that half of a leg.
641,3509,0,0,7,7,1.0,0.1543033499620919,508,"You should be careful with how you speak to me, everyone in my family is a lawyer"
643,3509,0,0,7,7,1.0,0.1543033499620919,508,"Hey Genius, try holding the picture outside of my blind spot. Don't you know sharks can't see right in front their snout?"
645,3509,0,0,7,7,1.0,0.1543033499620919,508,"Okay, clam up if you want, take the Fish Amendment. Just sign this to show that you did it on porpoise."
648,3509,0,0,7,7,1.0,0.1543033499620919,508,"Yeah he slept with me. He sleeps with a lot of us, so what?!"
649,3509,0,0,7,7,1.0,0.1543033499620919,508,Could it be our boy's done something rash?
655,3509,0,0,7,7,1.0,0.1543033499620919,508,Who are you calling old chum?
657,3509,0,0,7,7,1.0,0.1543033499620919,508,Are you sure you want to put that document so close to the shredder?
688,3509,0,0,8,8,1.0,0.1336306209562122,508,So I'm a Wall St shark. Since when has that been a crime?
687,3509,0,0,8,8,1.0,0.1336306209562122,508,No. That's not him. I've told you. He looked like Robert Shaw.
685,3509,0,0,7,7,1.0,0.1543033499620919,508,"You want $150,000 for 10% of your company?"
684,3509,0,0,7,7,1.0,0.1543033499620919,508,I tell you I'm not a Bull-- I haven't bitten a red dress in my life--
683,3509,0,0,7,7,1.0,0.1543033499620919,508,I've never seen this seal before.
680,3509,0,0,7,7,1.0,0.1543033499620919,508,"Yea, Buffet, that's the one!"
620,3509,0,0,8,8,1.0,0.1336306209562122,508,I'm telling you. That's my brother Phineas.
678,3509,0,0,7,7,1.0,0.1543033499620919,508,"Yeah, I recognize the deceased. You might say he was my chum."
671,3509,0,0,7,7,1.0,0.1543033499620919,508,Everyone knows the rules when they swim with the sharks
666,3509,0,0,5,5,1.0,0.22360679774997896,508,I've never been to a sushi restaurant in my life.
664,3509,0,0,6,6,1.0,0.18257418583505536,508,"Believe me when I tells ya, yous guys ain't going to find this Nemo kid."
662,3509,0,0,7,7,1.0,0.1543033499620919,508,I did NOT have relations with that Bar Examiner.
660,3509,0,0,7,7,1.0,0.1543033499620919,508,"Yeah, he sort of looked like that, except he had a peg leg and carried a harpoon."
658,3509,0,0,7,7,1.0,0.1543033499620919,508,"Just a knife has ol' MacHeath, see? And he keeps it, outta sight..."
673,3509,0,0,7,7,1.0,0.1543033499620919,508,"Please stop saying, 'Is it this one, Chum.' You're making me hungry."
691,3509,0,0,7,7,1.0,0.1543033499620919,508,I have a permit for that.
619,3509,0,0,7,7,1.0,0.1543033499620919,508,"Look, I'm not falling for the left cop, right cop thing."
616,3509,0,0,7,7,1.0,0.1543033499620919,508,"I didn't do it; it was Orca, I tell ya!"
542,3509,0,0,7,7,1.0,0.1543033499620919,508,"For the last time, no, I did not forget the dance moves at last year's Super Bowl."
543,3509,0,0,7,7,1.0,0.1543033499620919,508,I already know my rights. I'm a lawyer.
545,3509,0,0,7,7,1.0,0.1543033499620919,508,What do you mean my job's going overseas?
546,3509,0,0,7,7,1.0,0.1543033499620919,508,Those could be anyone's teeth.
547,3509,0,0,8,8,1.0,0.1336306209562122,508,"If I had eaten him, I would have known that he tasted like sweaty socks. Which I don't."
548,3509,0,0,7,7,1.0,0.1543033499620919,508,I don't speak that language so when you tell me to read my rights I don't get it!
551,3509,0,0,7,7,1.0,0.1543033499620919,508,"If he's sleeping with the fishes, I ain't seen 'em."
552,3509,0,0,7,7,1.0,0.1543033499620919,508,"But officer, I was only standing my water"
556,3509,0,0,7,7,1.0,0.1543033499620919,508,Never saw him. What's his blood type?
562,3509,0,0,7,7,1.0,0.1543033499620919,508,He looks familiar. I think he's starting to come back on me...I mean TO me.
563,3509,0,0,7,7,1.0,0.1543033499620919,508,That's not him. Can I call my hydrologist now?
564,3509,0,0,7,7,1.0,0.1543033499620919,508,If this goes down the wrong way you will lose the white sharks matters support.
565,3509,0,0,7,7,1.0,0.1543033499620919,508,Turkey on rye. And light mayo or else!
568,3509,0,0,7,7,1.0,0.1543033499620919,508,That's Mac the Scissors.
569,3509,0,0,7,7,1.0,0.1543033499620919,508,"Na, that's not my bite. Check it against my dental chart."
570,3509,0,0,7,7,1.0,0.1543033499620919,508,"Blood and gore? Nah, that's just shark click bait."
571,3509,0,0,9,9,1.0,0.11785113019775792,508,"Yeah, that's me alright doing what all sharks do... rip flesh."
611,3509,0,0,7,7,1.0,0.1543033499620919,508,"Yes, he stole my fin."
602,3509,0,0,7,7,1.0,0.1543033499620919,508,"Yes, that’s the gazpacho they tried to dip me in."
597,3509,0,0,7,7,1.0,0.1543033499620919,508,I don't remember. I was in a frenzy.
592,3509,0,0,7,7,1.0,0.1543033499620919,508,I never saw that seal before in my life! I swear officer I'm on a strict tuna diet only!!
591,3509,0,0,7,7,1.0,0.1543033499620919,508,Don't know him too well... just asked me to join the frenzy last we talked.
588,3509,0,0,8,8,1.0,0.1336306209562122,508,"Okay, okay - there will be a rumble with the jets tonight!"
617,3509,0,0,7,7,1.0,0.1543033499620919,508,I never loaned him a dime!
587,3509,0,0,7,7,1.0,0.1543033499620919,508,I want to call my shark lawyer.
584,3509,0,0,7,7,1.0,0.1543033499620919,508,"Hardly any point in lawyering up, I guess"
581,3509,0,0,8,8,1.0,0.1336306209562122,508,Maybe I ate him—there are plenty of fish in the sea.
578,3509,0,0,6,6,1.0,0.18257418583505536,508,no no no im a LONE shark not a LOAN shark ...i feel like we're swimming in goddamn circles here...why are you showing me polaroids of your trip to florida?
577,3509,0,0,7,7,1.0,0.1543033499620919,508,I'm turning this in to HR because 'Take your Dog to Work' day isn't until June 24th.
576,3509,0,0,8,8,1.0,0.1336306209562122,508,"Well, yeah, he was provided to me, and now I want another one."
574,3509,0,0,7,7,1.0,0.1543033499620919,508,"Look, I swim with the sharks, I wouldn't be hanging around with a minnow like that!"
585,3509,0,0,7,7,1.0,0.1543033499620919,508,That's the one! It's the biggest boat in the area.
819,3509,0,0,8,8,1.0,0.1336306209562122,508,"No, Gerard, he had one arm before I saw him."
692,3509,0,0,7,7,1.0,0.1543033499620919,508,"For the last time, I have never seen that guy and I don't even lend friends money"
694,3509,0,0,7,7,1.0,0.1543033499620919,508,I'm telling you two once and for all... you can't bait me to squeal with that document!'
761,3509,0,0,7,7,1.0,0.1543033499620919,508,The Choreography Police
762,3509,0,0,7,7,1.0,0.1543033499620919,508,"I don't care what happened to him. He played for the N.Y. Jets and when you're a jet, you're a jet all the way, from your first cigarette to your last dyin’ day."
763,3509,0,0,7,7,1.0,0.1543033499620919,508,I am telling you for the last time. I didn't go to school with that guy.
765,3509,0,0,7,7,1.0,0.1543033499620919,508,"I was just a pup when dey blew up Granpa, but I ain't nevah fugettin' dat face. Dat creep looked just like Roy Scheider!"
766,3509,0,0,6,6,1.0,0.18257418583505536,508,"Yeah, like I'm the only one in this berg wearin' a sharkskin suit!"
773,3509,0,0,7,7,1.0,0.1543033499620919,508,I won't talk until you give me a splash of water.
775,3509,0,0,7,7,1.0,0.1543033499620919,508,I plead the squid.
776,3509,0,0,7,7,1.0,0.1543033499620919,508,I've been on an all-seafood diet and don't eat human garbage anymore.
777,3509,0,0,7,7,1.0,0.1543033499620919,508,"So I took a chunk, I was born this way."
779,3509,0,0,7,7,1.0,0.1543033499620919,508,"I'm telling you, I never lent that guy a nickel."
781,3509,0,0,7,7,1.0,0.1543033499620919,508,I'm still hungry -- I demand another attorney!
782,3509,0,0,7,7,1.0,0.1543033499620919,508,Usury? That deadbeat nearly sunk me!
783,3509,0,0,7,7,1.0,0.1543033499620919,508,"I already told you, I've never heard of this Nemo."
785,3509,0,0,7,7,1.0,0.1543033499620919,508,"Well... all loan sharks look the same to me, Detective."
786,3509,0,0,7,7,1.0,0.1543033499620919,508,Looks like old Macky's back in town.
787,3509,0,0,8,8,1.0,0.1336306209562122,508,"It wasn't me, man. My anemones are trying to set me up."
789,3509,0,0,7,7,1.0,0.1543033499620919,508,"That's L-O-N-E, Copper."
817,3509,0,0,7,7,1.0,0.1543033499620919,508,"I told you, I don't know that dude."
816,3509,0,0,7,7,1.0,0.1543033499620919,508,Do I look like I can grow a beard?
815,3509,0,0,7,7,1.0,0.1543033499620919,508,"Well, I wasn't aware lawyers can't subpoena themselves."
811,3509,0,0,7,7,1.0,0.1543033499620919,508,That's the purse. I'd recognize that skin anywhere.
810,3509,0,0,7,7,1.0,0.1543033499620919,508,I'm telling you I don't know what she looked like. All I saw were you two goons keeping me from my breakfast. Can I go back to swimming in the shallow water now?
809,3509,0,0,7,7,1.0,0.1543033499620919,508,Bite mark evidence is junk science. You got nothin' on me man!
760,3509,0,0,7,7,1.0,0.1543033499620919,508,Never seen that surfer dude in all my life!
805,3509,0,0,7,7,1.0,0.1543033499620919,508,"Like I told you before, I don't know who Teresa Halbach is."
803,3509,0,0,7,7,1.0,0.1543033499620919,508,damm lawyers
802,3509,0,0,7,7,1.0,0.1543033499620919,508,"I told you already, it was Stephen Spielberg!"
801,3509,0,0,7,7,1.0,0.1543033499620919,508,"Oh, I get it. You find the half-eaten body of a guy named Chum and figure the shark must have done it."
799,3509,0,0,7,7,1.0,0.1543033499620919,508,"Listen chum, you say she was a stripper, I say striper. What's it to ya anyway?"
798,3509,0,0,8,8,1.0,0.1336306209562122,508,Don't know him. I'm not in the lending business anymore.
792,3509,0,0,8,8,1.0,0.1336306209562122,508,He kept trying to sell me some damned trawler insurance!
804,3509,0,0,7,7,1.0,0.1543033499620919,508,"I know you're framing me and my kind for these crimes, but no matter what you do, you'll never get back the hours you wasted on Sharknado."
693,3509,0,0,7,7,1.0,0.1543033499620919,508,Those damn Republicans.
759,3509,0,0,7,7,1.0,0.1543033499620919,508,Yes! My name is Moby and your a Dick?
756,3509,0,0,7,7,1.0,0.1543033499620919,508,Just because I'm a lone shark doesn't mean I'm a loan shark.
698,3509,0,0,6,6,1.0,0.18257418583505536,508,"Don't worry, you won't lose your gun or badge, the judge and I do an annual fishing trip in the Turks and Caicos."
699,3509,0,0,7,7,1.0,0.1543033499620919,508,"I'm telling you, I didn't do it. Fish are friends, not food."
701,3509,0,0,7,7,1.0,0.1543033499620919,508,I've got a task list a foot long.
704,3509,0,0,7,7,1.0,0.1543033499620919,508,We ran out of oversized checks.
705,3509,0,0,7,7,1.0,0.1543033499620919,508,See this? You were caught on camera behind the swimmer before he disappeared.
711,3509,0,0,7,7,1.0,0.1543033499620919,508,I didn't enter illegally. I was caught in shark tournament
716,3509,0,0,7,7,1.0,0.1543033499620919,508,Nope...not that dolphin.
719,3509,0,0,8,8,1.0,0.1336306209562122,508,"Yeah, maybe I loaned him some money, maybe I didn't."
720,3509,0,0,7,7,1.0,0.1543033499620919,508,All I remember is that he was an innie.
725,3509,0,0,8,8,1.0,0.1336306209562122,508,"There are better shredders on the market!, don't you know?"
726,3509,0,0,7,7,1.0,0.1543033499620919,508,That's not my sudoku.
728,3509,0,0,8,8,1.0,0.1336306209562122,508,"I swear, Officer, those jaws ain't mine."
730,3509,0,0,7,7,1.0,0.1543033499620919,508,I'm farsighted!
733,3509,0,0,6,6,1.0,0.18257418583505536,508,I'd never trust the omakase there.
734,3509,0,0,7,7,1.0,0.1543033499620919,508,Really?! You are going to show me a picture? Two words for ya: lateral line.
735,3509,0,0,7,7,1.0,0.1543033499620919,508,"I already told you we're not friends...I prey on surfers, he preys on fear."
736,3509,0,0,7,7,1.0,0.1543033499620919,508,"It wasn't me. I was with Mary Lee in Bermuda, ask OCEARCH."
755,3509,0,0,7,7,1.0,0.1543033499620919,508,'Sure. That's 'Hammerhead' Pete. He could never see what was right in front of him.
754,3509,0,0,7,7,1.0,0.1543033499620919,508,"your lawyer says that he will give you a discount, as a matter of professional courtesy"
752,3509,0,0,7,7,1.0,0.1543033499620919,508,I'm not signing anything I didn't read
750,3509,0,0,7,7,1.0,0.1543033499620919,508,You've got the wrong man. The one you're looking for is Mark Cuban.
749,3509,0,0,7,7,1.0,0.1543033499620919,508,I'm not a card shark.
748,3509,0,0,7,7,1.0,0.1543033499620919,508,There's a taste I'll never forget.
758,3509,0,0,7,7,1.0,0.1543033499620919,508,"Look, as a loan-shark I can offer you a better deal!"
746,3509,0,0,7,7,1.0,0.1543033499620919,508,"That's it, Officer. I recognize that lousy chum."
744,3509,0,0,7,7,1.0,0.1543033499620919,508,"My right is my good eye and it's not up front, stupid."
742,3509,0,0,7,7,1.0,0.1543033499620919,508,You got it all wrong man; me and Flipper was tight.
740,3509,0,0,7,7,1.0,0.1543033499620919,508,Mack the Knife? Never heard of him.
739,3509,0,0,7,7,1.0,0.1543033499620919,508,"I don't recognize him, I see a lot of fish."
738,3509,0,0,7,7,1.0,0.1543033499620919,508,It's not me. I wasn't even born when that movie came out!
737,3509,0,0,7,7,1.0,0.1543033499620919,508,You're grilling me way beyond well done.
745,3509,0,0,8,8,1.0,0.1336306209562122,508,"...and stop calling me knuckles, that's really hurtful."
2180,3509,0,0,7,7,1.0,0.1543033499620919,508,"Yeah, that's Shorty - I'd know that piranha anywhere."
2183,3509,0,0,8,8,1.0,0.1336306209562122,508,Was it this person? this person? this person? this person? For the last time is this the swimmer that tried to KISS you ?
2187,3509,0,0,7,7,1.0,0.1543033499620919,508,All arms look alike to me.
3754,3509,0,0,8,8,1.0,0.1336306209562122,508,"Yes, I shot him, and then attended to his wounds...what can I say? I'm a nurse shark..."
3755,3509,0,0,7,7,1.0,0.1543033499620919,508,"Yeah, that's the chump I chomped."
3756,3509,0,0,6,6,1.0,0.18257418583505536,508,"Yeh, that's what Brecht wrote. Jenny Towler, not Sukey Tawdry."
3763,3509,0,0,7,7,1.0,0.1543033499620919,508,"Yep, that's him alright, though he looked tastier in a bathing suit"
3764,3509,0,0,8,8,1.0,0.1336306209562122,508,"Nope. Robert Shaw doesnt ring any bells, sorry."
3765,3509,0,0,7,7,1.0,0.1543033499620919,508,"I don't know how my fin prints got on the paper, I've never been to Manitowoc Wisconsin."
3766,3509,0,0,7,7,1.0,0.1543033499620919,508,That could be him. Hard to tell from a bowl of shark-fin soup.
3767,3509,0,0,7,7,1.0,0.1543033499620919,508,"Yes, that's definitely Captain Ahab."
3768,3509,0,0,7,7,1.0,0.1543033499620919,508,I ain't spoutin' off; I've never seen that thigh in my life.
3769,3509,0,0,8,8,1.0,0.1336306209562122,508,"I told you, I haven't seen left shark since last February!"
3778,3509,0,0,7,7,1.0,0.1543033499620919,508,Shot him? But I don't even have hands.
3781,3509,0,0,7,7,1.0,0.1543033499620919,508,It's a lie. I never met that chum fish in my life.
3787,3509,0,0,7,7,1.0,0.1543033499620919,508,"I only see what I don't eat, copper."
3790,3509,0,0,7,7,1.0,0.1543033499620919,508,Recognize this card?
3750,3509,0,0,7,7,1.0,0.1543033499620919,508,Wanna go swimming?
3791,3509,0,0,7,7,1.0,0.1543033499620919,508,Sure I recognize him! It's Robert Shaw. What about him?
3793,3509,0,0,7,7,1.0,0.1543033499620919,508,I told you already - he was already dead when I bit him.
3794,3509,0,0,8,8,1.0,0.1336306209562122,508,You ever see this leg before?
3798,3509,0,0,7,7,1.0,0.1543033499620919,508,"Look officer, I keep telling you, I was just circling."
3805,3509,0,0,8,8,1.0,0.1336306209562122,508,Not me. I can't even swim.
3806,3509,0,0,7,7,1.0,0.1543033499620919,508,Do I recognize the torso in the picture? You're gonna have to give me something better than that to go on.
3808,3509,0,0,7,7,1.0,0.1543033499620919,508,"Yah, that's him. That's Harry the piranha. He was the one raiding the minnow farm."
3809,3509,0,0,6,6,1.0,0.18257418583505536,508,"Naw, I ain't never seen 'im with his clothes on before."
3810,3509,0,0,7,7,1.0,0.1543033499620919,508,"I told you before, I have an inflatable fetish. Is that against the law?!"
3817,3509,0,0,7,7,1.0,0.1543033499620919,508,Integrating a Wall Street Hedge Fund Manager!
3821,3509,0,0,7,7,1.0,0.1543033499620919,508,"Look, I told you, I'm not the sharpest at this sort of thing."
3822,3509,0,0,7,7,1.0,0.1543033499620919,508,"Like I said, the fish you're after is life-sized and three-dimensional.'"
3824,3509,0,0,8,8,1.0,0.1336306209562122,508,Majority consensus is flawed if the ranks of confusion or ignorance prevail.
3825,3509,0,0,10,10,1.0,0.10540925533894598,508,Sure I had that tourist for lunch. It was the Catch of thr Day.
3828,3509,0,0,7,7,1.0,0.1543033499620919,508,"Eat'em her rights, Joe."
3792,3509,0,0,7,7,1.0,0.1543033499620919,508,"Hey, I'm not a card shark."
3749,3509,0,0,7,7,1.0,0.1543033499620919,508,Never hoid of no 'Freddie the Fork'
3747,3509,0,0,7,7,1.0,0.1543033499620919,508,I can recognize a fishing expedition when I see one!
3746,3509,0,0,7,7,1.0,0.1543033499620919,508,"'For the last time'!,... that surfboard looks familiar, but for 'sure' I have never seen that torso."
3686,3509,0,0,7,7,1.0,0.1543033499620919,508,While your words say you are innocent your salivation tells a different story
3688,3509,0,0,8,8,1.0,0.1336306209562122,508,"Yeah, I loaned him some dough. So what?"
3689,3509,0,0,8,8,1.0,0.1336306209562122,508,Once again. . . a little to the side please.
3690,3509,0,0,7,7,1.0,0.1543033499620919,508,Can you explain what your dorsal fin is doing in South Beach at around 10 PM last night?
3691,3509,0,0,8,8,1.0,0.1336306209562122,508,Never ate 'I'm. Never ate 'im.
3692,3509,0,0,7,7,1.0,0.1543033499620919,508,"The Sharknado was my fault, but I've never been to Manitowoc!"
3694,3509,0,0,7,7,1.0,0.1543033499620919,508,That's him! With a deadly weapon! - a harpoon! His name is Ahab!
3695,3509,0,0,7,7,1.0,0.1543033499620919,508,"Sure, I was in the tank with Mark Cuban, but I've sworn off rich food."
3696,3509,0,0,7,7,1.0,0.1543033499620919,508,"Yeah, that's him. I can tell by the patch over his eye, the hook hand, and his wooden leg."
3697,3509,0,0,7,7,1.0,0.1543033499620919,508,"I told you, I'm color-blind."
3700,3509,0,0,9,9,1.0,0.11785113019775792,508,O.K. O.K. I confess. Global warming made me do it.
3701,3509,0,0,7,7,1.0,0.1543033499620919,508,"Yes, that is the big Kahuna"
3703,3509,0,0,7,7,1.0,0.1543033499620919,508,Look. Buttface. I'm Great. I'm White. And I'm going to make this country great again. So what if I ate an immigrant?
3706,3509,0,0,7,7,1.0,0.1543033499620919,508,I never loaned that guy a dime and this is the basest kind of discrimination.
3708,3509,0,0,7,7,1.0,0.1543033499620919,508,I never ate that man before in my life.!
3710,3509,0,0,8,8,1.0,0.1336306209562122,508,"You're in luck, we're releasing prisoners today for a fin. Just sign here."
3712,3509,0,0,7,7,1.0,0.1543033499620919,508,I never saw that krill before in my life!
3743,3509,0,0,7,7,1.0,0.1543033499620919,508,"I've never seen that seal before in my life! As I keep telling you guys, I'm a vegetarian, and seals are the last thing on my mind."
3742,3509,0,0,7,7,1.0,0.1543033499620919,508,"Your plan has teeth, but will never survive the 'Shark Tank.'"
3741,3509,0,0,7,7,1.0,0.1543033499620919,508,That bite is not mine... My canines were removed before I could use braces.
3738,3509,0,0,10,10,1.0,0.10540925533894598,508,I know my rights. I'm not saying another word until I talk to a marine biologist.
3733,3509,0,0,7,7,1.0,0.1543033499620919,508,"Like I said, that movie was 30 years ago and was not me who ate those people!"
3729,3509,0,0,8,8,1.0,0.1336306209562122,508,You're gonna need bigger bait.
3830,3509,0,0,7,7,1.0,0.1543033499620919,508,"You may try to hide the truth, but you can't hide your fin."
3728,3509,0,0,7,7,1.0,0.1543033499620919,508,Yeah! That's him. Police Chief Martin Brody; the man who killed my father.
3725,3509,0,0,9,9,1.0,0.11785113019775792,508,I didn't see the sign saying locals weren't allowed in the hotel pool.
3722,3509,0,0,7,7,1.0,0.1543033499620919,508,"I'm telling you- it wasn't me, she's not even my type. I prefer blondes."
3719,3509,0,0,8,8,1.0,0.1336306209562122,508,"So ya got me, so what? Ya think I'm some guppy? The fish bowl that can hold me ain't been built yet."
3718,3509,0,0,7,7,1.0,0.1543033499620919,508,"Yeah, that's an underwater selfie of me and the guy who disappeared. So what? Is that all you got, Sherlock?"
3715,3509,0,0,7,7,1.0,0.1543033499620919,508,Sure I seen him. I delivered a candy-gram to him once or something.
3714,3509,0,0,8,8,1.0,0.1336306209562122,508,I am not Jaws just ask my dentist
3726,3509,0,0,7,7,1.0,0.1543033499620919,508,There's no way I'm stupid enough to be distracted by a photo of your beautiful wife to tell you that I hid the body in my garage
3832,3509,0,0,7,7,1.0,0.1543033499620919,508,i haven't seen him since the movie Blackfish.
3836,3509,0,0,9,9,1.0,0.11785113019775792,508,I'm not answering another question until I talk to a bottom feeder.
3837,3509,0,0,7,7,1.0,0.1543033499620919,508,I can't see it without my reading glasses.
3903,3509,0,0,7,7,1.0,0.1543033499620919,508,"I told you, I've never seen that appetizing human before."
3904,3509,0,0,7,7,1.0,0.1543033499620919,508,How many pieces of paper am I holding?
3905,3509,0,0,8,8,1.0,0.1336306209562122,508,"O.K., SO TRUMP IS A RELATIVE OF MINE. WHAT OF IT?"
3908,3509,0,0,7,7,1.0,0.1543033499620919,508,"I had nothing to do with the mortgage collapse, I'm a loan shark"
3912,3509,0,0,7,7,1.0,0.1543033499620919,508,Stop calling me Jaws!
3913,3509,0,0,7,7,1.0,0.1543033499620919,508,Oh! That's the guy I ate!...er...um... I mean did NOT eat him.
3914,3509,0,0,7,7,1.0,0.1543033499620919,508,... but before you go... which wallpaper do you like better?
3915,3509,0,0,7,7,1.0,0.1543033499620919,508,"Yeah, that's the guy who jumped me all right."
3918,3509,0,0,7,7,1.0,0.1543033499620919,508,Is this the person you ate?
3921,3509,0,0,7,7,1.0,0.1543033499620919,508,I'm a lone shark not a card shark.
3925,3509,0,0,7,7,1.0,0.1543033499620919,508,Getting this guy to talk is three times harder than pulling teeth...
3926,3509,0,0,7,7,1.0,0.1543033499620919,508,That's not me. You 'coppers'think all whales look alike.
3927,3509,0,0,7,7,1.0,0.1543033499620919,508,Does that mean I can never make partner?
3928,3509,0,0,7,7,1.0,0.1543033499620919,508,I've never eaten that guy before in my life.
3929,3509,0,0,9,9,1.0,0.11785113019775792,508,Let's just agree the person in that picture looks like a seal... I mean what would you do?
3930,3509,0,0,7,7,1.0,0.1543033499620919,508,How to I know that's my client's confession?
3932,3509,0,0,7,7,1.0,0.1543033499620919,508,"Look, for the millionth time, you guys got the wrong shark. I'm not THAT type of Reefer Shark"
3954,3509,0,0,7,7,1.0,0.1543033499620919,508,He mighta jumped over me once or twice. So?
3952,3509,0,0,7,7,1.0,0.1543033499620919,508,"As a Vegan, I find that repulsive"
3951,3509,0,0,7,7,1.0,0.1543033499620919,508,I didn't do it! I eat quinoa.
3948,3509,0,0,7,7,1.0,0.1543033499620919,508,"Duh, I took a bite out of crime"
3947,3509,0,0,7,7,1.0,0.1543033499620919,508,"I was there for his first cigarette, seemed like I should be there for his last dying day."
3946,3509,0,0,8,8,1.0,0.1336306209562122,508,"If I 'm a rat, then you're chum."
3900,3509,0,0,8,8,1.0,0.1336306209562122,508,"Yep, that's Kaiser Soze alright."
3945,3509,0,0,7,7,1.0,0.1543033499620919,508,I wasn't even in the ocean that day.
3941,3509,0,0,7,7,1.0,0.1543033499620919,508,"Hey, I'm the real victim here......That guy was loaded with toxins Hey, I'm the real victim here. I was doing my natural diet and this guy was loaded with toxins!!"
3940,3509,0,0,7,7,1.0,0.1543033499620919,508,"Yeah, that's my chum"
3937,3509,0,0,7,7,1.0,0.1543033499620919,508,Appearance and steriotypes can be key motives to becoming a suspect
3936,3509,0,0,7,7,1.0,0.1543033499620919,508,"Well, it should look familiar, sir...."
3934,3509,0,0,8,8,1.0,0.1336306209562122,508,Sometimes we may incriminate the wrong suspect due to their appearance
3933,3509,0,0,7,7,1.0,0.1543033499620919,508,"so, you mean to tell me you dont recognize your old chum? the one you killed for a little bit of chum?"
3943,3509,0,0,8,8,1.0,0.1336306209562122,508,My pilot's always on me about flossing better.
3683,3509,0,0,7,7,1.0,0.1543033499620919,508,But I keep telling' ya; he's the one who jumped me!
3899,3509,0,0,7,7,1.0,0.1543033499620919,508,Does this look like your teeth will be petrified in a few million years?
3896,3509,0,0,7,7,1.0,0.1543033499620919,508,"Thanks, I am hungry. I'll have the tuna salad and ice tea."
3838,3509,0,0,7,7,1.0,0.1543033499620919,508,"This is Inshark, I'm in here six hours, without a cup of blood...."
3841,3509,0,0,8,8,1.0,0.1336306209562122,508,Boring! Let me put a little bite in it!
3842,3509,0,0,7,7,1.0,0.1543033499620919,508,"That's not a feeding frenzy. You at Red Lobster, THAT's a feeding frenzy."
3843,3509,0,0,7,7,1.0,0.1543033499620919,508,Is this the guy whose loan you deep-sixed?
3844,3509,0,0,7,7,1.0,0.1543033499620919,508,I don't care what Charlie the Tuna said. I told you. I never seen that foot before.
3845,3509,0,0,7,7,1.0,0.1543033499620919,508,"Yeah, so what. I was hungry."
3846,3509,0,0,7,7,1.0,0.1543033499620919,508,Shaw. I was bullied.
3847,3509,0,0,7,7,1.0,0.1543033499620919,508,Never seen 'im. Not a regular on the Great White Way.
3848,3509,0,0,7,7,1.0,0.1543033499620919,508,It couldn't have been me. I am a man eating shark!
3851,3509,0,0,7,7,1.0,0.1543033499620919,508,Candygram Sir
3853,3509,0,0,7,7,1.0,0.1543033499620919,508,"O.K. wise guy, tell us about this 'Charlie the Tuna' character."
3855,3509,0,0,7,7,1.0,0.1543033499620919,508,I never saw this navy seal before.
3856,3509,0,0,7,7,1.0,0.1543033499620919,508,Robert Shaw? Never seen him before.
3857,3509,0,0,7,7,1.0,0.1543033499620919,508,"You say timely author, I say tasty hors d'oeuvre."
3858,3509,0,0,7,7,1.0,0.1543033499620919,508,"Black? White. Sorry, you guys just all look the same to me."
3861,3509,0,0,7,7,1.0,0.1543033499620919,508,"That was my hit list, but now it's my list of contributors. I'm running as an independent."
3862,3509,0,0,7,7,1.0,0.1543033499620919,508,"Now I'm gonna ask you one more time, did you krill her"
3895,3509,0,0,7,7,1.0,0.1543033499620919,508,Color blindness is not going to save you this time.
3894,3509,0,0,7,7,1.0,0.1543033499620919,508,"Again, I'm a loan shark, not a loan shark."
3888,3509,0,0,7,7,1.0,0.1543033499620919,508,There's an anklet. I'd never chomp on that.
3883,3509,0,0,7,7,1.0,0.1543033499620919,508,I'm getting a lil tired of you accusing me every time another one washes up.
3882,3509,0,0,7,7,1.0,0.1543033499620919,508,Yup. That's the guy that jumped me. The Fonz.
3881,3509,0,0,8,8,1.0,0.1336306209562122,508,You're making a man-eater.
3897,3509,0,0,7,7,1.0,0.1543033499620919,508,I told you - I have no idea what Bobby Darin looked like.
3875,3509,0,0,7,7,1.0,0.1543033499620919,508,Just because of the look on our faces doesn't mean we're not shark-ed.
3871,3509,0,0,7,7,1.0,0.1543033499620919,508,I'm gonna need a bigger photo.
3868,3509,0,0,7,7,1.0,0.1543033499620919,508,"I'll give you $100,000 for 15%."
3867,3509,0,0,7,7,1.0,0.1543033499620919,508,Pigs eat people but sharks don't squeal !
3866,3509,0,0,7,7,1.0,0.1543033499620919,508,I don't eat anything with artificial coloring.
3864,3509,0,0,7,7,1.0,0.1543033499620919,508,I'll never forget that face! That kid kept wiggling past my sigmoid colon.
3863,3509,0,0,7,7,1.0,0.1543033499620919,508,It's always the remoras that sneak up on you.
3872,3509,0,0,7,7,1.0,0.1543033499620919,508,"Hey, don't look at me--the remora did it."
3681,3509,0,0,7,7,1.0,0.1543033499620919,508,You can treat me like some kind of hammerhead but I know I have the right to an attorney.
3680,3509,0,0,7,7,1.0,0.1543033499620919,508,THE FISH SWIMS BETWEEN MY TEETH.
3678,3509,0,0,7,7,1.0,0.1543033499620919,508,"Yeah, yeah. He used to be my chum. So what?"
3473,3509,0,0,7,7,1.0,0.1543033499620919,508,E M D X L O
3474,3509,0,0,7,7,1.0,0.1543033499620919,508,That's him. Last I saw he was swimming with my buddies.
3478,3509,0,0,7,7,1.0,0.1543033499620919,508,"I keep telling you, I didn't see the guy who took my fin!"
3480,3509,0,0,7,7,1.0,0.1543033499620919,508,Cooperate with us we'll keep you out of the tank.
3482,3509,0,0,7,7,1.0,0.1543033499620919,508,"Sure, he's sleepin' with the fishes, but who hasn't?"
3483,3509,0,0,7,7,1.0,0.1543033499620919,508,not another word til I get my water
3484,3509,0,0,7,7,1.0,0.1543033499620919,508,"School terrorism, by you!!!"
3489,3509,0,0,7,7,1.0,0.1543033499620919,508,We don't have nobody in the sea named Miranda.
3490,3509,0,0,9,9,1.0,0.11785113019775792,508,Sorry I've never seen seen Charlie .....Aw I mean him before!
3495,3509,0,0,7,7,1.0,0.1543033499620919,508,"Stop with the faces already; now legs, maybe I can help you.'"
3496,3509,0,0,8,8,1.0,0.1336306209562122,508,"Yes, that's the crappy loan I offered him. Happy now?"
3497,3509,0,0,7,7,1.0,0.1543033499620919,508,"I know my rights, so either net me or get off my dorsal."
3499,3509,0,0,7,7,1.0,0.1543033499620919,508,I ain't sayin' another word until I talk to my burbot.
3500,3509,0,0,7,7,1.0,0.1543033499620919,508,I wouldn't call it jaw dropping...
3505,3509,0,0,9,9,1.0,0.11785113019775792,508,"I'm telling ya', that is NOT my signature! That Spielberg guy has been using my image without my permission since 1975!"
3506,3509,0,0,7,7,1.0,0.1543033499620919,508,Never seen him and wouldn't have eaten him if I had.
3515,3509,0,0,7,7,1.0,0.1543033499620919,508,Do you really think I'd put shark fin soup on the menu?
3542,3509,0,0,7,7,1.0,0.1543033499620919,508,Remember? How could I? I'm sleep-deprived.
3541,3509,0,0,8,8,1.0,0.1336306209562122,508,You guys got nuthin'! I ain't the only loan shark in the sea!
3540,3509,0,0,7,7,1.0,0.1543033499620919,508,We have evidence of you coral reefing.
3536,3509,0,0,7,7,1.0,0.1543033499620919,508,Looks like the killer whale photo didn't work.
3534,3509,0,0,7,7,1.0,0.1543033499620919,508,It was just the blow-hole. I promise.
3532,3509,0,0,7,7,1.0,0.1543033499620919,508,"I'm telling ya, without the smell of blood it means nothin' to me."
3471,3509,0,0,7,7,1.0,0.1543033499620919,508,"That there's my cousin, a reef shark."
3530,3509,0,0,8,8,1.0,0.1336306209562122,508,"Just give us the name of the big fish and you can swim, His street name's 'Chicken of the Sea'"
3527,3509,0,0,7,7,1.0,0.1543033499620919,508,I don't know nuthin'. Try talkin' to the coconuts.
3525,3509,0,0,7,7,1.0,0.1543033499620919,508,"Give us a break, does this guy on a surfboard really look like a seal to you?"
3524,3509,0,0,7,7,1.0,0.1543033499620919,508,That's right. It says: 'Back to the Tank.'
3523,3509,0,0,7,7,1.0,0.1543033499620919,508,"So you're sayin' ya didn't post this this picture of a ladies leg to Facebooks' Food Porn page? You dirty, bloodthirsty man-eating son of a ...., why I oughtta...."
3518,3509,0,0,8,8,1.0,0.1336306209562122,508,No those aren't my teeth marks and I resent being characterized as a predator.
3517,3509,0,0,7,7,1.0,0.1543033499620919,508,"Look, can we wrap this up? Shark Week starts tomorrow."
3528,3509,0,0,7,7,1.0,0.1543033499620919,508,"Incriminating, perhaps, but it was Susan Sontag who said there is 'something predatory in the act of taking a picture.' Who's gory now?"
3544,3509,0,0,7,7,1.0,0.1543033499620919,508,I have no three-second memory of this.
3469,3509,0,0,7,7,1.0,0.1543033499620919,508,Never seen that torso in my life.
3466,3509,0,0,7,7,1.0,0.1543033499620919,508,not the same old fish story!!
3411,3509,0,0,7,7,1.0,0.1543033499620919,508,Which of these sharks helped you escape ABC's 'Shark Tank?'
3414,3509,0,0,7,7,1.0,0.1543033499620919,508,Do you recognize this theme song?
3415,3509,0,0,7,7,1.0,0.1543033499620919,508,I already told you I don't recognize that delicious bloody stump.
3418,3509,0,0,7,7,1.0,0.1543033499620919,508,"Dental records don’t lie, we know you’ve been back to your old tricks"
3419,3509,0,0,7,7,1.0,0.1543033499620919,508,"I keep telling you guys, I don't recognize that body. You all taste the same."
3420,3509,0,0,7,7,1.0,0.1543033499620919,508,Sign the confession or we're throwing you back in the tank.
3422,3509,0,0,7,7,1.0,0.1543033499620919,508,"I worked for you guys 23 years, and bite one head off...."
3423,3509,0,0,8,8,1.0,0.1336306209562122,508,Wrong! I only plead to being a Lone Ranger.
3425,3509,0,0,7,7,1.0,0.1543033499620919,508,And I would sign it how?
3427,3509,0,0,7,7,1.0,0.1543033499620919,508,My lawyer's Flipper defense will make your head spin.
3428,3509,0,0,7,7,1.0,0.1543033499620919,508,We're going to need a bigger quote.
3429,3509,0,0,7,7,1.0,0.1543033499620919,508,Stop profiling me.
3434,3509,0,0,7,7,1.0,0.1543033499620919,508,That one
3435,3509,0,0,7,7,1.0,0.1543033499620919,508,Do you recognize this beach?
3437,3509,0,0,7,7,1.0,0.1543033499620919,508,I'm the lawyer - That's the defendant
3438,3509,0,0,7,7,1.0,0.1543033499620919,508,No! I wouldn't even touch someone with a wooden leg.
3440,3509,0,0,7,7,1.0,0.1543033499620919,508,Did you threaten to chomp this guy if he defaulted?
3463,3509,0,0,7,7,1.0,0.1543033499620919,508,I know my rights. I want to call a lawyer. Wait a minute..I am a lawyer.
3462,3509,0,0,6,6,1.0,0.18257418583505536,508,Oh no – anything but waterboarding.
3455,3509,0,0,7,7,1.0,0.1543033499620919,508,Look pal - I'm not confessing to anything without consulting my artiste representative.
3454,3509,0,0,7,7,1.0,0.1543033499620919,508,I smell a rat.
3453,3509,0,0,7,7,1.0,0.1543033499620919,508,"So, Mack, you can positively ID 'MacHeath, dear'?"
3452,3509,0,0,8,8,1.0,0.1336306209562122,508,It says here you run a profitable business giving out loans?
3468,3509,0,0,9,9,1.0,0.11785113019775792,508,Mind loaning me a lawyer?
3449,3509,0,0,7,7,1.0,0.1543033499620919,508,"No, I don't know who killed this Riff."
3447,3509,0,0,7,7,1.0,0.1543033499620919,508,"Yea, that's the guy that jumped me; it's been downhill ever since."
3445,3509,0,0,7,7,1.0,0.1543033499620919,508,"Look, #1. My name ain't Charlie. #2. I told ya I never seen the guy and #3. Even if you bring charges, they'll never stick. The guy ain't got a leg to stand on."
3444,3509,0,0,7,7,1.0,0.1543033499620919,508,"Of course, I reconize him, he's my cousin, 'Hammerhead'!'."
3443,3509,0,0,7,7,1.0,0.1543033499620919,508,"Just wait until my lawyer gets here, he's the real shark."
3442,3509,0,0,7,7,1.0,0.1543033499620919,508,I keep tellin' you guys... I'm a vegan!
3441,3509,0,0,7,7,1.0,0.1543033499620919,508,"Yep, he was a chum of mine."
3448,3509,0,0,8,8,1.0,0.1336306209562122,508,The cardshark I know is missing a fin.
3955,3509,0,0,7,7,1.0,0.1543033499620919,508,Maybe he was born with one leg?
3546,3509,0,0,7,7,1.0,0.1543033499620919,508,Smells Fishy to Me
3550,3509,0,0,7,7,1.0,0.1543033499620919,508,"I already told ya, you're looking for someone swims with the fishes. Do I look like someone who swims with the fishes?"
3620,3509,0,0,9,9,1.0,0.11785113019775792,508,"You can throw me in the tank, but I'd never rat on a schoolmate."
3621,3509,0,0,7,7,1.0,0.1543033499620919,508,Is this the loan you were trying to collect?
3622,3509,0,0,7,7,1.0,0.1543033499620919,508,"He called me a 'shark' once, alright! I deserve better! And yes, that's him on the beach in the picture."
3623,3509,0,0,7,7,1.0,0.1543033499620919,508,I told you my name is not Moby Dick
3624,3509,0,0,7,7,1.0,0.1543033499620919,508,"Those couldn't be my tooth marks. I'm, uh, mmm, uh, a vegetarian."
3625,3509,0,0,7,7,1.0,0.1543033499620919,508,"Look, all I can say is that Lewie C. said it best: 'Never go to sea without a porpoise.'"
3627,3509,0,0,7,7,1.0,0.1543033499620919,508,"I don't know, all arms look the same to us."
3629,3509,0,0,7,7,1.0,0.1543033499620919,508,I don't even know which way the road is?
3630,3509,0,0,7,7,1.0,0.1543033499620919,508,'Recognize this morsel?
3634,3509,0,0,7,7,1.0,0.1543033499620919,508,Get some eggs too
3635,3509,0,0,7,7,1.0,0.1543033499620919,508,I keep telling you they all taste the same.
3636,3509,0,0,7,7,1.0,0.1543033499620919,508,"It was a loan, pure and simple. You got a problem with that?"
3638,3509,0,0,7,7,1.0,0.1543033499620919,508,"For the last time, the Jets did it!!"
3645,3509,0,0,7,7,1.0,0.1543033499620919,508,Did you click 'like' on this surfer's Facebook?
3646,3509,0,0,7,7,1.0,0.1543033499620919,508,I never took an arm and a leg! That's what I'm worth for sushi.
3648,3509,0,0,7,7,1.0,0.1543033499620919,508,'To Catch a Predator' unaired footage.
3652,3509,0,0,7,7,1.0,0.1543033499620919,508,I never pay attention to little fish.
3677,3509,0,0,8,8,1.0,0.1336306209562122,508,"Listen pal, from that angle they all look like seals."
3676,3509,0,0,7,7,1.0,0.1543033499620919,508,I swear I didn't mean to bite Moby Dick.
3674,3509,0,0,9,9,1.0,0.11785113019775792,508,"I'm innocent, I'm innocent, I tell ya, that not my signature. You've got the wrong shark. I'm the lone shark not the loan shark. Don't you guy know how to spell."
3673,3509,0,0,7,7,1.0,0.1543033499620919,508,Of course he looks familiar. He was my attorney.
3671,3509,0,0,8,8,1.0,0.1336306209562122,508,That is an absolute lie as I am a vegan.
3670,3509,0,0,7,7,1.0,0.1543033499620919,508,At least no one knows my fly is open.
3619,3509,0,0,8,8,1.0,0.1336306209562122,508,"You got the wrong guy, it's against my religion to eat meat on Friday."
3669,3509,0,0,7,7,1.0,0.1543033499620919,508,It's in moments like these I wish I was an albino.
3663,3509,0,0,7,7,1.0,0.1543033499620919,508,"So, was this the candidate that jumped over you in a motorcycle?"
3662,3509,0,0,7,7,1.0,0.1543033499620919,508,I'll have to confer with my colleague at the law firm
3661,3509,0,0,7,7,1.0,0.1543033499620919,508,"It wasn't me, it was Flipper!"
3659,3509,0,0,7,7,1.0,0.1543033499620919,508,"Hey, what was I supposed to think Shark Week meant?"
3658,3509,0,0,7,7,1.0,0.1543033499620919,508,Clearly you haven't noticed that I'm a shark not a rat.
3655,3509,0,0,7,7,1.0,0.1543033499620919,508,"That's not me. It's my brother, my attorney."
3665,3509,0,0,8,8,1.0,0.1336306209562122,508,"I've never seen that face. I told you, I only eat fish if I'm at Nobu."
3547,3509,0,0,8,8,1.0,0.1336306209562122,508,"I don't anyone by the name of Fonzarelli, but he doesn't look like he's in any shape to do any jumpin',..., if you get my drift."
3618,3509,0,0,7,7,1.0,0.1543033499620919,508,"Bertolt Brecht, Kurt Weill, Lotte Lehmann, mean anything to you?. Come on now, Shark with the pearly teeth."
3615,3509,0,0,7,7,1.0,0.1543033499620919,508,"Like I said, he's swimming with the fishes."
3552,3509,0,0,7,7,1.0,0.1543033499620919,508,"Read it to me, I am a school dropout."
3553,3509,0,0,7,7,1.0,0.1543033499620919,508,"Just because that looks like a shark bite, what makes you think I would know when it happened?"
3554,3509,0,0,7,7,1.0,0.1543033499620919,508,It was the halibut. Second from the right in the top row.
3556,3509,0,0,8,8,1.0,0.1336306209562122,508,"Yeah, that's the guy. Punched me right in the nose."
3557,3509,0,0,7,7,1.0,0.1543033499620919,508,I'm not warm blooded and neither is my lawyer. Give her a call.
3558,3509,0,0,7,7,1.0,0.1543033499620919,508,I swear...I became a vegetarian.
3559,3509,0,0,7,7,1.0,0.1543033499620919,508,You dirty cops. I could smell blood on your hands from five miles away.
3561,3509,0,0,7,7,1.0,0.1543033499620919,508,"Yes, that is me. But, I didn't do anything wrong eating that seal pup."
3563,3509,0,0,7,7,1.0,0.1543033499620919,508,OK. I confess. He's the guy I ate last week.
3564,3509,0,0,7,7,1.0,0.1543033499620919,508,"Like I said, I only saw him up close and straight on."
3565,3509,0,0,7,7,1.0,0.1543033499620919,508,"Yeh, we used to play cards together, so what?"
3567,3509,0,0,7,7,1.0,0.1543033499620919,508,A lone is fine for a wolf but not me?
3569,3509,0,0,7,7,1.0,0.1543033499620919,508,"I don't know what you're talkin' about, those loans were legit."
3571,3509,0,0,7,7,1.0,0.1543033499620919,508,No answers till my lawyer is present.
3573,3509,0,0,7,7,1.0,0.1543033499620919,508,And I told you — I don’t know no Tony or Maria and I wasn’t at no rumble!
3575,3509,0,0,7,7,1.0,0.1543033499620919,508,Are you saying he was delicious ?
3582,3509,0,0,8,8,1.0,0.1336306209562122,508,Does this picture look kind of fishy to you?
3611,3509,0,0,7,7,1.0,0.1543033499620919,508,The Feds claim the spotted seal is endangered?
3609,3509,0,0,8,8,1.0,0.1336306209562122,508,"Sure I recognize him, I'd know him anywhere. He's Mack the Knife."
3604,3509,0,0,7,7,1.0,0.1543033499620919,508,"No, he looks more like Richard Dreyfuss."
3603,3509,0,0,7,7,1.0,0.1543033499620919,508,Do you recognize this upper torso?
3599,3509,0,0,7,7,1.0,0.1543033499620919,508,Nope...I ate that one two days ago!
3596,3509,0,0,8,8,1.0,0.1336306209562122,508,I swear it wasn't me! I'm a vegetarian!
3617,3509,0,0,7,7,1.0,0.1543033499620919,508,"Yeah, that's Luca Brasi ."
3595,3509,0,0,7,7,1.0,0.1543033499620919,508,"I'm telling ya, I couldn't a been there. Impossible, I tell ya."
3592,3509,0,0,8,8,1.0,0.1336306209562122,508,I'D LIKE MY DENTIST PRESENT FOR THIS INTERROGATION.THOSE ARE NOT MY BITE MARKS.
3590,3509,0,0,7,7,1.0,0.1543033499620919,508,I want my sawfish.
3587,3509,0,0,7,7,1.0,0.1543033499620919,508,"For the last time, you've got the wrong species! I'm not a loan shark! [underline loan]"
3586,3509,0,0,7,7,1.0,0.1543033499620919,508,I was just playing an honest game of poker. .
3584,3509,0,0,7,7,1.0,0.1543033499620919,508,I ate her.
3583,3509,0,0,7,7,1.0,0.1543033499620919,508,"Yeah, that's him. Trump's the one who jumped."
3594,3509,0,0,7,7,1.0,0.1543033499620919,508,That's a great white lie! I've never seen him before. Something smells fishy- so bring me my lawyer!
3956,3509,0,0,7,7,1.0,0.1543033499620919,508,Oh yeah! Well it's less than the Bank of America charges!
3959,3509,0,0,8,8,1.0,0.1336306209562122,508,I want my lawyer present...and a glass of water
3960,3509,0,0,7,7,1.0,0.1543033499620919,508,So you're the Bad Carp.
4335,3509,0,0,7,7,1.0,0.1543033499620919,508,I know my rights! My family are all lawyers. Studied law.
4337,3509,0,0,8,8,1.0,0.1336306209562122,508,"For the last time, I never jumped that shark!"
4338,3509,0,0,7,7,1.0,0.1543033499620919,508,My client is swimming with the fishes.
4339,3509,0,0,8,8,1.0,0.1336306209562122,508,I'm telling you it was Marlon Brando . . . that putz from 'On the Waterfront'?
4340,3509,0,0,7,7,1.0,0.1543033499620919,508,"After looking at these, I will have that snack you offered."
4341,3509,0,0,7,7,1.0,0.1543033499620919,508,Do you deny that your loan agreement calls for 50% interest ?
4342,3509,0,0,7,7,1.0,0.1543033499620919,508,The last time I saw a mouth like that it had a hook in it!
4343,3509,0,0,7,7,1.0,0.1543033499620919,508,How do I know if his name is Ahab---do I look like Moby Dick to you?
4344,3509,0,0,7,7,1.0,0.1543033499620919,508,They picked me out of the 'fishing lineup'?
4346,3509,0,0,7,7,1.0,0.1543033499620919,508,"Swimming with the sharks, my guess."
4348,3509,0,0,7,7,1.0,0.1543033499620919,508,"OK, Whitie, dental records don't lie !!"
4349,3509,0,0,7,7,1.0,0.1543033499620919,508,I didn't kill Willie!
4350,3509,0,0,7,7,1.0,0.1543033499620919,508,"Mistaken identity, I tell ya! She thought I was a dolphin. I thought she was lunch."
4351,3509,0,0,7,7,1.0,0.1543033499620919,508,"I swear, I've never set foot in that billiard hall in my life"
4352,3509,0,0,9,9,1.0,0.11785113019775792,508,So what? Everyone knew Mickey The Finn.
4355,3509,0,0,7,7,1.0,0.1543033499620919,508,"I told you that ain't me. I'm no card shark. Release me now, or you'll be hearing from my cousin, Marty."
4357,3509,0,0,8,8,1.0,0.1336306209562122,508,Yea I ate the midget. Why? He was on my shirt list.
4393,3509,0,0,7,7,1.0,0.1543033499620919,508,"Oh, I see...this is the switch. Can we just do more bait?"
4391,3509,0,0,9,9,1.0,0.11785113019775792,508,You can't keep trying to pin The Jets on me.
4385,3509,0,0,9,9,1.0,0.11785113019775792,508,"Yeah, but do I have the right to swim ceaselessly?"
4382,3509,0,0,7,7,1.0,0.1543033499620919,508,"I'm telling you, those are not my teeth marks on Charley Tuna"
4380,3509,0,0,7,7,1.0,0.1543033499620919,508,"Yeah, I've seen him. He sleeps with us fishes."
4379,3509,0,0,7,7,1.0,0.1543033499620919,508,Coney Island? You kidding? There are friendlier places to eat.
4334,3509,0,0,7,7,1.0,0.1543033499620919,508,That's Joey! I told you he was sleeping with the fishes!
4376,3509,0,0,7,7,1.0,0.1543033499620919,508,'That's my twin...do I look like a loan shark'?
4372,3509,0,0,7,7,1.0,0.1543033499620919,508,Can I have some water? This is suffocating.
4371,3509,0,0,7,7,1.0,0.1543033499620919,508,You can keep talking about where I was on the night of July 17th all you want... I gotta keep moving forward.
4369,3509,0,0,7,7,1.0,0.1543033499620919,508,That's right blame the obvious!
4366,3509,0,0,7,7,1.0,0.1543033499620919,508,"All you got is circumstantial, Copper. Yes, I met him in the water that day. And yes, he was wearing banana flavored sunscreen. And yes I like bananas!"
4361,3509,0,0,7,7,1.0,0.1543033499620919,508,I demand to see one of my own. Where's my lawyer?
4359,3509,0,0,7,7,1.0,0.1543033499620919,508,I don't answer a single question until you take off these fincuffs.
4373,3509,0,0,7,7,1.0,0.1543033499620919,508,I wouldn't be caught dead in that dress.
4395,3509,0,0,7,7,1.0,0.1543033499620919,508,"Again, I don't have any feet."
4333,3509,0,0,7,7,1.0,0.1543033499620919,508,Do you recognize the fisherman in this photo?
4331,3509,0,0,7,7,1.0,0.1543033499620919,508,Not that old lawyer joke!
4263,3509,0,0,7,7,1.0,0.1543033499620919,508,Doesn't look familiar. Can we move on to waterboarding?
4266,3509,0,0,7,7,1.0,0.1543033499620919,508,*You* tell McGruff he's out if his league.
4267,3509,0,0,7,7,1.0,0.1543033499620919,508,"I swear, Officer Krupke. The Jets started the rumble."
4268,3509,0,0,7,7,1.0,0.1543033499620919,508,I tell ya it was Mac The Knife.
4271,3509,0,0,7,7,1.0,0.1543033499620919,508,If you’re well enough to post a selfie then I should not be here.
4273,3509,0,0,8,8,1.0,0.1336306209562122,508,This is a still from 'Jaws'. Do you recognize this shark?
4275,3509,0,0,7,7,1.0,0.1543033499620919,508,It still looks like a bed of kelp and coffee stains.
4281,3509,0,0,8,8,1.0,0.1336306209562122,508,"I told ya, I never seen the guy! Can we just move forward?"
4283,3509,0,0,7,7,1.0,0.1543033499620919,508,"Faces I dunno. Feet, maybe I can help."
4284,3509,0,0,7,7,1.0,0.1543033499620919,508,I was promised I could go back to school if I confessed.
4287,3509,0,0,7,7,1.0,0.1543033499620919,508,And just why do you think I'd recognize that dead bankrupt guy?
4288,3509,0,0,7,7,1.0,0.1543033499620919,508,"It could have been a beautiful friendship, except for the frenzy, of course."
4292,3509,0,0,7,7,1.0,0.1543033499620919,508,"Yeah, he's a client of mine. So what!"
4293,3509,0,0,7,7,1.0,0.1543033499620919,508,You're going to need a higher resolution photo...
4294,3509,0,0,7,7,1.0,0.1543033499620919,508,I've been jumped before... But this was like a whole field of 'em.
4295,3509,0,0,7,7,1.0,0.1543033499620919,508,"I told ya', I'm operatin' a loan."
4296,3509,0,0,7,7,1.0,0.1543033499620919,508,"Yah, I seen the scarlet billowin' alright, but not from my pearly whites."
4329,3509,0,0,7,7,1.0,0.1543033499620919,508,That's clearly a propeller.
4328,3509,0,0,8,8,1.0,0.1336306209562122,508,"Loitering? Officers, surely you know what happens to a shark that isn’t moving forward."
4327,3509,0,0,7,7,1.0,0.1543033499620919,508,But I am a loan shark !!
4325,3509,0,0,8,8,1.0,0.1336306209562122,508,I refuse to take the bait.
4324,3509,0,0,7,7,1.0,0.1543033499620919,508,"I repeat, my client's confession was coerced."
4323,3509,0,0,7,7,1.0,0.1543033499620919,508,"Actually officer, I've gone blubber-free."
4332,3509,0,0,7,7,1.0,0.1543033499620919,508,Charlie the Tuna? Never seen him!
4320,3509,0,0,7,7,1.0,0.1543033499620919,508,"Yes, I was in the film. But I've stopped giving autographs."
4316,3509,0,0,8,8,1.0,0.1336306209562122,508,We see a lotta stuff dumped in the ocean!
4315,3509,0,0,7,7,1.0,0.1543033499620919,508,"Yeah, so I charged 22 percent interest, so what? I'm still better than the credit card companies, but I guess they got you guys in their pockets."
4312,3509,0,0,7,7,1.0,0.1543033499620919,508,"Which are you, a loan shark or a lone shark?"
4309,3509,0,0,7,7,1.0,0.1543033499620919,508,You are not going to use me as bait.
4308,3509,0,0,7,7,1.0,0.1543033499620919,508,I told you already I've been NPO for my colonoscopy!
4307,3509,0,0,7,7,1.0,0.1543033499620919,508,"Yeah, that's him. That's Lefty. Said he's one of Coldplay's 'surprise' guests and he'd show 'em all this time."
4317,3509,0,0,7,7,1.0,0.1543033499620919,508,"I don't know man, there are a lot of fish in the sea."
4257,3509,0,0,7,7,1.0,0.1543033499620919,508,"Yeah, that was the jumper, and I am the chomper. So what?"
4396,3509,0,0,7,7,1.0,0.1543033499620919,508,Elmo is with the fishes.
4400,3509,0,0,7,7,1.0,0.1543033499620919,508,"Yeah, that's him. I'd recognize that fish-face anywhere."
4473,3509,0,0,7,7,1.0,0.1543033499620919,508,I'm swear - I never saw that surfboard in my life!
4475,3509,0,0,7,7,1.0,0.1543033499620919,508,"Yes that is him, I recognize his fin tattoo, does that get me the reward?"
4476,3509,0,0,7,7,1.0,0.1543033499620919,508,not true. I only caught the right thigh and buttock.
4477,3509,0,0,9,9,1.0,0.11785113019775792,508,These dental records are all the evidence we need
4478,3509,0,0,7,7,1.0,0.1543033499620919,508,You got the wrong gal guy - I never slept with Luca Brasi
4481,3509,0,0,7,7,1.0,0.1543033499620919,508,That ain'[t me.Did you check my dental records?
4482,3509,0,0,6,6,1.0,0.18257418583505536,508,I don't know nothin' about that stump. Looks like Moby D's work.
4483,3509,0,0,9,9,1.0,0.11785113019775792,508,"Yeah, that's him, always has the best remoras stuck to him."
4484,3509,0,0,7,7,1.0,0.1543033499620919,508,OK--I confess. I did it. Just couldn't resist those tentacles !
4486,3509,0,0,7,7,1.0,0.1543033499620919,508,"Guys, I am a vegetarian!"
4489,3509,0,0,7,7,1.0,0.1543033499620919,508,I had to kill him - he sleeps with the fishes
4492,3509,0,0,7,7,1.0,0.1543033499620919,508,"I told you, I was at a Trump event with my daughter."
4494,3509,0,0,7,7,1.0,0.1543033499620919,508,thank you for showing me your explicit steven universe fan art
4495,3509,0,0,7,7,1.0,0.1543033499620919,508,"Who?? No, I did not know or eat Kevin O'Leary."
4497,3509,0,0,7,7,1.0,0.1543033499620919,508,"You think we all look the same, don't you?"
4498,3509,0,0,7,7,1.0,0.1543033499620919,508,It ain't me. Dat's uh poorpuss!
4499,3509,0,0,7,7,1.0,0.1543033499620919,508,"I've never seen that arm in my life, officer."
4527,3509,0,0,7,7,1.0,0.1543033499620919,508,"Yeah, I know that guy. He always seemed a little fishy."
4521,3509,0,0,7,7,1.0,0.1543033499620919,508,"No, that's not Mack the Knife either."
4520,3509,0,0,9,9,1.0,0.11785113019775792,508,"Of course, it's Tiffany Stewart. We all know who she is, this is not some secret you know."
4519,3509,0,0,7,7,1.0,0.1543033499620919,508,My alibi? May I ask you to check with Ms. Katy Perry?
4518,3509,0,0,8,8,1.0,0.1336306209562122,508,Who told you Luca Brasi swims with us?
4512,3509,0,0,7,7,1.0,0.1543033499620919,508,"Yeah, that's uncle Luca sleeping with the fishes, all right! But where I'm from that means he's getting friendly with the neighbors."
4471,3509,0,0,9,9,1.0,0.11785113019775792,508,"That behavior is in my DNA, but it is not my DNA."
4508,3509,0,0,7,7,1.0,0.1543033499620919,508,'I never heard of this Mack the Knife'.
4506,3509,0,0,7,7,1.0,0.1543033499620919,508,"Yes, I ate him last week."
4505,3509,0,0,7,7,1.0,0.1543033499620919,508,"You call that evidence! Those charges won't hold water, particularly underwater. or - Those charges won't hold up underwater."
4504,3509,0,0,7,7,1.0,0.1543033499620919,508,Just cause I run a worthless unsecured mortgage investment fund doesn't make me a loan shark!
4503,3509,0,0,7,7,1.0,0.1543033499620919,508,So what? So what if I wasn't at the ABA convention like I said.
4502,3509,0,0,8,8,1.0,0.1336306209562122,508,All those cod look alike to me.
4500,3509,0,0,7,7,1.0,0.1543033499620919,508,'That can't be me- I only wear sharkskin suits'.
4507,3509,0,0,7,7,1.0,0.1543033499620919,508,You made a loan to the wrong person this time
4397,3509,0,0,9,9,1.0,0.11785113019775792,508,So Abe Vigoda wasn't really a fish?
4470,3509,0,0,7,7,1.0,0.1543033499620919,508,Don't recognize 'em. I keep telling you: smelling is more important than seeing!
4468,3509,0,0,7,7,1.0,0.1543033499620919,508,Exorbitant? You try moving those condos.
4401,3509,0,0,7,7,1.0,0.1543033499620919,508,"I told you already, he looked like chum, not a chump."
4402,3509,0,0,7,7,1.0,0.1543033499620919,508,"Him? Hard to say. You know, there are plenty of fishes in the sea...but if yous grant me immunity, I just might be able to narrow it down."
4403,3509,0,0,7,7,1.0,0.1543033499620919,508,I swear I didn't see the guy.
4413,3509,0,0,7,7,1.0,0.1543033499620919,508,"Well officer, he shouldn't have been kicking around my dinner; Who's really at fault here?"
4415,3509,0,0,6,6,1.0,0.18257418583505536,508,Of course I don't recognize him. Do you remember what you had for dinner last week?
4417,3509,0,0,7,7,1.0,0.1543033499620919,508,I am positive...that's the loan shark who vandalized my property.
4418,3509,0,0,7,7,1.0,0.1543033499620919,508,"I keep tellin ya, it was a frenzy, I saw nothun!"
4419,3509,0,0,8,8,1.0,0.1336306209562122,508,His name was Ahab you say ?
4420,3509,0,0,7,7,1.0,0.1543033499620919,508,Sharknado?... Never heard of him.
4421,3509,0,0,8,8,1.0,0.1336306209562122,508,"Yes, I recognize him. I ate him, so what? He was delicious. You gotta problem with that, Mac?"
4422,3509,0,0,7,7,1.0,0.1543033499620919,508,...you know--THIS--this realllllllly isn't your week....
4423,3509,0,0,8,8,1.0,0.1336306209562122,508,Never eaten him before in my life.
4428,3509,0,0,8,8,1.0,0.1336306209562122,508,He signed up for this loan.
4429,3509,0,0,7,7,1.0,0.1543033499620919,508,"If I know anything, he's swimming with the fishes by now."
4431,3509,0,0,8,8,1.0,0.1336306209562122,508,So I charged a little extra on the loan...is it a crime? Since when is it a crime to lend a friend a little money?
4433,3509,0,0,7,7,1.0,0.1543033499620919,508,We've got evidence of you taking the bait.
4435,3509,0,0,7,7,1.0,0.1543033499620919,508,"I don't mean to speak out of school, but once you've seen one plankton you've seen them all."
4466,3509,0,0,7,7,1.0,0.1543033499620919,508,I had her for dinner. So?
4465,3509,0,0,8,8,1.0,0.1336306209562122,508,'Did you approve this loan'?
4462,3509,0,0,8,8,1.0,0.1336306209562122,508,"I'm just a fish out of water here, guys."
4460,3509,0,0,8,8,1.0,0.1336306209562122,508,I was in school; those can't be my fin prints
4459,3509,0,0,7,7,1.0,0.1543033499620919,508,How did I not make the cut for Shark Tank? I though eating Trump alive would be a valuable proposition for the bureaucrats- not a crime.
4457,3509,0,0,7,7,1.0,0.1543033499620919,508,"Moby? Moby Tom, Dick, or Harry?"
4469,3509,0,0,7,7,1.0,0.1543033499620919,508,"You got me , I had my eyes rolled back."
4456,3509,0,0,9,9,1.0,0.11785113019775792,508,I tell you I never had sex with that intern.
4449,3509,0,0,7,7,1.0,0.1543033499620919,508,He attacked me first with his snorkel.
4445,3509,0,0,7,7,1.0,0.1543033499620919,508,That can't be me! I was auditioning for Shark Week when that happened.
4444,3509,0,0,7,7,1.0,0.1543033499620919,508,"Read it and weep, Detective. Now bring me my client."
4442,3509,0,0,10,10,1.0,0.10540925533894598,508,"Forget it, flatfoot. You'll never convince me to speak out of school."
4440,3509,0,0,7,7,1.0,0.1543033499620919,508,"See, we can prove you weren’t on ‘Shark Tank’ when he was murdered."
4439,3509,0,0,7,7,1.0,0.1543033499620919,508,"That's him, he definitely jumped me. You call him the Fonz?"
4451,3509,0,0,7,7,1.0,0.1543033499620919,508,I'd like to exercise my right to an attorney. The last one tasted funny.
3410,3509,0,0,7,7,1.0,0.1543033499620919,508,"Do what you want, Dan, but you're going to lose your microwave priveleges again."
4256,3509,0,0,7,7,1.0,0.1543033499620919,508,So I age the guy. That's what sharks do!
4252,3509,0,0,7,7,1.0,0.1543033499620919,508,Nope. I've never seen that fish before in my life. Does this mean I'm off the hook?
4051,3509,0,0,7,7,1.0,0.1543033499620919,508,"Well don't look at me fellas, i'm a vegan!"
4053,3509,0,0,7,7,1.0,0.1543033499620919,508,". . . and I suppose you don't know MacHeath either then, do you?"
4054,3509,0,0,7,7,1.0,0.1543033499620919,508,I ain't never seen that bicycle before in my life.
4055,3509,0,0,7,7,1.0,0.1543033499620919,508,"I told you, I don't know anyone named Riff or Maria."
4056,3509,0,0,7,7,1.0,0.1543033499620919,508,"I couldn't have done it, I say! Ask anyone. My school was off Delray all day."
4057,3509,0,0,7,7,1.0,0.1543033499620919,508,I know a LOT of fish. He 'might' look a little familiar.
4058,3509,0,0,7,7,1.0,0.1543033499620919,508,Yeah he swims with us - name's Fat Tony
4059,3509,0,0,7,7,1.0,0.1543033499620919,508,Quint?
4060,3509,0,0,7,7,1.0,0.1543033499620919,508,Were you part of this tornado?
4067,3509,0,0,7,7,1.0,0.1543033499620919,508,"I don't care that you have a fetish about rubber ducks, what were you doing in the kiddie pool in the first place?"
4069,3509,0,0,7,7,1.0,0.1543033499620919,508,"OK, I admit it was a mistake to use my private email server for official business."
4072,3509,0,0,8,8,1.0,0.1336306209562122,508,"I can't read that, I am a SHARK!"
4077,3509,0,0,7,7,1.0,0.1543033499620919,508,"No, it was definitely a bigger boat."
4078,3509,0,0,7,7,1.0,0.1543033499620919,508,How the hell am I supposed to recognize a fish out of water?
4080,3509,0,0,7,7,1.0,0.1543033499620919,508,"We know it's you under there, Trump."
4083,3509,0,0,7,7,1.0,0.1543033499620919,508,"Yes, I know my Miranda Rights. I need a 'shark' attorney!"
4084,3509,0,0,7,7,1.0,0.1543033499620919,508,"Yeah, well call my dentist and he'll prove it's not me."
4111,3509,0,0,9,9,1.0,0.11785113019775792,508,"Yeah, you could say he was a chum of mine. What's it to you?"
4110,3509,0,0,7,7,1.0,0.1543033499620919,508,Those bite marks could have come from a tuna.
4106,3509,0,0,7,7,1.0,0.1543033499620919,508,It's a feeding frenzy. Catered. What about it?
4105,3509,0,0,7,7,1.0,0.1543033499620919,508,That ain't me! That's my cousin! I'm Gnaws!
4103,3509,0,0,7,7,1.0,0.1543033499620919,508,"Yea, that's Donny alright.. In the tank we call him Top Trump.."
4102,3509,0,0,7,7,1.0,0.1543033499620919,508,Evidence? Ha! That's a still from my work in Sharknado!
4050,3509,0,0,7,7,1.0,0.1543033499620919,508,I'm a shark. Why would I can that tuna?
4101,3509,0,0,7,7,1.0,0.1543033499620919,508,Never smelled him before...
4096,3509,0,0,8,8,1.0,0.1336306209562122,508,"Ten thousand bucks chief. For that you get the head, the tail, the whole damn thing"
4094,3509,0,0,7,7,1.0,0.1543033499620919,508,A Blonde and a Brunette entered the water on a surf board and then what did you see?
4091,3509,0,0,7,7,1.0,0.1543033499620919,508,"But officer, I'm 100% organic, gmo free. I couldn't have bit that human."
4089,3509,0,0,7,7,1.0,0.1543033499620919,508,"My eyes are on the side of my head, and the guy stole my pectoral fins. How am I supposed to point him out?"
4088,3509,0,0,7,7,1.0,0.1543033499620919,508,All herring look alike to me.....
4086,3509,0,0,7,7,1.0,0.1543033499620919,508,The last time I got framed this bad I was at SeaWorld.
4100,3509,0,0,9,9,1.0,0.11785113019775792,508,"Yep, that's her... I know a picture of his wife when I see one!"
4113,3509,0,0,7,7,1.0,0.1543033499620919,508,"No, I don't recognize him. Maybe if I smelled his blood...?"
4046,3509,0,0,7,7,1.0,0.1543033499620919,508,"Never seen him. I tellin' ya, I ain't the loan shark you're looking for."
4043,3509,0,0,7,7,1.0,0.1543033499620919,508,"For the last time, is this you swimming at Cape Cod last summer or not?"
3963,3509,0,0,7,7,1.0,0.1543033499620919,508,Never been to Amity.
3965,3509,0,0,7,7,1.0,0.1543033499620919,508,"now see, that there's a whole 'nother kettle of fish"
3968,3509,0,0,7,7,1.0,0.1543033499620919,508,"Oh, grow up."
3973,3509,0,0,7,7,1.0,0.1543033499620919,508,"Look, man, I was just standing my ground."
3977,3509,0,0,7,7,1.0,0.1543033499620919,508,I swear that I'm finnocent!
3978,3509,0,0,7,7,1.0,0.1543033499620919,508,I wanna talk to my lamprey.
3980,3509,0,0,7,7,1.0,0.1543033499620919,508,I don't go for the thin ones.
3986,3509,0,0,7,7,1.0,0.1543033499620919,508,Maybe I seen him once or twice at the beach but he wasn't no chum of mine.
3996,3509,0,0,7,7,1.0,0.1543033499620919,508,Yea ' burp' I recognize the surfer and your point?
3998,3509,0,0,7,7,1.0,0.1543033499620919,508,Does the punchline 'professional courtesy' mean anything to you?
3999,3509,0,0,7,7,1.0,0.1543033499620919,508,"Yes, he's one of my law partners."
4002,3509,0,0,7,7,1.0,0.1543033499620919,508,"James Bond, the British spy? I'm afraid you've got the wrong Jaws, officer."
4004,3509,0,0,7,7,1.0,0.1543033499620919,508,"Bruh, that's not me...I was on the right side!"
4008,3509,0,0,8,8,1.0,0.1336306209562122,508,'Admit it!' Little Timmy is in your stomach.
4010,3509,0,0,7,7,1.0,0.1543033499620919,508,The last time I saw him he was hanging out next to the Olive Garden.
4011,3509,0,0,7,7,1.0,0.1543033499620919,508,"Sure, I ate the dude. But, hey, that's my thing. And, by the way, he was delish."
4014,3509,0,0,7,7,1.0,0.1543033499620919,508,"No Sir, never have I become attached to that gam in my life."
4042,3509,0,0,7,7,1.0,0.1543033499620919,508,"These dudes aren't wearing goggles so I can't tell if it's 1, 2, or 3 ok?"
4040,3509,0,0,7,7,1.0,0.1543033499620919,508,Those look nothing like my jaw marks.
4039,3509,0,0,7,7,1.0,0.1543033499620919,508,Don't try getting chummy with me.
4038,3509,0,0,7,7,1.0,0.1543033499620919,508,"Oh please, you've got bupkis. That's just some guy in a sharkskin suit."
4034,3509,0,0,7,7,1.0,0.1543033499620919,508,I ain't never seen that leg before.
4033,3509,0,0,9,9,1.0,0.11785113019775792,508,"Yea, I've been known to hang out in some pretty salty places."
4045,3509,0,0,7,7,1.0,0.1543033499620919,508,"You got the wrong guy, I'm a dolphin."
4028,3509,0,0,7,7,1.0,0.1543033499620919,508,"Wasn't me. Told you, I went vegan."
4025,3509,0,0,7,7,1.0,0.1543033499620919,508,"That's a hammerhead, fool."
4024,3509,0,0,7,7,1.0,0.1543033499620919,508,"Never seen him before in my life. Again, it's L-O-N-E."
4023,3509,0,0,7,7,1.0,0.1543033499620919,508,You got the wrong guy... I was on the right.
4022,3509,0,0,7,7,1.0,0.1543033499620919,508,"Yea,thats the guy I gave the loan to,but I didn't charge no 25%."
4020,3509,0,0,7,7,1.0,0.1543033499620919,508,CSI finally jumps the shark
4019,3509,0,0,7,7,1.0,0.1543033499620919,508,No - not my bite prints -- I wear dentures.
4027,3509,0,0,7,7,1.0,0.1543033499620919,508,I had nothing to do with the Omega 3 robbery
4254,3509,0,0,7,7,1.0,0.1543033499620919,508,Failure to abide by shark week contract. You're not allowed to eat without camera present. You know this.
4119,3509,0,0,7,7,1.0,0.1543033499620919,508,"My cousin, Little Finnie. Word on the street is, he's been skipping school lately."
4124,3509,0,0,7,7,1.0,0.1543033499620919,508,What'd ya expect?'He thought I was a dolphin
4196,3509,0,0,7,7,1.0,0.1543033499620919,508,I swear I've never seen that fish before in my life.
4197,3509,0,0,7,7,1.0,0.1543033499620919,508,So you're telling me this isn't your handwriting?
4198,3509,0,0,7,7,1.0,0.1543033499620919,508,I will not talk you. You have no jurisdiction in my ecozone.
4201,3509,0,0,10,10,1.0,0.10540925533894598,508,There may be some lingering resentment.
4202,3509,0,0,7,7,1.0,0.1543033499620919,508,I only eat canned surfer.
4203,3509,0,0,7,7,1.0,0.1543033499620919,508,"Yeah, I ate him...he's a tuna for Pete's sake. You gonna charge me or what?"
4206,3509,0,0,7,7,1.0,0.1543033499620919,508,I thought that guy was lying when he told me he belonged to an endangered species.
4207,3509,0,0,7,7,1.0,0.1543033499620919,508,"Seen one lawyer, seen them all."
4208,3509,0,0,7,7,1.0,0.1543033499620919,508,"Navy, Shnavy. A seal is a seal."
4209,3509,0,0,9,9,1.0,0.11785113019775792,508,"'All you people look the same to me.' (smell, on the other fin, is another matter)"
4211,3509,0,0,7,7,1.0,0.1543033499620919,508,Sharknado??? What's that??
4212,3509,0,0,7,7,1.0,0.1543033499620919,508,He can't be Jaws. His teeth aren't large enough.'
4213,3509,0,0,7,7,1.0,0.1543033499620919,508,"Just because it's Shark Week on the Discovery Channel, doesn't automatically make me a suspect."
4215,3509,0,0,7,7,1.0,0.1543033499620919,508,"I'd like to help you, officers...But 'loan shark' isn't really a THING where I come from."
4220,3509,0,0,7,7,1.0,0.1543033499620919,508,That guy looks fishy to me
4221,3509,0,0,7,7,1.0,0.1543033499620919,508,That's a stereotype - we're not all that great.
4222,3509,0,0,10,10,1.0,0.10540925533894598,508,"You gonna dance, left shark?"
4251,3509,0,0,7,7,1.0,0.1543033499620919,508,"I know profiling, and this is profiling!"
4248,3509,0,0,7,7,1.0,0.1543033499620919,508,During a feeding frenzy there's not much discussion of protected species.
4246,3509,0,0,8,8,1.0,0.1336306209562122,508,I toldja already. I don't know nothin' 'bout no loan sharks.
4245,3509,0,0,7,7,1.0,0.1543033499620919,508,"Yeah, I saw him around the reef a few times, but I didn't know him. He wasn't my chum, in either sense of the word."
4241,3509,0,0,7,7,1.0,0.1543033499620919,508,They made SOUP out of it!
4240,3509,0,0,7,7,1.0,0.1543033499620919,508,"Fine. You wanna match my bite with that photo, go right ahead. But you better check my lawyer's bite too, Bucko."
4195,3509,0,0,7,7,1.0,0.1543033499620919,508,"For the last time, I'm NOT a card shark!"
4237,3509,0,0,7,7,1.0,0.1543033499620919,508,Just tell him to go ahead and shoot me!
4234,3509,0,0,8,8,1.0,0.1336306209562122,508,Do you recognize this INVERTEBRATE?
4231,3509,0,0,7,7,1.0,0.1543033499620919,508,"I get it, alright? Something smells fishy. Ha. Ha."
4229,3509,0,0,8,8,1.0,0.1336306209562122,508,It looks like an open-and-shut case.
4227,3509,0,0,7,7,1.0,0.1543033499620919,508,"Nah, I don't chum around with those fellas no more. Now I'm just a lone shark."
4226,3509,0,0,9,9,1.0,0.11785113019775792,508,The Fruitti Di Mare
4224,3509,0,0,7,7,1.0,0.1543033499620919,508,"Hey, half-time shows are meant to be entertaining; Ms. Perry told me to have fun!"
4235,3509,0,0,7,7,1.0,0.1543033499620919,508,Showing me the recipe for shark fin soup will not make me talk.
4122,3509,0,0,7,7,1.0,0.1543033499620919,508,"I'm telling you, she was a plant."
4194,3509,0,0,7,7,1.0,0.1543033499620919,508,"So the guy was in debt, so his body washed up on shore. I tell ya I never seen him before, never loaned him a dime!"
4192,3509,0,0,7,7,1.0,0.1543033499620919,508,"Last I seen him, he was swimming with the fishes."
4126,3509,0,0,8,8,1.0,0.1336306209562122,508,I don't see the problem officer. The contract clearly says 'pound of flesh' in bold type.
4128,3509,0,0,7,7,1.0,0.1543033499620919,508,How many times do I have to tell you guys that I am not a loan shark.
4129,3509,0,0,8,8,1.0,0.1336306209562122,508,"I'm just saying, I didn't like the guy that's all - he, uh, left a bad taste in my mouth."
4134,3509,0,0,9,9,1.0,0.11785113019775792,508,"What do you mean, loitering? You know it's my nature to keep moving."
4135,3509,0,0,7,7,1.0,0.1543033499620919,508,"Yeah, that's Nemo...but you'll never find him."
4142,3509,0,0,7,7,1.0,0.1543033499620919,508,"He looks familiar. We swam together, and then we had a little snack."
4145,3509,0,0,9,9,1.0,0.11785113019775792,508,I've never seen that dolphin before in my life.
4146,3509,0,0,7,7,1.0,0.1543033499620919,508,That's Donald Trump swimming with the sharks looking for votes.
4154,3509,0,0,7,7,1.0,0.1543033499620919,508,I plead sharkfluenza.
4155,3509,0,0,7,7,1.0,0.1543033499620919,508,Him? He's swimming with the fishies because he's a FISH!
4156,3509,0,0,10,10,1.0,0.10540925533894598,508,'I was there when he was eaten but I didn't eat him'.
4159,3509,0,0,7,7,1.0,0.1543033499620919,508,PETA says this is your last chance!
4161,3509,0,0,7,7,1.0,0.1543033499620919,508,"Officer, I'll have the Tuna tartar in wine sauce and 87 gallons of water."
4163,3509,0,0,7,7,1.0,0.1543033499620919,508,"Well when you turn it THAT way, I would say it's the Left Shark."
4164,3509,0,0,7,7,1.0,0.1543033499620919,508,"What is this 'Good Cop/ Bad Cop? No, I didn't eat him. And, by the way, he didn't taste all that good."
4165,3509,0,0,8,8,1.0,0.1336306209562122,508,"Scarlet billows? Doze ain't no scarlet billows! Mack framed me, I tell ya. Check the Knife."
4166,3509,0,0,7,7,1.0,0.1543033499620919,508,"Officer, Miranda must be in the arrestee's language"
4191,3509,0,0,7,7,1.0,0.1543033499620919,508,No problem. How much of a loan do you need?
4188,3509,0,0,8,8,1.0,0.1336306209562122,508,The guy with the wooden leg? Never seen him.
4187,3509,0,0,7,7,1.0,0.1543033499620919,508,It's not me; I don't eat meat.
4186,3509,0,0,7,7,1.0,0.1543033499620919,508,Maybe she just stopped moving forward.
4185,3509,0,0,7,7,1.0,0.1543033499620919,508,"I told you, I've never seen that leg before."
4184,3509,0,0,7,7,1.0,0.1543033499620919,508,Have you seen this whale from SeaWorld?
4193,3509,0,0,8,8,1.0,0.1336306209562122,508,"I know, I know. Fish are friends, not food."
4180,3509,0,0,7,7,1.0,0.1543033499620919,508,I told you it was a bad idea to free Willy.
4177,3509,0,0,7,7,1.0,0.1543033499620919,508,"All right, I'll give you a reeftip!"
4175,3509,0,0,7,7,1.0,0.1543033499620919,508,"Buddy, I'm tellin ya I danced fine. The guy you want is Left Shark, and he's still out there."
4174,3509,0,0,7,7,1.0,0.1543033499620919,508,Mack the who? Never heard of him.
4173,3509,0,0,7,7,1.0,0.1543033499620919,508,"Yeah, I might have imbibed someone who looked that at some point."
4170,3509,0,0,9,9,1.0,0.11785113019775792,508,Getting kicked off 'Shark Tank' clearly did a number on him.
4169,3509,0,0,7,7,1.0,0.1543033499620919,508,"Guys, it's impossible to literally take a bite out of crime."
4178,3509,0,0,7,7,1.0,0.1543033499620919,508,You planted those bite marks. I want my court-appointed documentarian.
4535,3509,0,0,7,7,1.0,0.1543033499620919,508,You're fired!
3403,3509,0,0,7,7,1.0,0.1543033499620919,508,"Yeah, he's the one I made the loan to."
3400,3509,0,0,7,7,1.0,0.1543033499620919,508,Just because I chose to represent myself don't think I am a fool.
2627,3509,0,0,7,7,1.0,0.1543033499620919,508,I guess this just isn't my week.
2628,3509,0,0,7,7,1.0,0.1543033499620919,508,If you give up your remora we can cut you a deal
2630,3509,0,0,7,7,1.0,0.1543033499620919,508,These loan sharks are tough.
2632,3509,0,0,7,7,1.0,0.1543033499620919,508,You'll have to read me my rights.
2641,3509,0,0,7,7,1.0,0.1543033499620919,508,I keep telling you I never saw the yacht that hit me...
2645,3509,0,0,7,7,1.0,0.1543033499620919,508,"Good cod, bad cod.., listen hear fellas, I'm pleadin' the fin amendment!"
2649,3509,0,0,7,7,1.0,0.1543033499620919,508,"I'll say it again. No, I'm not a card shark. That is not my card. I've never seen it before in my life."
2650,3509,0,0,7,7,1.0,0.1543033499620919,508,Not my teeth . .
2654,3509,0,0,8,8,1.0,0.1336306209562122,508,those could have been made by a hammerhead
2655,3509,0,0,9,9,1.0,0.11785113019775792,508,Yeah.... I knew that there was blood in the water.... but I was miles away I tell ya!
2656,3509,0,0,8,8,1.0,0.1336306209562122,508,That does not look like a tuna!
2657,3509,0,0,7,7,1.0,0.1543033499620919,508,"Yeah, that's the guy. Old Macheith, babe."
2658,3509,0,0,7,7,1.0,0.1543033499620919,508,"Who, me? No, I'm just the sophisticated spokes-tuna for a much larger outfit."
2659,3509,0,0,7,7,1.0,0.1543033499620919,508,"Give it to the guy under the table, I'm just his puppet."
2624,3509,0,0,7,7,1.0,0.1543033499620919,508,"I keep telling you, I am a Vegan!"
2660,3509,0,0,7,7,1.0,0.1543033499620919,508,They're the ones who named their show Shark Tank.
2668,3509,0,0,7,7,1.0,0.1543033499620919,508,"Dude. I was just pulling his leg, broah."
2669,3509,0,0,7,7,1.0,0.1543033499620919,508,Take a good look! You know him - you ate Charlie the Tuna for for dinner last week!
2670,3509,0,0,7,7,1.0,0.1543033499620919,508,"Oh, you don't recognize this arm, is that what you're telling us?"
2676,3509,0,0,7,7,1.0,0.1543033499620919,508,"I'm pleading the fish and no, I've never seen that IOU before."
2677,3509,0,0,7,7,1.0,0.1543033499620919,508,"Look pal, you can't expect me to remember every chum I had for dinner."
2679,3509,0,0,7,7,1.0,0.1543033499620919,508,Not THAT Richard Dreyfuss.
2680,3509,0,0,8,8,1.0,0.1336306209562122,508,"For goodness sake, do you recognize this Sea World trainer, yes or no?!"
2681,3509,0,0,7,7,1.0,0.1543033499620919,508,"Yeah, I know da bum. That lay about is Charlie the Tuna's grandson."
2683,3509,0,0,7,7,1.0,0.1543033499620919,508,"Come on Tony, when your a Jet your a Jet all the way."
2684,3509,0,0,7,7,1.0,0.1543033499620919,508,"Yeah, I gave him a loan. So what?"
2686,3509,0,0,7,7,1.0,0.1543033499620919,508,NO! I did not take the bite out of crime. That was the dog.
2687,3509,0,0,7,7,1.0,0.1543033499620919,508,Yep...that's me in Sharknado 3...so what !
2688,3509,0,0,7,7,1.0,0.1543033499620919,508,If you are innocent then what is the victim's DNA doing in your poop?
2690,3509,0,0,7,7,1.0,0.1543033499620919,508,You've been watching too many movies.
2666,3509,0,0,7,7,1.0,0.1543033499620919,508,"Bu-r-r-r-r-r-p-p ... Nope, never saw 'em ... !"
2617,3509,0,0,7,7,1.0,0.1543033499620919,508,So I've been tagged -- talk to NOAA about it.
2615,3509,0,0,7,7,1.0,0.1543033499620919,508,"Why would I kill him, he made good on his bet?"
2614,3509,0,0,7,7,1.0,0.1543033499620919,508,"Sorry, I can't see without my reading glasses."
2523,3509,0,0,8,8,1.0,0.1336306209562122,508,I told you. It looked just like a seal to me.
2524,3509,0,0,7,7,1.0,0.1543033499620919,508,Don't try the old 'seal cop' 'dolphin cop' routine on me.
2528,3509,0,0,7,7,1.0,0.1543033499620919,508,"Yes, that's him, he was delicious. Now, can I see the dessert menu?"
2529,3509,0,0,7,7,1.0,0.1543033499620919,508,Where’s Cuban? You call this Shark Tank?!
2533,3509,0,0,7,7,1.0,0.1543033499620919,508,I didn't know he was jail bait.
2544,3509,0,0,7,7,1.0,0.1543033499620919,508,Poor Brendan Dassey of the shark world never stood a chance.
2548,3509,0,0,7,7,1.0,0.1543033499620919,508,Yeah. That's the guy - I mean - sea lion......
2550,3509,0,0,7,7,1.0,0.1543033499620919,508,"OK you got me, I was hungry!"
2551,3509,0,0,7,7,1.0,0.1543033499620919,508,"I don't know, I eat a lot of fish."
2552,3509,0,0,7,7,1.0,0.1543033499620919,508,"Said it before and I'll say it again, fellas: I was in Pittsburgh at the time, and I max out on sniffing blood at a quarter mile away."
2553,3509,0,0,8,8,1.0,0.1336306209562122,508,Mr. Wonderful? I've never met him. That's a different kind of tank.
2557,3509,0,0,7,7,1.0,0.1543033499620919,508,Do you recognize this bloody stump?
2559,3509,0,0,7,7,1.0,0.1543033499620919,508,I told you to stick to dolphins.
2561,3509,0,0,7,7,1.0,0.1543033499620919,508,"Tony the Hammerhead? Yeah, I know him."
2568,3509,0,0,7,7,1.0,0.1543033499620919,508,My client signed that indemnification waiver voluntarily.
2575,3509,0,0,6,6,1.0,0.18257418583505536,508,I'm just a dolphin with teeth. Never hurt a soul in my life.
2577,3509,0,0,9,9,1.0,0.11785113019775792,508,"Here's your assignment. Don't mess it up this time, and easy on the travel expense account."
2613,3509,0,0,7,7,1.0,0.1543033499620919,508,So he's swimming with the fishes. What's the problem?
2611,3509,0,0,7,7,1.0,0.1543033499620919,508,What can I say? I don't really like sushi.
2610,3509,0,0,7,7,1.0,0.1543033499620919,508,Does the name Paul Newman ring a bell?
2606,3509,0,0,7,7,1.0,0.1543033499620919,508,"That's him, the lawyer!"
2604,3509,0,0,7,7,1.0,0.1543033499620919,508,Word on the street is that you sharked up a list of lawless resolutes. Is this it?
2603,3509,0,0,7,7,1.0,0.1543033499620919,508,"It was a bad investment, I'm sorry!"
2691,3509,0,0,7,7,1.0,0.1543033499620919,508,That eye witness account looks fishy to me
2602,3509,0,0,7,7,1.0,0.1543033499620919,508,You got me!! This WAS no boating accident!
2595,3509,0,0,7,7,1.0,0.1543033499620919,508,I'm tired of doing you guys' dirty work for you!
2592,3509,0,0,7,7,1.0,0.1543033499620919,508,"Look ! I'm a Loan Shark, not a RAT !!"
2591,3509,0,0,7,7,1.0,0.1543033499620919,508,"Loose lips sink ships, copper, and sharks have no lips."
2586,3509,0,0,7,7,1.0,0.1543033499620919,508,I told you...I couldn't stop moving long enough to get a good look!
2583,3509,0,0,7,7,1.0,0.1543033499620919,508,Now that's a jaw dropper!
2580,3509,0,0,8,8,1.0,0.1336306209562122,508,Let's just move past the statement; I'm dying here.
2596,3509,0,0,7,7,1.0,0.1543033499620919,508,"Maybe I ate him, but you are only focusing on me to displace a multitude fears generated by the conflicts inherent to late capitalism."
2692,3509,0,0,7,7,1.0,0.1543033499620919,508,"I may have seen him back in school, but this guy's teeth are pearly white"
2694,3509,0,0,7,7,1.0,0.1543033499620919,508,"I'd lawyer UP, but I need to get back under water.'"
2697,3509,0,0,7,7,1.0,0.1543033499620919,508,Do you recognize this phony Stradivarius ?
2790,3509,0,0,7,7,1.0,0.1543033499620919,508,I knew in the tank!
2791,3509,0,0,7,7,1.0,0.1543033499620919,508,He never swam with me.
2793,3509,0,0,7,7,1.0,0.1543033499620919,508,It's a Jaws dropper
2796,3509,0,0,7,7,1.0,0.1543033499620919,508,"Yeah, that's my belt...so what?"
2798,3509,0,0,7,7,1.0,0.1543033499620919,508,I haven't seen Bernardo since the '50's.
2799,3509,0,0,8,8,1.0,0.1336306209562122,508,"Again, this one is the surfer, the other the seal. I only ever bit the seal."
2800,3509,0,0,8,8,1.0,0.1336306209562122,508,"For the last time, a picture of me with Ian Ziering in no way proves that I directed Sharknado."
2801,3509,0,0,7,7,1.0,0.1543033499620919,508,What do other lawyers say?
2806,3509,0,0,7,7,1.0,0.1543033499620919,508,"I swear, Officer Krupke, you must be mistaken!"
2807,3509,0,0,7,7,1.0,0.1543033499620919,508,"you've got the wrong shark, I've never seen that leg before!"
2808,3509,0,0,7,7,1.0,0.1543033499620919,508,Sorry--not my toothprints!
2809,3509,0,0,7,7,1.0,0.1543033499620919,508,Just how can I hand something like that to FINRA?
2810,3509,0,0,7,7,1.0,0.1543033499620919,508,"Yeah, I recognize him. He was into me for fifty large. But I didn't kill him."
2812,3509,0,0,7,7,1.0,0.1543033499620919,508,No chum of mine . How many times do I need to tell ya ?
2814,3509,0,0,7,7,1.0,0.1543033499620919,508,"Yeah that's him agent, he stole my lunch!"
2816,3509,0,0,7,7,1.0,0.1543033499620919,508,"But Officer, my name is Melinda, not Miranda..."
2817,3509,0,0,7,7,1.0,0.1543033499620919,508,And here is another seal that has gone missing.
2842,3509,0,0,7,7,1.0,0.1543033499620919,508,I told you! I was trying to eat the surfboard and not the surfer.
2841,3509,0,0,7,7,1.0,0.1543033499620919,508,Recognize this krill?
2840,3509,0,0,7,7,1.0,0.1543033499620919,508,"Dude, you all taste A like to me!"
2838,3509,0,0,8,8,1.0,0.1336306209562122,508,Yeah I ate him. Every damn time I saw him he did that 'duh-duh... duh-duh' Jaws theme!
2836,3509,0,0,7,7,1.0,0.1543033499620919,508,Do you have some blood of his I could smell?
2835,3509,0,0,7,7,1.0,0.1543033499620919,508,I'm getting really sick of practicing with sock puppets.
2786,3509,0,0,7,7,1.0,0.1543033499620919,508,I was set up. MacHeath made it look like I did it.
2834,3509,0,0,7,7,1.0,0.1543033499620919,508,"OK...You're right...My name is Card Shark and that's my brother, Loan."
2831,3509,0,0,7,7,1.0,0.1543033499620919,508,And you're saying those are my FINGER prints on the gun? I call the rights to the Netflix series.
2827,3509,0,0,7,7,1.0,0.1543033499620919,508,It was mechanical. It was just a movie fellas.
2823,3509,0,0,8,8,1.0,0.1336306209562122,508,"I asked for my last meal to be boneless, gluten-free,vegan, grass-fed, free-range, and low-cal. But not skinless!"
2821,3509,0,0,7,7,1.0,0.1543033499620919,508,It's a loan. It's what I do.
2819,3509,0,0,7,7,1.0,0.1543033499620919,508,Never seen her before.
2818,3509,0,0,7,7,1.0,0.1543033499620919,508,"I told you, I don't have a partner. I'm more of a lone shark."
2832,3509,0,0,7,7,1.0,0.1543033499620919,508,He didn't look like that before I ate him.
2522,3509,0,0,8,8,1.0,0.1336306209562122,508,"Yeah, I ate him. Now let me move forward or you're gonna have a dead shark on your hands."
2782,3509,0,0,7,7,1.0,0.1543033499620919,508,"Him, I ate back in '09, and you won't find the remains, he's pushing up kelp off of Montauk, sleeping with the fishes."
2780,3509,0,0,7,7,1.0,0.1543033499620919,508,I ain't no spotted ratfish.
2700,3509,0,0,7,7,1.0,0.1543033499620919,508,Lawyer? I need someone from Marine Salvage!
2703,3509,0,0,7,7,1.0,0.1543033499620919,508,You loan sharks don't scare me
2709,3509,0,0,7,7,1.0,0.1543033499620919,508,Shark is enver to be grilled.
2711,3509,0,0,7,7,1.0,0.1543033499620919,508,I prefer a green salad wit olives and tomatoes myself.
2714,3509,0,0,7,7,1.0,0.1543033499620919,508,"Where's my lawyer, you pigs?"
2720,3509,0,0,7,7,1.0,0.1543033499620919,508,I can't recognize him All Orcas look alike
2722,3509,0,0,7,7,1.0,0.1543033499620919,508,I never saw that lifeboat in my life!
2724,3509,0,0,9,9,1.0,0.11785113019775792,508,"Yeah, dat was de porpoisetrator."
2727,3509,0,0,7,7,1.0,0.1543033499620919,508,Are you the good tasting cop or the bad tasting cop?
2729,3509,0,0,8,8,1.0,0.1336306209562122,508,It couldn't have been me. I was sleeping!
2730,3509,0,0,7,7,1.0,0.1543033499620919,508,"Yea, that tuna's the one- he's the loan shark!"
2734,3509,0,0,7,7,1.0,0.1543033499620919,508,"Forget Miranda, read me my Peta rights"
2735,3509,0,0,7,7,1.0,0.1543033499620919,508,Yep--that's the bastard that jumped me.
2736,3509,0,0,7,7,1.0,0.1543033499620919,508,"Nope, not him O I mean her...to skinny"
2739,3509,0,0,6,6,1.0,0.18257418583505536,508,Scott? We knew him as breakfast.
2741,3509,0,0,7,7,1.0,0.1543033499620919,508,Can't be sure it's him with all those missing teeth.
2745,3509,0,0,7,7,1.0,0.1543033499620919,508,Can you identify this as the republican candidate that jumped you most recently?
2776,3509,0,0,7,7,1.0,0.1543033499620919,508,Looks juicy enough! Where can I find that swimmer?
2775,3509,0,0,7,7,1.0,0.1543033499620919,508,"Sorry Charley, you got the wrong fish!"
2774,3509,0,0,7,7,1.0,0.1543033499620919,508,Go ahead officer. I am a lawyer.
2773,3509,0,0,8,8,1.0,0.1336306209562122,508,"Shylock, you said? I don't think so."
2772,3509,0,0,7,7,1.0,0.1543033499620919,508,Looks fishy to me too.
2771,3509,0,0,7,7,1.0,0.1543033499620919,508,"Yup,I ate him.Watch your hand!"
2781,3509,0,0,8,8,1.0,0.1336306209562122,508,I'm innocent! Fonzie is the one who jumped me.
2770,3509,0,0,7,7,1.0,0.1543033499620919,508,"I told you, you can trust me!"
2758,3509,0,0,7,7,1.0,0.1543033499620919,508,"YOU try keepin' 1,000 feet away from a school at all times down there."
2755,3509,0,0,7,7,1.0,0.1543033499620919,508,Is this the card shark you lost a fin to?
2753,3509,0,0,7,7,1.0,0.1543033499620919,508,That's clearly the work of a chainsaw.
2751,3509,0,0,7,7,1.0,0.1543033499620919,508,I was framed by the dolphin!
2750,3509,0,0,6,6,1.0,0.18257418583505536,508,"As I said, that's NOT my aunt Matilda!"
2747,3509,0,0,7,7,1.0,0.1543033499620919,508,Yup. That's him. 'Mr. Wonderful.'
2769,3509,0,0,8,8,1.0,0.1336306209562122,508,All I'm sayin' is the idiot jumped. Then I don't remember.
2519,3509,0,0,7,7,1.0,0.1543033499620919,508,"Again, I did not, nor did I ever, deliver a candygram to Chevy Chase."
2517,3509,0,0,7,7,1.0,0.1543033499620919,508,I'd like to speak with my atuna.
2513,3509,0,0,7,7,1.0,0.1543033499620919,508,Is the business scalable?
2269,3509,0,0,7,7,1.0,0.1543033499620919,508,"No , you were busted not for being a lone shark but a loan shark!"
2272,3509,0,0,7,7,1.0,0.1543033499620919,508,You got it all wrong!!! I'm a SAND Shark! You want the LAND Shark!
2275,3509,0,0,7,7,1.0,0.1543033499620919,508,"Yea, dat's him. I'd recognize that hammerhead anywhere."
2279,3509,0,0,7,7,1.0,0.1543033499620919,508,It was Mack the Knife!
2286,3509,0,0,7,7,1.0,0.1543033499620919,508,"I told you, his fin wasn't black"
2287,3509,0,0,7,7,1.0,0.1543033499620919,508,I can't take it anymore! I'm hungry.
2288,3509,0,0,8,8,1.0,0.1336306209562122,508,"Go ahead, keep on showin' me pictures of sharks! You think I know 'em? Like we're all related or something?"
2294,3509,0,0,7,7,1.0,0.1543033499620919,508,I refuse to answer on the grounds it may incriminate me.
2297,3509,0,0,7,7,1.0,0.1543033499620919,508,"Well, it may be the nuclear launch code, but it's not marked 'Classified.'"
2298,3509,0,0,8,8,1.0,0.1336306209562122,508,"No, No..I swear, I've never seen that dolphin before !!"
2301,3509,0,0,8,8,1.0,0.1336306209562122,508,Since when is it a crime to make someone your chum?
2302,3509,0,0,7,7,1.0,0.1543033499620919,508,"I swear, Officer Krupke, you've got the wrong shark."
2303,3509,0,0,7,7,1.0,0.1543033499620919,508,I ain't no largemouth bass.
2307,3509,0,0,7,7,1.0,0.1543033499620919,508,"Like I've told you before, all humans look alike to me."
2308,3509,0,0,8,8,1.0,0.1336306209562122,508,I already told you guys. Thats a surfer. All I saw was seals.
2309,3509,0,0,7,7,1.0,0.1543033499620919,508,Listen here sushi eaters - I ain't checking no sustainability list!
2310,3509,0,0,7,7,1.0,0.1543033499620919,508,Making a Murderer Meets Shark Week - season premiere this fall!
2345,3509,0,0,7,7,1.0,0.1543033499620919,508,"Look dude, it's not MY fault that guy decided to go swimming where I live and eat. He looked like food, so I tried to eat him. Maybe next time he should try a pool. I hear they make them with waves now."
2342,3509,0,0,7,7,1.0,0.1543033499620919,508,Never saw that ‘nado in my life.
2341,3509,0,0,7,7,1.0,0.1543033499620919,508,I had him for dinner. Is there a question?
2340,3509,0,0,8,8,1.0,0.1336306209562122,508,"I've never seen that ravaged, masticated corpse before in my life."
2336,3509,0,0,8,8,1.0,0.1336306209562122,508,The bikinis are all starting to look the same.
2331,3509,0,0,8,8,1.0,0.1336306209562122,508,I might have seen him before. Can you hold the picture closer?
2267,3509,0,0,7,7,1.0,0.1543033499620919,508,Not that one. Show me the other foot again.
2326,3509,0,0,7,7,1.0,0.1543033499620919,508,I'm no swindler.
2323,3509,0,0,7,7,1.0,0.1543033499620919,508,Oh no. Not waterboarding. Anything but that.
2321,3509,0,0,7,7,1.0,0.1543033499620919,508,Never met the rat. Don went extinct before I ever cut my teeth in that sewer.
2319,3509,0,0,7,7,1.0,0.1543033499620919,508,"The evidence will show, those are not my fingerprints or bite marks."
2317,3509,0,0,7,7,1.0,0.1543033499620919,508,'I had him for lunch yesterday can I see a dinner menu'?
2316,3509,0,0,7,7,1.0,0.1543033499620919,508,Do you recognize this great white shark?
2315,3509,0,0,7,7,1.0,0.1543033499620919,508,I already told ya -- I've never seen your chum!
2325,3509,0,0,8,8,1.0,0.1336306209562122,508,"Look man, I can't read music. Maybe it goes 'dum-dum dum-dum'?"
2347,3509,0,0,8,8,1.0,0.1336306209562122,508,"He has such teeth, dear, and it shows them pearly white."
2263,3509,0,0,8,8,1.0,0.1336306209562122,508,"Yes, that's him - fame went to his hammerhead after his role in JAWS"
2261,3509,0,0,7,7,1.0,0.1543033499620919,508,I don't mind obeying the rest as long as I can skip No.6.
2188,3509,0,0,8,8,1.0,0.1336306209562122,508,Are you the criminal who killed the person on this picture?
2189,3509,0,0,8,8,1.0,0.1336306209562122,508,I swear officer! I didn't know she was a pup!
2194,3509,0,0,7,7,1.0,0.1543033499620919,508,"For the last time, when I said the bloke looked like me chum..."
2196,3509,0,0,7,7,1.0,0.1543033499620919,508,"It's a decent sketch, but his nose looked more like a sword."
2197,3509,0,0,7,7,1.0,0.1543033499620919,508,"Yeah, I lent them money, so bite me."
2199,3509,0,0,7,7,1.0,0.1543033499620919,508,You've been caught and your sharking business is over.
2201,3509,0,0,7,7,1.0,0.1543033499620919,508,"Of course, I recognize that picture. It's actually a still from a classic movie. Hello, anyone hear of Spielberg?"
2202,3509,0,0,7,7,1.0,0.1543033499620919,508,I told you. I don't know nobody named Mack the Knife.
2205,3509,0,0,7,7,1.0,0.1543033499620919,508,"I've told you like a thousand times. We all look alike. That could be my cousin, brother, sister, I don't know. Can I leave now?"
2207,3509,0,0,7,7,1.0,0.1543033499620919,508,"No, I told you I've never seen that fin before."
2216,3509,0,0,7,7,1.0,0.1543033499620919,508,People all look the same to me.
2217,3509,0,0,7,7,1.0,0.1543033499620919,508,'Fess up. Did you take a big bite out of this corporation's profits?
2219,3509,0,0,7,7,1.0,0.1543033499620919,508,"So he's sleeping with the fishes. You aint gonna pin that on me, copper!"
2222,3509,0,0,7,7,1.0,0.1543033499620919,508,Arthur Fonzarelli.
2226,3509,0,0,7,7,1.0,0.1543033499620919,508,Tell us why you ate this innocent little girl' 'It wasn't on porpoise
2228,3509,0,0,7,7,1.0,0.1543033499620919,508,I've never seen that license plate before in my life.
2230,3509,0,0,7,7,1.0,0.1543033499620919,508,"No, I don't like your idea for a business!"
2260,3509,0,0,7,7,1.0,0.1543033499620919,508,'But I thought that it's the ones you don't see that you have to worry about'.
2259,3509,0,0,7,7,1.0,0.1543033499620919,508,"Like I told your partner, I've never even heard of a Hire purchase agreement"
2256,3509,0,0,7,7,1.0,0.1543033499620919,508,"My bad, I mistook him for Spielberg."
2250,3509,0,0,7,7,1.0,0.1543033499620919,508,"Look, pal, I'm not your chum. But you could soon be mine."
2249,3509,0,0,7,7,1.0,0.1543033499620919,508,Clearly those aren't MY fingerprints!
2247,3509,0,0,8,8,1.0,0.1336306209562122,508,Cop 1: Do you recognize this shark? Shark: Uhhh... no sir.
2262,3509,0,0,12,12,1.0,0.08703882797784893,508,"You've got it all wrong. She wasn't like the others. They'd all turn right, and she'd turn left. I'd never hurt her!"
2243,3509,0,0,7,7,1.0,0.1543033499620919,508,confess! did you bite the surfer?
2240,3509,0,0,8,8,1.0,0.1336306209562122,508,I've told you - I would never bite a lawyer. Haven't you heard of professional courtesy?
2238,3509,0,0,7,7,1.0,0.1543033499620919,508,"Listen, pal, don't you think I'd know if Luca Brasi sleeps with the fishes?"
2237,3509,0,0,7,7,1.0,0.1543033499620919,508,I already told you it was a fish. Stop showing me pictures of Steven Avery.
2235,3509,0,0,7,7,1.0,0.1543033499620919,508,I think we may need to bring in a dolphin if we want to find anything out
2233,3509,0,0,8,8,1.0,0.1336306209562122,508,"No, I asked for 'water, Mark.' Not a watermark."
2232,3509,0,0,7,7,1.0,0.1543033499620919,508,If Jaws was caught and was inspected by laws. 'Is this the person you ate?'
2242,3509,0,0,7,7,1.0,0.1543033499620919,508,Things went bad for him after we quit school to hang around the pool hall.
2843,3509,0,0,6,6,1.0,0.18257418583505536,508,"Hey, she looked like a seal."
2352,3509,0,0,7,7,1.0,0.1543033499620919,508,Sorry guys but I don't know anything about loan sharks.
2357,3509,0,0,7,7,1.0,0.1543033499620919,508,So...it wasn't a buffet.
2442,3509,0,0,8,8,1.0,0.1336306209562122,508,Really? A sea level felony?
2444,3509,0,0,7,7,1.0,0.1543033499620919,508,'Am I the first catch of the day!?' And you talk about being done with racial profiling.
2445,3509,0,0,7,7,1.0,0.1543033499620919,508,"I'm innocent see, and I don't know nuthin 'bout no sharknado."
2446,3509,0,0,7,7,1.0,0.1543033499620919,508,"Its was the chef, he took my fins."
2448,3509,0,0,7,7,1.0,0.1543033499620919,508,"'Yeah, I'm a 'lone' shark. So what?"
2450,3509,0,0,7,7,1.0,0.1543033499620919,508,"Met her at the beach, last thing I remember is we were swimming, she was smiling at me and then I blacked out......"
2451,3509,0,0,8,8,1.0,0.1336306209562122,508,Yeah sure I seen him. He sleeps with the fishes.
2455,3509,0,0,7,7,1.0,0.1543033499620919,508,...you have a right to contact your ABA representative...
2456,3509,0,0,7,7,1.0,0.1543033499620919,508,A liquidated claim is off the table. Need I remind you who ATE the accused?
2461,3509,0,0,7,7,1.0,0.1543033499620919,508,That couldn't be me...I was on vacation in Lake Michigan!
2464,3509,0,0,7,7,1.0,0.1543033499620919,508,"Looks nothing like my friend, Jaws, I tell ya."
2466,3509,0,0,7,7,1.0,0.1543033499620919,508,So you found Nemo swimming with the fishes...
2467,3509,0,0,7,7,1.0,0.1543033499620919,508,Could be Mac the Knife.
2470,3509,0,0,7,7,1.0,0.1543033499620919,508,"You've got the wrong gang, pal. You want the Jets."
2471,3509,0,0,9,9,1.0,0.11785113019775792,508,Mr. Trump said it's okay. She's married to a terrorist.
2472,3509,0,0,7,7,1.0,0.1543033499620919,508,How many times do I gotta tell you? The gun's registered to my brother-in-law.
2473,3509,0,0,6,6,1.0,0.18257418583505536,508,"No, this guy was more barrel-chested; he had a gray beard, and the name on the boat was 'Pilar'"
2511,3509,0,0,8,8,1.0,0.1336306209562122,508,"I told ya already, I don't know nobody called 'Mack the Knife'"
2510,3509,0,0,7,7,1.0,0.1543033499620919,508,"Yeah, he was swimming with us fishes; so what?"
2507,3509,0,0,7,7,1.0,0.1543033499620919,508,Did you loan money to this man?
2506,3509,0,0,8,8,1.0,0.1336306209562122,508,What the hell is on Joey's head
2499,3509,0,0,7,7,1.0,0.1543033499620919,508,I don't hang out with guppies. They're losers!
2498,3509,0,0,6,6,1.0,0.18257418583505536,508,Are you telling me this isn't you swimming with the fishes?
2441,3509,0,0,8,8,1.0,0.1336306209562122,508,A subpoena for my dental records? Aren't they are protected under the Endangered Species Act?
2493,3509,0,0,7,7,1.0,0.1543033499620919,508,I was trying to take a bite out of crime.
2487,3509,0,0,7,7,1.0,0.1543033499620919,508,That's him alright. Charlie the Troller
2485,3509,0,0,7,7,1.0,0.1543033499620919,508,True...but he was only a tiny minnow!
2479,3509,0,0,7,7,1.0,0.1543033499620919,508,That's my old chum.
2478,3509,0,0,7,7,1.0,0.1543033499620919,508,"No, I didn't bite that man. It's professional courtesy that we don't attack lawyers."
2477,3509,0,0,7,7,1.0,0.1543033499620919,508,"Sorry guys, but your sleep deprivation tactics aren't going to work on me."
2475,3509,0,0,7,7,1.0,0.1543033499620919,508,"You guys from Manitowoc County just don't give up, do you?"
2488,3509,0,0,7,7,1.0,0.1543033499620919,508,Way too much garlic in that guy!
2356,3509,0,0,7,7,1.0,0.1543033499620919,508,"I'll get the planton, extra salty."
2434,3509,0,0,8,8,1.0,0.1336306209562122,508,"So he's missing an arm, that doesn't prove anything."
2431,3509,0,0,7,7,1.0,0.1543033499620919,508,"Okay, who agreed to this loan?"
2361,3509,0,0,7,7,1.0,0.1543033499620919,508,"I’ll have the dolphin burger – rare, please – with a seaweed salad and a Bloody Mary."
2362,3509,0,0,7,7,1.0,0.1543033499620919,508,That's not my writing and I'm not a loan shark.
2363,3509,0,0,7,7,1.0,0.1543033499620919,508,"I know you know this guy! Give me $20,000 for 30% of my company or I'm goin' with Mark Cuban."
2367,3509,0,0,7,7,1.0,0.1543033499620919,508,"No, that's not me."
2368,3509,0,0,7,7,1.0,0.1543033499620919,508,"Great smile, handsome, charming to all his clients.... of course we swam together, but after my humiliation and one too many trips to Starbucks, I flipped and finally had some Sashimi for myself."
2369,3509,0,0,7,7,1.0,0.1543033499620919,508,"I told you, I was away on business when that surfer disappeared."
2372,3509,0,0,8,8,1.0,0.1336306209562122,508,"Sure I recognize him. I told him, 'Listen pal, don't come back or I'll eat your OTHER leg off.'"
2373,3509,0,0,7,7,1.0,0.1543033499620919,508,"Yeah, I know that guy. But he's a reef shark not a loan shark."
2374,3509,0,0,9,9,1.0,0.11785113019775792,508,I've told you. I have never seen that fin before.
2375,3509,0,0,7,7,1.0,0.1543033499620919,508,"Yeah, I might-a swam by her once, so what?"
2376,3509,0,0,7,7,1.0,0.1543033499620919,508,I've never seen that dick before.
2377,3509,0,0,7,7,1.0,0.1543033499620919,508,I never went swimming with Kevin Spacey.
2381,3509,0,0,7,7,1.0,0.1543033499620919,508,"I'm telling you, I'm a strict vegan."
2384,3509,0,0,8,8,1.0,0.1336306209562122,508,"I've never seen that boat. Besides, it's is too small for my taste."
2385,3509,0,0,8,8,1.0,0.1336306209562122,508,"I admit I'd been drinking all day, but I'm not a monster."
2387,3509,0,0,9,9,1.0,0.11785113019775792,508,I SWARE I HAVE NEVER SEEN THAT FISH.
2389,3509,0,0,7,7,1.0,0.1543033499620919,508,Care to explain these selfies?
2429,3509,0,0,7,7,1.0,0.1543033499620919,508,"I told you before , I don't know anyone called Orca !"
2428,3509,0,0,7,7,1.0,0.1543033499620919,508,Do I look like a fool?
2427,3509,0,0,7,7,1.0,0.1543033499620919,508,"Of course I know him, he's my financial advisor!"
2424,3509,0,0,7,7,1.0,0.1543033499620919,508,I only read Sharkese.
2420,3509,0,0,7,7,1.0,0.1543033499620919,508,Have you seen this tuna?
2419,3509,0,0,7,7,1.0,0.1543033499620919,508,"that's not the one, he doesn't even look tasty!"
2433,3509,0,0,7,7,1.0,0.1543033499620919,508,"'I'm telling you, I don't know anyone named Charlie'."
2415,3509,0,0,7,7,1.0,0.1543033499620919,508,That is not the guy I ate!
2412,3509,0,0,7,7,1.0,0.1543033499620919,508,"Forget it, Bill, I ain't no ratfish."
2410,3509,0,0,7,7,1.0,0.1543033499620919,508,Some fins just can not be explained.
2408,3509,0,0,7,7,1.0,0.1543033499620919,508,Will you get my cousin Vinnie on the phone? I need a lawyer.
2404,3509,0,0,7,7,1.0,0.1543033499620919,508,I take offense to fin profiling.
2398,3509,0,0,8,8,1.0,0.1336306209562122,508,"No, I've never seen that seal in my life."
2391,3509,0,0,7,7,1.0,0.1543033499620919,508,They all look the same in a tide pool.
2414,3509,0,0,7,7,1.0,0.1543033499620919,508,"Don't chum the waters, detective."
2844,3509,0,0,7,7,1.0,0.1543033499620919,508,I could tell you what he smelled like.
2847,3509,0,0,7,7,1.0,0.1543033499620919,508,I have no idea how old he is.
2849,3509,0,0,7,7,1.0,0.1543033499620919,508,Doesn't ring a bell. Can I go? I don't have all week.
3191,3509,0,0,7,7,1.0,0.1543033499620919,508,I was never involved in the loaning money.
3192,3509,0,0,7,7,1.0,0.1543033499620919,508,"Yeah, Quint and me had our differences. But the day he disappeared I was with the Gray seals in Chatham. Just ask any of 'em."
3193,3509,0,0,7,7,1.0,0.1543033499620919,508,"I know, I know if the bite radius doesn't fit you must acquit but do you really want us to ignore all the other evidence including this picture from the seal-cam?"
3194,3509,0,0,8,8,1.0,0.1336306209562122,508,"No, I said it was a grizzly, not a black bear that attacked my legacy as the scariest animal ever to appear on the big screen."
3195,3509,0,0,7,7,1.0,0.1543033499620919,508,I caught him sleeping with the fishes.
3196,3509,0,0,7,7,1.0,0.1543033499620919,508,You think you can jump me? Fuggetaboutit!
3201,3509,0,0,8,8,1.0,0.1336306209562122,508,So? We all look the same underwater.
3202,3509,0,0,7,7,1.0,0.1543033499620919,508,"I'm an accessory to the crime? Looks, that's not my chum."
3203,3509,0,0,9,9,1.0,0.11785113019775792,508,"Nah. Never saw him before, never loaned him a cent."
3204,3509,0,0,7,7,1.0,0.1543033499620919,508,That's not him. The killer had pointy teeth and a much bigger blowhole.
3206,3509,0,0,8,8,1.0,0.1336306209562122,508,"No, that's not my fin mark on that loan."
3207,3509,0,0,7,7,1.0,0.1543033499620919,508,"Watch that fist, young man."
3208,3509,0,0,7,7,1.0,0.1543033499620919,508,"Hey pal, I don't see anything fishy about this photo"
3209,3509,0,0,7,7,1.0,0.1543033499620919,508,"Yeah, I remember him, he's the guy pitched overboard to sleep with us"
3210,3509,0,0,10,10,1.0,0.10540925533894598,508,You're not getting a nibble out of me until my lawyer's here---and he's a shark.
3211,3509,0,0,7,7,1.0,0.1543033499620919,508,"I told you, i was home watching shark week."
3215,3509,0,0,7,7,1.0,0.1543033499620919,508,"Those bite marks in the photo don't match my pearly whites, so try again copper."
3235,3509,0,0,7,7,1.0,0.1543033499620919,508,I've never seen that Fox in my entire life
3232,3509,0,0,7,7,1.0,0.1543033499620919,508,What are you showing me that for? I didn't see anyone's face!
3231,3509,0,0,10,10,1.0,0.10540925533894598,508,"I want my attorney, now!"
3230,3509,0,0,9,9,1.0,0.11785113019775792,508,"Yeah, that's the guy. Said he'd clear me by a mile."
3228,3509,0,0,7,7,1.0,0.1543033499620919,508,"I not gonna sing for you, Copper... I ain't no stool shark."
3227,3509,0,0,7,7,1.0,0.1543033499620919,508,"Yeah, I make the occasional loan. What of it?"
3187,3509,0,0,7,7,1.0,0.1543033499620919,508,That orca's full of seaweed! I've never seen that squid before.
3226,3509,0,0,7,7,1.0,0.1543033499620919,508,"Never seen him, but I'm more of a smell guy."
3224,3509,0,0,7,7,1.0,0.1543033499620919,508,Do I look like a snitch?
3223,3509,0,0,7,7,1.0,0.1543033499620919,508,"That's not me, I tell ya!' 'I was in South Beach when that guy lost a limb."
3221,3509,0,0,7,7,1.0,0.1543033499620919,508,"Bait and switch is for car salesmen, not cops!"
3220,3509,0,0,8,8,1.0,0.1336306209562122,508,"I know.. I know.. I BITE and have VERY clean teeth. But, how many times to I gotta tell ya, I don't know where Ol' MacHeath is."
3218,3509,0,0,8,8,1.0,0.1336306209562122,508,"I'd say there's something fishy about this whole thing, but I'm a mammal."
3216,3509,0,0,8,8,1.0,0.1336306209562122,508,I heard somebody say 'school'.
3225,3509,0,0,7,7,1.0,0.1543033499620919,508,No way! This is a card shark. You're looking for a loan shark.
3236,3509,0,0,7,7,1.0,0.1543033499620919,508,"Yeah, that's Hammerhead Harry, all right. He's the one who put the bite on everyone after losing that last round of poker to me."
3186,3509,0,0,7,7,1.0,0.1543033499620919,508,All it says is 'Lend me a fin!'
3183,3509,0,0,7,7,1.0,0.1543033499620919,508,That's him. 'Mr. Wonderful' he's not!'
3122,3509,0,0,7,7,1.0,0.1543033499620919,508,Sure--I recognize him. We were in a school together.
3123,3509,0,0,7,7,1.0,0.1543033499620919,508,"What do you mean, 'fishy'?"
3125,3509,0,0,7,7,1.0,0.1543033499620919,508,"Nope, that's not the guy who jumped me."
3126,3509,0,0,7,7,1.0,0.1543033499620919,508,I have no idea who - just another hairless beach ape.
3127,3509,0,0,8,8,1.0,0.1336306209562122,508,"'That dead eel? Never seen him, i'm a lawyer ya know and ya better back off!'"
3128,3509,0,0,7,7,1.0,0.1543033499620919,508,All hulls look alike to me!
3130,3509,0,0,8,8,1.0,0.1336306209562122,508,Yah. That's him. Black leather jacket. Sunglasses. I think they said his name was Fonzi.
3131,3509,0,0,7,7,1.0,0.1543033499620919,508,"Omaha? July, 2014? You guys are nuts!"
3132,3509,0,0,7,7,1.0,0.1543033499620919,508,You know as well as I do that it would never have happened if I was still allowed within 500 feet of a school.
3134,3509,0,0,7,7,1.0,0.1543033499620919,508,i don't know nothin' about no Louie Miller or Lucy Brown or Jenny Diver.
3135,3509,0,0,7,7,1.0,0.1543033499620919,508,"Hey, I've never been anywhere near Amity Island."
3139,3509,0,0,7,7,1.0,0.1543033499620919,508,I think this is just a red herring
3140,3509,0,0,7,7,1.0,0.1543033499620919,508,You're saying you didn't approve these loans?
3141,3509,0,0,7,7,1.0,0.1543033499620919,508,"I never got a good look at him. The guy jumped me, then faded out of the limelight."
3143,3509,0,0,7,7,1.0,0.1543033499620919,508,I want my shark.
3147,3509,0,0,7,7,1.0,0.1543033499620919,508,This man...ihmm no thanks. I just had my lunch
3148,3509,0,0,7,7,1.0,0.1543033499620919,508,"For the 10th time, I ain't telling ya nothin', and by the way, you might wanna give 'the Hair Club for Men' a call."
3178,3509,0,0,7,7,1.0,0.1543033499620919,508,Yeah. Dat's de one. Dey call him 'Fonzie.' He's de one dat jumped me foist.
3177,3509,0,0,7,7,1.0,0.1543033499620919,508,"Yeah, I recognize that. It's the promissory note signed by the prospective borrower. What's the crime in that ?"
3176,3509,0,0,7,7,1.0,0.1543033499620919,508,"I already told ya. I never saw that guy before, I didn't bite him, and he hit me first."
3175,3509,0,0,7,7,1.0,0.1543033499620919,508,Look what you did to Mr. Wonderful
3172,3509,0,0,8,8,1.0,0.1336306209562122,508,He never paid me; tasted like chicken.
3168,3509,0,0,8,8,1.0,0.1336306209562122,508,"That is DEFINATELY not on of my victims, officer !"
3184,3509,0,0,7,7,1.0,0.1543033499620919,508,that's the sweet and sour dude
3163,3509,0,0,7,7,1.0,0.1543033499620919,508,"He teased me, called me a minnow, so I ate his leg. Is that so wrong?"
3156,3509,0,0,8,8,1.0,0.1336306209562122,508,"Sorry, can't help you. I've chummed around with lots of guys who look like him."
3155,3509,0,0,7,7,1.0,0.1543033499620919,508,Yeah - I recognize him: he's the King of Spades
3154,3509,0,0,7,7,1.0,0.1543033499620919,508,We DO have your dental records here.
3152,3509,0,0,7,7,1.0,0.1543033499620919,508,Yeah...lemme call Netflix...
3150,3509,0,0,7,7,1.0,0.1543033499620919,508,"Him? Hell, yes, I remember! I mean, who's gonna forget t'ree days of heartburn and gas?"
3149,3509,0,0,7,7,1.0,0.1543033499620919,508,"Ok , that is me stalking Bobby Darin in 1959."
3158,3509,0,0,7,7,1.0,0.1543033499620919,508,"No, that's not it. He ranted something bizarrely incongruous about 'opposing Shari law' before he jumped me."
3121,3509,0,0,7,7,1.0,0.1543033499620919,508,"I'm not gonna talk without my attorney present, and by the way...no I don't know what you call 100 dead lawyers at the bottom of an ocean."
3238,3509,0,0,7,7,1.0,0.1543033499620919,508,Give me a sonogram. You'll see I didn't take the leg.
3242,3509,0,0,7,7,1.0,0.1543033499620919,508,Those could be anybodies teeth marks on that surf board
3327,3509,0,0,7,7,1.0,0.1543033499620919,508,"What do you mean, call my lawyer? I am a lawyer!"
3328,3509,0,0,7,7,1.0,0.1543033499620919,508,"No, no, no. I said he had eight legs!"
3335,3509,0,0,7,7,1.0,0.1543033499620919,508,"I told ya, he was my chum!"
3338,3509,0,0,7,7,1.0,0.1543033499620919,508,How many times do I have to explain the difference between a loan shark and a lone shark?
3339,3509,0,0,7,7,1.0,0.1543033499620919,508,We know you know where this leg went missing!
3340,3509,0,0,7,7,1.0,0.1543033499620919,508,Do you think I'm some sort of cold blooded killer?!
3341,3509,0,0,7,7,1.0,0.1543033499620919,508,I'd know that card shark anywhere.
3344,3509,0,0,8,8,1.0,0.1336306209562122,508,"No, I'm not an attorney. I'm an actual shark!"
3345,3509,0,0,7,7,1.0,0.1543033499620919,508,Does this murder look podcast-worthy?
3349,3509,0,0,7,7,1.0,0.1543033499620919,508,We're going to need a bigger font
3353,3509,0,0,7,7,1.0,0.1543033499620919,508,You are supposed to read my Miranda Rights to me.
3357,3509,0,0,7,7,1.0,0.1543033499620919,508,Can you confirm that the man in this picture is Mark Cuban?
3363,3509,0,0,7,7,1.0,0.1543033499620919,508,"Who do you think I am, your new paper shredder?"
3364,3509,0,0,7,7,1.0,0.1543033499620919,508,Yep. Mark Cuban.
3367,3509,0,0,7,7,1.0,0.1543033499620919,508,That's not my signature on that loan application.
3371,3509,0,0,7,7,1.0,0.1543033499620919,508,This is a setup. That's just chum.
3373,3509,0,0,7,7,1.0,0.1543033499620919,508,'I've told you already...I'm a Jet! I just look like a Shark.
3399,3509,0,0,7,7,1.0,0.1543033499620919,508,"That's not a loan, it's a gift."
3398,3509,0,0,7,7,1.0,0.1543033499620919,508,Don't give me that! This is a seal!
3396,3509,0,0,7,7,1.0,0.1543033499620919,508,you have 10 seconds to explain
3389,3509,0,0,7,7,1.0,0.1543033499620919,508,That's ridiculous. What's my motivation for killing Spielberg?
6775,3509,0,0,7,7,1.0,0.1543033499620919,508,"Hey, that's not me. I was the right-shark not that left-shark character."
3387,3509,0,0,8,8,1.0,0.1336306209562122,508,Its a delicious room of sweet ribs and an ice cold beer
3326,3509,0,0,7,7,1.0,0.1543033499620919,508,"Naah, I don't know any Mack the Knife guy, okay? Where he keeps it, who can tell?"
3385,3509,0,0,7,7,1.0,0.1543033499620919,508,"I'll have the steak. I told you Copper, you humans all look the same to us!"
3381,3509,0,0,8,8,1.0,0.1336306209562122,508,"Told you, Lefty, your loan sharking days are over."
3379,3509,0,0,7,7,1.0,0.1543033499620919,508,I still can't tell...is that a surfer or a seal?
3378,3509,0,0,7,7,1.0,0.1543033499620919,508,Just because I'm at the top of the food chain shouldn't make me a top suspect.
3377,3509,0,0,7,7,1.0,0.1543033499620919,508,Didn't you realize we can only read under water?
3376,3509,0,0,7,7,1.0,0.1543033499620919,508,"OK, OK, but, please, no root canal!"
3375,3509,0,0,7,7,1.0,0.1543033499620919,508,Got another complaint about you being a predator...
3384,3509,0,0,7,7,1.0,0.1543033499620919,508,"'Yeah but he hit me first.' Submitted by Douglas Monaghan, Floral Park, NY"
3241,3509,0,0,7,7,1.0,0.1543033499620919,508,Yeh...that's Fin. He sleeps with the fishes.
3325,3509,0,0,7,7,1.0,0.1543033499620919,508,"Since Jaws you cops blame everything on us, there are other fish in the ocean, too. I don't even like surfers, too sinewy."
3321,3509,0,0,7,7,1.0,0.1543033499620919,508,"I'm telling you, I haven't seen the final 30 seconds of the twelfth episode of Frasier's eleventh season because it's still broken on Netflix."
3245,3509,0,0,7,7,1.0,0.1543033499620919,508,Your warning is a bit late- Miranda and I split up months ago.
3252,3509,0,0,7,7,1.0,0.1543033499620919,508,"Get me back to water, please."
3256,3509,0,0,7,7,1.0,0.1543033499620919,508,"Don't ask me if it smells fishy, I´m on a strict plankton diet."
3259,3509,0,0,7,7,1.0,0.1543033499620919,508,"Yeah, I know him. That's Loan Shark."
3260,3509,0,0,7,7,1.0,0.1543033499620919,508,"Yeah I seen him, he swimming with the fishes ... the dead ones."
3261,3509,0,0,7,7,1.0,0.1543033499620919,508,You really think a Miranda warning is necessary?
3262,3509,0,0,7,7,1.0,0.1543033499620919,508,My PhD? That's the third degree. I'll beat the rap if it don't beat me. Innocent is my only plea. I'll be free by Discovery.
3264,3509,0,0,7,7,1.0,0.1543033499620919,508,"This gets out, I'm sushi."
3265,3509,0,0,8,8,1.0,0.1336306209562122,508,You didn't read me my Menhaden rights.
3267,3509,0,0,10,10,1.0,0.10540925533894598,508,"If I'm not her teenage dream, why did she let me cop a feel?"
3269,3509,0,0,7,7,1.0,0.1543033499620919,508,"You know, I honestly don't know how we are supposed to get information out of a shark... hell, how is he even in here?"
3270,3509,0,0,7,7,1.0,0.1543033499620919,508,"What's this, an excuse from your mother the day the dolphins disappeared?"
3271,3509,0,0,8,8,1.0,0.1336306209562122,508,"Of course, I did it---self-defense. He was a fin-eating man."
3272,3509,0,0,7,7,1.0,0.1543033499620919,508,Forget about me. Wait till my lawyer gets here.
3273,3509,0,0,7,7,1.0,0.1543033499620919,508,Jaws ? I don't know that guy !
3276,3509,0,0,7,7,1.0,0.1543033499620919,508,"It wasn't me, I was off chasing some school fish. Plus, I don't hang out at The Coast anymore. Talk to the hammerhead about that."
3277,3509,0,0,7,7,1.0,0.1543033499620919,508,"I told you, I didn't lend the clownfish money."
3317,3509,0,0,8,8,1.0,0.1336306209562122,508,I am no Loan Shark.I am just a fish out of water!
3315,3509,0,0,7,7,1.0,0.1543033499620919,508,"Ah, the first word I see is 'BUSTED'!!!"
3313,3509,0,0,7,7,1.0,0.1543033499620919,508,Let me put it this way...you can tell the guys over at StarKist they were wrong about Charlie.
3307,3509,0,0,7,7,1.0,0.1543033499620919,508,Shark see bit crutch.
3306,3509,0,0,8,8,1.0,0.1336306209562122,508,I told Shamu it was a bad idea.
3305,3509,0,0,7,7,1.0,0.1543033499620919,508,I didn't go crazy. I went shark!
3322,3509,0,0,7,7,1.0,0.1543033499620919,508,"I'm a loan shark, not a stool pigeon."
3303,3509,0,0,7,7,1.0,0.1543033499620919,508,We found this imprint of your dorsal fin at the scene of the crime.
3295,3509,0,0,7,7,1.0,0.1543033499620919,508,1. Are you the grouper who groped her? 2. Something is fishy about your story Sharky!
3290,3509,0,0,7,7,1.0,0.1543033499620919,508,"Yeah, I ate that one, too. So what?"
3286,3509,0,0,7,7,1.0,0.1543033499620919,508,That's not me. I gave up man-eating for Lent!
3285,3509,0,0,8,8,1.0,0.1336306209562122,508,"No, the guy I saw had didn't have an overbite."
3281,3509,0,0,7,7,1.0,0.1543033499620919,508,"Love to help but I'm more of a smell-y, taste-y kind of guy."
3279,3509,0,0,9,9,1.0,0.11785113019775792,508,"There's blood on yer teeth,scum. Cough 'im up."
3296,3509,0,0,7,7,1.0,0.1543033499620919,508,I tell you it's not a Great White. It's cold blooded. Try Wall Street.
3402,3509,0,0,7,7,1.0,0.1543033499620919,508,You loan all that money because you just can't say no?
3119,3509,0,0,7,7,1.0,0.1543033499620919,508,Loan shark? Me? That's just species profiling!
3116,3509,0,0,7,7,1.0,0.1543033499620919,508,is this the hand you played five finger poker with at the casino?
2926,3509,0,0,7,7,1.0,0.1543033499620919,508,I've never been to the Ease Coast.
2927,3509,0,0,7,7,1.0,0.1543033499620919,508,I'm not saying one more word until I see my pilot fish.
2929,3509,0,0,7,7,1.0,0.1543033499620919,508,These octopuses all look the same to me.
2932,3509,0,0,8,8,1.0,0.1336306209562122,508,Give me a break! You can't call that loan usurious.
2934,3509,0,0,8,8,1.0,0.1336306209562122,508,I want my lawyer right now!
2935,3509,0,0,7,7,1.0,0.1543033499620919,508,"He's a liar, too. I don't even play cards."
2936,3509,0,0,7,7,1.0,0.1543033499620919,508,"I have the tuna on rye, no tomato."
2938,3509,0,0,8,8,1.0,0.1336306209562122,508,I'm not lying. He did say 'seize and dissect'.
2939,3509,0,0,7,7,1.0,0.1543033499620919,508,C'mon man... I did'nt do that. I said he was 'a' chum.
2940,3509,0,0,9,9,1.0,0.11785113019775792,508,Gee whiz! I'm just handing you a letter. So don't bit my head off!
2942,3509,0,0,7,7,1.0,0.1543033499620919,508,I don't care! There's no sea jail!
2943,3509,0,0,7,7,1.0,0.1543033499620919,508,Is that a menu? cuz I had that yesterday.
2944,3509,0,0,8,8,1.0,0.1336306209562122,508,"Like I keep tellin' ya, I'm a stock broker not a card shark."
2945,3509,0,0,7,7,1.0,0.1543033499620919,508,I'm a smiley shark. I don't do mean things...I'm telling you.
2946,3509,0,0,7,7,1.0,0.1543033499620919,508,We have to listen to Mr. Trump. You are under arrest for giving your gun back to the shop.
2947,3509,0,0,7,7,1.0,0.1543033499620919,508,"Yeah, that's the guy who was after my fin. Thankfully, the Soup Nazi intervened and took the guy out with his ladle. My hero's parting words were 'No soup for you!'"
2949,3509,0,0,7,7,1.0,0.1543033499620919,508,Again! I never saw that surf board in the 9th ward.
2973,3509,0,0,7,7,1.0,0.1543033499620919,508,"Don't ask the lawyer, ask my client"
2971,3509,0,0,7,7,1.0,0.1543033499620919,508,You've made a terrible mistake ... I'm the attorney.
2968,3509,0,0,7,7,1.0,0.1543033499620919,508,"Yes, it is 'lent' money; I'm very familiar with it."
2965,3509,0,0,9,9,1.0,0.11785113019775792,508,"I told you I'm a Mark!' 'Lol no, you're totally a Laurie.' 'Rofl, Laurie."
2964,3509,0,0,7,7,1.0,0.1543033499620919,508,"Yeah, I loaned him some money, but at a very reasonable rate."
2963,3509,0,0,7,7,1.0,0.1543033499620919,508,"Sure, I knew The Minnow. He used to hang around at The Reef."
2924,3509,0,0,7,7,1.0,0.1543033499620919,508,Looks like a Dolphinado to me.
2961,3509,0,0,7,7,1.0,0.1543033499620919,508,"Lookadiss, and tell me again how you don't like anchovies."
2957,3509,0,0,7,7,1.0,0.1543033499620919,508,Is this the person you ate?dmwhite
2956,3509,0,0,7,7,1.0,0.1543033499620919,508,"Sharks can't read, you idiot!"
2955,3509,0,0,7,7,1.0,0.1543033499620919,508,"I'm no snitch, I'm a shark !"
2953,3509,0,0,7,7,1.0,0.1543033499620919,508,"So, you're saying she was jail bait???"
2952,3509,0,0,7,7,1.0,0.1543033499620919,508,I have never seen this John Dory guy in my life.
2951,3509,0,0,8,8,1.0,0.1336306209562122,508,Stop circling around the subject !
2958,3509,0,0,7,7,1.0,0.1543033499620919,508,Why would I know anything about cement blocks with shoes stuck in them?
2974,3509,0,0,7,7,1.0,0.1543033499620919,508,I want to talk to my lawboster!
2920,3509,0,0,7,7,1.0,0.1543033499620919,508,"Yeah it's Mark Cuban, he gave me gas!"
2915,3509,0,0,7,7,1.0,0.1543033499620919,508,Let's just say he's not swimmin with the fishes.
2856,3509,0,0,7,7,1.0,0.1543033499620919,508,"I already told you, I stick to white-belly crime."
2860,3509,0,0,7,7,1.0,0.1543033499620919,508,"I don't recognize him, but then I only had his leg"
2861,3509,0,0,6,6,1.0,0.18257418583505536,508,"I have never seen that surfer in my life, I swear!"
2865,3509,0,0,7,7,1.0,0.1543033499620919,508,I'm vintage Shark..need my glasses
2868,3509,0,0,7,7,1.0,0.1543033499620919,508,Recognize him? Stop acting like a fish out of water.
2872,3509,0,0,7,7,1.0,0.1543033499620919,508,That could be any shark. I'm not the only one who likes eating people.
2874,3509,0,0,8,8,1.0,0.1336306209562122,508,I didn't know I was illegally swimming on 42nd Street.
2875,3509,0,0,7,7,1.0,0.1543033499620919,508,"Tell the truth did you kinda see , but still eat this man?"
2877,3509,0,0,8,8,1.0,0.1336306209562122,508,"YES!!! I saw 'Making a Murderer', but you still don't scare me!"
2878,3509,0,0,7,7,1.0,0.1543033499620919,508,Is 'up the river' salt water?
2879,3509,0,0,7,7,1.0,0.1543033499620919,508,"No, that's not him, I ate a blonde."
2880,3509,0,0,7,7,1.0,0.1543033499620919,508,I've never eaten anybody like that dude.
2881,3509,0,0,7,7,1.0,0.1543033499620919,508,I've turned vegan since then.
2882,3509,0,0,7,7,1.0,0.1543033499620919,508,"My God, my confession has been salted!"
2884,3509,0,0,7,7,1.0,0.1543033499620919,508,What feeding frenzy? I was home watching Better Call Saul.
2885,3509,0,0,7,7,1.0,0.1543033499620919,508,"I keep telling ya, I didn't see his face. Just his legs and torso."
2886,3509,0,0,9,9,1.0,0.11785113019775792,508,There's something fishy about your story.
2914,3509,0,0,7,7,1.0,0.1543033499620919,508,You've got the wrong guy. I'm Al Sharkton.
2913,3509,0,0,7,7,1.0,0.1543033499620919,508,"Yeah I know him, an old chum of mine."
2912,3509,0,0,7,7,1.0,0.1543033499620919,508,I never signed that confession!
2907,3509,0,0,7,7,1.0,0.1543033499620919,508,"I didn't break in, a tornado dropped me in that swimming pool."
2906,3509,0,0,7,7,1.0,0.1543033499620919,508,Perhaps *this* will refresh your memory.
2903,3509,0,0,7,7,1.0,0.1543033499620919,508,"Look, all I saw was a silhouette."
2917,3509,0,0,7,7,1.0,0.1543033499620919,508,Come on! Admit it! This is the guy you ate.
2901,3509,0,0,7,7,1.0,0.1543033499620919,508,"You're in deep water this time, sea."
2895,3509,0,0,7,7,1.0,0.1543033499620919,508,Yes I do recognize it but how was I expected to know it was your rubber ducky.
2893,3509,0,0,7,7,1.0,0.1543033499620919,508,Are you out of your mind?
2891,3509,0,0,7,7,1.0,0.1543033499620919,508,"Alright, chum, I'll tell ya what I know."
2890,3509,0,0,7,7,1.0,0.1543033499620919,508,"It's a boating accident, I tells ya!"
2888,3509,0,0,7,7,1.0,0.1543033499620919,508,"Yea, I texted her about a 'candy gram,' but I hardly think that allows you to hold me on suspicion of murder."
2887,3509,0,0,7,7,1.0,0.1543033499620919,508,"Yes, and we made some Mary McFinn soup..!"
2900,3509,0,0,8,8,1.0,0.1336306209562122,508,"I don't remember when I ate him, but it looks like Robert Shaw."
3117,3509,0,0,7,7,1.0,0.1543033499620919,508,Maria?
2975,3509,0,0,7,7,1.0,0.1543033499620919,508,He had a bigger boat.
2983,3509,0,0,7,7,1.0,0.1543033499620919,508,"Yes, that is the lawyer that tried to intimidate me."
3058,3509,0,0,7,7,1.0,0.1543033499620919,508,I don't recognize any of those body parts.
3059,3509,0,0,7,7,1.0,0.1543033499620919,508,What do you got against 'sleeping with the fishes?'
3060,3509,0,0,7,7,1.0,0.1543033499620919,508,"I already told you, 'E F P T O Z ... '"
3061,3509,0,0,7,7,1.0,0.1543033499620919,508,"The sucker didn't pay up. So yeah, I put the bite on him."
3063,3509,0,0,7,7,1.0,0.1543033499620919,508,How should I know if it's him? Youz guys all look the same from the trunks down.
3066,3509,0,0,7,7,1.0,0.1543033499620919,508,You sure you were just minding you own business and THIS guy came out the water and bit you?
3069,3509,0,0,7,7,1.0,0.1543033499620919,508,How would I know? All dolphins look the same.
3070,3509,0,0,7,7,1.0,0.1543033499620919,508,I swear he was already sleeping when he joined us.
3071,3509,0,0,7,7,1.0,0.1543033499620919,508,"I know we look alike, but I promise we're not related."
3072,3509,0,0,7,7,1.0,0.1543033499620919,508,"I don't like this 'Good carp, bad carp' routine."
3074,3509,0,0,7,7,1.0,0.1543033499620919,508,"Look how many times can I tell you, I don't know this Spielberg guy and I've never met any Captain Quint"
3075,3509,0,0,7,7,1.0,0.1543033499620919,508,It was not a bait and switch
3076,3509,0,0,8,8,1.0,0.1336306209562122,508,He wouldn't shut up about the U.S.S. Indianapolis.
3077,3509,0,0,7,7,1.0,0.1543033499620919,508,You won't get a nibble out of me
3081,3509,0,0,7,7,1.0,0.1543033499620919,508,"Alright, no more fishy business."
3083,3509,0,0,7,7,1.0,0.1543033499620919,508,"Yeah, he came down, he fell asleep. So what?"
3088,3509,0,0,7,7,1.0,0.1543033499620919,508,I only confessed for the halibut
3115,3509,0,0,7,7,1.0,0.1543033499620919,508,You think those kids out there like watching a shark interrogation?
3113,3509,0,0,7,7,1.0,0.1543033499620919,508,"Yeah, I had him on the hook for some dough, so what?"
3110,3509,0,0,8,8,1.0,0.1336306209562122,508,I didn't do it. That's not my blood type.
3109,3509,0,0,7,7,1.0,0.1543033499620919,508,"' I never ate him before in my life..!' Submitted by Neil L. Sachs Monmouth Junction, New Jersey"
3107,3509,0,0,7,7,1.0,0.1543033499620919,508,"There was a sexy mermaid, a middle aged writer and a peach. I dared to eat the peach. I never touched the girl."
3106,3509,0,0,7,7,1.0,0.1543033499620919,508,Nope. Dolphin.
3057,3509,0,0,8,8,1.0,0.1336306209562122,508,I am really starting to regret this trip to Manitowoc County.
3105,3509,0,0,7,7,1.0,0.1543033499620919,508,"I only read sonar, stupid."
3098,3509,0,0,8,8,1.0,0.1336306209562122,508,Is this your homework Larry?
3096,3509,0,0,8,8,1.0,0.1336306209562122,508,You could at least offer me a cup of coffee first.
3094,3509,0,0,7,7,1.0,0.1543033499620919,508,"I'm gonna need to speak to my lawyer, officer... Yeah, he is Jewish, what does that matter?"
3092,3509,0,0,7,7,1.0,0.1543033499620919,508,Candygram?
3091,3509,0,0,7,7,1.0,0.1543033499620919,508,"No, that's a hammerhead. Do I look like a hammerhead to you, flatfoot?"
3090,3509,0,0,7,7,1.0,0.1543033499620919,508,"Maybe, maybe not. Ya meet a lot of skirts at a feeding frenzy."
3100,3509,0,0,7,7,1.0,0.1543033499620919,508,"I've been framed, I tell ya!' I swear it was the Killer Whale!"
2980,3509,0,0,9,9,1.0,0.11785113019775792,508,"No, I don't think 25% daily interest is loan sharking."
3055,3509,0,0,7,7,1.0,0.1543033499620919,508,You sure Shark bait was the guy who bit you
3045,3509,0,0,7,7,1.0,0.1543033499620919,508,Western Union.
2984,3509,0,0,7,7,1.0,0.1543033499620919,508,"Unless you're with the Coast Guard, I ain't sayin' nothin'."
2986,3509,0,0,8,8,1.0,0.1336306209562122,508,"Yes, this is a restraining order from the Shark Tank producers. Cuban, O'Leary and the rest of the 'sharks' have no idea who you are and you are just a little too creepy."
2988,3509,0,0,7,7,1.0,0.1543033499620919,508,"I keep telling you, I don't know anyone named Jaws"
2989,3509,0,0,7,7,1.0,0.1543033499620919,508,"Yeah, he came to me for a loan once. But I swear, his shoes were leather last time I saw him."
2992,3509,0,0,7,7,1.0,0.1543033499620919,508,"Yeah, I saw him. He should've gotten a bigger boat."
2996,3509,0,0,7,7,1.0,0.1543033499620919,508,"Ok...so maybe I did take a bite out of that surfer, but I have affluenza!"
2997,3509,0,0,7,7,1.0,0.1543033499620919,508,He was way too salty.
2999,3509,0,0,7,7,1.0,0.1543033499620919,508,Mark Cuban? Never heard of the guy!
3002,3509,0,0,7,7,1.0,0.1543033499620919,508,"For the last time, the signature on that loan isn't mine!"
3003,3509,0,0,7,7,1.0,0.1543033499620919,508,"Hey, self-defense, OK? They were trying to take my fins."
3004,3509,0,0,7,7,1.0,0.1543033499620919,508,"Mr. Mako, do you realize that you’re not allowed to go over 50 mph during the nighttime?"
3005,3509,0,0,8,8,1.0,0.1336306209562122,508,"If you don't stop grilling me, I'm pleading the fish."
3006,3509,0,0,7,7,1.0,0.1543033499620919,508,I don't see what me being a great white supremacist has to do with any of this.
3007,3509,0,0,7,7,1.0,0.1543033499620919,508,"Yeah, that's the tuna. He confessed to me in the net."
3009,3509,0,0,7,7,1.0,0.1543033499620919,508,How should I know? I only saw him from the head down.
3011,3509,0,0,7,7,1.0,0.1543033499620919,508,"No, that lawyer is not my brother."
3015,3509,0,0,7,7,1.0,0.1543033499620919,508,"Sure I know him, he lives in a pineapple under the sea."
3043,3509,0,0,8,8,1.0,0.1336306209562122,508,You want to take this to the water officer.
3041,3509,0,0,7,7,1.0,0.1543033499620919,508,"After the SNL gig ended, I was desperate."
3040,3509,0,0,7,7,1.0,0.1543033499620919,508,My eyesight ain't so great. Got a scratch and sniff?
3036,3509,0,0,7,7,1.0,0.1543033499620919,508,Your fin-gerprints are all over it!
3034,3509,0,0,7,7,1.0,0.1543033499620919,508,"No, I don't recognize that little boat."
3033,3509,0,0,7,7,1.0,0.1543033499620919,508,"Look, I feel for 'Blackfish' and all... but you can't just dump those things where my kids play."
3049,3509,0,0,8,8,1.0,0.1336306209562122,508,Is this for a coloring contest?
3030,3509,0,0,7,7,1.0,0.1543033499620919,508,I will never return to Manitowoc County.
3028,3509,0,0,7,7,1.0,0.1543033499620919,508,I'd bottom-feed before I would eat that one.
3026,3509,0,0,7,7,1.0,0.1543033499620919,508,"I keep trying to tell ya: that guy's fresh water, I'm salt water."
3023,3509,0,0,7,7,1.0,0.1543033499620919,508,"If I say anything, I'll be in really deep water. You have to throw me a line here!"
3021,3509,0,0,7,7,1.0,0.1543033499620919,508,"Well, from my angle he looked like a seal!"
3018,3509,0,0,7,7,1.0,0.1543033499620919,508,It was self defense; he said he was Mack The Knife.
3017,3509,0,0,8,8,1.0,0.1336306209562122,508,IT SAY'S 'HE'S A SHARK'
3029,3509,0,0,7,7,1.0,0.1543033499620919,508,I Can't Read Cursive Writing
6776,3509,0,0,7,7,1.0,0.1543033499620919,508,And the name Nemo means nothing to you?
