rank,funny,somewhat_funny,unfunny,count,score,precision,contest,caption
1,45,47,81,173,1.7919075144508672,0.06310848986854366,526,Hey! My eyes are down here.
2,39,31,73,143,1.7622377622377623,0.07153674823941573,526,"It autocorrected to ""hula""."
3,34,44,69,147,1.7619047619047619,0.06641458257644059,526,"Excuse me, Miss, my eyes are down here."
4,29,57,65,151,1.7615894039735098,0.0614099310097688,526,Good Samaritan? I was a GREAT Samaritan.
5,38,33,77,148,1.7364864864864864,0.06937954643913878,526,My eyes are down here.
6,31,41,72,144,1.7152777777777777,0.06659611246505957,526,"Next time, wash it in cold water."
7,31,34,71,136,1.7058823529411764,0.07010546603556363,526,"I was cleaning the kitchen, without being asked, and that's all I remember."
8,39,20,82,141,1.6950354609929077,0.07392818225031382,526,It was autocorrected to 'hula.'
9,25,40,66,131,1.6870229007633588,0.0677496422870509,526,It's only dangerous if it lasts longer than 4 hours.
10,23,43,64,130,1.6846153846153846,0.06645878326407736,526,"If it last longer than 4 hours, I'm supposed to contact my theologian right away."
11,27,28,68,123,1.6666666666666667,0.07362101738323103,526,You didn't see the bonus questions at the end?
12,23,38,66,127,1.6614173228346456,0.06820540710180807,526,If it lasts more than 4 hours I'm supposed to call a doctor.
13,26,25,66,117,1.6581196581196582,0.07596747365226998,526,Excuse me. My eyes are down here!
14,21,37,63,121,1.6528925619834711,0.06914545673835334,526,"Pleased to meet you, obviously."
15,26,22,66,114,1.6491228070175439,0.07779612221063721,526,Actually it's kind of embarrassing. I almost wish I hadn't cured cancer.
16,17,41,58,116,1.646551724137931,0.06734893178379245,526,"What I actually said before I died was "" I hope St Peter gives me a big hello!"""
17,22,27,61,110,1.6454545454545455,0.07595526056436189,526,It's not funny. I've been dunked on twice today.
18,22,31,64,117,1.641025641025641,0.07228894038567361,526,I let my mother-in-law move in with us.
19,20,28,59,107,1.6355140186915889,0.07557750778761299,526,I taught my mother how to use a computer.
20,15,37,54,106,1.6320754716981132,0.07007308685870156,526,"If I hold my head just right, I can pick up basic cable."
21,22,28,64,114,1.631578947368421,0.07399186112203117,526,I once won The New Yorker caption contest.
22,14,39,54,107,1.6261682242990654,0.06838872122114123,526,"Thanks, I've been working out."
23,17,32,57,106,1.6226415094339623,0.0727496540423711,526,"Actually, I do think I'm too good for you."
24,26,27,75,128,1.6171875,0.07112798101878792,526,Remember all those times you said I was wrong?
25,22,19,63,104,1.6057692307692308,0.08016304943157422,526,"Still, I'd gladly give it up to have genitals again."
26,18,28,60,106,1.6037735849056605,0.07424885341973538,526,It's God's little joke with us atheists.
27,14,34,55,103,1.6019417475728155,0.07081130270752692,526,It's a little cumbersome but I get great Wi-Fi.
28,16,28,56,100,1.6,0.0752101433090355,526,"Ironically, it's for being so humble."
29,21,18,63,102,1.588235294117647,0.08046764547235495,526,My face is down here.
29,14,32,56,102,1.588235294117647,0.07152679597542662,526,It seems to happen when I'm spiritually aroused.
31,13,31,53,97,1.5876288659793814,0.07291279172755583,526,If it lasts more than 4 hours I am calling the doctor.
32,13,32,54,99,1.5858585858585859,0.07180291662121055,526,A disappointing reward for a life of abstinence.
33,19,18,60,97,1.577319587628866,0.08137965672086053,526,"My eyes are down here, Missy."
33,15,26,56,97,1.577319587628866,0.07591799522376418,526,I'm just glad to see you.
35,15,28,58,101,1.5742574257425743,0.07358773931113681,526,"As a matter of fact, I am holier than thou."
36,15,24,56,95,1.568421052631579,0.07726082057667276,526,I won the 'Holier Than Thou' contest.
37,16,23,58,97,1.5670103092783505,0.07741975184471354,526,I'm the guy who always left the toilet seat down.
38,12,31,55,98,1.5612244897959184,0.07115755141972316,526,"Well, yeah . . . as a matter of fact I am holier than thou."
39,12,28,53,93,1.5591397849462365,0.07405689660259941,526,I liked God on Facebook.
40,16,21,58,95,1.5578947368421052,0.07878669727256324,526,"Yes, I am happy to see you. Why do you ask?"
41,14,21,53,88,1.5568181818181819,0.08058361206408741,526,I won the cartoon caption contest.
42,14,26,58,98,1.5510204081632653,0.07413495660187752,526,they thought it would be funny because I fell down a manhole
43,11,28,52,91,1.5494505494505495,0.07373472609574289,526,The downside is that I didn't have much fun.
44,15,21,57,93,1.5483870967741935,0.07872898850314831,526,I took out the trash AND made the bed.
45,15,18,55,88,1.5454545454545454,0.08226973963643078,526,Sometimes I regret being the virgin Larry.
46,18,13,60,91,1.5384615384615385,0.08459873296027594,526,"I got God tickets to ""Hamilton""."
46,12,25,54,91,1.5384615384615385,0.07544364885981202,526,I'm just happy to see you.
48,10,30,53,93,1.5376344086021505,0.07098969725693105,526,"I used to be humble, but what's the point."
48,12,26,55,93,1.5376344086021505,0.07420946905903518,526,"It was more expensive, but the WiFi connection is incomparable."
48,18,14,61,93,1.5376344086021505,0.08312382235077632,526,I never removed a mattress tag.
51,14,23,58,95,1.5368421052631578,0.07603047411043738,526,...and then I donated my Prius to an orphanage.
52,13,21,54,88,1.5340909090909092,0.07909635876443342,526,They took into consideration that I had you for a wife.
53,7,35,50,92,1.5326086956521738,0.06639132953546928,526,Do you think it makes me look slimmer?
53,11,27,54,92,1.5326086956521738,0.07323506544302909,526,I was a public school teacher for 30 years.
55,12,19,50,81,1.5308641975308641,0.0825638917450504,526,"Well yes, I actually am holier than thou."
56,10,24,49,83,1.5301204819277108,0.07730653365803622,526,"It was the small things, like putting the toilet seat down every time."
57,11,23,51,85,1.5294117647058822,0.0777632608128404,526,It's not an attitude. I am holier than thou.
58,14,19,56,89,1.5280898876404494,0.08004385870098318,526,Your halo looks much smaller than it appeared in your profile picture.
59,15,18,58,91,1.5274725274725274,0.08020221595058614,526,I stopped Trump.
60,13,17,52,82,1.524390243902439,0.08362750202823561,526,Ahem...excuse me...my eyes are down here.
61,9,26,49,84,1.5238095238095237,0.07474606173786966,526,I fell into a manhole while texting. It's just His sense of humor.
62,15,15,56,86,1.5232558139534884,0.08389744274443134,526,What makes you think I'm a virgin?
62,12,21,53,86,1.5232558139534884,0.078854216535342,526,It's been four hours. I'm calling the doctor.
64,13,21,56,90,1.5222222222222221,0.07777777777777778,526,It's been like this for 4 hours.
64,13,21,56,90,1.5222222222222221,0.07777777777777778,526,It's been like this for four hours. I should find a doctor.
66,11,26,55,92,1.5217391304347827,0.07327937246229366,526,I always put the seat down after I used the toilet.
67,13,18,54,85,1.5176470588235293,0.08132613167687534,526,"I could've gotten it in platinum, but I didn't want to draw attention to myself."
68,13,19,55,87,1.5172413793103448,0.07986568008385839,526,"My dear wife, I have your Mother to thank for this. By the way, I haven't seen her here."
69,9,28,52,89,1.5168539325842696,0.07166550583722592,526,I taught junior high.
70,10,22,50,82,1.5121951219512195,0.07807512352784789,526,"We were both good, I was just better."
70,14,14,54,82,1.5121951219512195,0.08544109902674497,526,"Why, yes! I AM happy to see you ..."
72,11,22,53,86,1.5116279069767442,0.07713080907803256,526,Sorry. Happens every time it meets a cute halo.
72,9,26,51,86,1.5116279069767442,0.0734980685909289,526,My therapist says I'm going through a mid-eternity crisis.
74,14,17,57,88,1.5113636363636365,0.08080433910267965,526,...so then He asked if I'd like to super-size it for a dollar more.
74,9,27,52,88,1.5113636363636365,0.07227154432106937,526,"It's a blessing and a curse, really."
76,12,22,56,90,1.511111111111111,0.07618304464083643,526,"Oh, come on, everybody's getting haloplasty these days."
77,10,20,49,79,1.5063291139240507,0.08031384745683663,526,How did you know I was in advertising?
77,11,18,50,79,1.5063291139240507,0.0823096837446429,526,Arousal's a funny thing up here in heaven.
77,10,20,49,79,1.5063291139240507,0.08031384745683663,526,"You were the one who ate the apple, not me."
80,9,23,49,81,1.5061728395061729,0.07682643736652875,526,Sometimes a halo is just a halo.
80,11,19,51,81,1.5061728395061729,0.08074394979842421,526,"Why, yes, I am happy to see you. Why do you ask?"
80,9,23,49,81,1.5061728395061729,0.07682643736652875,526,Let’s just say St. Peter and I go way back.
83,15,12,56,83,1.5060240963855422,0.08634936788470794,526,"Actually, it's pronounced 'big halo', not 'big a-hole'."
84,8,27,50,85,1.5058823529411764,0.07222655263306024,526,I was having a bit of a mid-afterlife crisis.
85,12,20,55,87,1.5057471264367817,0.07819393299364331,526,"Yea, I know! The worst one I've been called is ""Sir Cumference""."
85,10,24,53,87,1.5057471264367817,0.07469722045893348,526,"Hey, you had me at halo."
87,13,16,55,84,1.5,0.08210511992046739,526,It’s from the ‘Holier than Thou’ collection.
87,10,21,51,82,1.5,0.07808688094430304,526,I need it to get FM radio.
87,10,23,53,86,1.5,0.07534689497758576,526,I saved a bus full of nuns.
87,10,21,51,82,1.5,0.07808688094430304,526,"If you are looking for equality, go to Hell."
87,12,16,52,80,1.5,0.08343875188697214,526,I never left the seat up.
87,10,22,52,84,1.5,0.0766854974504289,526,"Apparently, I'm holier than thou."
93,10,22,53,85,1.4941176470588236,0.0760059142099618,526,I wouldn't get too excited. Sometimes a halo is just a halo.
94,10,20,51,81,1.4938271604938271,0.07880953910372657,526,I always put the seat down.
94,15,10,56,81,1.4938271604938271,0.08805767047955003,526,Wait till you see my harp.
94,9,22,50,81,1.4938271604938271,0.07682643736652875,526,It means I'm happy to see you!
94,7,26,48,81,1.4938271604938271,0.0726981260268508,526,"Well,after all,we did live with your mother for 20 years."
94,13,14,54,81,1.4938271604938271,0.08447999396110142,526,I died in Texas.
99,12,15,52,79,1.4936708860759493,0.0842582576544652,526,If it lasts longer than 24 hours I'm supposed to call my doctor.
99,8,23,48,79,1.4936708860759493,0.07616543969330056,526,"Well, I did put the seat down every single time."
101,11,16,50,77,1.4935064935064934,0.08395425760242932,526,I finally found a use for all those unused airline miles.
101,10,18,49,77,1.4935064935064934,0.08189355206557367,526,"If we haven't met before, it's likely because we travel in different circles."
101,12,14,51,77,1.4935064935064934,0.08596557956085271,526,You bet this is incredible; I was a lawyer!
104,8,25,51,84,1.4880952380952381,0.0728370410135986,526,"I used to think I deserved it, but now it's just ironic."
104,10,21,53,84,1.4880952380952381,0.0766743634398511,526,"When I was good, I was really good."
106,10,19,51,80,1.4875,0.07954329686371674,526,Circumference matters.
107,11,15,50,76,1.486842105263158,0.08479784226945246,526,THEY SAY IF IT LASTS FOR MORE THAN FOUR HOURS I SHOULD CONSULT A DOCTOR.
108,9,22,52,83,1.4819277108433735,0.07542892489154675,526,"I had just finished washing the dishes, folding the laundry, and cleaning all three bathrooms when I got hit by lightning."
108,10,20,53,83,1.4819277108433735,0.0773523178099076,526,"You know, in retrospect, I wish I'd been a little less good..."
110,11,17,53,81,1.4814814814814814,0.08072035080630878,526,"I can get NPR, BBC, and wi-fi."
110,9,21,51,81,1.4814814814814814,0.07680163464195452,526,I invented ice cream.
112,12,14,53,79,1.481012658227848,0.08423387384331807,526,"Apparently God has a sense of humor, I was an atheist before I landed here."
112,10,18,51,79,1.481012658227848,0.08028826572423771,526,I drove a Prius and I didn't talk about it much.
112,5,28,46,79,1.481012658227848,0.06945038436819669,526,"Sure, but try parking it."
115,10,17,50,77,1.4805194805194806,0.08186644845666796,526,He said to only contact Him if it lasts more than 4 hours.
115,12,13,52,77,1.4805194805194806,0.085939760194131,526,The last thing I remember is shopping at Costco.
117,10,19,53,82,1.475609756097561,0.07803984065030856,526,"So, what is a bad girl like you doing in a place like this?"
117,7,25,50,82,1.475609756097561,0.07201995808085804,526,I used my miles to upgrade
119,10,18,52,80,1.475,0.07950599053936482,526,I won it from Saint Francis in a poker game.
120,6,25,47,78,1.4743589743589745,0.07236170793090994,526,I also have great WiFi.
120,6,25,47,78,1.4743589743589745,0.07236170793090994,526,"It used to fit better, before the diet."
120,11,15,52,78,1.4743589743589745,0.08307357245044888,526,I didn't realize the unequal compensation between men and women extended this far.
120,11,15,52,78,1.4743589743589745,0.08307357245044888,526,I abstained from all social media.
124,9,18,49,76,1.4736842105263157,0.08051083442514924,526,That's right...you do the same amount of work but you get a smaller halo.
124,10,16,50,76,1.4736842105263157,0.08266118589045436,526,Heaven isn’t fair either.
126,9,20,52,81,1.4691358024691359,0.07675200514750397,526,"It's a curse, really."
126,8,22,51,81,1.4691358024691359,0.07471431133895187,526,You know what they say about a man and the size of his halo...
128,9,19,51,79,1.4683544303797469,0.07818835404044687,526,I'm from Texas.
128,8,21,50,79,1.4683544303797469,0.07608448437579868,526,"Why yes, my Father does work here. Why do you ask?"
130,8,20,49,77,1.4675324675324675,0.0775223284581591,526,"Yeah, I work out."
130,7,22,48,77,1.4675324675324675,0.07528577495062708,526,"If it lasts over four hours, I need to call my doctor."
132,9,16,48,73,1.4657534246575343,0.08294932476979429,526,But enough about me...
133,8,22,52,82,1.4634146341463414,0.0740189717276296,526,Every Bernie voter gets one.
134,8,21,51,80,1.4625,0.07535517167875191,526,...and I only ever used the left lane for passing.
134,8,21,51,80,1.4625,0.07535517167875191,526,"You say goodbye, I say Halo."
134,9,19,52,80,1.4625,0.0774264657267572,526,"It's not the size, it's how piously you use it."
134,9,19,52,80,1.4625,0.0774264657267572,526,"""I find the new model gives me exceptional wi-fi reception."
138,8,20,50,78,1.4615384615384615,0.07675639617050044,526,"The reception is unbelievable, I can even pick up Philadelphia channels."
138,12,12,54,78,1.4615384615384615,0.08499144477583698,526,"Jealousy is a sin, Margaret."
138,9,18,51,78,1.4615384615384615,0.07889578370282628,526,You should have seen it before I learned humility.
141,6,22,46,74,1.4594594594594594,0.07499028491734214,526,"Really, this only happens when you're around"
142,9,18,52,79,1.4556962025316456,0.07810949536779516,526,I was an atheist.
142,7,22,50,79,1.4556962025316456,0.07383734405411257,526,I try to not let it get to my head.
144,9,17,51,77,1.4545454545454546,0.07961255835738038,526,"Why yes, I am from Texas."
145,8,18,49,75,1.4533333333333334,0.07894195229300978,526,My halo is evidently excited to meet you.
145,8,18,49,75,1.4533333333333334,0.07894195229300978,526,If this lasts more than four hours I have to go to the E.R.
145,8,18,49,75,1.4533333333333334,0.07894195229300978,526,What can I say? I'm holier than thou.
148,10,13,50,73,1.452054794520548,0.08512032822971347,526,I'm too good for you.
148,10,13,50,73,1.452054794520548,0.08512032822971347,526,I died in a hula hoop accident. God thinks this is funny!
148,7,19,47,73,1.452054794520548,0.07812757366332727,526,I work out.
151,6,23,49,78,1.4487179487179487,0.07218449531892232,526,The swelling's supposed to go down in a couple of days.
151,6,23,49,78,1.4487179487179487,0.07218449531892232,526,"Now that you mention it, yes, I AM holier than thou."
151,7,21,50,78,1.4487179487179487,0.074455367150044,526,"As a matter a fact, I did die a virgin, why do you ask?"
151,11,13,54,78,1.4487179487179487,0.08291925608354904,526,"Believe you me, I'm no saint, but I do feel there's a lot hanging over my head."
151,6,23,49,78,1.4487179487179487,0.07218449531892232,526,I had enough points for an upgrade.
156,7,16,44,67,1.4477611940298507,0.08314156702361689,526,You have no idea how much pressure it puts on me.
157,6,22,48,76,1.4473684210526316,0.07349600023036285,526,The extra large comes with a heavy conscious
157,7,20,49,76,1.4473684210526316,0.0758454958639203,526,"I'm from Texas, you know."
157,3,28,45,76,1.4473684210526316,0.06594717940074561,526,It's a rental.
160,8,17,49,74,1.445945945945946,0.0796649125645988,526,I died at Costco.
160,9,15,50,74,1.445945945945946,0.08195566814364182,526,I've lost a lot of weight since I got here.
160,8,17,49,74,1.445945945945946,0.0796649125645988,526,I'm a bit concerned. It's been that way longer than four hours.
160,13,7,54,74,1.445945945945946,0.09054095497979381,526,It lasted more than four hours. Do you think I should call a doctor?
164,8,18,51,77,1.4415584415584415,0.07732167872281914,526,That's what I get for ordering online.
164,9,16,52,77,1.4415584415584415,0.07950097798249464,526,I know. I had you at 'halo.'
164,10,14,53,77,1.4415584415584415,0.08162211097387359,526,Simple: I'm just holier than thou.
167,6,21,48,75,1.44,0.07410729985562751,526,"Regretfully, celibacy."
167,10,13,52,75,1.44,0.0832666399786453,526,I got the ring. She got everything else.
167,7,19,49,75,1.44,0.07650001472060153,526,Masters of Sainthood with a minor in compassion.
167,8,17,50,75,1.44,0.07882012821997063,526,I guess I'm just Holier than Thou...
167,9,15,51,75,1.44,0.08107387355352506,526,It's a hallehulahoop.
172,6,17,43,66,1.4393939393939394,0.08115939561097288,526,"Obviously, you had more fun down there than I did."
173,7,18,48,73,1.4383561643835616,0.07799402215771106,526,My trouble is getting close to people.
173,6,20,47,73,1.4383561643835616,0.07551523017598734,526,You get it when you reach Platinum Level.
175,9,13,49,71,1.4366197183098592,0.08447350105662399,526,"It's been over four hours, I better go call my doctor."
175,10,11,50,71,1.4366197183098592,0.08682273243618277,526,I'm pretty blessed...you know...up there.
177,8,18,52,78,1.435897435897436,0.07653359048662939,526,Platinum Circle donor level.
178,6,18,45,69,1.434782608695652,0.07855868313763514,526,How did you know I was lying?
179,7,19,50,76,1.4342105263157894,0.07570841181516923,526,"Why yes, I am very happy to see you. How did you know?"
179,8,17,51,76,1.4342105263157894,0.07799128677331663,526,My wife thinks I'm having an afterlife crisis.
179,6,21,49,76,1.4342105263157894,0.07335452560403345,526,"Yeah, it's impressive. Until you have to go into a bathroom stall."
182,11,10,53,74,1.4324324324324325,0.08622461279023537,526,How did you know I thought you were hot?
182,12,8,54,74,1.4324324324324325,0.0883454418618844,526,I killed Trump.
182,7,18,49,74,1.4324324324324325,0.07716055250608123,526,Your profile picture had a much bigger halo
182,6,20,48,74,1.4324324324324325,0.07472293902208439,526,Costco. $3.99.
186,9,13,50,72,1.4305555555555556,0.08351245746119847,526,It's the new iHalo7.
186,8,15,49,72,1.4305555555555556,0.08113626959923176,526,It lasts for up to 4 hours.
188,7,16,47,70,1.4285714285714286,0.08029817251910724,526,"No, I don't think it makes you look fat."
188,6,21,50,77,1.4285714285714286,0.07261489217891637,526,It was my mistake. I gave them my head diameter in millimeters.
188,4,22,44,70,1.4285714285714286,0.07214957023478095,526,I always remembered to put the toilet seat down.
191,5,22,48,75,1.4266666666666667,0.07146682802186975,526,Viagra seems to work differently here
191,9,14,52,75,1.4266666666666667,0.08092557660560071,526,Mid after-life crisis?
191,4,24,47,75,1.4266666666666667,0.0688995438819964,526,"Even up here, it's Who you know."
191,9,14,52,75,1.4266666666666667,0.08092557660560071,526,"I'm humble now, but I used to have a really big head."
195,6,17,45,68,1.4264705882352942,0.0792750750236945,526,It was this or my own Cherub.
196,8,15,50,73,1.4246575342465753,0.08023417073427205,526,Let me just say I am very blessed.
196,5,21,47,73,1.4246575342465753,0.07277341301602387,526,"Why yes, as a matter of fact, I am from Texas."
196,5,21,47,73,1.4246575342465753,0.07277341301602387,526,"Oh, alright. It's a training halo."
196,9,13,51,73,1.4246575342465753,0.08257142155262615,526,"In hindsight, I wish I had more sex."
196,7,17,49,73,1.4246575342465753,0.07782676049798773,526,I'm afraid it wouldn't work out. I'm holier than thou.
201,9,12,50,71,1.4225352112676057,0.08430559490560932,526,I lost mine so God loaned me His.
201,6,18,47,71,1.4225352112676057,0.07681269342774091,526,I'm sure you'll fit in my circle.
203,5,19,45,69,1.4202898550724639,0.07559312809449362,526,Does it make me look holier than thou?
204,8,10,44,62,1.4193548387096775,0.09067695082711547,526,So embarrassed - but it's not you - I woke up with this...
205,8,15,51,74,1.4189189189189189,0.07935027897914199,526,You should see my harp.
205,11,9,54,74,1.4189189189189189,0.08606489711203047,526,Up here size does matter.
205,9,13,52,74,1.4189189189189189,0.08164986234534165,526,"You're the real angel, mine's just a hula hoop"
208,7,14,46,67,1.4179104477611941,0.08277539245066162,526,"Then autocorrect changed ""halo"" to ""hula."" You can guess the rest."
208,7,14,46,67,1.4179104477611941,0.08277539245066162,526,I lost a lot of weight.
210,4,22,46,72,1.4166666666666667,0.07062763560249007,526,"I lived a perfect life, and I all I got was this lousy big halo."
210,6,18,48,72,1.4166666666666667,0.07596535739570144,526,I'm to seek immediate divine intervention if it lasts more than four hours. . . .
210,9,12,51,72,1.4166666666666667,0.08333333333333333,526,It means exactly what you think it means.
210,7,16,49,72,1.4166666666666667,0.07849822820284491,526,I was canonized for inventing the hula hoop.
214,4,19,42,65,1.4153846153846155,0.0756138586589904,526,"I know it looks silly, but I get great cell phone reception."
215,8,13,49,70,1.4142857142857144,0.08263982352246951,526,"I was really, really good."
215,8,13,49,70,1.4142857142857144,0.08263982352246951,526,I feel much more confident since my halo enhancement surgery.
215,6,17,47,70,1.4142857142857144,0.07746730330874069,526,Can you tell I am happy to see you?
215,7,15,48,70,1.4142857142857144,0.08009532918264751,526,If it lasts more than four hours I'm going to seek immediate medical attention
219,9,10,49,68,1.411764705882353,0.08698262094602864,526,If it stays like this another three hours I have to see a doctor.
219,8,12,48,68,1.411764705882353,0.08442153033359522,526,It's actually doing wonders for my core.
221,8,14,51,73,1.4109589041095891,0.08003903261624706,526,I was endowed in Heaven as on Earth.
221,4,22,47,73,1.4109589041095891,0.06988688522837429,526,I was much heavier then.
221,3,24,46,73,1.4109589041095891,0.06710930802145695,526,I've been working out.
221,4,22,47,73,1.4109589041095891,0.06988688522837429,526,"Yes, I did pray extra for it"
225,7,13,46,66,1.4090909090909092,0.08356082531824394,526,I taught fourth grade for thirty years and never raised my voice.
225,8,11,47,66,1.4090909090909092,0.08630534163113279,526,". . . eighty pounds on The Biggest Loser, but it killed me."
225,10,7,49,66,1.4090909090909092,0.09154787232081078,526,"Yes, I was responsible for ending Trump's campaign."
225,6,15,45,66,1.4090909090909092,0.08072305161269369,526,"It's true, but please don't refer to me as ""St Peter."""
225,4,19,43,66,1.4090909090909092,0.07472489631484729,526,"Angel of the Month is OK, I guess, but doorways are a real problem."
225,5,17,44,66,1.4090909090909092,0.07778181404071999,526,"Oh, how I wish that rumor were true."
231,7,15,49,71,1.408450704225352,0.079174475056649,526,I've been dead a long time.
231,4,21,46,71,1.408450704225352,0.07114319391010884,526,I guess I'm happy to see you.
231,8,13,50,71,1.408450704225352,0.08167626330469253,526,I've seen bigger.
231,7,15,49,71,1.408450704225352,0.079174475056649,526,I've lost 400 pounds.
231,8,13,50,71,1.408450704225352,0.08167626330469253,526,I slipped Jesus a fifty.
236,7,12,45,64,1.40625,0.08544569773783091,526,"Well, I guess we know who's 'holier than thou'!"
236,4,18,42,64,1.40625,0.07624219319910415,526,"Well actually, I really am holier than thou."
236,4,18,42,64,1.40625,0.07624219319910415,526,I called my mother every day.
239,8,16,55,79,1.4050632911392404,0.07540647687616586,526,I've always been an over achiever.
240,7,11,44,62,1.403225806451613,0.08744470918917688,526,I died in a Costco...in Texas.
241,7,13,47,67,1.4029850746268657,0.08253037348459476,526,"Yeah, they're sending me back to Purgatory to work off the rest of my ego."
241,5,17,45,67,1.4029850746268657,0.076855022469319,526,"Sure, you had more fun, but I get to be sanctimonious for eternity."
241,4,19,44,67,1.4029850746268657,0.07385398055884286,526,I wasn't expecting to see you up here.
241,9,9,49,67,1.4029850746268657,0.08783980086642884,526,"I can still hear her yelling, ""It's been more than five hours. Call the doctor."""
241,3,21,43,67,1.4029850746268657,0.07072571250975386,526,All they had left was the extra-extra large.
241,8,11,48,67,1.4029850746268657,0.0852264429732949,526,"I never forgot anniversaries, always took the garbage out and consistently put toilet seats down."
247,9,11,52,72,1.4027777777777777,0.08312114352008726,526,"Thanks, but God only knows why."
247,6,17,49,72,1.4027777777777777,0.07573252656487271,526,"Actually, I got it on Amazon."
247,5,19,48,72,1.4027777777777777,0.07310389369363225,526,"Ah, but I am holier than thou."
247,5,19,48,72,1.4027777777777777,0.07310389369363225,526,Do you think it gives me that 'holier-than-thou' look?
247,5,19,48,72,1.4027777777777777,0.07310389369363225,526,I recently lost a lot of weight.
247,8,13,51,72,1.4027777777777777,0.08073343912752434,526,Totally worth a joyless existence on earth.
247,10,9,53,72,1.4027777777777777,0.08544214888927015,526,I think it's a guilt thing... I was run over by the Popemobile.
247,8,13,51,72,1.4027777777777777,0.08073343912752434,526,It's called a Hula Halo. God's trying to appeal to a younger crowd.
247,5,19,48,72,1.4027777777777777,0.07310389369363225,526,"Actually, I used my miles to get the upgrade."
256,7,14,49,70,1.4,0.07985494095046906,526,Big halos are so New Testament.
256,7,12,46,65,1.4,0.08435273922869733,526,"Not to brag, but, let's just say ""world hunger"" isn't a thing anymore."
256,7,14,49,70,1.4,0.07985494095046906,526,I worked in a pizzeria
256,7,12,46,65,1.4,0.08435273922869733,526,"Ok, ok. So I am a little excited to see you. How did you know?"
256,6,14,45,65,1.4,0.08145314840210525,526,I can't begin to tell how how much this new router has helped my signal strength
256,4,20,46,70,1.4,0.07165595278382794,526,I've waited for a woman like you all my after life.
256,9,8,48,65,1.4,0.0898717034272917,526,I'll make heaven great again!
256,6,16,48,70,1.4,0.07721873425053444,526,I'm going to make Heaven great again.
264,9,11,53,73,1.3972602739726028,0.08216006491071497,526,I used to make pizzas
265,9,9,50,68,1.3970588235294117,0.08674107950520471,526,I'd like you to come and join my inner circle.
265,5,17,46,68,1.3970588235294117,0.07594793362976238,526,I worked for Wham-o. And you?
265,7,13,48,68,1.3970588235294117,0.08152332027205171,526,I really am that good.
265,8,11,49,68,1.3970588235294117,0.08417263991912029,526,I am backed by a particularly large angel investor.
265,7,13,48,68,1.3970588235294117,0.08152332027205171,526,"""Would you like to touch it?"
265,7,13,48,68,1.3970588235294117,0.08152332027205171,526,I thought they said 'Would you like a big HELLO when you get there?'.
265,9,9,50,68,1.3970588235294117,0.08674107950520471,526,...probably because our Father always liked me best
265,6,15,47,68,1.3970588235294117,0.07878496167039212,526,Remember when you told me I'd never amount to anything?
265,5,17,46,68,1.3970588235294117,0.07594793362976238,526,"A bit much, huh? It's for that six-month stint your mother stayed with us."
265,6,15,47,68,1.3970588235294117,0.07878496167039212,526,My mother picked it out for me.
275,9,7,47,63,1.3968253968253967,0.09202640635884554,526,I guess I'm just glad to see you.
275,6,13,44,63,1.3968253968253967,0.08326320410019969,526,You wouldn’t believe the hoops I had to go through to get here.
277,4,15,39,58,1.396551724137931,0.08135146713693613,526,You won't believe the hoops I had to go through for this...
278,4,20,47,71,1.3943661971830985,0.07086380861911594,526,I was a very good tipper.
278,5,18,48,71,1.3943661971830985,0.07364844776998507,526,Insecure? Why do you ask?
278,10,8,53,71,1.3943661971830985,0.08623320876284185,526,"Nice, right? Turns out mine was the deciding vote that defeated Donald Trump back in 2016."
281,6,14,46,66,1.393939393939394,0.08043815872698906,526,It's been like this for over four hours. Do you think I should consult my doctor?
281,5,16,45,66,1.393939393939394,0.07748610787223617,526,It's for putting the seat down.
281,8,10,48,66,1.393939393939394,0.08603893485968558,526,"You're right, I'm holier than thou!"
281,5,16,45,66,1.393939393939394,0.07748610787223617,526,"When I ordered, I thought for sure Heaven was metric."
281,5,16,45,66,1.393939393939394,0.07748610787223617,526,"Glad you asked. I'm gay, vegan and voted for Bernie."
281,8,10,48,66,1.393939393939394,0.08603893485968558,526,"See, up here, when a guy is turned on by a girl, it works a little differently."
281,7,12,47,66,1.393939393939394,0.08328564009232776,526,Yes as a matter of fact I am holier than thou.
281,8,10,48,66,1.393939393939394,0.08603893485968558,526,I'm guessing you're from Venus? I'm from Saturn
289,5,14,42,61,1.3934426229508197,0.08191255007892127,526,"Yes, I am from Texas! Was it the accent?"
290,6,15,48,69,1.391304347826087,0.07784773020575153,526,We've recently developed a plan to reduce the gender halo gap gradually over the next five centuries.
290,6,15,48,69,1.391304347826087,0.07784773020575153,526,I had to jump through mine a number of times just to get in here!
290,7,13,49,69,1.391304347826087,0.08053897539510309,526,I supported Bernie Sanders.
293,7,11,46,64,1.390625,0.08515039070784357,526,"I'm sorry if I seem holier than thou, but actually I am."
293,7,11,46,64,1.390625,0.08515039070784357,526,"Yes, it's true what they say about guys with big halos."
295,4,18,45,67,1.3880597014925373,0.07353337261785199,526,They never discovered my sins during audits.
295,4,18,45,67,1.3880597014925373,0.07353337261785199,526,"Not to blow my own trumpet, but I call my Mom every Sunday."
295,7,12,48,67,1.3880597014925373,0.08224359544473128,526,"If it lasts over four hours, I have to see St. Peter."
295,5,16,46,67,1.3880597014925373,0.07654698506753517,526,It's just for being a white male.
295,6,14,47,67,1.3880597014925373,0.07944636528692196,526,I got an upgrade based on my frequent prayer miles
295,6,14,47,67,1.3880597014925373,0.07944636528692196,526,I'm getting worried. It's been like that for more than four hours.
295,5,16,46,67,1.3880597014925373,0.07654698506753517,526,"I had you at ha-lo, right?"
295,4,18,45,67,1.3880597014925373,0.07353337261785199,526,'It's because I phoned my mother every day.'
295,6,14,47,67,1.3880597014925373,0.07944636528692196,526,I put the lid down.
295,7,12,48,67,1.3880597014925373,0.08224359544473128,526,"I know it's big, you don't have to stare."
305,7,13,50,70,1.3857142857142857,0.07957666757214087,526,"It's crazy! When they said the double reward points never expire, they were right!"
305,5,17,48,70,1.3857142857142857,0.07419089345728716,526,Let's talk endlessly about your feelings and my inadequacies.
305,8,11,51,70,1.3857142857142857,0.08213723088122253,526,"After all, you were just a rib."
305,5,17,48,70,1.3857142857142857,0.07419089345728716,526,I get a lot of likes.
305,10,7,53,70,1.3857142857142857,0.08703264931467809,526,Not just thou -- everybody.
310,4,17,44,65,1.3846153846153846,0.07497534111391511,526,I'm not taking it in until I'm sure I'll keep the weight off.
310,5,15,45,65,1.3846153846153846,0.07811575389073039,526,Go big or go home.
310,4,17,44,65,1.3846153846153846,0.07497534111391511,526,I got it during a mid-afterlife crisis.
310,7,11,47,65,1.3846153846153846,0.08404528224389292,526,It came with the 'holier than thou'package!
310,5,15,45,65,1.3846153846153846,0.07811575389073039,526,It turns out being 'holier than thou' is a real thing.
310,5,15,45,65,1.3846153846153846,0.07811575389073039,526,"Back on Earth, I invented the Hula Hoop."
310,7,11,47,65,1.3846153846153846,0.08404528224389292,526,I got this for being an honest politician. Of course I never won an election.
310,7,11,47,65,1.3846153846153846,0.08404528224389292,526,"Heavenlywear@Narcissus.com, why?"
310,7,11,47,65,1.3846153846153846,0.08404528224389292,526,Come here ad infinitum?
310,3,19,43,65,1.3846153846153846,0.07169750723964327,526,Once I resisted the temptation to leave a comment.
310,6,13,46,65,1.3846153846153846,0.08113470426818842,526,I'm just that good.
321,7,12,49,68,1.3823529411764706,0.08122582510538132,526,I do indeed find you quite attractive. What tipped you off?
321,6,14,48,68,1.3823529411764706,0.07847708647290386,526,"Yes, I am happy to see you, but the size of my halo has nothing to do with that."
321,5,16,47,68,1.3823529411764706,0.0756285100904498,526,"Sorry, this happens when I like someone."
321,7,12,49,68,1.3823529411764706,0.08122582510538132,526,"I listened to a woman--like, really listened--and didn't try to sleep with her."
325,5,14,44,63,1.380952380952381,0.0797736539022967,526,"What can I say, I died a virgin."
325,5,14,44,63,1.380952380952381,0.0797736539022967,526,Let's just say I'm blessed.
325,5,14,44,63,1.380952380952381,0.0797736539022967,526,"Mine's in the shop, but they gave me this hula hoop as a loaner."
325,4,16,43,63,1.380952380952381,0.07649707894309514,526,I call it a halo hoop.
329,8,6,44,58,1.3793103448275863,0.09471064669953178,526,This is why I don't like online shopping.
330,6,13,47,66,1.378787878787879,0.08010817719611207,526,"The funny thing is, I was a Buddhist!"
330,6,13,47,66,1.378787878787879,0.08010817719611207,526,"Why, yes--I AM holier than thou."
330,5,15,46,66,1.378787878787879,0.07714349996910448,526,"If this lasts longer than 4 hours, we should call someone."
330,4,17,45,66,1.378787878787879,0.07406023981383504,526,"So, you're a conservative."
330,5,15,46,66,1.378787878787879,0.07714349996910448,526,And a big 'Halo' to you to Miss.
330,7,11,48,66,1.378787878787879,0.0829669845172413,526,I was shopping at Costco during the Rapture.
330,7,11,48,66,1.378787878787879,0.0829669845172413,526,Say the word and I will jump through it.
330,7,11,48,66,1.378787878787879,0.0829669845172413,526,I failed to seek medical attention after four hours.
330,7,11,48,66,1.378787878787879,0.0829669845172413,526,*Sigh* Well what do you expect when you're wearing your wings like that?
330,6,13,47,66,1.378787878787879,0.08010817719611207,526,You haven't upgraded to the Halo 6 Plus yet?
330,5,15,46,66,1.378787878787879,0.07714349996910448,526,Actually I was thinking about Pizza.
330,4,17,45,66,1.378787878787879,0.07406023981383504,526,I had to jump through a lot of hoops to get here.
330,8,9,49,66,1.378787878787879,0.08573051373976842,526,"Yep, I'm a virgin."
330,7,11,48,66,1.378787878787879,0.0829669845172413,526,Unfortunately size no longer matters.
330,5,15,46,66,1.378787878787879,0.07714349996910448,526,Does my halo make me look fat?
330,8,9,49,66,1.378787878787879,0.08573051373976842,526,"Even up here, the gender pay gap is real"
330,8,9,49,66,1.378787878787879,0.08573051373976842,526,Remember me? I was your first husband!
330,6,13,47,66,1.378787878787879,0.08010817719611207,526,I gave to PBS.
330,3,19,44,66,1.378787878787879,0.07084291534855332,526,It's not what you're thinking - I have a big heart.
349,4,15,42,61,1.3770491803278688,0.07810576557096129,526,I rescued puppies.
350,7,12,50,69,1.3768115942028984,0.08023157360396053,526,Hmmm. I do the same amount of work and he still gets a bigger halo.
351,6,12,46,64,1.375,0.08183170883849714,526,"Women are from Venus, men are from Saturn."
351,6,12,46,64,1.375,0.08183170883849714,526,Its not an act. I really am holier than thou.
351,6,12,46,64,1.375,0.08183170883849714,526,"Not only is it huge, I made the folks down in hell pay for it!"
351,6,12,46,64,1.375,0.08183170883849714,526,I never lied online
351,8,8,48,64,1.375,0.08768404680152521,526,My halo's not ready yet so they lent me a hula hoop.
351,6,12,46,64,1.375,0.08183170883849714,526,is that a hula hoop on your head or are you just happy to see me?
351,3,18,43,64,1.375,0.07216878364870322,526,I never once stepped on a crack.
351,6,12,46,64,1.375,0.08183170883849714,526,"Yes, it is a bit showy but the reception is to die for."
351,5,14,45,64,1.375,0.078742598543589,526,"Too over the top, huh?"
351,6,12,46,64,1.375,0.08183170883849714,526,What about coming back to my cloud and finding out for yourself?
351,5,14,45,64,1.375,0.078742598543589,526,"Oh, that?"" ""That's the last hoop I had to jump through to finally get in here."
362,4,17,46,67,1.373134328358209,0.07316524328361153,526,I always left the toilet seat down.
362,7,11,49,67,1.373134328358209,0.08191461974440718,526,Aaargh! How embarrassing. It'll be back to normal in a bit.
362,6,13,48,67,1.373134328358209,0.07910575765073763,526,... and that's when I quit taking steroids.
362,3,19,45,67,1.373134328358209,0.07000620537049895,526,I have a lot of Likes.
362,5,15,47,67,1.373134328358209,0.07619341742646572,526,I got it at Costco.
362,6,13,48,67,1.373134328358209,0.07910575765073763,526,Don't be too impressed. He grades men on the curve.
362,7,11,49,67,1.373134328358209,0.08191461974440718,526,Exactly what you think it means.
362,7,11,49,67,1.373134328358209,0.08191461974440718,526,"Why, yes, as a matter of fact, I AM holier than thou."
362,3,19,45,67,1.373134328358209,0.07000620537049895,526,No. I’m just incredibly happy to see you.
362,7,11,49,67,1.373134328358209,0.08191461974440718,526,Told you I was the better half.
362,8,9,50,67,1.373134328358209,0.08463030758684745,526,"Sorry, this is Judeo-Christian Biblical Heaven, so you will be doing most of the work and receiving a fraction of the credit and pay..."
362,8,9,50,67,1.373134328358209,0.08463030758684745,526,Equal halos!? Where do you think you are... Utopia?
362,5,15,47,67,1.373134328358209,0.07619341742646572,526,"It comes with unlimited text, talk and data."
375,4,15,43,62,1.3709677419354838,0.07707596151416209,526,It's my way of making Heaven great again.
375,7,9,46,62,1.3709677419354838,0.08675924177083624,526,And my golden chalice comes with unlimited refills.
375,4,15,43,62,1.3709677419354838,0.07707596151416209,526,They said if the condition lasts for more than 24 hours to consult my physician.
375,5,13,44,62,1.3709677419354838,0.08043335485422203,526,They let me upgrade in Atlanta.
379,8,8,49,65,1.3692307692307693,0.08651709137847687,526,"Believe me, if I had met you, this would be a much smaller halo."
379,3,18,44,65,1.3692307692307693,0.07128366535711785,526,You can't be afraid to negotiate.
379,4,16,45,65,1.3692307692307693,0.07457969011409737,526,"Yes, I may have exaggerated the truth a little."
379,4,16,45,65,1.3692307692307693,0.07457969011409737,526,I got this for inventing kale chips.
379,4,16,45,65,1.3692307692307693,0.07457969011409737,526,"Exactly what makes you say I have a "" holier than thou"" attitude?"
379,3,18,44,65,1.3692307692307693,0.07128366535711785,526,Who do I call for holiness lasting longer than 4 hours?
379,4,16,45,65,1.3692307692307693,0.07457969011409737,526,So.....just how naughty were you?
379,4,16,45,65,1.3692307692307693,0.07457969011409737,526,"Nope, never even removed a mattress tag."
387,8,9,51,68,1.3676470588235294,0.0835568281559177,526,"If you think this is bad, you should see Gandhi's."
387,7,11,50,68,1.3676470588235294,0.08088734121420482,526,I miss lust.
387,7,11,50,68,1.3676470588235294,0.08088734121420482,526,"You know what they say...'big hands, big halo'"
387,7,11,50,68,1.3676470588235294,0.08088734121420482,526,Miracle-Gro.
387,6,13,49,68,1.3676470588235294,0.0781266945795663,526,It only happens when I get excited
387,5,15,48,68,1.3676470588235294,0.07526485795611701,526,You thought it would be different here?
387,5,15,48,68,1.3676470588235294,0.07526485795611701,526,Gender equality hasn't come this far yet.
387,4,17,47,68,1.3676470588235294,0.07228981449955524,526,"When I was good, I was very, very good."
395,5,13,45,63,1.3650793650793651,0.07936507936507937,526,"Seriously, is He playing ring-toss, again?"
395,8,7,48,63,1.3650793650793651,0.08851505031867296,526,I'm very very good.
395,4,15,44,63,1.3650793650793651,0.07607090805641839,526,You should see my wingspan.
395,5,13,45,63,1.3650793650793651,0.07936507936507937,526,"I met my target weight, but I still have all this excess halo."
399,5,14,47,66,1.3636363636363635,0.07675336226088955,526,"Right before I died, I doubled my contribution to PBS."
399,6,12,48,66,1.3636363636363635,0.07973254720972991,526,What patriarchy?
399,4,16,46,66,1.3636363636363635,0.07365377215153938,526,I'm from Texas. Its a ten gallon halo.
399,5,14,47,66,1.3636363636363635,0.07675336226088955,526,"That's OK, your's is brighter."
399,5,14,47,66,1.3636363636363635,0.07675336226088955,526,I bought mine at Costco.
399,3,18,45,66,1.3636363636363635,0.07041787902195303,526,This is nothing. You should see God's.
399,3,18,45,66,1.3636363636363635,0.07041787902195303,526,Does this mean we aren't a match made in heaven?
399,3,18,45,66,1.3636363636363635,0.07041787902195303,526,"I can't overstate the importance of starting early. A few good deeds when you are young, then through the magic of compound interest..."
399,5,14,47,66,1.3636363636363635,0.07675336226088955,526,I'm really not that good. I think it's a hole in the ozone layer.
399,7,10,49,66,1.3636363636363635,0.08260435551925986,526,I'm not acting holier-than-thou. I am.
399,6,12,48,66,1.3636363636363635,0.07973254720972991,526,I had to overcompensate when I was alive too
399,6,12,48,66,1.3636363636363635,0.07973254720972991,526,Makes it Hell to walk through a doorway.
399,6,12,48,66,1.3636363636363635,0.07973254720972991,526,"I guess I can't use heaven must be missing an angel anymore so I'll just say hi, I'm Doug."
399,6,12,48,66,1.3636363636363635,0.07973254720972991,526,I always used my turn signal.
399,3,18,45,66,1.3636363636363635,0.07041787902195303,526,They tell me I'm too good to be true.
399,4,16,46,66,1.3636363636363635,0.07365377215153938,526,I'm the one who never watched porn.
399,3,18,45,66,1.3636363636363635,0.07041787902195303,526,"Honestly, it wasn’t all worth it."
399,6,12,48,66,1.3636363636363635,0.07973254720972991,526,I can read all I like in bed but I can't sleep a wink.
417,5,12,44,61,1.360655737704918,0.08108818273901441,526,Essentially I'm holier than thou.
417,5,12,44,61,1.360655737704918,0.08108818273901441,526,"It feels a little mid-afterlife crisis, huh?"
417,7,8,46,61,1.360655737704918,0.08756819944922462,526,I'm a vegan.
417,5,12,44,61,1.360655737704918,0.08108818273901441,526,I got a very high score on the entrance exam.
417,7,8,46,61,1.360655737704918,0.08756819944922462,526,"No, I am not compensating for anything!"
417,3,16,42,61,1.360655737704918,0.07404321174187684,526,I would sin for you.
417,3,16,42,61,1.360655737704918,0.07404321174187684,526,I invented post-its.
417,3,16,42,61,1.360655737704918,0.07404321174187684,526,"It's rude to stare, you know."
417,7,8,46,61,1.360655737704918,0.08756819944922462,526,Oh like you've never lied on your dating profile.
426,5,13,46,64,1.359375,0.07832316138363532,526,I'm told my only sin was sanctimony.
426,8,7,49,64,1.359375,0.08730757611583442,526,Why do you want to see my hands?
426,6,11,47,64,1.359375,0.08142818526259031,526,What 'holier than thou' attitude?
426,3,17,44,64,1.359375,0.07171090654191657,526,Tragic hula-hooping accident. You?
426,6,11,47,64,1.359375,0.08142818526259031,526,"...and then God said, ""Why didn't I think of that?"""
426,7,9,48,64,1.359375,0.08441908019630678,526,Well haloooooooooo!
426,3,17,44,64,1.359375,0.07171090654191657,526,Because God is a guy.
426,4,15,45,64,1.359375,0.07508985193150429,526,"Howdy, Ma'am. I'm from Texas."
426,3,17,44,64,1.359375,0.07171090654191657,526,A mid-eternity crisis?
426,6,11,47,64,1.359375,0.08142818526259031,526,Yes it means exactly what you're thinking.
426,9,5,50,64,1.359375,0.09010352153636376,526,"Um, actually, wing size is a better indicator."
426,5,13,46,64,1.359375,0.07832316138363532,526,"As a matter of fact, I am happy to to see you."
426,4,15,45,64,1.359375,0.07508985193150429,526,"Costco. Why, where did you get yours?"
426,7,9,48,64,1.359375,0.08441908019630678,526,Harvard.
426,6,11,47,64,1.359375,0.08142818526259031,526,Did you wash your's?
426,2,19,43,64,1.359375,0.06816467098894959,526,They call this one 'The Mandela.'
426,8,7,49,64,1.359375,0.08730757611583442,526,"Unbeknownst to Tom, while he was playing hard to get, his halo was giving him away."
426,4,15,45,64,1.359375,0.07508985193150429,526,I really am holier than thou.
426,8,7,49,64,1.359375,0.08730757611583442,526,You were right. I AM holier-than-thou.
426,2,19,43,64,1.359375,0.06816467098894959,526,Aren't you glad we waited?
426,6,11,47,64,1.359375,0.08142818526259031,526,"For the last time, I'm not compensating for anything, Gloria."
426,4,15,45,64,1.359375,0.07508985193150429,526,"Yes, Viagra works here. Just differently."
426,6,11,47,64,1.359375,0.08142818526259031,526,Now you decide that size doesn't matter?
449,4,16,47,67,1.3582089552238805,0.07274887114566478,526,If it lasts more than four hours I have to go to the emergency cloud
449,7,10,50,67,1.3582089552238805,0.08154293566023545,526,"I don't know, I got to the pearly gates, said hi to Uncle Peter and here I am."
449,4,16,47,67,1.3582089552238805,0.07274887114566478,526,It's one of the new halogens.
449,3,18,46,67,1.3582089552238805,0.06957092940729591,526,"Yes, it's natural."
453,6,14,53,73,1.356164383561644,0.07394582073379749,526,I invented gelato.
454,4,14,44,62,1.3548387096774193,0.07660420502266237,526,...But how do you know I find you attractive?
454,5,12,45,62,1.3548387096774193,0.07998140381942978,526,Yes it's true I have an inflated halo.
454,4,14,44,62,1.3548387096774193,0.07660420502266237,526,Does this halo make me look holier than thou?
454,4,14,44,62,1.3548387096774193,0.07660420502266237,526,I'm just as surprised as you--Goldman Sachs really does do God's work.
454,4,14,44,62,1.3548387096774193,0.07660420502266237,526,You had me at Halo.
454,6,10,46,62,1.3548387096774193,0.0832216659692613,526,Turns out He's cool with vanity
454,4,14,44,62,1.3548387096774193,0.07660420502266237,526,The Seraphim got a deal at Costco.
454,4,14,44,62,1.3548387096774193,0.07660420502266237,526,You were right. I wasn't much fun.
454,2,18,42,62,1.3548387096774193,0.06935822062026156,526,Sexism doesn't end. Sorry.
454,6,10,46,62,1.3548387096774193,0.0832216659692613,526,Turns out I AM holier than thou.
454,3,16,43,62,1.3548387096774193,0.07307108523473209,526,"Shhh, I stole it from Ghandi!"
454,3,16,43,62,1.3548387096774193,0.07307108523473209,526,"For a buck, He supersized it."
454,5,12,45,62,1.3548387096774193,0.07998140381942978,526,"What do you mean, 'is that a cumulonimbus cloud or are you happy to see me?'"
454,4,14,44,62,1.3548387096774193,0.07660420502266237,526,What can I say? I'm Blessed.
454,5,12,45,62,1.3548387096774193,0.07998140381942978,526,I’m literally holier than thou.
454,6,10,46,62,1.3548387096774193,0.0832216659692613,526,"You'll find that, up here, size really does matter."
454,4,14,44,62,1.3548387096774193,0.07660420502266237,526,I guess my biggest accomplishment was the pop up ad blocker.
454,3,16,43,62,1.3548387096774193,0.07307108523473209,526,"You'll find size matters up here, too."
472,3,17,45,65,1.353846153846154,0.07081520245969988,526,Fifty years ago women didn't even have halos.
472,6,11,48,65,1.353846153846154,0.08035608621452375,526,What can I say? Father always liked me best.
472,5,13,47,65,1.353846153846154,0.07730673554708377,526,After four hours I'm supposed to call my doctor.
472,2,19,44,65,1.353846153846154,0.06733515923081383,526,Relax. I only borrowed this from Mother Theresa.
472,3,17,45,65,1.353846153846154,0.07081520245969988,526,"To be honest, I'm kind of a big deal up here."
472,4,15,46,65,1.353846153846154,0.07413205872075532,526,Because I AM holier than thou.
472,4,15,46,65,1.353846153846154,0.07413205872075532,526,"No, no, nothing like that, I'm just real happy to see you."
472,4,15,46,65,1.353846153846154,0.07413205872075532,526,"Yeah, I'm from Texas. How'd you know?"
472,7,9,49,65,1.353846153846154,0.08329387626041428,526,Isn't it obvious that I find you very attractive?
472,6,11,48,65,1.353846153846154,0.08035608621452375,526,I'm glad to see you too.
472,4,15,46,65,1.353846153846154,0.07413205872075532,526,"Yes, ma'am. Patron saint of Texas."
472,5,13,47,65,1.353846153846154,0.07730673554708377,526,"If I act holier than thou, it's because I AM holier than thou."
472,5,13,47,65,1.353846153846154,0.07730673554708377,526,They ran out of halos. They gave me a hula hoop.
472,5,13,47,65,1.353846153846154,0.07730673554708377,526,Well obviously it's not just my opinion... I AM 'holier than thou'!
472,7,9,49,65,1.353846153846154,0.08329387626041428,526,I was hoping you wouldn't notice.
472,5,13,47,65,1.353846153846154,0.07730673554708377,526,"The 79% gender gap is pretty much the norm here, too."
472,4,15,46,65,1.353846153846154,0.07413205872075532,526,It's been more than four hours. Should I call a doctor?
472,7,9,49,65,1.353846153846154,0.08329387626041428,526,I saw Hamilton and didn't mention it to anyone.
472,5,13,47,65,1.353846153846154,0.07730673554708377,526,"Yes dear, I'm sorry... you're right."
491,5,9,40,54,1.3518518518518519,0.08830022878508999,526,"Sorry, sometimes I get excited too easily"
492,4,14,45,63,1.3492063492063493,0.07558859380847571,526,"It's just good to know all those years in Catholic School , weren't for nothing !"
492,3,16,44,63,1.3492063492063493,0.07212213768216695,526,It gets bigger every time I see you.
492,6,10,47,63,1.3492063492063493,0.0820835004988049,526,I didn't know being an alter boy would make such a difference.
492,5,12,46,63,1.3492063492063493,0.07890290415466353,526,The doctor said it's benign.
492,4,14,45,63,1.3492063492063493,0.07558859380847571,526,...which isn't to say that I'm NOT happy to see you
492,6,10,47,63,1.3492063492063493,0.0820835004988049,526,Remember the salary differences you discovered at work?
492,5,12,46,63,1.3492063492063493,0.07890290415466353,526,"Yes, I'm afraid I am holier than thou."
492,7,8,48,63,1.3492063492063493,0.08514536877737151,526,Help! It's been like this for over 4 hours!
492,6,10,47,63,1.3492063492063493,0.0820835004988049,526,"Yeah, but I still miss my Ferrari."
492,6,10,47,63,1.3492063492063493,0.0820835004988049,526,"People told me I was ""holier-than-thou"" my whole life. I was just too modest to believe it."
492,4,14,45,63,1.3492063492063493,0.07558859380847571,526,"Sure the reception's slightly better, but I wish I thought twice before springing for the latest upgrade."
492,6,10,47,63,1.3492063492063493,0.0820835004988049,526,I was the billionth entrant at the pearly gates so they supersized it for free.
492,6,10,47,63,1.3492063492063493,0.0820835004988049,526,"Well, you always told me that size mattered."
492,6,10,47,63,1.3492063492063493,0.0820835004988049,526,Halooo.....where have YOU been all my afterlife?
492,4,14,45,63,1.3492063492063493,0.07558859380847571,526,It's like being back in high school. I have no control over it.
507,5,13,48,66,1.3484848484848484,0.0763149658048288,526,I got it when 'It's A Wonderful Life' grossed one billion.
507,5,13,48,66,1.3484848484848484,0.0763149658048288,526,I had a Groupon.
509,5,10,43,58,1.3448275862068966,0.08359628497380898,526,I'd say the upgraded halo package was worth it
509,6,8,44,58,1.3448275862068966,0.08713954061720913,526,"Don't let this fool you, I am quite the bad boy."
509,7,6,45,58,1.3448275862068966,0.09054424452462011,526,I got it from Trump University. It's huge.
512,6,9,46,61,1.3442622950819672,0.08391136978406379,526,You forget all those summers spent at your mother's.
512,4,13,44,61,1.3442622950819672,0.07712471590984633,526,Whoever said you can't take it with you clearly wasn't the Northwest hula hoop champion three years running.
512,2,17,42,61,1.3442622950819672,0.06968016668544297,526,I used to change the diapers.
512,5,11,45,61,1.3442622950819672,0.08058951477460452,526,Would you call God? It's been longer than four hours.
516,5,12,47,64,1.34375,0.07785170452100196,526,I have lost weight. Thanks for noticing!
516,5,12,47,64,1.34375,0.07785170452100196,526,"That's right, darlin'. You have died and gone to heaven...!"
516,7,8,49,64,1.34375,0.08398185154477655,526,"Yes, as a matter of fact, I am a virgin. How about you?"
516,2,18,44,64,1.34375,0.06762242718751049,526,My good deeds just vested.
516,2,18,44,64,1.34375,0.06762242718751049,526,My biggest sin was vanity... go figure!
516,5,12,47,64,1.34375,0.07785170452100196,526,The last thing I remember is wearing a sombrero.
516,5,12,47,64,1.34375,0.07785170452100196,526,"Thanks, but if it lasts for four millennia, I need to see a doctor."
516,5,12,47,64,1.34375,0.07785170452100196,526,"I supported Bernie. Of course, I'm holier than thou."
516,5,12,47,64,1.34375,0.07785170452100196,526,"Yeah, hula hoop accident. What about you?"
516,3,16,45,64,1.34375,0.07119567686848623,526,"If it were just a vanity thing, I wouldn't be here"
516,4,14,46,64,1.34375,0.07459796344937072,526,"What, you thought there would be equality in heaven?"
516,5,12,47,64,1.34375,0.07785170452100196,526,"Well in all honesty, the guys at the gate called it a loop hole!"
516,7,8,49,64,1.34375,0.08398185154477655,526,It's all true.
516,5,12,47,64,1.34375,0.07785170452100196,526,"No, it is the pothole I fell through and ended up here."
516,5,12,47,64,1.34375,0.07785170452100196,526,Every NPR contributor has one.
516,3,16,45,64,1.34375,0.07119567686848623,526,"Yes, I’ve been working out."
516,3,16,45,64,1.34375,0.07119567686848623,526,Halo equality is still only a goal.
533,4,10,39,53,1.3396226415094339,0.08494596688823428,526,I tipped the guy at the gate.
534,4,11,41,56,1.3392857142857142,0.08168988601295087,526,It's a much better predictor than hand size. . . .
535,2,16,41,59,1.3389830508474576,0.07093831125984225,526,Do you really think we have gender inequality up here?
535,3,14,42,59,1.3389830508474576,0.07494462982990946,526,"What do you think: unfunny, somewhat funny, or funny?"
535,7,6,46,59,1.3389830508474576,0.08918806918034342,526,"No, it's just a Hula-Hoop."
535,2,16,41,59,1.3389830508474576,0.07093831125984225,526,"In my day I walked 128,234 little old ladies across the street, rescued 34,627 cats from trees, helped....."
539,6,9,47,62,1.3387096774193548,0.08273340742355272,526,"Never fails , my Halo gets huge when I meet a Victoria's Secret Angel."
539,5,11,46,62,1.3387096774193548,0.07947324061681996,526,You heard wrong. God does play favorites
539,5,11,46,62,1.3387096774193548,0.07947324061681996,526,My insurance guy said the extra coverage would be good in perpetuity.
539,5,11,46,62,1.3387096774193548,0.07947324061681996,526,I was very good.
539,5,11,46,62,1.3387096774193548,0.07947324061681996,526,It's actually not a halo...it's the hole in my ozone layer.
539,5,11,46,62,1.3387096774193548,0.07947324061681996,526,I took the garbage out
539,5,11,46,62,1.3387096774193548,0.07947324061681996,526,O.K.—I am just happy to see you.
539,6,9,47,62,1.3387096774193548,0.08273340742355272,526,I'm His press secretary.
539,4,13,45,62,1.3387096774193548,0.07607348581711208,526,It was a free upgrade down at Purgatory because my cloud hadn't been cleaned yet.
539,3,15,44,62,1.3387096774193548,0.07251451244126066,526,We're still a whole generation behind on gender equality.
539,2,17,43,62,1.3387096774193548,0.06877160594912074,526,I was told I had an eternity to grow into it.
539,4,13,45,62,1.3387096774193548,0.07607348581711208,526,The key is negotiating on the way in.
539,4,13,45,62,1.3387096774193548,0.07607348581711208,526,Have you seen the size of my hands?
539,3,15,44,62,1.3387096774193548,0.07251451244126066,526,"Good luck at ring toss, I'm off to hula hooping."
539,5,11,46,62,1.3387096774193548,0.07947324061681996,526,How about we get together and try to make a bullseye?
554,7,8,50,65,1.3384615384615384,0.08284868934053083,526,I can't help feeling holier than thou!
554,6,10,49,65,1.3384615384615384,0.07989453106861918,526,"Now, I don't mean to come off as holier than thou..."
554,3,16,46,65,1.3384615384615384,0.07029102647114255,526,Admit it; I had you at halo.
554,4,14,47,65,1.3384615384615384,0.07363149891952556,526,I drove a Prius.
558,2,17,44,63,1.3333333333333333,0.06788442333021306,526,I probably just attended more charity dinners than you.
558,7,9,53,69,1.3333333333333333,0.07906817357665433,526,It's over my head.
558,3,12,39,54,1.3333333333333333,0.07930515857181442,526,"Is your halo always that big, or are you just happy to see me?"
558,3,14,43,60,1.3333333333333333,0.07390124218838826,526,"Yeah, they come standard when you buy a Prius."
558,5,8,41,54,1.3333333333333333,0.0876751516407819,526,I believe that they call it the Pinocchio halo.
558,1,19,43,63,1.3333333333333333,0.06400204809830924,526,"C'mon, there's room for both of us under mine."
558,6,9,48,63,1.3333333333333333,0.0815869230407957,526,"I’m confused. You’re my neighbor’s wife. I coveted you. Yet, here I am."
558,6,9,48,63,1.3333333333333333,0.0815869230407957,526,It's fully loaded with zero percent financing until the Second Coming.
558,8,6,52,66,1.3333333333333333,0.0845482533728944,526,"You're waiting for the dick joke, aren't you?"
558,4,12,44,60,1.3333333333333333,0.0776296679652776,526,"Not that I'm holier than thou, but..."
558,4,13,46,63,1.3333333333333333,0.07504905376532171,526,"Let me say this just once, and then I'll shut up forever: brake is left and gas is right."
558,4,13,46,63,1.3333333333333333,0.07504905376532171,526,It's not the circumference that counts.
558,5,9,43,57,1.3333333333333333,0.08426794199726531,526,"They told me it was specially made for Trump's ego, but apparently he won't be getting to use it"
558,2,15,40,57,1.3333333333333333,0.07225916412701001,526,I think everyone's pretty surprised.
558,3,14,43,60,1.3333333333333333,0.07390124218838826,526,"Yeah, I did a few rescues. Some pro bono work. How about you?"
558,4,12,44,60,1.3333333333333333,0.0776296679652776,526,"Well, I'm happy to see you"
558,5,9,43,57,1.3333333333333333,0.08426794199726531,526,I only eat free-range Manna.
558,5,10,45,60,1.3333333333333333,0.08118705007457577,526,Actually I am hollier than thou
558,5,9,43,57,1.3333333333333333,0.08426794199726531,526,"'I had you at 'halo'"""
558,3,14,43,60,1.3333333333333333,0.07390124218838826,526,I wanted to do something big for our date tonight.
578,3,15,46,64,1.328125,0.07062183937301952,526,This is why you shouldn't just buy a halo off the rack.
578,6,9,49,64,1.328125,0.080470736510385,526,"I don't know what to say, I thought this was going to be a Playboy cartoon."
578,5,11,48,64,1.328125,0.07732727648438203,526,It grows in the presence of celestial bodies.
581,4,12,45,61,1.3278688524590163,0.07654175429461477,526,"No, it doesn't make you look fat."
581,3,14,44,61,1.3278688524590163,0.07288478622501052,526,I was a Bernie Sanders supporter.
581,4,12,45,61,1.3278688524590163,0.07654175429461477,526,"But, of course, I'm holier than thou."
581,5,10,46,61,1.3278688524590163,0.08003179516872573,526,"Trouble is, I AM holier than thou."
581,5,10,46,61,1.3278688524590163,0.08003179516872573,526,You're not fooling anyone with that hula hoop.
581,4,12,45,61,1.3278688524590163,0.07654175429461477,526,I had a ton of points left on my card.
581,5,10,46,61,1.3278688524590163,0.08003179516872573,526,I know halos. I have the best halos. The halos love me.
581,4,12,45,61,1.3278688524590163,0.07654175429461477,526,"We are equal, but I'm more equal."
581,7,6,48,61,1.3278688524590163,0.08659090259832299,526,I can't believe we got away with it.
581,5,10,46,61,1.3278688524590163,0.08003179516872573,526,It's nothing special; just a bigger hole in the ozone layer.
581,3,14,44,61,1.3278688524590163,0.07288478622501052,526,"You may be prettier, but I'm holier than thou."
581,3,14,44,61,1.3278688524590163,0.07288478622501052,526,"Sure, I did a couple good deeds, but let's talk about you."
581,6,8,47,61,1.3278688524590163,0.0833758737607023,526,I'm not wearing pants.
581,4,12,45,61,1.3278688524590163,0.07654175429461477,526,Some say its because I made more money than god.
581,5,10,46,61,1.3278688524590163,0.08003179516872573,526,I still couldn't live up to my parents' expectations and now this.
581,6,8,47,61,1.3278688524590163,0.0833758737607023,526,"Holier than thou? Why, yes I am."
581,6,8,47,61,1.3278688524590163,0.0833758737607023,526,"Yep, I did get it at Costco."
598,5,9,44,58,1.3275862068965518,0.08300150886930444,526,This size came with the wings and a bag of chips.
598,6,7,45,58,1.3275862068965518,0.08656911199808615,526,Apparently size matters up here too.
598,5,9,44,58,1.3275862068965518,0.08300150886930444,526,Something tells me this is better than meeting online.
598,2,15,41,58,1.3275862068965518,0.0712346014371762,526,Am I detecting a touch of halo envy?
598,1,17,40,58,1.3275862068965518,0.06685362940302783,526,"I know, and the robe is too big too!"
598,3,13,42,58,1.3275862068965518,0.07536132376404561,526,I died with the most toys.
598,2,15,41,58,1.3275862068965518,0.0712346014371762,526,"Be honest, do you think it's too much?"
598,4,11,43,58,1.3275862068965518,0.07927351258160108,526,I'm a Republican but I voted for Hillary.
598,5,9,44,58,1.3275862068965518,0.08300150886930444,526,My halo is large because I'm happy to see you.
598,3,13,42,58,1.3275862068965518,0.07536132376404561,526,"I'm really, really good, if you know what I mean."
598,5,9,44,58,1.3275862068965518,0.08300150886930444,526,"Holiness? No, they measure sales."
598,4,11,43,58,1.3275862068965518,0.07927351258160108,526,Me? I died saving a puppy.
598,3,13,42,58,1.3275862068965518,0.07536132376404561,526,I never watched Fox News.
598,4,11,43,58,1.3275862068965518,0.07927351258160108,526,"Going through doors can be tough, but it's worth it."
612,4,10,41,55,1.3272727272727274,0.08228449234107596,526,Those little blue pills work in mysterious ways.
613,6,9,50,65,1.323076923076923,0.07938372092519344,526,I suppose this is God's way of telling me my head is too big.
614,3,14,45,62,1.3225806451612903,0.07189434028626156,526,I said 'bless you' even when people were just coughing.
614,3,14,45,62,1.3225806451612903,0.07189434028626156,526,"When it comes to halo size, I assure you, I have no problems in that area."
614,6,8,48,62,1.3225806451612903,0.08219037872229688,526,"Mother claims that when she placed the order for a ""halo"" it autocorrected to ""hula""."
614,4,12,46,62,1.3225806451612903,0.07548256020412515,526,"Yeah, you're a God fan? Name five of his albums."
614,3,14,45,62,1.3225806451612903,0.07189434028626156,526,... so I said everything is negotiable.
614,4,12,46,62,1.3225806451612903,0.07548256020412515,526,I guess I am holier than thou
614,6,8,48,62,1.3225806451612903,0.08219037872229688,526,"""Does this Halo make me look fat""?"
614,3,14,45,62,1.3225806451612903,0.07189434028626156,526,I was having a mid-afterlife crisis....
614,4,12,46,62,1.3225806451612903,0.07548256020412515,526,All those Facebook posts that I liked and shared finally paid off.
614,4,12,46,62,1.3225806451612903,0.07548256020412515,526,"It's cumbersome, but I can hang my fine woolens on it."
614,3,14,45,62,1.3225806451612903,0.07189434028626156,526,I'd say you barely made it.
614,5,10,47,62,1.3225806451612903,0.07890777924097209,526,"As I suspected. Women get haloes, men get hula hoops."
614,3,14,45,62,1.3225806451612903,0.07189434028626156,526,"It means I'm really good, if you know what I mean."
627,5,9,45,59,1.3220338983050848,0.0817712950300013,526,I'm still a virgin
627,6,7,46,59,1.3220338983050848,0.085270148509472,526,"I could show you why I have a big halo, but then you'd have to have to go to Hell."
627,4,11,44,59,1.3220338983050848,0.0781158828596312,526,My guess is that I was correct about global warming.
627,3,13,43,59,1.3220338983050848,0.07428080249294383,526,"Trust me, I can be a bad boy if that's really what you're looking for."
627,4,11,44,59,1.3220338983050848,0.0781158828596312,526,I paid for premium.
627,2,15,42,59,1.3220338983050848,0.07023662921191362,526,"I guess I am holier than thou, after all."
627,4,11,44,59,1.3220338983050848,0.0781158828596312,526,I built mother-in-law suites for a living.
627,5,9,45,59,1.3220338983050848,0.0817712950300013,526,"You're still gonna swipe left, aren't you?"
627,5,9,45,59,1.3220338983050848,0.0817712950300013,526,I'm applying for patron saint of the arrogant and smug.
627,5,9,45,59,1.3220338983050848,0.0817712950300013,526,I used to work in a pizza parlor.
627,3,13,43,59,1.3220338983050848,0.07428080249294383,526,'Hot' is a tricky term here.
627,5,9,45,59,1.3220338983050848,0.0817712950300013,526,It's a continuation of the gender pay gap.
627,6,7,46,59,1.3220338983050848,0.085270148509472,526,I'm not compensating for anything if that's what's you're thinking.
627,8,3,48,59,1.3220338983050848,0.091868957209251,526,I worked at the returns counter in Costco.
627,3,13,43,59,1.3220338983050848,0.07428080249294383,526,"Because I didn't swear, steal, cheat on my wife; but mostly because I didn't vote for Donald Trump."
627,3,13,43,59,1.3220338983050848,0.07428080249294383,526,Halo envy is fairly common.
643,2,14,40,56,1.3214285714285714,0.07255603681751223,526,"It's heaven. Small hands, big halo."
643,4,10,42,56,1.3214285714285714,0.08101283711465418,526,I said I was sorry three lives ago.
643,2,14,40,56,1.3214285714285714,0.07255603681751223,526,Viagra sideffect.
643,0,18,38,56,1.3214285714285714,0.06297362289056342,526,"No, seriously. I'm a bad boy."
643,3,12,41,56,1.3214285714285714,0.076900774560565,526,I'm assigned to Texas.
643,5,8,43,56,1.3214285714285714,0.08492602914722988,526,It's the same one God uses.
643,5,8,43,56,1.3214285714285714,0.08492602914722988,526,I opted for the wider radius option. It covers a multitude of sins.
643,5,8,43,56,1.3214285714285714,0.08492602914722988,526,"Yes yes, I invented the hula hoop."
651,4,11,45,60,1.3166666666666667,0.07699022854818702,526,It appears that I had a lot more fun getting here than you did.
651,3,13,44,60,1.3166666666666667,0.07322925331102074,526,"""My halo is in the shop and they didn't have any replacements, so they gave me a hula hoop instead""."
651,4,11,45,60,1.3166666666666667,0.07699022854818702,526,I guess it means I'm holier than thou.
651,6,7,47,60,1.3166666666666667,0.08400856381778544,526,It's not exactly what I meant when I said 'extra large.'
651,5,9,46,60,1.3166666666666667,0.08057584652558421,526,"I was meeker than most. Ironically, now I'm considered a show-off."
651,1,17,42,60,1.3166666666666667,0.06505828185300302,526,It's real--go ahead and pull on it.
651,6,7,47,60,1.3166666666666667,0.08400856381778544,526,"They sized it for some guy named Trump, and reconsidered."
651,4,11,45,60,1.3166666666666667,0.07699022854818702,526,I'm happy to see you.
651,5,9,46,60,1.3166666666666667,0.08057584652558421,526,It's a heaven thing. On Earth it would be an erection.
651,3,13,44,60,1.3166666666666667,0.07322925331102074,526,You were right! I really was holier than thou
651,4,11,45,60,1.3166666666666667,0.07699022854818702,526,"Well, I finally opened the 'options' menu."
651,2,15,43,60,1.3166666666666667,0.06926436160881881,526,For a few extra good deeds I was able to super size it.
663,3,12,42,57,1.3157894736842106,0.0757497807504131,526,"They say ""you can't take it with you,"" but I did, and this is what I bought with it."
663,5,8,44,57,1.3157894736842106,0.08361316951184097,526,Yes...I'm THAT good.
663,2,14,41,57,1.3157894736842106,0.07149449536639554,526,My Father said I'd grow into it.
663,3,12,42,57,1.3157894736842106,0.0757497807504131,526,I'm not picturing you naked.
663,6,6,45,57,1.3157894736842106,0.08727959974619473,526,I shot Donald Trump.
663,3,12,42,57,1.3157894736842106,0.0757497807504131,526,They were all out of Men's Medium.
663,2,14,41,57,1.3157894736842106,0.07149449536639554,526,We need to make heaven great again!
663,3,12,42,57,1.3157894736842106,0.0757497807504131,526,Halo Envy
663,6,6,45,57,1.3157894736842106,0.08727959974619473,526,"Sorry, the correct religion was United Southern Conservative Baptist Council of 1892, not United Southern Conservative Baptist Council of 1912."
663,3,12,42,57,1.3157894736842106,0.0757497807504131,526,"Thanks, but sainthood was really my fall-back position."
663,4,10,43,57,1.3157894736842106,0.07977841625261656,526,I am the guy who invented The Pill
663,4,10,43,57,1.3157894736842106,0.07977841625261656,526,"It won't get in the way, I promise!"
663,3,12,42,57,1.3157894736842106,0.0757497807504131,526,I went to Harvard.
663,5,8,44,57,1.3157894736842106,0.08361316951184097,526,It matches my ego.
663,2,14,41,57,1.3157894736842106,0.07149449536639554,526,Nothing fits right after you lose weight.
663,4,10,43,57,1.3157894736842106,0.07977841625261656,526,It's true what they say about the size of your halo.
663,4,10,43,57,1.3157894736842106,0.07977841625261656,526,I'm from Canada.
663,5,8,44,57,1.3157894736842106,0.08361316951184097,526,Yes. It is true what they say...
663,3,12,42,57,1.3157894736842106,0.0757497807504131,526,I got an upgrade.
663,3,12,42,57,1.3157894736842106,0.0757497807504131,526,"Underneath it all, I'm really a humble guy!"
663,3,12,42,57,1.3157894736842106,0.0757497807504131,526,Green stamps.
663,4,10,43,57,1.3157894736842106,0.07977841625261656,526,"Now, how'd ya know I'm from Texas?"
663,3,12,42,57,1.3157894736842106,0.0757497807504131,526,Seriously .... I am a Super Delegate.
663,4,10,43,57,1.3157894736842106,0.07977841625261656,526,I really can't explain it. Seems like every time I see you it just gets bigger.
687,3,11,40,54,1.3148148148148149,0.07852623144217596,526,What do you mean size doesn't matter?
687,4,9,41,54,1.3148148148148149,0.08285638807042534,526,I always knew I was holier than thou
689,4,8,39,51,1.3137254901960784,0.08627450980392158,526,What do you mean I'm acting holier than thou?
690,5,9,47,61,1.3114754098360655,0.07941377977960633,526,Is a safe word really a necessity?
690,4,11,46,61,1.3114754098360655,0.07589532483264116,526,"Honestly, I always took your complaint that I was holier than thou as a compliment."
690,4,11,46,61,1.3114754098360655,0.07589532483264116,526,Marketing. You?
690,5,9,47,61,1.3114754098360655,0.07941377977960633,526,I know what you're thinking....and you're right.
690,3,13,45,61,1.3114754098360655,0.07220562473949259,526,Flattery even works on you-know-who.
690,4,11,46,61,1.3114754098360655,0.07589532483264116,526,I got it for my humility.
690,3,13,45,61,1.3114754098360655,0.07220562473949259,526,It looked bigger on your profile.
690,4,11,46,61,1.3114754098360655,0.07589532483264116,526,Of course that old saying is true! The bigger the halo the bigger the . . .
690,5,9,47,61,1.3114754098360655,0.07941377977960633,526,Good luck with getting through the pearly gates.
690,4,11,46,61,1.3114754098360655,0.07589532483264116,526,"Well, maybe just a bit holier-than-thou."
700,2,14,42,58,1.3103448275862069,0.07046168958066996,526,Loop hole.
700,4,10,44,58,1.3103448275862069,0.07857971146342174,526,Because Our Father likes me better.
700,5,8,45,58,1.3103448275862069,0.08233912636912401,526,"I'm no longer the last man on earth, so how about NOW?"
700,2,14,42,58,1.3103448275862069,0.07046168958066996,526,Unfortunately it is really heavy.
700,3,12,43,58,1.3103448275862069,0.07463116223213098,526,Does this halo make my head look small?
700,3,12,43,58,1.3103448275862069,0.07463116223213098,526,Not that size matters...
700,3,12,43,58,1.3103448275862069,0.07463116223213098,526,"I invented the ""hula-hoop"", St. Peter thought this would be funny!"
700,5,8,45,58,1.3103448275862069,0.08233912636912401,526,Because I never once wrote anything in the comments section.
700,5,8,45,58,1.3103448275862069,0.08233912636912401,526,What can I say? Size matters.
700,6,6,46,58,1.3103448275862069,0.0859342330435696,526,St. Peter likes geometry teachers.
700,6,6,46,58,1.3103448275862069,0.0859342330435696,526,The halo gap is just a statistical illusion.
700,4,10,44,58,1.3103448275862069,0.07857971146342174,526,I never posted anything about Donald Trump to Facebook.
700,4,10,44,58,1.3103448275862069,0.07857971146342174,526,I was Trump's anger management coach.
700,2,14,42,58,1.3103448275862069,0.07046168958066996,526,I lost the weight and nothing fits anymore.
700,2,14,42,58,1.3103448275862069,0.07046168958066996,526,"""I just downloaded the 'Holier Than Thou' app."
700,5,8,45,58,1.3103448275862069,0.08233912636912401,526,"Oh, this? I ran a marathon and never talked about it."
700,4,10,44,58,1.3103448275862069,0.07857971146342174,526,Hoola Hoop accident. And you?
700,4,10,44,58,1.3103448275862069,0.07857971146342174,526,The mile high club is for amateurs.
700,3,12,43,58,1.3103448275862069,0.07463116223213098,526,How'd you know I was thinking of that?
700,5,8,45,58,1.3103448275862069,0.08233912636912401,526,My realm or yours?
700,4,10,44,58,1.3103448275862069,0.07857971146342174,526,What's an angel have to do to impress you?
700,4,10,44,58,1.3103448275862069,0.07857971146342174,526,"I wrote a scathing review of Monty Python's ""Life of Brian""."
700,3,12,43,58,1.3103448275862069,0.07463116223213098,526,It was first prize in the Holier Than Thou contest.
700,1,16,41,58,1.3103448275862069,0.06602945570733365,526,I suppose you could say I'm holier than thou.
700,6,6,46,58,1.3103448275862069,0.0859342330435696,526,"Frankly, I'd rather have a penis."
700,6,6,46,58,1.3103448275862069,0.0859342330435696,526,Does this robe make my halo look big?
700,3,12,43,58,1.3103448275862069,0.07463116223213098,526,"Enough about my halo, what do you think about it?"
700,6,6,46,58,1.3103448275862069,0.0859342330435696,526,"So, when all is said and done, size DOES matter"
700,6,6,46,58,1.3103448275862069,0.0859342330435696,526,"It’s the biggest, greatest, most-terrific halo heaven has ever seen—that I can tell you—because God loves me—really, everybody loves me, it’s terrific, everyone loves me, but mostly God loves me—it’s incredible…"
700,4,10,44,58,1.3103448275862069,0.07857971146342174,526,"So you must be the Virgin Gary, am I right?"
700,2,14,42,58,1.3103448275862069,0.07046168958066996,526,You're busy for the next million weekends?
700,3,12,43,58,1.3103448275862069,0.07463116223213098,526,It's the Trump model.
700,5,8,45,58,1.3103448275862069,0.08233912636912401,526,"Then she asked, ""Is that your halo or are you just glad to see me?"""
700,5,8,45,58,1.3103448275862069,0.08233912636912401,526,"Yes I get that reaction a lot, but I'm more than that."
700,3,12,43,58,1.3103448275862069,0.07463116223213098,526,I was surprised to find a Costco up here
700,4,10,44,58,1.3103448275862069,0.07857971146342174,526,Wow! Didn't expect to see you here.
700,3,12,43,58,1.3103448275862069,0.07463116223213098,526,"It's not what you do, it's who you know."
700,4,10,44,58,1.3103448275862069,0.07857971146342174,526,"There is a glass Ceiling here too, I'm afraid."
700,4,10,44,58,1.3103448275862069,0.07857971146342174,526,"If this halo lasts more than four hours, we should call a doctor."
700,4,10,44,58,1.3103448275862069,0.07857971146342174,526,"What, if anything, would lead you to think I'm exaggerating?"
700,5,8,45,58,1.3103448275862069,0.08233912636912401,526,I'll have to have you meet my Father first.
700,5,8,45,58,1.3103448275862069,0.08233912636912401,526,You know what they say about large halos...
700,4,10,44,58,1.3103448275862069,0.07857971146342174,526,I just think He understands that making good choices is harder for men.
700,2,14,42,58,1.3103448275862069,0.07046168958066996,526,"On the positive side, it brings in overseas television."
700,3,12,43,58,1.3103448275862069,0.07463116223213098,526,I did some extra credit.
700,5,8,45,58,1.3103448275862069,0.08233912636912401,526,"Of course, men have perks everywhere."
700,4,10,44,58,1.3103448275862069,0.07857971146342174,526,Someone's idea of a joke. . . I used to own a Big & Tall store.
700,4,10,44,58,1.3103448275862069,0.07857971146342174,526,"Oh, nothing special; I never littered."
700,7,4,47,58,1.3103448275862069,0.0893848593797769,526,"And likewise, a big hello too you."
700,4,10,44,58,1.3103448275862069,0.07857971146342174,526,"Apparently, I brought my ego with me."
700,5,8,45,58,1.3103448275862069,0.08233912636912401,526,I never masturbated.
700,4,10,44,58,1.3103448275862069,0.07857971146342174,526,I used to sell Viagra.
752,6,5,44,55,1.309090909090909,0.08941533727810395,526,I may have to seek medical help if this lasts for more than 4 hours.
752,4,9,42,55,1.309090909090909,0.08153711543681037,526,"Hula Hoop champ, Fresno, '64."
752,2,13,40,55,1.309090909090909,0.07281139915531354,526,Now I really am 'holier than thou.'
752,3,11,41,55,1.309090909090909,0.07729748068569291,526,I'm off to a Kentucky derby party!
752,6,5,44,55,1.309090909090909,0.08941533727810395,526,I was fitted in the 80s when my hair was bigger.
752,4,9,42,55,1.309090909090909,0.08153711543681037,526,I don't date dead women.
758,4,8,40,52,1.3076923076923077,0.08481397236506516,526,"Well, actually I died falling through an open manhole..."
759,5,9,48,62,1.3064516129032258,0.07828377806886798,526,"Forgive me for saying so, but that was one HELL of a first date."
759,5,9,48,62,1.3064516129032258,0.07828377806886798,526,Sorry to be holier than thou.
759,5,9,48,62,1.3064516129032258,0.07828377806886798,526,"Hey, great wings."
762,1,13,35,49,1.3061224489795917,0.07263318538796812,526,Am I in heaven or are you in Hell?
763,3,12,44,59,1.305084745762712,0.07354367209702453,526,I actually listened to telemarketers
763,3,12,44,59,1.305084745762712,0.07354367209702453,526,I doubled my PBS contribution *many* times.
763,5,8,46,59,1.305084745762712,0.08110227356494051,526,"It's bigger than the Halo 5S, but it takes better pictures."
763,3,12,44,59,1.305084745762712,0.07354367209702453,526,My therapist thinks I might be having a mid-death crisis.
763,5,8,46,59,1.305084745762712,0.08110227356494051,526,I guess it's because I once fired Donald Trump
763,5,8,46,59,1.305084745762712,0.08110227356494051,526,It doubles as a holy hula hoop.
763,2,14,43,59,1.305084745762712,0.0694565919806808,526,Never hurts to ask for an upgrade...
763,4,10,45,59,1.305084745762712,0.07741527782975759,526,"It's about humility, but I can't go into details or it would be smaller."
763,5,8,46,59,1.305084745762712,0.08110227356494051,526,I AM holier than thou. Isn't it obvious?
763,3,12,44,59,1.305084745762712,0.07354367209702453,526,I voted my conscience at the Republican Convention.
763,1,16,42,59,1.305084745762712,0.0651134750541459,526,And you thought earning 77 cents for every dollar on earth wasn't fair.
763,4,10,45,59,1.305084745762712,0.07741527782975759,526,"Yes, I am the person who invented s'mores."
763,4,10,45,59,1.305084745762712,0.07741527782975759,526,"Yes, I know women say size doesn't matter."
763,4,10,45,59,1.305084745762712,0.07741527782975759,526,It makes my shorter wings less noticeable.
763,4,10,45,59,1.305084745762712,0.07741527782975759,526,This is not the place for halo envy.
763,4,10,45,59,1.305084745762712,0.07741527782975759,526,It gives meaning to holier than thou.
763,2,14,43,59,1.305084745762712,0.0694565919806808,526,It's been more than four hours and I can't find a doctor.
763,4,10,45,59,1.305084745762712,0.07741527782975759,526,"As a matter of fact, I am the one percent."
763,6,6,47,59,1.305084745762712,0.08462879127901062,526,They gave it to me for creating a cure for Donald Trump.
763,3,12,44,59,1.305084745762712,0.07354367209702453,526,Just before I died I took a Viagra.
763,2,14,43,59,1.305084745762712,0.0694565919806808,526,Don't be impressed. It's a hula hoop.
763,3,12,44,59,1.305084745762712,0.07354367209702453,526,would you like to go somewhere and help me make this thing get smaller?
763,4,10,45,59,1.305084745762712,0.07741527782975759,526,How the hell did you get in here?
763,3,12,44,59,1.305084745762712,0.07354367209702453,526,"So I said to Peter, 'I did save all the children in the fire, AND I went back for Spot.' Earthly-speaking, that didn't work out for me, but..."
763,6,6,47,59,1.305084745762712,0.08462879127901062,526,Of course this is what I meant when I said said that size matters!
763,4,10,45,59,1.305084745762712,0.07741527782975759,526,I found the slim-fit uncomfortable.
763,3,12,44,59,1.305084745762712,0.07354367209702453,526,"Actually, nothing special. Apparently this is the size you get if you've led an incredibly boring life."
790,2,13,41,56,1.3035714285714286,0.07171209962001492,526,"Yep, I won the hula-hoop contest last night!"
790,2,13,41,56,1.3035714285714286,0.07171209962001492,526,"Yes, in spite of my small hands."
790,5,7,44,56,1.3035714285714286,0.08420615880066548,526,It was really hell getting this good.
790,4,9,43,56,1.3035714285714286,0.08025787519372939,526,"Yes, even here."
790,3,11,42,56,1.3035714285714286,0.07610503190500345,526,"It's not the size of your halo, it's how you use it."
790,4,9,43,56,1.3035714285714286,0.08025787519372939,526,"You know, even up here they say size matters."
790,4,9,43,56,1.3035714285714286,0.08025787519372939,526,It's a halo affect.
790,4,9,43,56,1.3035714285714286,0.08025787519372939,526,I know what your thinking ... and that's sinful.
790,4,9,43,56,1.3035714285714286,0.08025787519372939,526,What gender gap?
790,3,11,42,56,1.3035714285714286,0.07610503190500345,526,Guess this settles it. God is a man.
790,5,7,44,56,1.3035714285714286,0.08420615880066548,526,"According to God, size actually does matter."
801,3,10,40,53,1.3018867924528301,0.07893019118245996,526,I believe you're confusing big halo with big hands.
801,5,6,42,53,1.3018867924528301,0.08764333340288386,526,Everything is bigger in heaven.
803,3,13,47,63,1.3015873015873016,0.07023813139859228,526,I assure you I'm not compensating for anything.
803,5,9,49,63,1.3015873015873016,0.07718458811550716,526,You'd think up here it wouldn't matter but..
805,6,6,48,60,1.3,0.08336157713463008,526,I found the halo on Hulu in Hilo: it's a holy hula
805,2,14,44,60,1.3,0.06847821213147406,526,Ever since i went solar.
805,4,10,46,60,1.3,0.0762837403353298,526,"No. For your information, this doesn't mean I died a virgin."
805,1,16,43,60,1.3,0.06422066478409214,526,"It may look impressive, but I haven't been able to sleep a wink in eighty years."
805,2,14,44,60,1.3,0.06847821213147406,526,"It's not the size, it's the...no wait, it is the size."
805,4,10,46,60,1.3,0.0762837403353298,526,I staid out of politics.
805,4,10,46,60,1.3,0.0762837403353298,526,What matters is what you do with it.
805,2,14,44,60,1.3,0.06847821213147406,526,Heart attack during a hula hoop competition. You?
813,5,7,45,57,1.2982456140350878,0.08288694583535684,526,"Who's ""holier than thou"" now?"
813,4,9,44,57,1.2982456140350878,0.07901695624277917,526,Class of '16 Halodictorian!
813,4,9,44,57,1.2982456140350878,0.07901695624277917,526,"Actually, I have very large hands, too."
813,2,13,42,57,1.2982456140350878,0.070643800448398,526,You wouldn't believe the hoops I had to jump through to get in here!
813,1,15,41,57,1.2982456140350878,0.06606042783507368,526,It doesn't mean that I'm no fun.
813,1,15,41,57,1.2982456140350878,0.06606042783507368,526,Just one of several hoops I had to jump through to get here.
813,5,7,45,57,1.2982456140350878,0.08288694583535684,526,"Yes, you had to put with me your whole life, but I had to put up with your mother."
813,1,15,41,57,1.2982456140350878,0.06606042783507368,526,I always put the shopping cart in the corral.
813,3,11,43,57,1.2982456140350878,0.07494740127471518,526,"Well, honey, you know what they say...."
813,5,7,45,57,1.2982456140350878,0.08288694583535684,526,"Yes, it's big. But we don't have envy here in heaven."
813,2,13,42,57,1.2982456140350878,0.070643800448398,526,I didn't realize they were asking for my size in cubits.
813,3,11,43,57,1.2982456140350878,0.07494740127471518,526,"Please, let me explain the meaning of sanctimonious."
813,3,11,43,57,1.2982456140350878,0.07494740127471518,526,So my mother was right--I AM the real saint in our marriage.
813,4,9,44,57,1.2982456140350878,0.07901695624277917,526,I resigned from Trump's staff.
813,5,7,45,57,1.2982456140350878,0.08288694583535684,526,So you're saying size STILL matters?
813,4,9,44,57,1.2982456140350878,0.07901695624277917,526,What halo gap?
813,5,7,45,57,1.2982456140350878,0.08288694583535684,526,"I don't like to brag, but yeah, I'm really good..."
813,3,11,43,57,1.2982456140350878,0.07494740127471518,526,"It's the Harvard difference, my dear."
813,2,13,42,57,1.2982456140350878,0.070643800448398,526,"Yah, I just saved a busload of orphans. How'd you get yours?"
813,3,11,43,57,1.2982456140350878,0.07494740127471518,526,"I've tried shrinking it, but my ego keeps getting in the way."
813,4,9,44,57,1.2982456140350878,0.07901695624277917,526,I had halo enlargement surgery.
813,4,9,44,57,1.2982456140350878,0.07901695624277917,526,I call it a 'Halo-Hoop'. Patent pending.
813,3,11,43,57,1.2982456140350878,0.07494740127471518,526,"Yes, how did you know I'm from Texas?"
813,1,15,41,57,1.2982456140350878,0.06606042783507368,526,"No, I'm not overcompensating for anything."
813,3,11,43,57,1.2982456140350878,0.07494740127471518,526,I am aroused. How did you know?
813,5,7,45,57,1.2982456140350878,0.08288694583535684,526,Midlife crisis? That's impossible.
813,3,11,43,57,1.2982456140350878,0.07494740127471518,526,I guess some of us are a little more angelic than others.
813,4,9,44,57,1.2982456140350878,0.07901695624277917,526,"I'm afraid we don't count ""Victoria's Secret"" as previous experience."
813,4,9,44,57,1.2982456140350878,0.07901695624277917,526,I always knew God would compensate me one day. I just didn't think it would be here.
813,3,11,43,57,1.2982456140350878,0.07494740127471518,526,I may have stretched things a little with St. Peter.
813,4,9,44,57,1.2982456140350878,0.07901695624277917,526,it was just diet and exercise.
813,3,11,43,57,1.2982456140350878,0.07494740127471518,526,Size will always matter.
813,2,13,42,57,1.2982456140350878,0.070643800448398,526,I died a virgin.
813,6,5,46,57,1.2982456140350878,0.08658413368483558,526,Ironically I got it for not manspreading.
813,2,13,42,57,1.2982456140350878,0.070643800448398,526,"Yes I know, the big halo was not worth the life of celibacy"
813,3,11,43,57,1.2982456140350878,0.07494740127471518,526,"No. This time, it's because I'm happy to see you."
813,1,15,41,57,1.2982456140350878,0.06606042783507368,526,Enough of my holier-than-though attitude? I AM holier than thou.
850,2,12,40,54,1.2962962962962963,0.07301833256126636,526,"Yes, well, evidently just getting here at all after 20 years in Congress is deemed worthy of special recognition."
850,1,14,39,54,1.2962962962962963,0.06806515165972199,526,Are you one of Charlie's?
850,3,10,41,54,1.2962962962962963,0.07765622260704179,526,"Around here, I'm known as God's gift to women."
850,1,14,39,54,1.2962962962962963,0.06806515165972199,526,I suppose you prefer bad boys.
850,3,10,41,54,1.2962962962962963,0.07765622260704179,526,Hi I'm Brian but all my friends up here call me Lord of the Ring.
850,4,8,42,54,1.2962962962962963,0.08203231637081305,526,It’s not an attitude – I actually am ‘all holier than thou’.
850,2,12,40,54,1.2962962962962963,0.07301833256126636,526,Want to come over and see my miracle collection?
850,4,8,42,54,1.2962962962962963,0.08203231637081305,526,I showed Him how to put on voicemail.
858,3,9,39,51,1.2941176470588236,0.08065476000471818,526,"Actually, it's an escape hatch."
859,3,11,44,58,1.293103448275862,0.07382317573945477,526,I died in 1520 - back when a little cash could buy you a bigger halo.
859,2,13,43,58,1.293103448275862,0.06960532018964113,526,"Yes, I am God's gift."
859,2,13,43,58,1.293103448275862,0.06960532018964113,526,I never drop a call.
859,3,11,44,58,1.293103448275862,0.07382317573945477,526,Halo. How are you?
859,5,7,46,58,1.293103448275862,0.08160749126992167,526,"It's not the size that counts, it's how you use it."
859,2,13,43,58,1.293103448275862,0.06960532018964113,526,My father is kind of a big wheel around here.
859,3,11,44,58,1.293103448275862,0.07382317573945477,526,"No, nothing like that. It's just a hula hoop."
859,4,9,45,58,1.293103448275862,0.07781273644985365,526,"Unfortunately for you, the gender gap is eternal."
859,0,17,41,58,1.293103448275862,0.06029078904435193,526,I always ate all my vegetables.
859,2,13,43,58,1.293103448275862,0.06960532018964113,526,"It's called ""male enhancement""."
859,5,7,46,58,1.293103448275862,0.08160749126992167,526,My shrink says overcompensation is common during an afterlife crisis.
859,1,15,42,58,1.293103448275862,0.06511482105593554,526,You know what they say...the bigger your halo...
859,4,9,45,58,1.293103448275862,0.07781273644985365,526,It cost a bunch extra but was totally worth it.
859,2,13,43,58,1.293103448275862,0.06960532018964113,526,"Oh, this old thing? Why, thank you."
859,5,7,46,58,1.293103448275862,0.08160749126992167,526,I died in a freak Hoola Hoop accident.
859,3,11,44,58,1.293103448275862,0.07382317573945477,526,No dunking.
859,4,9,45,58,1.293103448275862,0.07781273644985365,526,I got it on line from Lane Bryant.
859,2,13,43,58,1.293103448275862,0.06960532018964113,526,"Don't be silly, of course I'm not holier than YOU."
859,5,7,46,58,1.293103448275862,0.08160749126992167,526,"Well, I wouldn't say 'than most,' but certainly 'than thou...'"
859,3,11,44,58,1.293103448275862,0.07382317573945477,526,Costco.
859,3,11,44,58,1.293103448275862,0.07382317573945477,526,You were expecting halo equality?
859,3,11,44,58,1.293103448275862,0.07382317573945477,526,I got in before steroids were banned.
881,2,12,41,55,1.290909090909091,0.07188059343295837,526,HE knew I invented the Hula Hoop.
881,3,10,42,55,1.290909090909091,0.07642133462374844,526,"So, do you want to see my harp?"
881,2,12,41,55,1.290909090909091,0.07188059343295837,526,I'm scheduled for halo reduction surgery.
881,4,8,43,55,1.290909090909091,0.08070700749671991,526,"In my previous life, I was president of Wham-O"
881,3,10,42,55,1.290909090909091,0.07642133462374844,526,"What do you mean ""overcompensating""?"
881,2,12,41,55,1.290909090909091,0.07188059343295837,526,I brought my ego with me.
881,1,14,40,55,1.290909090909091,0.06703296979004872,526,"It was my reward. In my former life, I had small hands!"
881,4,8,43,55,1.290909090909091,0.08070700749671991,526,"Yes, there is a gender-gap in the standard compensation for good works."
881,3,10,42,55,1.290909090909091,0.07642133462374844,526,"You get it at 250,000 prayer miles."
881,3,10,42,55,1.290909090909091,0.07642133462374844,526,I'm the patron saint of hula hoopers.
881,4,8,43,55,1.290909090909091,0.08070700749671991,526,"Yes, bigger hands...keep going."
881,3,10,42,55,1.290909090909091,0.07642133462374844,526,"Hey, my eyes are down here. Do you think you are the first angel to stare at my halo?"
881,3,10,42,55,1.290909090909091,0.07642133462374844,526,"Now that I live in the cloud, I thought I’d splurge and go for the iHalo 6 Plus."
881,3,10,42,55,1.290909090909091,0.07642133462374844,526,Looks like the holes in the glass ceiling are no different here.
881,3,10,42,55,1.290909090909091,0.07642133462374844,526,"Actually, it's a curse."
881,3,10,42,55,1.290909090909091,0.07642133462374844,526,I left a big tip at the Gates...
881,1,14,40,55,1.290909090909091,0.06703296979004872,526,All they had left was XXL.
881,3,10,42,55,1.290909090909091,0.07642133462374844,526,Nice try but I still don't think you're getting in.
881,4,8,43,55,1.290909090909091,0.08070700749671991,526,There's nothing wrong with Costco
881,5,6,44,55,1.290909090909091,0.08477630407417085,526,I'm not really that holy. I'm just good at levitating hula hoops.
881,2,12,41,55,1.290909090909091,0.07188059343295837,526,"I know there are differences, but we can work it out."
881,4,8,43,55,1.290909090909091,0.08070700749671991,526,"It turns out they're real sticklers about ""ten items or less."""
881,6,4,45,55,1.290909090909091,0.08865902326259269,526,Because I'm holier-than-thou.
881,2,12,41,55,1.290909090909091,0.07188059343295837,526,"I try not to come across as 'holier than thou,' but this makes it difficult."
881,3,10,42,55,1.290909090909091,0.07642133462374844,526,"Free installation with wi-fi, $49.99/mo. for 2 years...but then..."
881,1,14,40,55,1.290909090909091,0.06703296979004872,526,"In your picture, your wings looked bigger."
881,3,10,42,55,1.290909090909091,0.07642133462374844,526,You wouldn't believe the number of candles I lit.
881,3,10,42,55,1.290909090909091,0.07642133462374844,526,"Why yes, I have been very, very good."
881,5,6,44,55,1.290909090909091,0.08477630407417085,526,I'm not that good. I just invented the hula hoop.
881,3,10,42,55,1.290909090909091,0.07642133462374844,526,I've been blessed.
881,5,6,44,55,1.290909090909091,0.08477630407417085,526,It's because I was gluten free.
881,4,8,43,55,1.290909090909091,0.08070700749671991,526,"I saw it on ""As seen on TV"". Shipping was hell though."
913,2,11,39,52,1.2884615384615385,0.07438302518417335,526,Having a great publicist is only part of the equation
913,3,9,40,52,1.2884615384615385,0.07929049280033962,526,I'm pretty sure that size does matter up here...
915,2,13,44,59,1.2881355932203389,0.0685955265593542,526,Saint Viagra.
916,2,12,42,56,1.2857142857142858,0.07077624204383748,526,It was a trend in the 50's!
916,0,16,40,56,1.2857142857142858,0.06091449038731727,526,I took a bullet protecting the Pope.
916,4,8,44,56,1.2857142857142858,0.07942277844893847,526,I doubled my contribution to PBS.
916,3,10,43,56,1.2857142857142858,0.07522384653285497,526,"Why, halo there..."
916,5,6,45,56,1.2857142857142858,0.08341060116016318,526,Just my luck! I'm incapable of having impure thoughts.
916,2,14,47,63,1.2857142857142858,0.06569402390274377,526,But who had more fun?
916,4,8,44,56,1.2857142857142858,0.07942277844893847,526,"I'm sure more people would remember public television in their will if they knew about this ""Halo Benefit""."
916,4,8,44,56,1.2857142857142858,0.07942277844893847,526,"Fooled me too, I thought I was going there as well."
916,2,12,42,56,1.2857142857142858,0.07077624204383748,526,It used to be my waistband.
916,5,6,45,56,1.2857142857142858,0.08341060116016318,526,I'm the only one who can make Heaven great again.
916,2,12,42,56,1.2857142857142858,0.07077624204383748,526,I got my first promotion.
916,3,10,43,56,1.2857142857142858,0.07522384653285497,526,I had it made to fit my ego.
916,1,14,41,56,1.2857142857142858,0.06602973412408396,526,Stop accusing me of taking a holier-than-thou attitude.
916,3,10,43,56,1.2857142857142858,0.07522384653285497,526,I can't help it. It grows every time I see you with those beautiful feathered wings.
916,1,14,41,56,1.2857142857142858,0.06602973412408396,526,"It's not mine, I fell through it"
916,2,12,42,56,1.2857142857142858,0.07077624204383748,526,Does it make my ears look smaller
916,4,8,44,56,1.2857142857142858,0.07942277844893847,526,Up here it's the only thing on me that gets bigger when I see a pretty girls.
916,3,10,43,56,1.2857142857142858,0.07522384653285497,526,"Well, I did jump through quite a few hoops to achieve this."
916,3,10,43,56,1.2857142857142858,0.07522384653285497,526,"Yeah, the rest were on backorder, so I had to go with the XXXL."
916,4,8,44,56,1.2857142857142858,0.07942277844893847,526,I'm kind of a big wheel around here.
916,4,8,44,56,1.2857142857142858,0.07942277844893847,526,Mine's bigger than Peters.
916,4,8,44,56,1.2857142857142858,0.07942277844893847,526,My father being an archangel had nothing to do with it. I earned this halo.
916,4,8,44,56,1.2857142857142858,0.07942277844893847,526,"Holier than Thou. No, why do you ask?"
916,3,10,43,56,1.2857142857142858,0.07522384653285497,526,"Guess who won this year's ""Holier than Thou"" contest?"
916,5,6,45,56,1.2857142857142858,0.08341060116016318,526,Peter said I got in through a loophole the size of a hula hoop.
916,5,6,45,56,1.2857142857142858,0.08341060116016318,526,Compensating for what?
916,2,12,42,56,1.2857142857142858,0.07077624204383748,526,Yes. The smaller one does make you look thinner.
916,2,12,42,56,1.2857142857142858,0.07077624204383748,526,It's not sexism. I was just a better person.
916,3,10,43,56,1.2857142857142858,0.07522384653285497,526,What's the value of a great points program if you never get to turn them in?
916,3,10,43,56,1.2857142857142858,0.07522384653285497,526,You know what they say about an angel with a big halo?
916,4,8,44,56,1.2857142857142858,0.07942277844893847,526,So now I know what happens when an erection lasts longer than four hours.
916,3,10,43,56,1.2857142857142858,0.07522384653285497,526,"No, it's not natural. I had it enlarged."
916,4,8,44,56,1.2857142857142858,0.07942277844893847,526,"Believe me, if the two were connected, I wouldn't be standing here right now."
916,4,8,44,56,1.2857142857142858,0.07942277844893847,526,It helps with my poor self-esteem.
916,4,8,44,56,1.2857142857142858,0.07942277844893847,526,I summer on cloud ten.
916,3,10,43,56,1.2857142857142858,0.07522384653285497,526,I never took home a single office supply.
916,2,12,42,56,1.2857142857142858,0.07077624204383748,526,It doubles as a wormhole.
916,3,10,43,56,1.2857142857142858,0.07522384653285497,526,Let's just say a Certain Somebody was grateful I got some of His associatess out of the tech and home loan bubbles just in time.
916,2,12,42,56,1.2857142857142858,0.07077624204383748,526,He liked it so he put a ring on it.
916,3,10,43,56,1.2857142857142858,0.07522384653285497,526,"Its a hole in the ozone, not a halo."
916,2,12,42,56,1.2857142857142858,0.07077624204383748,526,"They promised more radiance, but all I get is curious looks"
916,4,8,44,56,1.2857142857142858,0.07942277844893847,526,It's because I never signed up for Facebook.
916,3,10,43,56,1.2857142857142858,0.07522384653285497,526,Quite right. Holier than thou.
916,3,10,43,56,1.2857142857142858,0.07522384653285497,526,Mine is actually a hula hoop.
916,2,12,42,56,1.2857142857142858,0.07077624204383748,526,I gave up dairy.
916,4,8,44,56,1.2857142857142858,0.07942277844893847,526,Hi sweet wings. I like girls who aren't complete angels.
916,5,6,45,56,1.2857142857142858,0.08341060116016318,526,I died in a sombrero.
916,3,10,43,56,1.2857142857142858,0.07522384653285497,526,No I really am a Virgin
916,4,8,44,56,1.2857142857142858,0.07942277844893847,526,"Yeah, even in Heaven there's a Gender Gap !"
916,3,10,43,56,1.2857142857142858,0.07522384653285497,526,"Yeah, I'll say it: holier than thou."
916,1,14,41,56,1.2857142857142858,0.06602973412408396,526,I can't begin to tell you how many hoops I jumped through to get in here.
916,3,10,43,56,1.2857142857142858,0.07522384653285497,526,It turns out 'holier than thou' is a thing.
916,1,14,41,56,1.2857142857142858,0.06602973412408396,526,Well - the frequent flier points help.
916,5,6,45,56,1.2857142857142858,0.08341060116016318,526,"""Yes, you had to put up with me your whole life, but I had to put up with your mother."" (I submitted this under my another email but it had a typo so I'm resubmitting under this email)"
916,1,14,41,56,1.2857142857142858,0.06602973412408396,526,My head has shrunk considerably since I arrived here.
916,5,6,45,56,1.2857142857142858,0.08341060116016318,526,"So, do you come up here often?"
916,4,8,44,56,1.2857142857142858,0.07942277844893847,526,"You know what they say about men with big halos, right?"
916,2,12,42,56,1.2857142857142858,0.07077624204383748,526,Why did I expect things to be different up here?
916,5,6,45,56,1.2857142857142858,0.08341060116016318,526,Apparently size does matter.
916,2,12,42,56,1.2857142857142858,0.07077624204383748,526,"Actually, it's more of a curse."
916,3,10,43,56,1.2857142857142858,0.07522384653285497,526,"Well, of course it's a sin to brag, but I'm very... very...good."
916,2,12,42,56,1.2857142857142858,0.07077624204383748,526,Do they shrink the longer you've been here?
916,2,12,42,56,1.2857142857142858,0.07077624204383748,526,Holier than thou? I get that a lot.
979,4,7,42,53,1.2830188679245282,0.08249272515124054,526,"This halo would be shrinking, if He knew what I was thinking!!"
979,5,5,43,53,1.2830188679245282,0.08677983122715094,526,... and that's the story of me sleeping with three other guys in Bali that summer.
979,3,9,41,53,1.2830188679245282,0.0779702526476824,526,Please don't think I'm compensating.
979,4,7,42,53,1.2830188679245282,0.08249272515124054,526,I'm afraid that we're incompatible
979,2,11,40,53,1.2830188679245282,0.07316878359661814,526,It's not a halo it's an exit.
979,3,9,41,53,1.2830188679245282,0.0779702526476824,526,It's all silicone and only one week recovery.
979,3,9,41,53,1.2830188679245282,0.0779702526476824,526,Mine is a portal
979,3,9,41,53,1.2830188679245282,0.0779702526476824,526,...AND ... my dog was a rescue.
979,4,7,42,53,1.2830188679245282,0.08249272515124054,526,I was so surprised to find out that size does matter.
979,3,9,41,53,1.2830188679245282,0.0779702526476824,526,"Yeah, I'm vegan...is it obvious?"
989,5,12,61,78,1.2820512820512822,0.0655351085197591,526,"Well, you know what they say, the bigger the halo..."
990,4,8,45,57,1.280701754385965,0.07817781433825675,526,Halo? No. Ozone layer.
990,1,14,42,57,1.280701754385965,0.06505437269382161,526,"Yea, you can see how well gender equality works here."
990,3,10,44,57,1.280701754385965,0.0740621646906627,526,Why in Heaven's name would you ask about equal pay now?
990,3,10,44,57,1.280701754385965,0.0740621646906627,526,I was just too good to be true!
990,2,12,43,57,1.280701754385965,0.0697039297502425,526,I ordered from the secret menu.
990,3,10,44,57,1.280701754385965,0.0740621646906627,526,It's called an iHalo 6 plus - some guy called Steve sold it to me
990,4,8,45,57,1.280701754385965,0.07817781433825675,526,My doctor said I should keep an eye on it.
990,4,8,45,57,1.280701754385965,0.07817781433825675,526,Turns out Viagra is the one thing you CAN take with you...
990,3,10,44,57,1.280701754385965,0.0740621646906627,526,People say I'm a dead ringer.
990,1,14,42,57,1.280701754385965,0.06505437269382161,526,It will be the same size as yours when the Viagra wears off.
990,3,10,44,57,1.280701754385965,0.0740621646906627,526,"When I'm bad, I'm bad, but when I'm good, I'm very, very good."
990,3,10,44,57,1.280701754385965,0.0740621646906627,526,"Yes, it's true, even this is a man's world."
990,4,8,45,57,1.280701754385965,0.07817781433825675,526,"Why, yes, thank you. I am holier than thou."
990,3,10,44,57,1.280701754385965,0.0740621646906627,526,"No,no, not a halo; just a hole I dropped through."
990,4,8,45,57,1.280701754385965,0.07817781433825675,526,They have a Costco.
990,2,12,43,57,1.280701754385965,0.0697039297502425,526,I was always told I'd get my reward in heaven.
990,3,10,44,57,1.280701754385965,0.0740621646906627,526,It helps me move in larger circles.
990,1,14,42,57,1.280701754385965,0.06505437269382161,526,I had a Groupon for it.
990,2,12,43,57,1.280701754385965,0.0697039297502425,526,I've never heard of halo envy.
990,4,8,45,57,1.280701754385965,0.07817781433825675,526,Wait until you see my hands.
990,5,6,46,57,1.280701754385965,0.08208737461234245,526,"It's not the size of the halo but the motion of the devotion, baby."
990,2,12,43,57,1.280701754385965,0.0697039297502425,526,"I made it myself, in shop class."
990,4,8,45,57,1.280701754385965,0.07817781433825675,526,"Even here, size still counts!"
990,3,10,44,57,1.280701754385965,0.0740621646906627,526,"I'm not one to brag, but I did invent the hula hoop."
990,3,10,44,57,1.280701754385965,0.0740621646906627,526,"What are you talking about? If anything, I'm UNDER compensating."
990,3,10,44,57,1.280701754385965,0.0740621646906627,526,"Yeah, seems we've been working on this Halo Equity Gap for, like, eternity"
990,4,8,45,57,1.280701754385965,0.07817781433825675,526,Why yes! I am from Utah. How could you tell?
990,2,12,43,57,1.280701754385965,0.0697039297502425,526,Overcompensating for what?
990,2,12,43,57,1.280701754385965,0.0697039297502425,526,It's called the halo effect.
990,4,8,45,57,1.280701754385965,0.07817781433825675,526,AngelsMingle.com
990,3,10,44,57,1.280701754385965,0.0740621646906627,526,"For just a little more, I super-sized it."
990,3,10,44,57,1.280701754385965,0.0740621646906627,526,Who knew it would stretch when all my sins were washed clean?
990,4,8,45,57,1.280701754385965,0.07817781433825675,526,Do you know that you have a heavenly body?
990,3,10,44,57,1.280701754385965,0.0740621646906627,526,It's a loaner while mine's in the shop
990,5,6,46,57,1.280701754385965,0.08208737461234245,526,"Yeah, I died a virgin. How 'bout you?"
990,2,12,43,57,1.280701754385965,0.0697039297502425,526,Viagra? No. Why do you ask?
990,3,10,44,57,1.280701754385965,0.0740621646906627,526,"God’s got a good sense of humor. On Earth, I was the hula hoop champion."
990,2,12,43,57,1.280701754385965,0.0697039297502425,526,So there's a halo gap in heaven?
990,4,8,45,57,1.280701754385965,0.07817781433825675,526,Welcome to heaven as it is on earth.
990,2,12,43,57,1.280701754385965,0.0697039297502425,526,I was a loophole lawyer.
1030,3,11,47,61,1.278688524590164,0.0706377951937,526,I had to jump through several big hoops to get here.
1031,2,11,41,54,1.2777777777777777,0.07199205381003258,526,"""Now if I remember correctly, you got our house, summer home, and the sailboat. I got to keep my tools and the Porsche""."
1031,2,11,41,54,1.2777777777777777,0.07199205381003258,526,"Well, I don't want to sound holier than thou..."
1031,3,9,42,54,1.2777777777777777,0.07669203238507481,526,"And when I get bored, I use it as a hula hoop."
1031,4,7,43,54,1.2777777777777777,0.08112015687189036,526,"Honestly, I’m not one to let size go to my head."
1031,1,13,40,54,1.2777777777777777,0.06696300316010245,526,"Sure, the upgrade was so expensive I had to take out a loan, but I literally have an eternity to pay it back."
1031,2,11,41,54,1.2777777777777777,0.07199205381003258,526,I do not have a holier-than-thou attitude.
1031,4,7,43,54,1.2777777777777777,0.08112015687189036,526,Not even God could get Hamilton tickets without cashing in a favor
1031,3,9,42,54,1.2777777777777777,0.07669203238507481,526,"Hula hoop champion, 1964."
1031,3,9,42,54,1.2777777777777777,0.07669203238507481,526,The platinum package also included extra wings and an after-lifetime guarantee.
1031,2,11,41,54,1.2777777777777777,0.07199205381003258,526,Are you telling me size doesn’t matter here?
1031,3,9,42,54,1.2777777777777777,0.07669203238507481,526,I swear... it never crossed my mind.
1031,2,11,41,54,1.2777777777777777,0.07199205381003258,526,"Yeah, maybe one day, women will have halos the same size as men."
1031,3,9,42,54,1.2777777777777777,0.07669203238507481,526,"Believe me, I'm no angel. I just fell through a open manhole!"
1031,3,9,42,54,1.2777777777777777,0.07669203238507481,526,It reflects my deep and fulfilling faith in female angels.
1031,1,13,40,54,1.2777777777777777,0.06696300316010245,526,They were all out of mediums.
1031,4,7,43,54,1.2777777777777777,0.08112015687189036,526,I also have really big hands.
1031,4,7,43,54,1.2777777777777777,0.08112015687189036,526,"""Well, a big 'hello' to you too!"
1031,5,5,44,54,1.2777777777777777,0.08531876622693765,526,"I won't say Holier than who, but you get the picture."
1031,3,9,42,54,1.2777777777777777,0.07669203238507481,526,I've been taking halo enhancement capsules I found on the internet.
1031,3,9,42,54,1.2777777777777777,0.07669203238507481,526,I know. This is just my ego.
1031,4,7,43,54,1.2777777777777777,0.08112015687189036,526,This is not what I meant when I prayed to become well endowed.
1031,0,15,39,54,1.2777777777777777,0.061524237278109795,526,"The size of my halo slows me down, but I do get better service."
1031,4,7,43,54,1.2777777777777777,0.08112015687189036,526,Does this halo make my ass look big?
1031,3,9,42,54,1.2777777777777777,0.07669203238507481,526,"Well, size matters here too. Sorry."
1031,4,7,43,54,1.2777777777777777,0.08112015687189036,526,"What they say is true; big halo, ....."
1031,2,11,41,54,1.2777777777777777,0.07199205381003258,526,""" It's actually a Hula hoop malfunction""."
1057,2,9,36,47,1.2765957446808511,0.0787396537971014,526,Yours was way larger before last night
1058,0,16,42,58,1.2758620689655173,0.05919966036406568,526,One of many hoops I had to jump through to get here.
1058,4,8,46,58,1.2758620689655173,0.0769704001382646,526,"""Halo affect"" trumps ""halo effect""."
1060,3,8,40,51,1.2745098039215685,0.07959914953013505,526,"OK, I admit it. I'm holier than thou"
1060,3,8,40,51,1.2745098039215685,0.07959914953013505,526,Because She likes me better than you.
1060,3,8,40,51,1.2745098039215685,0.07959914953013505,526,I supported Bernie.
1063,4,7,44,55,1.2727272727272727,0.079791586497501,526,"What do you mean I have a ""holyier than thou"" attitude?"
1063,2,11,42,55,1.2727272727272727,0.07085122390606133,526,I can see you were good but not too good.
1063,2,11,42,55,1.2727272727272727,0.07085122390606133,526,"Actually, it's a hula hoop. I didn't qualify for a halo."
1063,2,11,42,55,1.2727272727272727,0.07085122390606133,526,"To be honest, I'm a little sick of being good."
1063,2,11,42,55,1.2727272727272727,0.07085122390606133,526,"No, Honestly! I really was the guy who invented the Hula Hoop!"
1063,2,11,42,55,1.2727272727272727,0.07085122390606133,526,I need more personal space.
1063,3,9,43,55,1.2727272727272727,0.07545393695750746,526,Mine doubles as a hula-hoop.
1063,3,9,43,55,1.2727272727272727,0.07545393695750746,526,"And, a big Halo to you, sweetie!"
1063,4,7,44,55,1.2727272727272727,0.079791586497501,526,my death was magna cum laude
1063,4,7,44,55,1.2727272727272727,0.079791586497501,526,Think of it as the heavenly wage gap.
1063,3,9,43,55,1.2727272727272727,0.07545393695750746,526,That blue pill has strange side effects up here.
1063,2,11,42,55,1.2727272727272727,0.07085122390606133,526,"Take care, He disdains halo envy."
1063,4,7,44,55,1.2727272727272727,0.079791586497501,526,There just aren't that many ways to overcompensate up here.
1063,3,9,43,55,1.2727272727272727,0.07545393695750746,526,"Well, have you ever heard the saying ""On Earth as it is in Heaven""?"
1063,2,11,42,55,1.2727272727272727,0.07085122390606133,526,"I don't know if I'd call myself 'holier than though,' per se..."
1063,2,11,42,55,1.2727272727272727,0.07085122390606133,526,"Please forgive my, ""Holier than thou attitude."""
1063,3,9,43,55,1.2727272727272727,0.07545393695750746,526,How long did it take you to graduate from your safety halo?
1063,3,9,43,55,1.2727272727272727,0.07545393695750746,526,They ran out of halos last week so I got stuck with this hula hoop.
1063,1,13,41,55,1.2727272727272727,0.06592795503870998,526,My goodness grows when I'm near you!
1063,2,11,42,55,1.2727272727272727,0.07085122390606133,526,It was only a dollar more to supersize it.
1063,3,9,43,55,1.2727272727272727,0.07545393695750746,526,I think it was my insistence on eating only sustainable arugula.
1063,2,11,42,55,1.2727272727272727,0.07085122390606133,526,You wanna ditch the halos and get out of here.
1063,3,9,43,55,1.2727272727272727,0.07545393695750746,526,I can tell when you're lying.
1063,3,9,43,55,1.2727272727272727,0.07545393695750746,526,It was cool for a while until I realized I was an atheist.
1063,3,9,43,55,1.2727272727272727,0.07545393695750746,526,Now drop the halo envy and fetch me a beer like the good Lord intended!
1063,5,5,45,55,1.2727272727272727,0.08390529154462702,526,I was the one who removed Mr. Trump's hairpiece at the convention!
1063,3,9,43,55,1.2727272727272727,0.07545393695750746,526,"Yeah, well I invented the hula hoop."
1063,3,9,43,55,1.2727272727272727,0.07545393695750746,526,"Don't get excited, it doesn't mean what you think it means."
1063,1,13,41,55,1.2727272727272727,0.06592795503870998,526,"Don't get me wrong, I'm no Saint."
1063,2,11,42,55,1.2727272727272727,0.07085122390606133,526,I suffered from compulsive virtue disorder.
1063,3,9,43,55,1.2727272727272727,0.07545393695750746,526,It's just a Hula-hoop. I died in the '50s.
1063,2,11,42,55,1.2727272727272727,0.07085122390606133,526,"Why yes, I do have a very large harp."
1063,4,7,44,55,1.2727272727272727,0.079791586497501,526,My hands are also larger than average.
1063,4,7,44,55,1.2727272727272727,0.079791586497501,526,It's a side effect of the medication that I was taking for erectile dysfunction.
1063,4,7,44,55,1.2727272727272727,0.079791586497501,526,I got this for completing the bonus missions.
1063,4,7,44,55,1.2727272727272727,0.079791586497501,526,"It's not a hula hoop, I'm just glad to see you."
1063,3,9,43,55,1.2727272727272727,0.07545393695750746,526,I invented the Hula Hoop. How about you?
1063,3,9,43,55,1.2727272727272727,0.07545393695750746,526,"Actually, it's a myth."
1063,2,11,42,55,1.2727272727272727,0.07085122390606133,526,"Yeah, I'm REALLY good."
1063,4,7,44,55,1.2727272727272727,0.079791586497501,526,I invented the hula hoop. God's a fan.
1063,2,11,42,55,1.2727272727272727,0.07085122390606133,526,"and I don’t like to brag, but all this you see is God given"
1104,2,10,40,52,1.2692307692307692,0.07325333948798678,526,"Yes, I've always had a big one."
1104,4,6,42,52,1.2692307692307692,0.08291168417108005,526,". . . Not that I think I'm holier than thou, or anything."""
1104,3,8,41,52,1.2692307692307692,0.07823170430914556,526,"Eternally speaking, size does matter."
1104,3,8,41,52,1.2692307692307692,0.07823170430914556,526,Don't let the huge halo fool you -- I'm really a bad boy who needs taming.
1104,4,6,42,52,1.2692307692307692,0.08291168417108005,526,"If my halo lasts longer than four hours, will you marry me?"
1104,2,10,40,52,1.2692307692307692,0.07325333948798678,526,"This time, it's forever."
1104,2,10,40,52,1.2692307692307692,0.07325333948798678,526,As you can see I'm not that kind of guy.
1104,1,12,39,52,1.2692307692307692,0.0679110000896092,526,I use it as a hula hoop when I get bored.
1104,4,6,42,52,1.2692307692307692,0.08291168417108005,526,I always use the tumble-dry setting. Keeps it from shrinking.
1104,4,6,42,52,1.2692307692307692,0.08291168417108005,526,"Next time, you drive."
1104,3,8,41,52,1.2692307692307692,0.07823170430914556,526,But you know what they say about angels with large Halos...
1104,2,10,40,52,1.2692307692307692,0.07325333948798678,526,"Actually, mine’s just in the shop. This is a loaner from Wham-O."
1104,4,6,42,52,1.2692307692307692,0.08291168417108005,526,I donated regularly to my local classical music station
1117,2,11,43,56,1.2678571428571428,0.06974476393590386,526,"I thought they were giving out something else so I said, ""Give me the largest one."""
1117,3,9,44,56,1.2678571428571428,0.07425417662209718,526,"Yeah that's right, I'm that good."
1117,3,9,44,56,1.2678571428571428,0.07425417662209718,526,"Apparently, it's proportional."
1117,3,9,44,56,1.2678571428571428,0.07425417662209718,526,"Actually, halo circumference is a much better indicator than height or hand size."
1117,4,7,45,56,1.2678571428571428,0.07850498961961752,526,I am a little tongue tied: it's been 560 years since I asked a girl out on a date...
1117,1,13,42,56,1.2678571428571428,0.06492288846873887,526,This is my fat halo.
1117,3,9,44,56,1.2678571428571428,0.07425417662209718,526,I also have big feet.
1117,3,9,44,56,1.2678571428571428,0.07425417662209718,526,"if it lasts more than four hours, they clip my wings."
1117,3,9,44,56,1.2678571428571428,0.07425417662209718,526,"In life, I was a Mormon."
1117,2,11,43,56,1.2678571428571428,0.06974476393590386,526,My dating App promised a match made in Heaven.
1117,2,11,43,56,1.2678571428571428,0.06974476393590386,526,"You say goodbye, but I say 'halo'. 'Halo, halo...'"
1117,4,7,45,56,1.2678571428571428,0.07850498961961752,526,"I trust you've heard the expression ""too big to fail."""
1117,4,7,45,56,1.2678571428571428,0.07850498961961752,526,"If I can get it down around my belly, you'll see something really cool."
1117,2,11,43,56,1.2678571428571428,0.06974476393590386,526,Are you going to make Heaven great again?
1117,5,5,46,56,1.2678571428571428,0.08253716765510495,526,Sorry. We don't have equal pray for equal work.
1117,2,11,43,56,1.2678571428571428,0.06974476393590386,526,It only this size for four hours.
1117,2,11,43,56,1.2678571428571428,0.06974476393590386,526,"It's not the size of the halo in the man, it's the size of the man in the halo."
1117,3,9,44,56,1.2678571428571428,0.07425417662209718,526,"I am tempted, but I am holier than thou."
1117,2,11,43,56,1.2678571428571428,0.06974476393590386,526,Halo? Is it me you're looking for?
1117,2,11,43,56,1.2678571428571428,0.06974476393590386,526,Is that a hula hoop or are you just glad to see me?
1117,2,11,43,56,1.2678571428571428,0.06974476393590386,526,I used to have a very big head.
1117,4,7,45,56,1.2678571428571428,0.07850498961961752,526,It's supposed to last for up to five hours.
1117,4,7,45,56,1.2678571428571428,0.07850498961961752,526,I invented the Hula hoop.
1117,2,11,43,56,1.2678571428571428,0.06974476393590386,526,What do you mean I'm too halocentric?
1117,2,11,43,56,1.2678571428571428,0.06974476393590386,526,It's really a hole in the ozone layer.
1117,4,7,45,56,1.2678571428571428,0.07850498961961752,526,"Apparently, there is viagra in heaven."
1117,2,11,43,56,1.2678571428571428,0.06974476393590386,526,"Yeah, it's the Stetson of halos."
1117,2,11,43,56,1.2678571428571428,0.06974476393590386,526,I need to talk to a shrink.
1117,3,9,44,56,1.2678571428571428,0.07425417662209718,526,I'll bet your wondering how good I've been.
1117,4,7,45,56,1.2678571428571428,0.07850498961961752,526,I thought Envy was a sin
1117,2,11,43,56,1.2678571428571428,0.06974476393590386,526,Would you like to play with my hula hoop?
1117,1,13,42,56,1.2678571428571428,0.06492288846873887,526,"It's actually an iHalo 6 Plus, it was just released last week."
1117,3,9,44,56,1.2678571428571428,0.07425417662209718,526,What is this 'manspreading' thou speakest of?
1117,2,11,43,56,1.2678571428571428,0.06974476393590386,526,It's made by Wham-O.
1117,3,9,44,56,1.2678571428571428,0.07425417662209718,526,"You know what they say, ""big halo, big hands."""
1117,4,7,45,56,1.2678571428571428,0.07850498961961752,526,"I invented the ""Halo Extender, For Men,"" it usually lasts about five hours."
1117,3,9,44,56,1.2678571428571428,0.07425417662209718,526,Am I holier than thou?
1117,3,9,44,56,1.2678571428571428,0.07425417662209718,526,"I tell everyone I was really good, but it's actually a hula hoop."
1117,3,9,44,56,1.2678571428571428,0.07425417662209718,526,"Truthfully, really: Does size matter?"
1117,4,7,45,56,1.2678571428571428,0.07850498961961752,526,"Well ah, yes, I am holier than thou."
1157,0,13,36,49,1.2653061224489797,0.06372446937141224,526,Good heavens. You barely made it!
1157,2,9,38,49,1.2653061224489797,0.07590446804224965,526,Now do you believe I was always right?
1159,2,10,41,53,1.2641509433962264,0.07203723938303844,526,"Yes, it's true what they say about the size of one's halo."
1159,1,12,40,53,1.2641509433962264,0.06681073606086448,526,God's working at closing the gap.
1159,2,10,41,53,1.2641509433962264,0.07203723938303844,526,"Yeah, I HAVE lost a lot of weight since High School."
1159,0,14,39,53,1.2641509433962264,0.061139063192526995,526,Do you think it makes my butt look small?
1159,4,6,43,53,1.2641509433962264,0.08149075203848938,526,Naw! It's just a hole in the ozone layer.
1159,3,8,42,53,1.2641509433962264,0.07690938345133104,526,"To paraphrase George Orwell, ""All angels are created equal, but some are more equal than others."""
1159,3,8,42,53,1.2641509433962264,0.07690938345133104,526,"It's huge, it's really beautiful. Everybody says so."
1159,4,6,43,53,1.2641509433962264,0.08149075203848938,526,Remember calling me a 'goddamned overachiever'?
1159,1,12,40,53,1.2641509433962264,0.06681073606086448,526,It covers a multitude of sins.
1159,3,8,42,53,1.2641509433962264,0.07690938345133104,526,"It's my old man's, but he let me take it out for a spin."
1159,2,10,41,53,1.2641509433962264,0.07203723938303844,526,I've lost a lot of weight since I've been up here.
1159,3,8,42,53,1.2641509433962264,0.07690938345133104,526,"Err, I gave Sister Teresa a free cab ride once."
1159,3,8,42,53,1.2641509433962264,0.07690938345133104,526,"I know it's heaven, but we could have a hell of a good time."
1159,2,10,41,53,1.2641509433962264,0.07203723938303844,526,I'm fine as long as it lasts for less than four hours.
1159,4,6,43,53,1.2641509433962264,0.08149075203848938,526,"It's sad that so many exaggerate their true halo size on e-Heaven, don't you think?"
1159,3,8,42,53,1.2641509433962264,0.07690938345133104,526,"So I told Him, with the right marketing plan, we can create a huge halo effect."
1159,2,10,41,53,1.2641509433962264,0.07203723938303844,526,"No, really. I LIKE small halos."
1159,2,10,41,53,1.2641509433962264,0.07203723938303844,526,"I was more than good, I was National Hula hoop champion, 1957"
1159,2,10,41,53,1.2641509433962264,0.07203723938303844,526,What can I say? The donuts up here are heavenly.
1159,3,8,42,53,1.2641509433962264,0.07690938345133104,526,Classic situational irony: You like bad boys.
1159,2,10,41,53,1.2641509433962264,0.07203723938303844,526,Who says you can't take your elite mileage bonus with you?
1159,5,4,44,53,1.2641509433962264,0.08582792128866486,526,"You know, it's true what they say about men with big halos."
1159,3,8,42,53,1.2641509433962264,0.07690938345133104,526,"Yeah, it means exactly what you think it does."
1159,2,10,41,53,1.2641509433962264,0.07203723938303844,526,"Yes honey, I'm gay!"
1159,1,12,40,53,1.2641509433962264,0.06681073606086448,526,I was always a big kiss ass
1159,4,6,43,53,1.2641509433962264,0.08149075203848938,526,"Actually, Janice, size *does* matter."
1159,3,8,42,53,1.2641509433962264,0.07690938345133104,526,Really? Even up here size matters?
1186,2,11,44,57,1.263157894736842,0.0686712218487231,526,Wouldn't you like to know...
1186,3,9,45,57,1.263157894736842,0.07309106050835933,526,Some of us are more equal than others.
1186,2,11,44,57,1.263157894736842,0.0686712218487231,526,"Even ""here""we do not get equal pay and benefits!"
1189,2,9,39,50,1.26,0.07455993343257081,526,It's part of the premium package.
1189,4,5,41,50,1.26,0.08480469759803333,526,I drove a taxi and everyone prayed for me.
1189,1,11,38,50,1.26,0.06886840453253687,526,Is it that obvious?
1189,3,7,40,50,1.26,0.07984679207132642,526,I'll trade you my hula-hoop for your frisbee.
1189,1,11,38,50,1.26,0.06886840453253687,526,"In the catalog, the photo looked a lot smaller."
1189,3,7,40,50,1.26,0.07984679207132642,526,The difference is I was a priest and you were a nun.
1195,1,12,41,54,1.2592592592592593,0.06574406247451946,526,"It's not the size of the halo, it's what you do with it."
1195,3,8,43,54,1.2592592592592593,0.07563005877154262,526,it gets bigger round pretty angels like you
1195,3,8,43,54,1.2592592592592593,0.07563005877154262,526,"Just patented it, the Halo Hoop"
1195,3,8,43,54,1.2592592592592593,0.07563005877154262,526,So NOW you're telling me you find me attractive?!
1195,2,10,42,54,1.2592592592592593,0.0708596766166785,526,I used to have a swelled head
1195,4,6,44,54,1.2592592592592593,0.08011690089708742,526,"Yes, size does matter."
1195,5,4,45,54,1.2592592592592593,0.08436545400174449,526,Since I met you I feel like I've died and went to heaven.
1195,3,8,43,54,1.2592592592592593,0.07563005877154262,526,Interested in halo enlargement?
1195,3,8,43,54,1.2592592592592593,0.07563005877154262,526,Halo be my name
1195,1,12,41,54,1.2592592592592593,0.06574406247451946,526,I'm a member of the honors program.
1195,3,8,43,54,1.2592592592592593,0.07563005877154262,526,"Well actually, I was hula hooping when I died."
1195,3,8,43,54,1.2592592592592593,0.07563005877154262,526,"If you really must know, the Father is my uncle and the Son is my cousin."
1195,2,10,42,54,1.2592592592592593,0.0708596766166785,526,You always said I was holier-than-thou.
1195,3,8,43,54,1.2592592592592593,0.07563005877154262,526,I'm no angel.
1195,3,8,43,54,1.2592592592592593,0.07563005877154262,526,"Sometimes, for kicks, I use it as a hula hoop."
1195,2,10,42,54,1.2592592592592593,0.0708596766166785,526,Haaaalooo there.
1195,3,8,43,54,1.2592592592592593,0.07563005877154262,526,"I can't help it, I'm just really good."
1195,5,4,45,54,1.2592592592592593,0.08436545400174449,526,"Yes, what you're thinking is true and that's one of the reason this place is called heaven."
1195,1,12,41,54,1.2592592592592593,0.06574406247451946,526,"Sorry, but I'm holier than thou."
1195,3,8,43,54,1.2592592592592593,0.07563005877154262,526,"I can assure you, I am not compensating for anything."
1195,3,8,43,54,1.2592592592592593,0.07563005877154262,526,I promise you it's not compensation for anything
1195,3,8,43,54,1.2592592592592593,0.07563005877154262,526,"By the way, it's true what they say about the size of a guy's halo."
1195,1,12,41,54,1.2592592592592593,0.06574406247451946,526,AND big feet
1195,1,12,41,54,1.2592592592592593,0.06574406247451946,526,"Actually, size does matter."
1195,2,10,42,54,1.2592592592592593,0.0708596766166785,526,I had to go through many hoops before I got this one.
1195,3,8,43,54,1.2592592592592593,0.07563005877154262,526,I swear I'm not a virgin
1195,4,6,44,54,1.2592592592592593,0.08011690089708742,526,I've lost quite a bit of weight since coming here...
1195,0,14,40,54,1.2592592592592593,0.060195263360888956,526,"'The devil's in the details."""
1195,1,12,41,54,1.2592592592592593,0.06574406247451946,526,"When I came in, gold was cheaper."
1195,4,6,44,54,1.2592592592592593,0.08011690089708742,526,I'm saving myself for my next life.
1195,1,12,41,54,1.2592592592592593,0.06574406247451946,526,"Instead of selling my soul to the Devil, I shorted it."
1195,3,8,43,54,1.2592592592592593,0.07563005877154262,526,I died doing what I love: hula hooping
1195,1,12,41,54,1.2592592592592593,0.06574406247451946,526,I'm afraid it's true even in heaven.
1228,4,7,47,58,1.2586206896551724,0.07605019845184599,526,Obviously I am holier than thou!
1229,1,10,36,47,1.2553191489361701,0.07112213509352609,526,"You say Hoover DAM, I say Hoover DARN."
1230,4,5,42,51,1.2549019607843137,0.08328141404547178,526,Who said I am overcompensating for a small harp?
1230,3,7,41,51,1.2549019607843137,0.0784313725490196,526,I used to Be a lasso champion
1230,2,9,40,51,1.2549019607843137,0.07326094781282119,526,"If you wanna get the boss's attention, you gotta think big."
1230,2,9,40,51,1.2549019607843137,0.07326094781282119,526,"In my defense, no one said NOT to wash it."
1230,0,13,38,51,1.2549019607843137,0.061632288805889064,526,"I know I am not supposed to flirt here, but my halo reacts involuntarily."
1230,3,7,41,51,1.2549019607843137,0.0784313725490196,526,It's true what they say about big halos.
1230,1,11,39,51,1.2549019607843137,0.06769677059463557,526,"As you can see, I have a lot on my mind right now."
1230,2,9,40,51,1.2549019607843137,0.07326094781282119,526,What 'holier than thou' attitude are you talking about?
1230,1,11,39,51,1.2549019607843137,0.06769677059463557,526,Hula Hoop Champion.
1230,4,5,42,51,1.2549019607843137,0.08328141404547178,526,...and what makes you think I have a big ego?
1230,3,7,41,51,1.2549019607843137,0.0784313725490196,526,I've got a big one
1230,4,5,42,51,1.2549019607843137,0.08328141404547178,526,"You made it through the glass ceiling but, sorry, we have not reached halo equality yet."
1230,4,5,42,51,1.2549019607843137,0.08328141404547178,526,The boss says I'm easier to keep an eye on this way.
1230,2,9,40,51,1.2549019607843137,0.07326094781282119,526,I can't tell you how many times I've been mistaken for Him!
1230,2,9,40,51,1.2549019607843137,0.07326094781282119,526,"Thank you, ma'am. I'm from Texas."
1230,3,7,41,51,1.2549019607843137,0.0784313725490196,526,"I don’t mean to brag, but it’s true that my large halo is indicative of…. And, if your small halo means what I believe it does, this could be a match made in heaven."
1230,2,9,40,51,1.2549019607843137,0.07326094781282119,526,I don't know about you... but i'm holy-as-hell right now.
1230,2,9,40,51,1.2549019607843137,0.07326094781282119,526,I got in late and all they had left on the shelf were hula hoops.
1230,2,9,40,51,1.2549019607843137,0.07326094781282119,526,I think you got your halo and hula hoop mixed up.
1230,3,7,41,51,1.2549019607843137,0.0784313725490196,526,"Yes, I died a virgin"
1230,1,11,39,51,1.2549019607843137,0.06769677059463557,526,Equality doesn't happen over night.
1230,4,5,42,51,1.2549019607843137,0.08328141404547178,526,Yeah that's right. I invented the cloud.
1230,2,9,40,51,1.2549019607843137,0.07326094781282119,526,"Have you seen my hula hoop, I cant seem to find it anywhere."
1230,3,7,41,51,1.2549019607843137,0.0784313725490196,526,"I know, you want to see my hands."
1230,2,9,40,51,1.2549019607843137,0.07326094781282119,526,"I atoned, but steroids have after effects."
1230,2,9,40,51,1.2549019607843137,0.07326094781282119,526,"You're really going to blame me for the halo? I died--that's all I did. I did not ask for one THIS big. Oh, come on, don't give me that look."
1256,4,6,45,55,1.2545454545454546,0.0787878787878788,526,Tossed pizza crusts. What did you do?
1256,2,10,43,55,1.2545454545454546,0.06971892495651474,526,"Did it hurt? When you fell from heav...darn, that won't work anymore."
1256,2,10,43,55,1.2545454545454546,0.06971892495651474,526,It's not easy being holier-than-thou.
1256,3,8,44,55,1.2545454545454546,0.0743917278364524,526,"I don't like to brag, but you know what they say about the size of a man's halo."
1256,3,8,44,55,1.2545454545454546,0.0743917278364524,526,Can I help it if I invested wisely in my Afterlife portfolio?
1256,0,14,41,55,1.2545454545454546,0.059278386873217015,526,My friends called me goody two shoes
1256,1,12,42,55,1.2545454545454546,0.06470956516382613,526,"You know, this halo is anatomically correct."
1256,4,6,45,55,1.2545454545454546,0.0787878787878788,526,"OK, so you left the iron on. Does it really matter now?"
1256,3,8,44,55,1.2545454545454546,0.0743917278364524,526,Fancy meeting YOU here.
1256,4,6,45,55,1.2545454545454546,0.0787878787878788,526,You have no idea how I feel about you.
1256,3,8,44,55,1.2545454545454546,0.0743917278364524,526,"I had to redeem all my miles for it, but where else was I going to go?"
1256,1,12,42,55,1.2545454545454546,0.06470956516382613,526,It's in recognition of my having invented the hula hoop.
1256,2,10,43,55,1.2545454545454546,0.06971892495651474,526,I died summa cum laude.
1256,0,14,41,55,1.2545454545454546,0.059278386873217015,526,This was part of my early retirement package.
1256,3,8,44,55,1.2545454545454546,0.0743917278364524,526,...I had tickets to Hamilton
1256,2,10,43,55,1.2545454545454546,0.06971892495651474,526,I guess it's my reward for a super-boring life.
1256,3,8,44,55,1.2545454545454546,0.0743917278364524,526,It was the only size they had left.
1256,1,12,42,55,1.2545454545454546,0.06470956516382613,526,They only had XL's in stock.
1256,4,6,45,55,1.2545454545454546,0.0787878787878788,526,"I'm celibate, damn it, and you?"
1275,2,9,41,52,1.25,0.07200532073519275,526,We always like to welcome new comers with a big halo.
1275,4,5,43,52,1.25,0.08181113518415854,526,"Down there, I drove a VERY small car"
1275,1,11,40,52,1.25,0.06656289057129833,526,I see you're admiring my girth.
1275,4,6,46,56,1.25,0.07750157099371281,526,"Well, up here size does matter!"
1275,2,9,41,52,1.25,0.07200532073519275,526,". . . then I said, 'who is Kim Kardashian?'."
1275,2,9,41,52,1.25,0.07200532073519275,526,"Howdy,Miss......They call me Tex."
1275,3,7,42,52,1.25,0.07706434991063846,526,"All angels are holy, but some angels are holier than others."
1275,2,9,41,52,1.25,0.07200532073519275,526,It's in honor of my Hula Hoop championship when I was twelve.
1275,3,7,42,52,1.25,0.07706434991063846,526,It may be Heaven but size still matters
1275,2,9,41,52,1.25,0.07200532073519275,526,"I'm flattered, but frankly the trick has been getting through doorways"
1275,2,9,41,52,1.25,0.07200532073519275,526,And to think I argued with you when you called me ‘holier than thou.'
1275,1,11,40,52,1.25,0.06656289057129833,526,Now do you believe I'm holier than thou?
1275,1,11,40,52,1.25,0.06656289057129833,526,"Why yes, I did drive a Porsche. Why do you ask?"
1275,3,7,42,52,1.25,0.07706434991063846,526,It was an option in my life insurance policy.
1275,2,9,41,52,1.25,0.07200532073519275,526,"Yeah, I'm kind of a big deal."
1275,3,8,45,56,1.25,0.07319250547113999,526,Why yes I DID invent the Hula Hoop. Why do you ask?
1275,2,9,41,52,1.25,0.07200532073519275,526,"It's embarrassing, but when I see the Angel of my Dreams...."
1275,4,4,40,48,1.25,0.0868070330843521,526,"Hon, it's a little late to exchange rings now."
1275,2,9,41,52,1.25,0.07200532073519275,526,Guess what? Size really does matter.
1275,3,7,42,52,1.25,0.07706434991063846,526,It's been four hours or more
1275,1,11,40,52,1.25,0.06656289057129833,526,"It's great that I lost the weight, but now none of my stuff fits."
1275,1,11,40,52,1.25,0.06656289057129833,526,Actually I'm no saint. That's a manhole.
1275,2,9,41,52,1.25,0.07200532073519275,526,I'm not as innocent as I look.
1275,4,5,43,52,1.25,0.08181113518415854,526,I guess God just cares more about the spotted owl than the whales.
1275,1,11,40,52,1.25,0.06656289057129833,526,"Trust me, being too good to be true, is not all it's cracked up to be."
1275,3,6,39,48,1.25,0.08154100913168028,526,I can tell already we are a match made in heaven
1275,4,5,43,52,1.25,0.08181113518415854,526,Told you I was His favorite!
1275,3,7,42,52,1.25,0.07706434991063846,526,Wow! It's really as big as you claimed in your Tinder profile!
1275,1,11,40,52,1.25,0.06656289057129833,526,It came with the Costco lifetime membership.
1275,3,7,42,52,1.25,0.07706434991063846,526,Yes it's very big. Notice I keep my hands in my pockets.
1275,2,9,41,52,1.25,0.07200532073519275,526,But so much for me; now tell me about you.
1275,1,11,40,52,1.25,0.06656289057129833,526,It's a macHalo.
1275,2,9,41,52,1.25,0.07200532073519275,526,"It's a rental, mine is in the shop."
1275,3,7,42,52,1.25,0.07706434991063846,526,Well I drove a Prius.
1275,3,7,42,52,1.25,0.07706434991063846,526,It's called 'radial enhancement'.
1275,2,9,41,52,1.25,0.07200532073519275,526,"Well, because it's harder for men."
1275,3,7,42,52,1.25,0.07706434991063846,526,I was always overcompensating.
1275,2,9,41,52,1.25,0.07200532073519275,526,"Halo? Hell no, I just fell through a hole."
1275,5,3,44,52,1.25,0.08629721694870586,526,"It's been over five hours, I'm calling God."
1275,4,5,43,52,1.25,0.08181113518415854,526,"Whoever said ""Size doesn't matter"" was lying."
1275,2,9,41,52,1.25,0.07200532073519275,526,The pearly gates weren't wide enough. I had to come in through the loading dock.
1275,2,9,41,52,1.25,0.07200532073519275,526,Mine's a hula hoop.
1275,4,5,43,52,1.25,0.08181113518415854,526,It lasted more than four hours!
1275,1,11,40,52,1.25,0.06656289057129833,526,My halo is happy to see you!
1275,3,7,42,52,1.25,0.07706434991063846,526,I call it my 'huge heavenly holy halo hula hoop'. Bet you can't say That three times fast.
1275,0,13,39,52,1.25,0.06063390625908324,526,What say you help me sin a little and bring it down in size?
1275,2,9,41,52,1.25,0.07200532073519275,526,You should see my boyfriend's!
1275,2,9,41,52,1.25,0.07200532073519275,526,"The halos were on back order, so I used my daughter's hula hoop."
1275,2,9,41,52,1.25,0.07200532073519275,526,I get claustrophobic.
1275,1,11,40,52,1.25,0.06656289057129833,526,It's heavier than it looks.
1275,1,11,40,52,1.25,0.06656289057129833,526,No sweat! Getting here is the important thing.
1275,1,11,40,52,1.25,0.06656289057129833,526,Sounds like a case of halo envy to me.
1275,2,9,41,52,1.25,0.07200532073519275,526,"Yeah, I know, weird...good lookin' guy like me dies a virgin. But it's true!"
1275,3,7,42,52,1.25,0.07706434991063846,526,"Jesus is coming, look busy!"
1275,2,9,41,52,1.25,0.07200532073519275,526,"The gates were closed when I arrived, hence the upgrade."
1275,2,9,41,52,1.25,0.07200532073519275,526,But of course--up here!--size doesn't matter
1275,2,9,41,52,1.25,0.07200532073519275,526,Alas...not my halo...just a hole in the ceiling...
1275,0,13,39,52,1.25,0.06063390625908324,526,It's hell fitting through doorways.
1275,2,9,41,52,1.25,0.07200532073519275,526,It used to belong to a guy from Texas
1275,1,11,40,52,1.25,0.06656289057129833,526,"Yes, I'm the guy that fixed the Ozone layer, thank you very much."
1275,2,9,41,52,1.25,0.07200532073519275,526,Careful! Halo-envy is still ENVY.
1275,1,11,40,52,1.25,0.06656289057129833,526,"If I told you, I'd go to Hell."
1275,2,9,41,52,1.25,0.07200532073519275,526,It grows when you're around.
1275,2,9,41,52,1.25,0.07200532073519275,526,They're trying to get rid of their XXXLs.
1275,3,7,42,52,1.25,0.07706434991063846,526,I always hung the toilet paper flap-front.
1275,4,5,43,52,1.25,0.08181113518415854,526,I cannot tell a lie.
1341,2,9,42,53,1.2452830188679245,0.07079099215243659,526,"As you can see, size does matter."
1341,2,9,42,53,1.2452830188679245,0.07079099215243659,526,I told you the Prius was the way to go.
1341,3,7,43,53,1.2452830188679245,0.07574334277585738,526,"Oh, sure. But it doesn't count for much up here."
1341,3,7,43,53,1.2452830188679245,0.07574334277585738,526,"Well yes, smaller looks good on you."
1341,0,13,40,53,1.2452830188679245,0.059665616229592086,526,"I'm more than just the size of my halo, you know?"
1341,1,11,41,53,1.2452830188679245,0.06546506828066133,526,"If I said how I got this, I would be sent waaaaay South in a flash."
1341,1,11,41,53,1.2452830188679245,0.06546506828066133,526,It's a little thing I'm working on called a Hula Halo.
1341,3,7,43,53,1.2452830188679245,0.07574334277585738,526,It's a punishment for boasting.
1341,3,7,43,53,1.2452830188679245,0.07574334277585738,526,"I behaved badly, but I made up for it with a lot of guilt."
1341,4,5,44,53,1.2452830188679245,0.08039118969013777,526,"Actually, I bought it on e-Bay..."
1341,1,11,41,53,1.2452830188679245,0.06546506828066133,526,I do good great.
1341,1,11,41,53,1.2452830188679245,0.06546506828066133,526,Overcompensating is no sin.
1341,3,7,43,53,1.2452830188679245,0.07574334277585738,526,They pulled up my record and saw I failed the BAR exam 11 times before I quit and 'poof' there it was
1341,1,11,41,53,1.2452830188679245,0.06546506828066133,526,I'm sorry you feel that way. You'll have to take that up with Angel Resources.
1341,3,7,43,53,1.2452830188679245,0.07574334277585738,526,"Well, you know what they say about a big halo."
1341,3,7,43,53,1.2452830188679245,0.07574334277585738,526,"A mid-life crises? You realize we are in this for eternity, right?"
1341,2,9,42,53,1.2452830188679245,0.07079099215243659,526,I used to do rodeo rope tricks. It takes pracice.
1341,5,3,45,53,1.2452830188679245,0.08478462587480352,526,It's always gets big when I meet a pretty angel
1341,4,5,44,53,1.2452830188679245,0.08039118969013777,526,"'Size doesn't matter,' I believe were your words."
1341,5,3,45,53,1.2452830188679245,0.08478462587480352,526,That's not what your halo looks like on your profile pictiure
1341,0,13,40,53,1.2452830188679245,0.059665616229592086,526,I went with the platinum package.
1341,3,7,43,53,1.2452830188679245,0.07574334277585738,526,Would you believe me if I told you I'm just a better negotiator?
1341,4,5,44,53,1.2452830188679245,0.08039118969013777,526,"My name's Earl, but my friends call me Goody Goody Two-Shoes."
1341,3,7,43,53,1.2452830188679245,0.07574334277585738,526,No. What do they say about big halos?
1341,2,9,42,53,1.2452830188679245,0.07079099215243659,526,I've always felt a little holier than thou.
1341,2,9,42,53,1.2452830188679245,0.07079099215243659,526,I watched every presidential debate.
1341,2,9,42,53,1.2452830188679245,0.07079099215243659,526,I'm the first to die in a Tesla
1341,3,7,43,53,1.2452830188679245,0.07574334277585738,526,"Yes, I am that guy who took down Donald Trump."
1341,3,7,43,53,1.2452830188679245,0.07574334277585738,526,"Why do you think they call it 'heaven'? But if this thing lasts longer than four hours, it can be hell."
1341,2,9,42,53,1.2452830188679245,0.07079099215243659,526,I got the assault weapons ban reinstated.
1341,2,9,42,53,1.2452830188679245,0.07079099215243659,526,At parties it comes in handy as a hula hoop.
1341,1,11,41,53,1.2452830188679245,0.06546506828066133,526,"No, I'm not especially good, but I did have a successful career as a pizza maker."
1341,2,9,42,53,1.2452830188679245,0.07079099215243659,526,"Yes, I did pay a bit more for this one."
1341,0,13,40,53,1.2452830188679245,0.059665616229592086,526,Single. No girl ever seemed good enough.
1341,1,11,41,53,1.2452830188679245,0.06546506828066133,526,"I prefer to say, 'More well-rounded than thou.'"
1341,4,5,44,53,1.2452830188679245,0.08039118969013777,526,What makes you think I am lying?
1341,3,7,43,53,1.2452830188679245,0.07574334277585738,526,"By the time they got to me, all they had left were Hula Hoops."
1341,1,11,41,53,1.2452830188679245,0.06546506828066133,526,I'm not looking for a perfect angel. My halo is big enough for two.
1341,3,7,43,53,1.2452830188679245,0.07574334277585738,526,"""Bespoke"" in the description should have tipped me off to European sizing."
1341,3,7,43,53,1.2452830188679245,0.07574334277585738,526,"I'm a Platinum member, so the upgrade was free."
1341,3,7,43,53,1.2452830188679245,0.07574334277585738,526,Just like on Earth. Size matters.
1341,3,7,43,53,1.2452830188679245,0.07574334277585738,526,Trust me. It's not compensating for ANYthing.
1341,2,9,42,53,1.2452830188679245,0.07079099215243659,526,"Enough of the holier-than-though crap, please."
1341,2,9,42,53,1.2452830188679245,0.07079099215243659,526,It's a cowboy thing
1341,3,7,43,53,1.2452830188679245,0.07574334277585738,526,It's for my ego
1341,3,7,43,53,1.2452830188679245,0.07574334277585738,526,...and then I joined Weight Watchers
1341,3,7,43,53,1.2452830188679245,0.07574334277585738,526,Its my angel of the month award--I also get to go out to lunch with the Boss!
1341,4,5,44,53,1.2452830188679245,0.08039118969013777,526,Now who thinks size doesn't matter?
1341,3,7,43,53,1.2452830188679245,0.07574334277585738,526,"No thanks,one woman already had me jumping through hoops"
1341,2,9,42,53,1.2452830188679245,0.07079099215243659,526,It gets in my way at the drinking fountain
1341,2,9,42,53,1.2452830188679245,0.07079099215243659,526,Well...for some of us abstinence was more challenging.
1341,2,9,42,53,1.2452830188679245,0.07079099215243659,526,I wasn't expecting to find you here.
1341,1,11,41,53,1.2452830188679245,0.06546506828066133,526,"Depends what you mean by ""gifted"""
1341,3,7,43,53,1.2452830188679245,0.07574334277585738,526,"What can I say, babe? I really am holier than thou."
1341,3,7,43,53,1.2452830188679245,0.07574334277585738,526,"Well, I did make a lot of money for God"
1341,2,9,42,53,1.2452830188679245,0.07079099215243659,526,It turns out I was actually holier than thou...
1341,2,9,42,53,1.2452830188679245,0.07079099215243659,526,Why? Heaven only knows.
1341,4,5,44,53,1.2452830188679245,0.08039118969013777,526,Accidental death by hula hoop.
1341,3,7,43,53,1.2452830188679245,0.07574334277585738,526,Perhaps if you had received equal pay . . .?
1341,3,7,43,53,1.2452830188679245,0.07574334277585738,526,You made it. That's what really counts.
1341,2,9,42,53,1.2452830188679245,0.07079099215243659,526,What's a naughty girl like you doing in a place like this?
1341,2,9,42,53,1.2452830188679245,0.07079099215243659,526,I just am holier than thou.
1403,3,6,40,49,1.2448979591836735,0.08002238337427613,526,"I opted for the ""holier than thou"" feature."
1403,2,8,39,49,1.2448979591836735,0.074520075851043,526,I didn't realize I was hula hooping so close to the edge of the cliff.
1403,3,6,40,49,1.2448979591836735,0.08002238337427613,526,I jump through so many hoops up here that I had mine enlarged.
1403,1,10,38,49,1.2448979591836735,0.06857770460427194,526,"Yes, it means exactly what you think it means."
1403,1,10,38,49,1.2448979591836735,0.06857770460427194,526,"Yes, that's what it means, except here we can't use it."
1403,1,10,38,49,1.2448979591836735,0.06857770460427194,526,I'm from New York.
1403,3,6,40,49,1.2448979591836735,0.08002238337427613,526,Don't blame me for the gender gap
1403,3,6,40,49,1.2448979591836735,0.08002238337427613,526,After 25 millennia together - NOW you tell me you prefer the bad boy type?
1411,4,5,45,54,1.2407407407407407,0.07901907873711286,526,You like it? It doubles as a hula hoop.
1411,2,9,43,54,1.2407407407407407,0.06961602376844407,526,"This I can tell you - my halo is huge. There are no problems with my halo. And by the way, my halo and I are going to make Heaven great again!"
1411,2,9,43,54,1.2407407407407407,0.06961602376844407,526,"Donald said I could have it, he's getting a bigger one !"
1411,3,7,44,54,1.2407407407407407,0.07446611836866017,526,"St. Peter's hearing is going. I told him I wanted bigger wings, not rings."
1411,2,9,43,54,1.2407407407407407,0.06961602376844407,526,How'd you guess I drove a Hummer while alive?
1411,3,7,44,54,1.2407407407407407,0.07446611836866017,526,"I was meek, poor in spirit, along with a few others."
1411,4,5,45,54,1.2407407407407407,0.07901907873711286,526,"Yeah, I lost mine, so Kanye let me borrow his."
1411,2,9,43,54,1.2407407407407407,0.06961602376844407,526,I got in Early Decision
1411,2,9,43,54,1.2407407407407407,0.06961602376844407,526,I realize size shouldn't matter but.....
1411,3,7,44,54,1.2407407407407407,0.07446611836866017,526,You know what they say about men's halos ?
1411,4,5,45,54,1.2407407407407407,0.07901907873711286,526,"Yes, I'm really THAT good!"
1411,3,7,44,54,1.2407407407407407,0.07446611836866017,526,"For what it's worth, size still matters."
1411,1,11,42,54,1.2407407407407407,0.06440169831426679,526,"No, I'm not 'compensating for something'."
1411,2,9,43,54,1.2407407407407407,0.06961602376844407,526,And whats ironic is the halo is the exact size as the open manhole!
1411,3,7,44,54,1.2407407407407407,0.07446611836866017,526,Whaddya mean I don't have a prayer
1426,1,10,39,50,1.24,0.06737043498600913,526,Oh this only happens when I meet a really pretty angel.
1426,1,10,39,50,1.24,0.06737043498600913,526,I've lost a little weight.
1426,2,8,40,50,1.24,0.07317856271351829,526,You obviously led a more exciting life than I did!
1426,1,10,39,50,1.24,0.06737043498600913,526,I have no problem in the halo department. No complaints.
1426,1,10,39,50,1.24,0.06737043498600913,526,Only an angel would say that size makes no difference.
1426,2,8,40,50,1.24,0.07317856271351829,526,I had a coupon to supersize my halo.
1426,1,10,39,50,1.24,0.06737043498600913,526,", ..., and it has an SPF rating of 100!"
1426,3,6,41,50,1.24,0.07855844048495728,526,"Yeah, it's this app I've developed, Uber-Hailo"
1426,3,6,41,50,1.24,0.07855844048495728,526,I got it for always voting Democrat.
1426,2,8,40,50,1.24,0.07317856271351829,526,"Face it honey, your family has been insufferable!"
1426,2,8,40,50,1.24,0.07317856271351829,526,I was an over-achiever.
1426,2,8,40,50,1.24,0.07317856271351829,526,Super-sized it with my Golden Gate Rewards card.
1426,0,12,38,50,1.24,0.06101187572589322,526,Call me. I'm around.
1426,3,6,41,50,1.24,0.07855844048495728,526,I just wish you told me you preferred the bad boy type before I wasted 25 millennia.
1426,5,2,43,50,1.24,0.0883407133356589,526,Wait'll you see my hands.
1426,2,8,40,50,1.24,0.07317856271351829,526,I didn't ask for it. It comes with an elite membership.
1426,2,8,40,50,1.24,0.07317856271351829,526,Well......A big halloo to you
1426,4,4,42,50,1.24,0.08359279336187311,526,"Even in heaven, size matters."
1426,2,8,40,50,1.24,0.07317856271351829,526,Because I invented the Hula Hoop.
1426,0,12,38,50,1.24,0.06101187572589322,526,. . . and I was a blood donor.
1426,1,10,39,50,1.24,0.06737043498600913,526,I've been told I'm very good.
1426,2,8,40,50,1.24,0.07317856271351829,526,"I bought an XXL, thinking it would shrink."
1426,2,8,40,50,1.24,0.07317856271351829,526,I was flattened by a steamroller.
1426,1,10,39,50,1.24,0.06737043498600913,526,"Actually, this is cloud 10."
1426,2,8,40,50,1.24,0.07317856271351829,526,It turns out that steroids affect your afterlife also.
1426,3,6,41,50,1.24,0.07855844048495728,526,"If you must know,I scored St.Peter tickets to the Janis,Jimi,Elvis,John and George concert."
1426,1,10,39,50,1.24,0.06737043498600913,526,Why yes – I was THAT good.
1426,2,8,40,50,1.24,0.07317856271351829,526,Let's face it.....you' re no angel.
1426,2,8,40,50,1.24,0.07317856271351829,526,"When I entered the Pearly Gates, they told me all the married guys got this size."
1426,3,6,41,50,1.24,0.07855844048495728,526,"That's right, I invented the Hula Hoop."
1426,2,8,40,50,1.24,0.07317856271351829,526,Its a lot of pressure.
1426,2,8,40,50,1.24,0.07317856271351829,526,"Sorry Eve, not to night."
1426,1,10,39,50,1.24,0.06737043498600913,526,"Yeah, you're right -- I AM holier than thou."
1426,2,8,40,50,1.24,0.07317856271351829,526,Why is it always about size with you guys?
1460,1,9,36,46,1.2391304347826086,0.07077748085260739,526,"That's not what I meant by ""size matters."""
1460,2,7,37,46,1.2391304347826086,0.0773022339309831,526,"White male privilege has nothing to do with it. I am just holier than you, God says so."
1462,4,5,46,55,1.2363636363636363,0.07769246271931074,526,"It doesn't work that way, I'm afraid"
1462,2,9,44,55,1.2363636363636363,0.06847859093607389,526,I was a Democrat.
1462,2,9,44,55,1.2363636363636363,0.06847859093607389,526,"Okay, okay. I lied."
1462,2,9,44,55,1.2363636363636363,0.06847859093607389,526,Let's just say I didn't get it for good deeds.
1462,4,5,46,55,1.2363636363636363,0.07769246271931074,526,I totally dis-endorsed Trump.
1462,1,11,43,55,1.2363636363636363,0.06337126117720451,526,It's really an ejection hatch if my wife is here.
1462,3,7,45,55,1.2363636363636363,0.07323058165814891,526,People who say size doesn't matter haven't been to heaven.
1469,2,8,41,51,1.2352941176470589,0.07188354031303278,526,"What do you mean ""less is more""? Where the hell am I?"
1469,3,6,42,51,1.2352941176470589,0.07714633558002353,526,"Well, it would hardly be heavenly if I couldn't feel superior."
1469,2,8,41,51,1.2352941176470589,0.07188354031303278,526,I'm the I.T. guy.
1469,1,10,40,51,1.2352941176470589,0.06620369810248677,526,"I'm from Original Ray's Pizza. Did you order a plain, extra large ?"
1469,2,8,41,51,1.2352941176470589,0.07188354031303278,526,Most people just don’t get my holier-than-thou attitude.
1469,4,4,43,51,1.2352941176470589,0.08207235112335823,526,"It's from sucking up to the boss. You thought you were done with that, huh?"
1469,2,8,41,51,1.2352941176470589,0.07188354031303278,526,Does halo size even matter here in Heaven? Only one way to find out...
1469,3,6,42,51,1.2352941176470589,0.07714633558002353,526,They were out of seven and a quarter.
1469,2,8,41,51,1.2352941176470589,0.07188354031303278,526,"So, uh, do you come to this cloud often?"
1469,3,6,42,51,1.2352941176470589,0.07714633558002353,526,I hope it's really me you're unterested in and not just the bling...
1469,2,8,41,51,1.2352941176470589,0.07188354031303278,526,I took out the entire NRA leadership. At a gun show. With an assault rifle I bought there.
1469,3,6,42,51,1.2352941176470589,0.07714633558002353,526,"What can I say. On Angelbook, I've got more friends."
1469,3,6,42,51,1.2352941176470589,0.07714633558002353,526,Let me saintsplain something to you.
1469,3,6,42,51,1.2352941176470589,0.07714633558002353,526,I exercise!
1469,2,8,41,51,1.2352941176470589,0.07188354031303278,526,What makes you say I'm lying?
1469,2,8,41,51,1.2352941176470589,0.07188354031303278,526,"It's true; size really does matter, even here in Heaven."
1469,1,10,40,51,1.2352941176470589,0.06620369810248677,526,"Yes, I was texting while driving but it was a bible verse..."
1469,4,4,43,51,1.2352941176470589,0.08207235112335823,526,"We have so much in common! Both headed our local Dump the Trump groups, both were murdered by Sig Sauer MCX owners, and NOW we're in the same New Yorker cartoon!"
1469,3,6,42,51,1.2352941176470589,0.07714633558002353,526,"After graduation from the elite preschool, the rest was easy."
1469,3,6,42,51,1.2352941176470589,0.07714633558002353,526,If you think my halo is big...
1469,2,8,41,51,1.2352941176470589,0.07188354031303278,526,It's called a hula halo.
1469,3,6,42,51,1.2352941176470589,0.07714633558002353,526,"Of course, it is a ring of confidence."
1469,2,8,41,51,1.2352941176470589,0.07188354031303278,526,It's the halo effect of having doubled my PBS contribution
1469,2,8,41,51,1.2352941176470589,0.07188354031303278,526,Let's both agree that size doesn't matter here.
1469,2,8,41,51,1.2352941176470589,0.07188354031303278,526,Apparently pride is not one of the seven deadly sins.
1469,2,8,41,51,1.2352941176470589,0.07188354031303278,526,"Yes, but I have a small ego."
1469,3,6,42,51,1.2352941176470589,0.07714633558002353,526,...and a big hallo to you!
1469,2,8,41,51,1.2352941176470589,0.07188354031303278,526,So ... do you finally accept that I'm holier than thou?
1469,2,8,41,51,1.2352941176470589,0.07188354031303278,526,"'It's not a Commandment, exactly, but it's been policy for quite a while."""
1469,4,4,43,51,1.2352941176470589,0.08207235112335823,526,My attitude comes the fact that I actually am holier than thou.
1469,2,8,41,51,1.2352941176470589,0.07188354031303278,526,You know what they say about big halos up here !
1469,3,6,42,51,1.2352941176470589,0.07714633558002353,526,I've got the biggest one in paradise.
1469,2,8,41,51,1.2352941176470589,0.07188354031303278,526,All true what you've heard about big halos.
1469,2,8,41,51,1.2352941176470589,0.07188354031303278,526,"No, for halo it's true. Hands and feet are a myth."
1469,3,6,42,51,1.2352941176470589,0.07714633558002353,526,I was told there would be 70 of you
1469,3,6,42,51,1.2352941176470589,0.07714633558002353,526,That's what He said.
1469,0,12,39,51,1.2352941176470589,0.05998846486579745,526,"I started contributing to the church very early plus compounding, voila!"
1469,2,8,41,51,1.2352941176470589,0.07188354031303278,526,What makes you think I was staring at your wings?
1469,3,6,42,51,1.2352941176470589,0.07714633558002353,526,I thought I ordered a medium.
1469,4,4,43,51,1.2352941176470589,0.08207235112335823,526,Does size really matter?
1469,4,4,43,51,1.2352941176470589,0.08207235112335823,526,"The gang up here just call me ""Hula Hoop"""
1469,2,8,41,51,1.2352941176470589,0.07188354031303278,526,They're calling it the Halo Hoop.
1469,1,10,40,51,1.2352941176470589,0.06620369810248677,526,I've upgraded for increased bandwidth!
1469,3,6,42,51,1.2352941176470589,0.07714633558002353,526,"I don't mean to brag, but..."
1469,1,10,40,51,1.2352941176470589,0.06620369810248677,526,Be honest... did you swipe right after seeing the size of my halo?
1469,2,8,41,51,1.2352941176470589,0.07188354031303278,526,Some stretching is normal during rebirth.
1469,1,10,40,51,1.2352941176470589,0.06620369810248677,526,I've died and gone to Heaven!
1469,4,4,43,51,1.2352941176470589,0.08207235112335823,526,"Clearly, small hands have no correlation."
1469,1,10,40,51,1.2352941176470589,0.06620369810248677,526,"Want to have sex? I'm very, very, very, very good."
1469,2,8,41,51,1.2352941176470589,0.07188354031303278,526,I actually did save my customers 15% by switching them to Geico.
1469,1,10,40,51,1.2352941176470589,0.06620369810248677,526,People always said I was holier than thou.
1469,2,8,41,51,1.2352941176470589,0.07188354031303278,526,There's a wage gap up here too.
1469,0,12,39,51,1.2352941176470589,0.05998846486579745,526,I have an enlarged halo
1469,3,6,42,51,1.2352941176470589,0.07714633558002353,526,"Sorry, but my halo has a mind of its own."
1469,2,8,41,51,1.2352941176470589,0.07188354031303278,526,...I always lifted the lid.
1469,3,6,42,51,1.2352941176470589,0.07714633558002353,526,It's not a sin to overcompensate.
1469,3,6,42,51,1.2352941176470589,0.07714633558002353,526,And how much did you donate to the St. Peter 2016 PAC?
1469,3,6,42,51,1.2352941176470589,0.07714633558002353,526,It's a hula hoop AND I'm happy to see you.
1469,2,8,41,51,1.2352941176470589,0.07188354031303278,526,How do you feel about tithing on the first date?
1469,3,6,42,51,1.2352941176470589,0.07714633558002353,526,No Internet.
1469,0,12,39,51,1.2352941176470589,0.05998846486579745,526,"It's LED, it uses less energy."
1469,2,8,41,51,1.2352941176470589,0.07188354031303278,526,Actually it's the manhole I fell through.
1469,3,6,42,51,1.2352941176470589,0.07714633558002353,526,I did a lot of good for a lot of bad people.
1469,2,8,41,51,1.2352941176470589,0.07188354031303278,526,Will you help make my halo smaller?
1469,2,8,41,51,1.2352941176470589,0.07188354031303278,526,"Apparently heaven ran out of halos, so they have me this sweet hula-hoop!"
1469,3,6,42,51,1.2352941176470589,0.07714633558002353,526,"C'mon, we'll have fun. It doubles as a hula hoop."
1469,3,6,42,51,1.2352941176470589,0.07714633558002353,526,I ordered it from the Trump catalog.
1469,2,8,41,51,1.2352941176470589,0.07188354031303278,526,"Unequal pay, unequal halos, but you get that nice sash."
1469,2,8,41,51,1.2352941176470589,0.07188354031303278,526,"They said there was a typo, and I ended up with a hula."
1469,3,6,42,51,1.2352941176470589,0.07714633558002353,526,I pledged a lot to the Kickstarter campaign.
1469,2,8,41,51,1.2352941176470589,0.07188354031303278,526,Come over to my cloud and bask in the halo effect.
1469,2,8,41,51,1.2352941176470589,0.07188354031303278,526,I guess I'm a little holier than I thought.
1469,1,10,40,51,1.2352941176470589,0.06620369810248677,526,Your halo would bigger if you didn't offer me that apple.
1469,1,10,40,51,1.2352941176470589,0.06620369810248677,526,I'm a good bluffer.
1469,3,6,42,51,1.2352941176470589,0.07714633558002353,526,You did notice I have very LARGE HANDS.
1469,1,10,40,51,1.2352941176470589,0.06620369810248677,526,I am NOT overcompensating!
1469,3,6,42,51,1.2352941176470589,0.07714633558002353,526,Want to see my hands?
1469,4,4,43,51,1.2352941176470589,0.08207235112335823,526,The request was for a halo. Damn autocorrect.
1547,3,5,39,47,1.2340425531914894,0.0816842024739688,526,"Up here, Melissa, you can have 'holier than thou,' or you can have ironic distance. You can't have both."
1547,3,5,39,47,1.2340425531914894,0.0816842024739688,526,"Sun protection is so important, especially up here."
1547,2,7,38,47,1.2340425531914894,0.07581055041090795,526,And it's not even a problem if it lasts for eternity.
1547,1,9,37,47,1.2340425531914894,0.06944184742215101,526,I was always the favorite child.
1551,2,8,42,52,1.2307692307692308,0.07063269667552394,526,My personal trainer is a miracle worker.
1551,2,8,42,52,1.2307692307692308,0.07063269667552394,526,I starred in movies for the Hallmark Channel. And you?
1551,2,8,42,52,1.2307692307692308,0.07063269667552394,526,It appear you were right about one thing. I am really am holier than thou.
1551,1,10,41,52,1.2307692307692308,0.06507557165853581,526,Where have you been all my life?
1551,2,8,42,52,1.2307692307692308,0.07063269667552394,526,I got all my values from 'The New Yorker'.
1551,2,8,42,52,1.2307692307692308,0.07063269667552394,526,Money talks.
1551,3,6,43,52,1.2307692307692308,0.0757834127802906,526,"Well, actually, I’m a vegan."
1551,4,4,44,52,1.2307692307692308,0.08060566646085904,526,God gave me this for a really good joke I told him.
1551,2,8,42,52,1.2307692307692308,0.07063269667552394,526,"As a matter of fact, I do think I'm holier than thou."
1551,1,10,41,52,1.2307692307692308,0.06507557165853581,526,I don't show this to just anybody.
1551,2,8,42,52,1.2307692307692308,0.07063269667552394,526,Can you guess what I'm thinking?
1551,1,10,41,52,1.2307692307692308,0.06507557165853581,526,"All you have to do is say ""Supersize me""."
1551,3,6,43,52,1.2307692307692308,0.0757834127802906,526,"They're naming some new saints, and I may toss my halo in the ring."
1551,1,10,41,52,1.2307692307692308,0.06507557165853581,526,they give the big halo to the greeter
1551,3,6,43,52,1.2307692307692308,0.0757834127802906,526,"If you think that's big, check this out."
1551,2,8,42,52,1.2307692307692308,0.07063269667552394,526,This was an unintended side effect of my weight loss.
1551,1,10,41,52,1.2307692307692308,0.06507557165853581,526,I just keep things in perspective.
1551,0,12,40,52,1.2307692307692308,0.058997306834413094,526,"Actually, this is regulation width."
1551,4,4,44,52,1.2307692307692308,0.08060566646085904,526,I was President Trump's Press Secretary for all eight years.
1551,2,8,42,52,1.2307692307692308,0.07063269667552394,526,They wouldn't let me bring my Ferrari.
1551,1,10,41,52,1.2307692307692308,0.06507557165853581,526,"How did I do It? Simple. Stay out of politics, away from the stock market, and eat all my vegetables."
1551,3,6,43,52,1.2307692307692308,0.0757834127802906,526,I've been told that size does matter.
1551,1,10,41,52,1.2307692307692308,0.06507557165853581,526,"I wish size mattered up here, but it doesn't."
1551,1,10,41,52,1.2307692307692308,0.06507557165853581,526,If you've got it. Flaunt it
1551,3,6,43,52,1.2307692307692308,0.0757834127802906,526,It almost feels like those little blue pills are still with me.
1551,1,10,41,52,1.2307692307692308,0.06507557165853581,526,"No, nothing special. Just an ozone hole."
1551,3,6,43,52,1.2307692307692308,0.0757834127802906,526,"My iHalo has more data space, and connects directly to my cloud."
1551,2,8,42,52,1.2307692307692308,0.07063269667552394,526,"Patron Saint of Hula Hoop, pleased to meet you!"
1551,2,8,42,52,1.2307692307692308,0.07063269667552394,526,You should see me trying to get through doorways.
1551,3,6,43,52,1.2307692307692308,0.0757834127802906,526,It means I'm very big up here and down there.
1551,2,8,42,52,1.2307692307692308,0.07063269667552394,526,I got mine from Costco!
1551,3,6,43,52,1.2307692307692308,0.0757834127802906,526,I can see it in your eyes...halo envy.
1551,2,8,42,52,1.2307692307692308,0.07063269667552394,526,God's having a hard time getting that Equal Halo Act through Congress. Hopefully next year.
1551,3,6,43,52,1.2307692307692308,0.0757834127802906,526,"It's not how big it is, it's what you do with it."
1551,2,8,42,52,1.2307692307692308,0.07063269667552394,526,"No, wings don't make your butt look big."
1551,1,10,41,52,1.2307692307692308,0.06507557165853581,526,I call it the Hula Halo
1551,0,12,40,52,1.2307692307692308,0.058997306834413094,526,I got in through a loophole.
1551,11,17,141,169,1.2307692307692308,0.04279604925109129,526,"I don't mean to sing my praises, but ..."
1551,4,4,44,52,1.2307692307692308,0.08060566646085904,526,Mine vibrates.
1551,1,10,41,52,1.2307692307692308,0.06507557165853581,526,"Actually, I'm just standing in a manhole."
1551,1,10,41,52,1.2307692307692308,0.06507557165853581,526,It's on loan from Mother Theresa for the week.
1551,4,4,44,52,1.2307692307692308,0.08060566646085904,526,"It's not you, it's your halo."
1551,3,6,43,52,1.2307692307692308,0.0757834127802906,526,Apparently it has something to do with my intellect.
1551,2,8,42,52,1.2307692307692308,0.07063269667552394,526,Size matters.
1551,2,8,42,52,1.2307692307692308,0.07063269667552394,526,It's my reward for having been monogamous. So I guess I'll have to pass up your offer.
1551,1,10,41,52,1.2307692307692308,0.06507557165853581,526,Relax...Halo Envy is NOT a sin
1551,5,2,45,52,1.2307692307692308,0.08515527745577839,526,"He ran out, so I got the hoola hoop."
1551,1,10,41,52,1.2307692307692308,0.06507557165853581,526,"Well, actually, I was really quite modest."
1551,1,10,41,52,1.2307692307692308,0.06507557165853581,526,Never mind what He says. Size DOES matter!
1551,1,10,41,52,1.2307692307692308,0.06507557165853581,526,Well now we know. Size does matter.
1551,1,10,41,52,1.2307692307692308,0.06507557165853581,526,"Oh, yeah, baby: I'm THAT good!"
1551,2,8,42,52,1.2307692307692308,0.07063269667552394,526,"As a matter of fact, size does matter."
1551,1,10,41,52,1.2307692307692308,0.06507557165853581,526,"Seriously, having a big one is truly overrated."
1551,3,6,43,52,1.2307692307692308,0.0757834127802906,526,Celibacy is a vastly overrated virtue.
1551,1,10,41,52,1.2307692307692308,0.06507557165853581,526,It turns out that tithing fifteen per cent from gross is better than fifteen net.
1551,2,8,42,52,1.2307692307692308,0.07063269667552394,526,"Geez, it looked bigger on your profile."
1551,1,10,41,52,1.2307692307692308,0.06507557165853581,526,At least up here I am well endowed.
1551,2,8,42,52,1.2307692307692308,0.07063269667552394,526,"Yes ma'am, I am from Texas. How can you tell?"
1551,2,8,42,52,1.2307692307692308,0.07063269667552394,526,I worked for this halo. White male privilege had nothing to do with it.
1551,4,4,44,52,1.2307692307692308,0.08060566646085904,526,"Maybe it's only the halo effect, but what's your stand on sex in heaven?"
1551,3,6,43,52,1.2307692307692308,0.0757834127802906,526,Let's just say I was endowed by the creator more than most......
1551,0,12,40,52,1.2307692307692308,0.058997306834413094,526,Where's my wingman when I need him
1551,3,6,43,52,1.2307692307692308,0.0757834127802906,526,"Have faith, my dear: As above, so below."
1551,3,6,43,52,1.2307692307692308,0.0757834127802906,526,"We've waited long enough, baby. Let's lose these things."
1551,1,10,41,52,1.2307692307692308,0.06507557165853581,526,"If you think that's big, wait until you see what else I've got."
1551,3,6,43,52,1.2307692307692308,0.0757834127802906,526,I used to have a huge afro.
1551,3,6,43,52,1.2307692307692308,0.0757834127802906,526,... and then I said 'Why don't you write a play about Alexander Hamilton?'
1551,2,8,42,52,1.2307692307692308,0.07063269667552394,526,"I realized a second too late that I should have been more clear when I asked for a ""big one"""
1619,2,7,39,48,1.2291666666666667,0.07437436055707797,526,You must be new here
1619,2,7,39,48,1.2291666666666667,0.07437436055707797,526,Oh my god! What the halo happened?
1619,2,7,39,48,1.2291666666666667,0.07437436055707797,526,I'm not mansplaining - I actually am holier than thou.
1619,2,7,39,48,1.2291666666666667,0.07437436055707797,526,It just grows when I get excited.
1619,1,9,38,48,1.2291666666666667,0.06815438860102259,526,It's actually a GPS device; I'm on a one day pass from Purgatory.
1619,3,5,40,48,1.2291666666666667,0.08011285995999187,526,"So, are you saying that will last for eternity?"
1619,2,7,39,48,1.2291666666666667,0.07437436055707797,526,It only gets this big when I see you!
1626,2,6,36,44,1.2272727272727273,0.07872958216222171,526,I never told a lie.
1626,1,8,35,44,1.2272727272727273,0.07170261260935148,526,"I said hula, not halo"
1626,1,8,35,44,1.2272727272727273,0.07170261260935148,526,They were low on halos; it's a hula hoop.
1629,2,8,43,53,1.2264150943396226,0.06942386498172073,526,What I asked for once I got here was a big 'Hello!'
1629,1,10,42,53,1.2264150943396226,0.06398424512382328,526,"Oh, I'd always heard that size didn't matter."""
1629,1,10,42,53,1.2264150943396226,0.06398424512382328,526,"Actually, I'd say it's hu-uuu-ge."
1629,2,8,43,53,1.2264150943396226,0.06942386498172073,526,You think I'm exaggerating?
1629,1,10,42,53,1.2264150943396226,0.06398424512382328,526,My team really deserves the credit; it's too bad they're in hell.
1629,3,6,44,53,1.2264150943396226,0.07446719031852134,526,"Rub yours, it will get bigger, too."
1629,1,10,42,53,1.2264150943396226,0.06398424512382328,526,Yep ... it means exactly that!
1629,2,8,43,53,1.2264150943396226,0.06942386498172073,526,I am not compensating.
1629,2,8,43,53,1.2264150943396226,0.06942386498172073,526,I am NOT overcompensating for a s short wing span.
1629,3,6,44,53,1.2264150943396226,0.07446719031852134,526,I could be really good to you too.
1629,2,8,43,53,1.2264150943396226,0.06942386498172073,526,You have no idea how boring my life was.
1629,1,10,42,53,1.2264150943396226,0.06398424512382328,526,I died in an untimely hula hoop accident.
1629,3,6,44,53,1.2264150943396226,0.07446719031852134,526,Got them fooled up here too I see.
1629,1,10,42,53,1.2264150943396226,0.06398424512382328,526,"You were right. I really am a ""Holier than thou guy."""
1629,3,6,44,53,1.2264150943396226,0.07446719031852134,526,It's a little embarrassing.
1644,3,5,41,49,1.2244897959183674,0.07860013611082545,526,"Since I've lost all of the weight, I haven't had the chance to get it re sized."
1644,3,5,41,49,1.2244897959183674,0.07860013611082545,526,"I don't wish to seem holier than thou, but..."
1644,0,11,38,49,1.2244897959183674,0.060224255815053626,526,"I had to cash in all my ""selfless deeds"", but I think it's a good look."
1644,1,9,39,49,1.2244897959183674,0.06691263800308161,526,"See, I am holier than thou."
1644,4,3,42,49,1.2244897959183674,0.08383508533242337,526,"Sure, now you say size doesn't matter!"
1644,2,7,40,49,1.2244897959183674,0.0729906929723637,526,Of course I was referring to my halo when I said it was bigger than most.
1644,1,9,39,49,1.2244897959183674,0.06691263800308161,526,"Unfortunately, it's an inverse relationship."
1644,4,3,42,49,1.2244897959183674,0.08383508533242337,526,"Up here, it's not size that matters, but circumference."
1644,2,7,40,49,1.2244897959183674,0.0729906929723637,526,"Yes, I invented the Hula Hoop."
1644,1,9,39,49,1.2244897959183674,0.06691263800308161,526,"There are no problems in that department, either."
1644,2,7,40,49,1.2244897959183674,0.0729906929723637,526,"Yeah, I used to have a swelled head. Somehow, everybody knows."
1644,2,7,40,49,1.2244897959183674,0.0729906929723637,526,"Yes, I am giving you a holier-than-thou attitude."
1644,1,9,39,49,1.2244897959183674,0.06691263800308161,526,5th grade. Hula Hoop champ.
1644,1,9,39,49,1.2244897959183674,0.06691263800308161,526,"I lived to a ripe old age, but it felt even longer."
1644,1,9,39,49,1.2244897959183674,0.06691263800308161,526,"When I behold your beauty , I can't control myself."
1644,1,9,39,49,1.2244897959183674,0.06691263800308161,526,"You're affecting my halo, you know."
1644,1,9,39,49,1.2244897959183674,0.06691263800308161,526,"I know...I know... it looks ridiculous, but the only size left was Republican Front Runner."
1644,2,7,40,49,1.2244897959183674,0.0729906929723637,526,I usually take M but XXL was the only size He had left.
1644,3,5,41,49,1.2244897959183674,0.07860013611082545,526,I remember saying that I wouldn't be caught dead with a hula hoop.
1644,3,5,41,49,1.2244897959183674,0.07860013611082545,526,"It's a Pinocchio halo. And no, the wings don't make your butt look fat."
1644,4,3,42,49,1.2244897959183674,0.08383508533242337,526,"""Is it true what they say about men with big halos""?"
1644,3,5,41,49,1.2244897959183674,0.07860013611082545,526,It's complicated.
1644,4,3,42,49,1.2244897959183674,0.08383508533242337,526,I play a lot of Halo.
1644,4,3,42,49,1.2244897959183674,0.08383508533242337,526,That’s just a recognition of my impressive humility.
1644,2,7,40,49,1.2244897959183674,0.0729906929723637,526,It's in proportion to my ego.
1644,2,7,40,49,1.2244897959183674,0.0729906929723637,526,"It'll shrink, you'll see."
1644,3,5,41,49,1.2244897959183674,0.07860013611082545,526,I hope it looks as big as it does on Tinder.
1644,3,5,41,49,1.2244897959183674,0.07860013611082545,526,"Well, I'm a Bernie supporter"
1644,2,7,40,49,1.2244897959183674,0.0729906929723637,526,"Once again, size DOES matter."
1644,1,9,39,49,1.2244897959183674,0.06691263800308161,526,I got the deluxe package.
1674,3,6,45,54,1.2222222222222223,0.0731953469605706,526,"They ran short of halos, so I had to settle for a hula hoop."
1674,1,10,43,54,1.2222222222222223,0.06292801266165045,526,Why do you say I have a holier-than-thou complex?
1676,3,5,42,50,1.22,0.07714285714285714,526,Don't give me that 'holier than thou' look again.
1676,2,7,41,50,1.22,0.07165677830848258,526,Why? Because chastity is harder for a man.
1676,2,7,41,50,1.22,0.07165677830848258,526,"Well, yes. It does make me ""holier than thou""!"
1676,1,9,40,50,1.22,0.06571428571428571,526,"All I said was, ""Super-size me!"""
1676,2,7,41,50,1.22,0.07165677830848258,526,Does this halo make me look fat? Be honest!
1676,0,11,39,50,1.22,0.059178043363451366,526,"'....so that's how I earned my 113th set of wings, but enough about me'"
1676,2,7,41,50,1.22,0.07165677830848258,526,Frankly I think they gave it to me as a punishment.
1676,3,5,42,50,1.22,0.07714285714285714,526,Do you think it steals His thunder?
1676,3,5,42,50,1.22,0.07714285714285714,526,"Two characters in search of a punch line, in a heaven-like environment."
1676,3,5,42,50,1.22,0.07714285714285714,526,I never got any complaints.
1676,3,5,42,50,1.22,0.07714285714285714,526,I was a hula hoop champion.
1676,3,5,42,50,1.22,0.07714285714285714,526,"When we were on Earth, you said size didn't matter."
1676,2,7,41,50,1.22,0.07165677830848258,526,am I seeing heaven or is just me?
1676,2,7,41,50,1.22,0.07165677830848258,526,They gave me the frequent flyer upgrade.
1676,4,3,43,50,1.22,0.08226388599364554,526,I've got accident forgiveness.
1676,3,5,42,50,1.22,0.07714285714285714,526,Yep. It's all thanks to Miracle-Gro.
1676,1,9,40,50,1.22,0.06571428571428571,526,You know I REALLY do like you.
1676,3,5,42,50,1.22,0.07714285714285714,526,They say halos lasting more than 4 hours may require emergency treatment.
1676,0,11,39,50,1.22,0.059178043363451366,526,Don't judge me by the size of my halo
1676,3,5,42,50,1.22,0.07714285714285714,526,I'm sorry to disappoint--it simply means I'm holier than thou.
1676,3,5,42,50,1.22,0.07714285714285714,526,It turns out that size DOES matter.
1676,2,7,41,50,1.22,0.07165677830848258,526,You should see my SAT scores.
1676,2,7,41,50,1.22,0.07165677830848258,526,"Apparently, size does matter up here."
1676,2,7,41,50,1.22,0.07165677830848258,526,Size matters here too.
1676,1,9,40,50,1.22,0.06571428571428571,526,You'te gonna need a bigger halo.
1676,3,5,42,50,1.22,0.07714285714285714,526,Not really .... I used to work in a pizzeria.
1676,3,5,42,50,1.22,0.07714285714285714,526,"Yeah, it's true what they say about men with big halos. This is heaven, isn't it?"
1676,3,5,42,50,1.22,0.07714285714285714,526,"You can't tell by looking at me, but I used to be very fat."
1676,1,9,40,50,1.22,0.06571428571428571,526,My mother was Goody Two-Shoes and my father was Dudley Do-Right. Why do you ask?
1676,4,3,43,50,1.22,0.08226388599364554,526,Yes. It's the same down there. Trust me.
1676,2,7,41,50,1.22,0.07165677830848258,526,...so Peter said 'would you like to be holy or super-holy?' so I sa...
1676,2,7,41,50,1.22,0.07165677830848258,526,They ran out of mediums and smalls.
1676,2,7,41,50,1.22,0.07165677830848258,526,"You probably think I'm compensating, but this halo is purely functional."
1676,3,5,42,50,1.22,0.07714285714285714,526,"Oh, yeah...and I also love puppies."
1676,2,7,41,50,1.22,0.07165677830848258,526,"Inversely proportional to number of sins, I swear."
1676,3,5,42,50,1.22,0.07714285714285714,526,"As it turns out, size does matter...."
1676,3,5,42,50,1.22,0.07714285714285714,526,"...ummm, I'm going to Hell, aren't I...!!"
1676,3,5,42,50,1.22,0.07714285714285714,526,"Up here, it's not the size of a man's hands that tells you anything ..."
1676,3,5,42,50,1.22,0.07714285714285714,526,I got it soon after I realized we had no feet.
1676,2,7,41,50,1.22,0.07165677830848258,526,Some women say it's the biggest they've ever seen.
1676,1,9,40,50,1.22,0.06571428571428571,526,You know it's true what they say about male angels with big halos.
1676,1,9,40,50,1.22,0.06571428571428571,526,"I was no angel, but I was exceptionally good."
1676,3,5,42,50,1.22,0.07714285714285714,526,Did u fall from heaven? Because... wait never mind.
1676,1,9,40,50,1.22,0.06571428571428571,526,"I get lounge access and 5,000 points a year for infinity."
1676,2,7,41,50,1.22,0.07165677830848258,526,From having an exaggerated sense of self-importance. Where'd you get your small one?
1676,2,7,41,50,1.22,0.07165677830848258,526,I had a crush on you in high school.
1676,2,7,41,50,1.22,0.07165677830848258,526,It is just the right size to double as a hula hoop.
1676,2,7,41,50,1.22,0.07165677830848258,526,"Lord knows, I am ready to downsize."
1676,3,5,42,50,1.22,0.07714285714285714,526,I had to exploit some big loopholes to get here.
1676,0,11,39,50,1.22,0.059178043363451366,526,Your cloud or mine?
1676,1,9,40,50,1.22,0.06571428571428571,526,"No matter what happens between us, please don't accuse me of acting like I'm holier than thou."
1676,4,3,43,50,1.22,0.08226388599364554,526,"Well you know what they say, big halo . . . ."
1676,2,7,41,50,1.22,0.07165677830848258,526,Let me mansplain it to you.
1676,2,7,41,50,1.22,0.07165677830848258,526,"I'm not saying I'm holier than thou, but."
1676,2,7,41,50,1.22,0.07165677830848258,526,"Yours may be brighter, but mine doubles as a Hula hoop."
1676,2,7,41,50,1.22,0.07165677830848258,526,"Well, I think my holier than thou attitude is justified."
1676,1,9,40,50,1.22,0.06571428571428571,526,"Not to brag, but the LEDs also make it 90 percent more efficient."
1676,2,7,41,50,1.22,0.07165677830848258,526,Let's just say the really exceptional thing about me isn't my personality.
1676,1,9,40,50,1.22,0.06571428571428571,526,Halo. I love you. Won't you tell me your name?
1676,2,7,41,50,1.22,0.07165677830848258,526,"Careful, I'm not sure how big this thing is going to get!"
1676,3,5,42,50,1.22,0.07714285714285714,526,"I'm, you know, one of your ""better"" angels."
1676,0,11,39,50,1.22,0.059178043363451366,526,You know size does matter.
1676,2,7,41,50,1.22,0.07165677830848258,526,"It was you who always said ""Size doesn't matter."""
1676,0,11,39,50,1.22,0.059178043363451366,526,I used my bonus miles to get the halo upgrade.
1676,3,5,42,50,1.22,0.07714285714285714,526,Congratulations! You've made it through one more glass ceiling.
1676,2,7,41,50,1.22,0.07165677830848258,526,Who knew God would be a woman?
1676,3,5,42,50,1.22,0.07714285714285714,526,"No, I am not over compensating!"
1676,3,5,42,50,1.22,0.07714285714285714,526,"Yes, size matters."
1676,2,7,41,50,1.22,0.07165677830848258,526,Let’s just say my conceptions are not immaculate.
1745,2,6,38,46,1.2173913043478262,0.07558495542263939,526,"Yes, I do believe there's a correlation"
1746,1,9,41,51,1.2156862745098038,0.0645571671888405,526,Well I think it looks vainglorious.
1746,2,7,42,51,1.2156862745098038,0.07037003311735827,526,I have large hands too.
1746,2,7,42,51,1.2156862745098038,0.07037003311735827,526,"I know, I know, it's not the size that counts..."
1746,3,5,43,51,1.2156862745098038,0.07573807025814888,526,"I know it's not very subtle, but I AM holier than thou!"
1746,1,9,41,51,1.2156862745098038,0.0645571671888405,526,"Yes Tina, In Heaven size does matter."
1746,2,7,42,51,1.2156862745098038,0.07037003311735827,526,You know what they say about angels with large halos...
1746,1,9,41,51,1.2156862745098038,0.0645571671888405,526,It's part of my retirement package.
1746,3,5,43,51,1.2156862745098038,0.07573807025814888,526,"Yeah, doll, even up here there's a glass ceiling."
1746,1,9,41,51,1.2156862745098038,0.0645571671888405,526,It's like Pinocchio's nose...
1746,1,9,41,51,1.2156862745098038,0.0645571671888405,526,You don't happen to have any polish I can borrow?
1746,2,7,42,51,1.2156862745098038,0.07037003311735827,526,It's not the size of the halo that matters.
1746,1,9,41,51,1.2156862745098038,0.0645571671888405,526,I have room for two.
1746,0,11,40,51,1.2156862745098038,0.058166262643887544,526,It's not the size of your halo that matters it is how you use it
1746,0,11,40,51,1.2156862745098038,0.058166262643887544,526,"Footwear? Size 14 medium, why do you ask?"
1746,2,7,42,51,1.2156862745098038,0.07037003311735827,526,"This sure beats a pitch fork, horns and a tail."
1746,1,9,41,51,1.2156862745098038,0.0645571671888405,526,It's true. The cloud is forever.
1746,2,7,42,51,1.2156862745098038,0.07037003311735827,526,"Yes, its big. No, I am not overcompensating"
1746,2,7,42,51,1.2156862745098038,0.07037003311735827,526,"Up here, it’s all concentric sex."
1746,1,9,41,51,1.2156862745098038,0.0645571671888405,526,Don't be fooled. I'm a bad boy.
1746,3,5,43,51,1.2156862745098038,0.07573807025814888,526,"Actually, I find the halo hoop is a great way to stay fit."
1746,2,7,42,51,1.2156862745098038,0.07037003311735827,526,We'll have a marriage made in heaven.
1746,3,5,43,51,1.2156862745098038,0.07573807025814888,526,"Well, you may not believe this, but, in a former life, I was Pinocchio."
1746,2,7,42,51,1.2156862745098038,0.07037003311735827,526,"I think it's because of my ""holier than thou"" attitude."
1746,1,9,41,51,1.2156862745098038,0.0645571671888405,526,How about seven minutes of Heaven?
1746,3,5,43,51,1.2156862745098038,0.07573807025814888,526,Wait a minute here. I was told it was until death do us part
1746,0,11,40,51,1.2156862745098038,0.058166262643887544,526,"I think we should go for ""Holier than Thou."" It works for me."
1746,1,9,41,51,1.2156862745098038,0.0645571671888405,526,I have to go back and take remedial sin.
1746,3,5,43,51,1.2156862745098038,0.07573807025814888,526,A woman who asked for a boob job her first day in heaven shouldn't talk!
1746,2,7,42,51,1.2156862745098038,0.07037003311735827,526,"It's not the size of you halo that matters, it's what you do with it."
1746,1,9,41,51,1.2156862745098038,0.0645571671888405,526,summa cum Lordie
1746,1,9,41,51,1.2156862745098038,0.0645571671888405,526,"Yes, there IS a correlation."
1746,3,5,43,51,1.2156862745098038,0.07573807025814888,526,I know halos. I've got the best halo.
1746,2,7,42,51,1.2156862745098038,0.07037003311735827,526,"I earned it. Do you remember the movie, It's a Wonderful Life?"
1746,1,9,41,51,1.2156862745098038,0.0645571671888405,526,"'the box says to go to the hospital if it stays like this for 4,000 years'"
1746,4,3,44,51,1.2156862745098038,0.08075004032146667,526,I'm the patron saint of cornhole players.
1746,1,9,41,51,1.2156862745098038,0.0645571671888405,526,Not really. I just died at the height of the hula hoop craze.
1746,3,5,43,51,1.2156862745098038,0.07573807025814888,526,I was a late bloomer.
1746,1,9,41,51,1.2156862745098038,0.0645571671888405,526,"Halo envy, my dear?"
1746,2,7,42,51,1.2156862745098038,0.07037003311735827,526,Hoola hoop contest winner.
1746,2,7,42,51,1.2156862745098038,0.07037003311735827,526,I'm holier than thou.
1746,1,9,41,51,1.2156862745098038,0.0645571671888405,526,I havn't done a lot since you dumped me in high school
1746,3,5,43,51,1.2156862745098038,0.07573807025814888,526,"With all the years I played Halo, I'm really not surprised."
1746,2,7,42,51,1.2156862745098038,0.07037003311735827,526,Bigger is better here too.
1746,3,5,43,51,1.2156862745098038,0.07573807025814888,526,"Big feet, big halo, ..."
1746,2,7,42,51,1.2156862745098038,0.07037003311735827,526,"Ok, ok, yes, I still have the receipt."
1746,2,7,42,51,1.2156862745098038,0.07037003311735827,526,Just because I'm holier than thou doesn't mean we can't remain friends and hang out like we used to.
1746,1,9,41,51,1.2156862745098038,0.0645571671888405,526,"Well, if size mattered down there it certainly should matter up here!"
1746,2,7,42,51,1.2156862745098038,0.07037003311735827,526,Yeah! That's what she said.
1746,3,5,43,51,1.2156862745098038,0.07573807025814888,526,Nothing exceptional really. Just pi r-squared times four.
1746,2,7,42,51,1.2156862745098038,0.07037003311735827,526,I made pizza. You??
1746,1,9,41,51,1.2156862745098038,0.0645571671888405,526,"Sorry, but even here we circulate in different orbits."
1746,2,7,42,51,1.2156862745098038,0.07037003311735827,526,An Oedipal victory and a lifetime of virtue...but that's enough about me. How'd you end up here?
1746,3,5,43,51,1.2156862745098038,0.07573807025814888,526,I worked in fast food most of my life so they let me supersize it.
1746,1,9,41,51,1.2156862745098038,0.0645571671888405,526,It's true what they say about angels with large halos.
1746,2,7,42,51,1.2156862745098038,0.07037003311735827,526,"No, I'm not compensating for anything, and no, I won't show you my hands."
1746,2,7,42,51,1.2156862745098038,0.07037003311735827,526,Is that your halo over your head or are you just happy to see me?
1746,3,5,43,51,1.2156862745098038,0.07573807025814888,526,I can't sleep on my stomach. How do you manage?
1746,2,7,42,51,1.2156862745098038,0.07037003311735827,526,"Hi, I'm Adam. You must be Eve. Long time - no see."
1746,4,3,44,51,1.2156862745098038,0.08075004032146667,526,"'Yes, I do know what they say about big halos.'"
1746,4,3,44,51,1.2156862745098038,0.08075004032146667,526,"Yeah, baby, and you know what THAT means..."
1746,3,5,43,51,1.2156862745098038,0.07573807025814888,526,...So then I died in a fire at the Wham-O factory.
1746,1,9,41,51,1.2156862745098038,0.0645571671888405,526,That's not a halo. It's a hole in the ceiling.
1746,3,5,43,51,1.2156862745098038,0.07573807025814888,526,"Thanks, but wait until you see my hands."
1746,1,9,41,51,1.2156862745098038,0.0645571671888405,526,"Sorry dear, it's just that we don't travel in the same circles."
1810,1,7,34,42,1.2142857142857142,0.0725807194981817,526,"Well, I may be a little narcissistic.."
1810,3,3,36,42,1.2142857142857142,0.08712543379825774,526,.. yes.. and I'm Jewish..
1812,1,8,38,47,1.2127659574468086,0.06757440284088687,526,"Well, if you got equal pay you could have afforded this one."
1812,2,6,39,47,1.2127659574468086,0.07410377385468282,526,I'd rather be lucky than good.
1812,1,8,38,47,1.2127659574468086,0.06757440284088687,526,It turns out that halo enhancement surgery is sort of frowned on around here.
1812,1,8,38,47,1.2127659574468086,0.06757440284088687,526,"Actually, I've found size does matter."
1812,1,8,38,47,1.2127659574468086,0.06757440284088687,526,Seriously? Size doesn't matter up here either?
1812,1,8,38,47,1.2127659574468086,0.06757440284088687,526,I told you to wear your seatbelt.
1812,1,8,38,47,1.2127659574468086,0.06757440284088687,526,Wham-o just took over halo production.
1812,3,4,40,47,1.2127659574468086,0.08010267585860968,526,Just so we are clear: I am not compensating for anything with this.
1812,2,6,39,47,1.2127659574468086,0.07410377385468282,526,"Wow, I didn't know that size would matter up here."
1821,3,5,44,52,1.2115384615384615,0.07438302518417335,526,"No, please...I'm a Jehovah's Witness, one virgin is enough."
1821,1,9,42,52,1.2115384615384615,0.0634392529086423,526,"All I can say is there are a lot of school teachers up here, but I was the first politician."
1821,2,7,43,52,1.2115384615384615,0.06912804512336526,526,I thought it would shrink in the wash...
1821,2,7,43,52,1.2115384615384615,0.06912804512336526,526,"Oh no, forget it, remember it was 'til death do us part."
1821,2,7,43,52,1.2115384615384615,0.06912804512336526,526,I have PlatinumMiles status and got upgraded.
1821,2,7,43,52,1.2115384615384615,0.06912804512336526,526,I swear I'm not compensating for something else.
1821,2,7,43,52,1.2115384615384615,0.06912804512336526,526,Welcome to Cloud 9 and yes I have big feet too.
1821,1,9,42,52,1.2115384615384615,0.0634392529086423,526,"Well, I was the National Hula Hoop Champion of 1963. What about you?"
1821,1,9,42,52,1.2115384615384615,0.0634392529086423,526,Even here ... size matters.
1821,2,7,43,52,1.2115384615384615,0.06912804512336526,526,"Yeah, I created the Halo Hoop brand. Business is booming."
1821,1,9,42,52,1.2115384615384615,0.0634392529086423,526,I super-sized it in the fly-thru.
1821,1,9,42,52,1.2115384615384615,0.0634392529086423,526,I was from Texas
1821,2,7,43,52,1.2115384615384615,0.06912804512336526,526,"Big feet, big hands, big halo!"
1821,2,7,43,52,1.2115384615384615,0.06912804512336526,526,Its herniated; and my personal care doctor has been cast out of network.
1821,1,9,42,52,1.2115384615384615,0.0634392529086423,526,I'm having trouble with my 'bad boy' image.
1821,2,7,43,52,1.2115384615384615,0.06912804512336526,526,"Actually, that email about enhancements wasn't a scam."
1821,3,5,44,52,1.2115384615384615,0.07438302518417335,526,"Why yes, I am a graduate of Trump University."
1821,3,5,44,52,1.2115384615384615,0.07438302518417335,526,A massive heart attack while hula hooping.
1821,3,5,44,52,1.2115384615384615,0.07438302518417335,526,God knows there are virgins and there are virgins.
1821,3,5,44,52,1.2115384615384615,0.07438302518417335,526,it's not ego - I was just a hula-hoop salesman.
1841,2,6,40,48,1.2083333333333333,0.07267881673425383,526,Trump loaned it to me.
1841,4,2,42,48,1.2083333333333333,0.08399559540405274,526,I've got a big you know what.
1841,2,6,40,48,1.2083333333333333,0.07267881673425383,526,"""What ever happened to equal halos for equal work?"
1841,1,8,39,48,1.2083333333333333,0.0662999666605966,526,I can explain!
1841,3,4,41,48,1.2083333333333333,0.07854129630064868,526,After the date we can hula-hoop.
1841,1,8,39,48,1.2083333333333333,0.0662999666605966,526,There's no envy up here.
1841,1,8,39,48,1.2083333333333333,0.0662999666605966,526,I worked in a pizza place. You?
1841,1,8,39,48,1.2083333333333333,0.0662999666605966,526,"No, sorry - just the halo."
1841,2,6,40,48,1.2083333333333333,0.07267881673425383,526,Yeah me and God. We're really tight.
1841,0,10,38,48,1.2083333333333333,0.059238169759886945,526,"It's the Beam Me Up, Scotty app."
1841,1,8,39,48,1.2083333333333333,0.0662999666605966,526,I'm having it resized. I've lossed so much weight.
1841,1,8,39,48,1.2083333333333333,0.0662999666605966,526,I recently dropped gluten.
1841,2,6,40,48,1.2083333333333333,0.07267881673425383,526,If you smoked cigarettes you'd be able to do this too.
1841,2,6,40,48,1.2083333333333333,0.07267881673425383,526,"Me? Oh, I owned a Pizza Restaurant!"
1841,1,8,39,48,1.2083333333333333,0.0662999666605966,526,"Trust me - in this case, heaven can definitely wait."
1841,3,4,41,48,1.2083333333333333,0.07854129630064868,526,My sins were bigger
1841,3,4,41,48,1.2083333333333333,0.07854129630064868,526,"I'm accused of being a snob, but actually I died hula hooping."
1841,2,6,40,48,1.2083333333333333,0.07267881673425383,526,"I'm sooo good, I'm bad."
1841,2,6,40,48,1.2083333333333333,0.07267881673425383,526,I get it!!! Women are tired of getting a 76% halo!
1841,4,2,42,48,1.2083333333333333,0.08399559540405274,526,i'm kind of a modest guy you know
1841,1,8,39,48,1.2083333333333333,0.0662999666605966,526,"Touch it, it's real."
1841,1,8,39,48,1.2083333333333333,0.0662999666605966,526,I used to work for Apple. It's called an Infinity Loop.
1841,1,8,39,48,1.2083333333333333,0.0662999666605966,526,"Why yes, I am good. I've always been very, very good! Why do you ask?"
1864,2,7,44,53,1.2075471698113207,0.06792855979005262,526,"You know what they say -- ""the bigger the halo..."""
1864,3,5,45,53,1.2075471698113207,0.07307515747561165,526,hello...or should i say halo
1866,3,3,38,44,1.2045454545454546,0.08339737432901621,526,"My feet are big, too."
1866,3,3,38,44,1.2045454545454546,0.08339737432901621,526,"Oh, halo-o..."
1866,1,7,36,44,1.2045454545454546,0.06957698714453991,526,Why you little devil you.
1866,3,3,38,44,1.2045454545454546,0.08339737432901621,526,I asked for one matching my hand size.
1866,1,7,36,44,1.2045454545454546,0.06957698714453991,526,It happened since I decided to vote independent in the upcoming presidential election.
1871,0,10,39,49,1.2040816326530612,0.058172215566282534,526,"Wow, this is my old hula hoop."
1871,2,6,41,49,1.2040816326530612,0.07130699079332185,526,I know you're a Virgin but God instructed me to spread his holy seed.
1871,4,2,43,49,1.2040816326530612,0.08237334039668254,526,"You thought ""holier than thou"" meant something else?"
1871,1,8,40,49,1.2040816326530612,0.06507185874050676,526,"wish it were true, but i think they mixed up our halos....."
1871,3,4,42,49,1.2040816326530612,0.07703912689051784,526,Why yes it is true what they say about men with big halos.
1871,4,2,43,49,1.2040816326530612,0.08237334039668254,526,I want a divorce.
1871,2,6,41,49,1.2040816326530612,0.07130699079332185,526,We Mormons work hard.
1871,1,8,40,49,1.2040816326530612,0.06507185874050676,526,I got my halo at Costco.
1871,1,8,40,49,1.2040816326530612,0.06507185874050676,526,"I assure you, everyone benefits from the newly privatized halo industry."
1871,1,8,40,49,1.2040816326530612,0.06507185874050676,526,Is it perfect here or is it just you?
1871,1,8,40,49,1.2040816326530612,0.06507185874050676,526,"Yeah, I've been doing Cross Fit."
1871,0,10,39,49,1.2040816326530612,0.058172215566282534,526,They ran out of halos. I got a hula hoop.
1871,3,4,42,49,1.2040816326530612,0.07703912689051784,526,"I know, I've been meaning to make an appointment with my urologist."
1871,0,10,39,49,1.2040816326530612,0.058172215566282534,526,Even in Heaven I still can't impress women...
1871,2,6,41,49,1.2040816326530612,0.07130699079332185,526,It's part of the new merit system HR is rolling out..
1871,2,6,41,49,1.2040816326530612,0.07130699079332185,526,See - I told you mine was bigger!
1871,1,8,40,49,1.2040816326530612,0.06507185874050676,526,I kept my social media posts to a minimum.
1871,3,4,42,49,1.2040816326530612,0.07703912689051784,526,You know what they say about angels with big halos...
1871,2,6,41,49,1.2040816326530612,0.07130699079332185,526,Science said this is impossible.
1871,2,6,41,49,1.2040816326530612,0.07130699079332185,526,And you should see my hands. They're huge -- HUGE!
1871,1,8,40,49,1.2040816326530612,0.06507185874050676,526,Oh goodness! Am I manspreading again?
1871,3,4,42,49,1.2040816326530612,0.07703912689051784,526,I'm taking part in a study on halo growth hormone.
1871,0,10,39,49,1.2040816326530612,0.058172215566282534,526,When I order XXXL I assumed there would be some shrinkage.
1871,3,4,42,49,1.2040816326530612,0.07703912689051784,526,I was the angel investor for hula hoop.
1871,0,10,39,49,1.2040816326530612,0.058172215566282534,526,"On size fits all, my ass!"
1871,1,8,40,49,1.2040816326530612,0.06507185874050676,526,Plastics.
1871,2,6,41,49,1.2040816326530612,0.07130699079332185,526,"Be honest, can you see the string?"
1871,4,2,43,49,1.2040816326530612,0.08237334039668254,526,"Yeah, I get to use it until one of the Kardashians shows up."
1871,2,6,41,49,1.2040816326530612,0.07130699079332185,526,You'll like it here. Think of it as several steps above assisted living.
1871,1,8,40,49,1.2040816326530612,0.06507185874050676,526,I guess I'm just blessed.
1871,1,8,40,49,1.2040816326530612,0.06507185874050676,526,It helps my night vision.
1871,2,6,41,49,1.2040816326530612,0.07130699079332185,526,What makes you think there wouldn't be a glass halo here?
1871,2,6,41,49,1.2040816326530612,0.07130699079332185,526,"I'm not saying that size matters, just that mine is bigger."
1871,2,6,41,49,1.2040816326530612,0.07130699079332185,526,"Up here, this is the white man's burden."
1871,0,10,39,49,1.2040816326530612,0.058172215566282534,526,I negotiated a golden parachute clause.
1871,1,8,40,49,1.2040816326530612,0.06507185874050676,526,Extra credit for rejecting campaign contributions from the gun lobby.
1871,1,8,40,49,1.2040816326530612,0.06507185874050676,526,I do not judge people by the size of their halo.
1871,1,8,40,49,1.2040816326530612,0.06507185874050676,526,"You're absolutly correct, I do have a ""holier then thou"" attitude."
1871,2,6,41,49,1.2040816326530612,0.07130699079332185,526,How'd you know I spent 12 years in Catholic school?
1871,2,6,41,49,1.2040816326530612,0.07130699079332185,526,It gives me the space I need to spread my wings.
1871,2,6,41,49,1.2040816326530612,0.07130699079332185,526,"Here too, size does matter"
1871,1,8,40,49,1.2040816326530612,0.06507185874050676,526,I used to be a fireman.
1871,2,6,41,49,1.2040816326530612,0.07130699079332185,526,I'm assigned to Trump.
1871,2,6,41,49,1.2040816326530612,0.07130699079332185,526,"Far be it from me to say that I'm more blessed than anyone else, but someone around here certainly thinks so!"
1871,1,8,40,49,1.2040816326530612,0.06507185874050676,526,In my previous life I had very large hands.
1871,2,6,41,49,1.2040816326530612,0.07130699079332185,526,"I don't know about thou, but I am holier than most."
1871,1,8,40,49,1.2040816326530612,0.06507185874050676,526,I OD'd on Viagra.
1871,3,4,42,49,1.2040816326530612,0.07703912689051784,526,I gave my first halo to charity.
1871,4,2,43,49,1.2040816326530612,0.08237334039668254,526,Even God had placed good money I'd go to Hell when I was born.
1920,4,5,55,64,1.203125,0.06747900724411107,526,"Well, you know what they say? Big halo, big..."
1921,2,6,42,50,1.2,0.06998542122237651,526,"It's not the size, it's what's inside that counts"
1921,1,7,37,45,1.2,0.06816498108607269,526,My halo gets bigger when I don't tell the truth.
1921,0,10,40,50,1.2,0.05714285714285714,526,Not exactly. They told me it represents how much better than other people I THOUGHT I was.
1921,3,4,43,50,1.2,0.07559289460184544,526,"I was a big-headed fool 'til I met you, Angel."
1921,1,8,41,50,1.2,0.06388765649999399,526,Yes. Big on virtue. Short on experience.
1921,0,9,36,45,1.2,0.06030226891555274,526,But yours looks more comfy.
1921,2,5,38,45,1.2,0.07521014330903551,526,"You excite me, Monica--even here of all places."
1921,0,10,40,50,1.2,0.05714285714285714,526,I'm blessed.
1921,3,4,43,50,1.2,0.07559289460184544,526,"You can vote for whomever you want, it's the holier than thou attitude that I have an issue with."
1921,2,6,42,50,1.2,0.06998542122237651,526,So you really were a shrink in your previous life.
1921,2,6,42,50,1.2,0.06998542122237651,526,There's no overcompensating in heaven.
1921,0,10,40,50,1.2,0.05714285714285714,526,When are you going to learn - everything's negotiable.
1921,4,2,44,50,1.2,0.08081220356417686,526,Does a small hallo mean what I think it means ?
1921,3,4,43,50,1.2,0.07559289460184544,526,It was part of class-action settlement against the Pearly Gate co.
1921,1,8,41,50,1.2,0.06388765649999399,526,Let me guess. You were a priest.
1921,2,6,42,50,1.2,0.06998542122237651,526,I'm compensating.
1921,1,7,37,45,1.2,0.06816498108607269,526,"I'm a high mileage, clean, one owner."
1921,2,6,42,50,1.2,0.06998542122237651,526,"Do you know what a big halo means, right? I'm a big chauvinist. We can't lie up here."
1921,1,8,41,50,1.2,0.06388765649999399,526,I'd take tits over a big halo anyday.
1921,0,9,36,45,1.2,0.06030226891555274,526,"Yes Gloria, as you probably surmised, I do need this very loose robe."""
1921,2,6,42,50,1.2,0.06998542122237651,526,Of course it's not just the Halo... We also get pockets.
1921,3,3,39,45,1.2,0.08164965809277261,526,"Hello, My Name Is Pinocchio."
1921,1,7,37,45,1.2,0.06816498108607269,526,It's apparently what happens when an erection lasts longer than four hours.
1921,3,4,43,50,1.2,0.07559289460184544,526,Small hands - big halo
1921,3,4,43,50,1.2,0.07559289460184544,526,"That's the problem, you think bigger is always better."
1921,1,8,41,50,1.2,0.06388765649999399,526,"Well the wings were marked, ""One size fits all."""
1921,4,2,44,50,1.2,0.08081220356417686,526,"I'd humblebrag about why, but then I'd lose it."
1921,2,6,42,50,1.2,0.06998542122237651,526,Why do you need to see my hands?
1921,1,8,41,50,1.2,0.06388765649999399,526,"Wow you're beautiful, did I live and go to Earth?"
1921,1,8,41,50,1.2,0.06388765649999399,526,I am NOT trying to over compensate.
1921,0,10,40,50,1.2,0.05714285714285714,526,"No, that's just a myth."
1921,1,8,41,50,1.2,0.06388765649999399,526,"Go ahead and laugh, but the Large Halo was perfectly ""hip"" during the dawn of time."
1921,1,7,37,45,1.2,0.06816498108607269,526,That's right; everything is proportional.
1921,2,6,42,50,1.2,0.06998542122237651,526,"What the halo, i'll wing it."
1921,1,7,37,45,1.2,0.06816498108607269,526,I ordered the extra large halo from Amazon Prime
1921,3,4,43,50,1.2,0.07559289460184544,526,I was a protester at a Donald Trump rally.
1921,2,6,42,50,1.2,0.06998542122237651,526,"I wish. Actually, they're inversely proportional"
1921,0,9,36,45,1.2,0.06030226891555274,526,Didn't Saint Peter tell you about the Super Size offer?
1921,2,6,42,50,1.2,0.06998542122237651,526,Mine is from Costco...!
1921,0,10,40,50,1.2,0.05714285714285714,526,All the cherubs are wearing them like this now.
1921,0,9,36,45,1.2,0.06030226891555274,526,"Don't be embarrassed, hon. Yours is supposed to be smaller."
1921,3,4,43,50,1.2,0.07559289460184544,526,I wish we had met sooner.
1921,4,2,44,50,1.2,0.08081220356417686,526,Size does matter here!
1921,2,5,38,45,1.2,0.07521014330903551,526,"'What can I say? I had to jump through a lot of hoops during my life........"""
1921,1,8,41,50,1.2,0.06388765649999399,526,"Your virtue, no matter how small, is safe with me."
1921,2,6,42,50,1.2,0.06998542122237651,526,"So what, we made it didn't we?"
1921,2,5,38,45,1.2,0.07521014330903551,526,Want to go to hell for the weekend?
1921,2,6,42,50,1.2,0.06998542122237651,526,"Yes, we seraphim get the cumulo-nimbus."
1921,2,6,42,50,1.2,0.06998542122237651,526,"Now you know that anything you can do, I can do better!"
1921,3,4,43,50,1.2,0.07559289460184544,526,"Not to brag, but I've lost a ton of weight since coming up here."
1921,1,8,41,50,1.2,0.06388765649999399,526,"Turns out, humility is not a virtue."
1921,1,8,41,50,1.2,0.06388765649999399,526,"Every time I say size doesn't matter, it gets bigger."
1921,2,6,42,50,1.2,0.06998542122237651,526,"So you see I was right in my ""Holier Than Thou"" attitude."
1921,1,8,41,50,1.2,0.06388765649999399,526,And you know where good guys finish.
1921,3,4,43,50,1.2,0.07559289460184544,526,"It's the Trump Line...best hair, biggest halo, and enormous pockets for small hands."
1921,2,6,42,50,1.2,0.06998542122237651,526,It's actually a repurposed hula hoop; the one I was using at the time.
1921,1,7,37,45,1.2,0.06816498108607269,526,Me? I fell through a manhole!
1921,1,8,41,50,1.2,0.06388765649999399,526,"""Holier than thou?"" Helluva joke lady."
1921,0,10,40,50,1.2,0.05714285714285714,526,What in heaven's name would make you think I'm going through a mid-death crisis?
1921,2,6,42,50,1.2,0.06998542122237651,526,"With that neckline it doesn't surprise me too much."""
1921,1,8,41,50,1.2,0.06388765649999399,526,I was breastfed.
1921,2,6,42,50,1.2,0.06998542122237651,526,Perhaps you should have been more diplomatic in the confessional.
1921,2,6,42,50,1.2,0.06998542122237651,526,I lived my entire life in Texas.
1921,2,5,38,45,1.2,0.07521014330903551,526,"Truth be told, it's a hula hoop."
1921,1,8,41,50,1.2,0.06388765649999399,526,"This is what I wanted on the golf course, not up here!"
1921,1,7,37,45,1.2,0.06816498108607269,526,"I know I seem too good to be true, but...."
1921,2,6,42,50,1.2,0.06998542122237651,526,"It""s bigger because I was a Democrat."
1988,3,4,44,51,1.196078431372549,0.07419956050362551,526,It enables a better shower.
1988,0,10,41,51,1.196078431372549,0.05614831789520141,526,It came as a free upgrade on my last flight!
1988,2,6,43,51,1.196078431372549,0.06871143320758917,526,Heaven can wait.
1988,2,6,43,51,1.196078431372549,0.06871143320758917,526,A match made in heaven!
1988,1,8,42,51,1.196078431372549,0.06274509803921571,526,So yeah... it stretches when you use it as a frisbee.
1988,2,6,43,51,1.196078431372549,0.06871143320758917,526,I do most of my work in Texas.
1994,2,5,39,46,1.1956521739130435,0.07368535547180384,526,"Apparently, it's commensurate with ego."
1994,1,7,38,46,1.1956521739130435,0.06680829316878904,526,"I,too, was once a little naughty."
1994,1,7,38,46,1.1956521739130435,0.06680829316878904,526,I got this before I went on The Biggest Loser and lost 140 pounds but they won't change it in case I regain it.
1994,0,9,37,46,1.1956521739130435,0.05913682829884976,526,Another one of those holier than thou types.
1994,1,7,38,46,1.1956521739130435,0.06680829316878904,526,It's actually the ozone hole caused by a certain New York tycoon's hairspray.
1994,3,3,40,46,1.1956521739130435,0.07997321542795012,526,"Sorry, you know what they say about men with big halos..."
1994,0,9,37,46,1.1956521739130435,0.05913682829884976,526,Because I'm so humble.
1994,2,5,39,46,1.1956521739130435,0.07368535547180384,526,"Well, you know what they say about halo size..."
1994,1,7,38,46,1.1956521739130435,0.06680829316878904,526,"I'm surprised you got in with your ""holier than thou"" attitude."
1994,0,9,37,46,1.1956521739130435,0.05913682829884976,526,I asked them to supersize it.
1994,3,3,40,46,1.1956521739130435,0.07997321542795012,526,"No I’m not over compensating, I’m the inventor of the Hula Hoop."
1994,2,5,39,46,1.1956521739130435,0.07368535547180384,526,They're supposed to compensate for the loss of our penises.
1994,1,7,38,46,1.1956521739130435,0.06680829316878904,526,"Yes, it is proportional."
1994,1,7,38,46,1.1956521739130435,0.06680829316878904,526,I was a virgin to the bitter end
1994,2,5,39,46,1.1956521739130435,0.07368535547180384,526,My halo likes to compensate for a lot of things.
1994,0,9,37,46,1.1956521739130435,0.05913682829884976,526,"Yeah, once I took a selfie with God, but, you know, it's no big deal."
1994,1,7,38,46,1.1956521739130435,0.06680829316878904,526,My father gave me a small loan of one-million good deeds.
1994,2,5,39,46,1.1956521739130435,0.07368535547180384,526,Why do people keep asking me if I invented the Hula Hoop?
1994,3,3,40,46,1.1956521739130435,0.07997321542795012,526,"Well, yeah, baby, I did drive a fancy sportscar when I was alive. How did you know?"
1994,1,7,38,46,1.1956521739130435,0.06680829316878904,526,Oh...just a lifetime of resistance training.
1994,2,5,39,46,1.1956521739130435,0.07368535547180384,526,"Big wings, big halo. Do the math."
1994,1,7,38,46,1.1956521739130435,0.06680829316878904,526,You should trust the system.
1994,3,3,40,46,1.1956521739130435,0.07997321542795012,526,I played Eight Seasons with the Knicks.
1994,1,7,38,46,1.1956521739130435,0.06680829316878904,526,Remember when you told me to tip ten percent but I did fifteen?
1994,1,7,38,46,1.1956521739130435,0.06680829316878904,526,"Hula Hoop Champion, 1976, and you?"
1994,2,5,39,46,1.1956521739130435,0.07368535547180384,526,If it doesn't go back to normal in four hours call a doctor.
1994,0,9,37,46,1.1956521739130435,0.05913682829884976,526,"No, I just loved to hula-hoop."
1994,1,7,38,46,1.1956521739130435,0.06680829316878904,526,Still not convinced my denomination was right?
1994,1,7,38,46,1.1956521739130435,0.06680829316878904,526,I typed 'AMEN' in the comments.
1994,2,5,39,46,1.1956521739130435,0.07368535547180384,526,"Oh, no no no no no - not overcompensating for anything."
1994,1,7,38,46,1.1956521739130435,0.06680829316878904,526,Do you even tithe?
1994,3,3,40,46,1.1956521739130435,0.07997321542795012,526,I must have died and gone to heaven!
1994,1,7,38,46,1.1956521739130435,0.06680829316878904,526,"Why, yes I am the founder of Whammo. How did you know?"
1994,1,7,38,46,1.1956521739130435,0.06680829316878904,526,You might say I was really meek.
1994,2,5,39,46,1.1956521739130435,0.07368535547180384,526,"Well, obviously I am halo-ier than thou."
1994,1,7,38,46,1.1956521739130435,0.06680829316878904,526,I used to have an Afro.
1994,3,3,40,46,1.1956521739130435,0.07997321542795012,526,I'm looking at your eyes.
1994,1,7,38,46,1.1956521739130435,0.06680829316878904,526,"If it were just up to me, you'd have a bigger halo already, but you have to understand that this place is very hierarchical."
1994,1,7,38,46,1.1956521739130435,0.06680829316878904,526,I had an ego problem on earth.
1994,1,7,38,46,1.1956521739130435,0.06680829316878904,526,I'd be happy to take you under my wing and show you around.
2034,1,8,43,52,1.1923076923076923,0.06164206964379924,526,Yeah...that's what they all say.
2034,1,8,43,52,1.1923076923076923,0.06164206964379924,526,Chauvinist!
2036,2,5,40,47,1.1914893617021276,0.07222061144970149,526,"Fortunately, up here, size does matter."
2036,2,5,40,47,1.1914893617021276,0.07222061144970149,526,"The truth is, they hold our impure thoughts."
2036,4,1,42,47,1.1914893617021276,0.0840592379133655,526,"Yes, it is!"
2036,0,9,38,47,1.1914893617021276,0.058014463349769285,526,"Apparently ""HE"" was impressed with my invention of the Hula Hoop"
2036,2,5,40,47,1.1914893617021276,0.07222061144970149,526,"I know what you're thinking, I can't lie up here, there's no connection."
2036,2,5,40,47,1.1914893617021276,0.07222061144970149,526,I had heard that size does matter.
2036,1,7,39,47,1.1914893617021276,0.06550379636299898,526,It's a hula hoop. They are out of halos until next week's delivery.
2036,2,5,40,47,1.1914893617021276,0.07222061144970149,526,I got the bigger one for letting you drive.
2036,2,5,40,47,1.1914893617021276,0.07222061144970149,526,You know what they say about men with small halos ...
2036,2,5,40,47,1.1914893617021276,0.07222061144970149,526,"'Holier than thou?' No, it's my hula hoop."
2036,4,1,42,47,1.1914893617021276,0.0840592379133655,526,I was a lot heavier down there.
2036,1,7,39,47,1.1914893617021276,0.06550379636299898,526,You're right. I HAVE lost weight.
2036,1,7,39,47,1.1914893617021276,0.06550379636299898,526,"Wow. You must have been really good, huh?"
2036,1,7,39,47,1.1914893617021276,0.06550379636299898,526,I'm in the preventative virtue program.
2036,1,7,39,47,1.1914893617021276,0.06550379636299898,526,"It sets off metal detectors at the airport, and don't get me started on narrow doorways!"
2036,1,7,39,47,1.1914893617021276,0.06550379636299898,526,Turns out I was right all those times...
2036,0,9,38,47,1.1914893617021276,0.058014463349769285,526,There are degrees of goodness.
2036,3,3,41,47,1.1914893617021276,0.07836380604827888,526,"After looking at your robe, maybe my halo shouldn't be as large as it appears."
2036,1,7,39,47,1.1914893617021276,0.06550379636299898,526,"While my king-size halo says I am very good, it doesn't say at what..."
2036,3,3,41,47,1.1914893617021276,0.07836380604827888,526,"Since we can't see our feet up here, it's the size of a man's halo that's indicative of ... you know."
2036,1,7,39,47,1.1914893617021276,0.06550379636299898,526,Closing the gender pay gap is taking a little longer than we expected
2036,2,5,40,47,1.1914893617021276,0.07222061144970149,526,"In eternity, size matters more."
2036,2,5,40,47,1.1914893617021276,0.07222061144970149,526,I don't see the point of a prenuptial agreement.
2036,0,9,38,47,1.1914893617021276,0.058014463349769285,526,The temptation to correlate is infinite.
2036,2,5,40,47,1.1914893617021276,0.07222061144970149,526,I died during my mid-life crisis.
2036,3,3,41,47,1.1914893617021276,0.07836380604827888,526,"Once, I had a dinner party with some ""gluten sensitive"" friends."
2036,1,7,39,47,1.1914893617021276,0.06550379636299898,526,"Sometimes parking is a little tight, but I like it."
2036,0,9,38,47,1.1914893617021276,0.058014463349769285,526,I was able to give more than the ten percent.
2036,2,5,40,47,1.1914893617021276,0.07222061144970149,526,"St. Peter ran our of halos, but he had some hula hoops left over from the sixties."
2036,2,5,40,47,1.1914893617021276,0.07222061144970149,526,I was told it will shrink in the rain.
2036,2,5,40,47,1.1914893617021276,0.07222061144970149,526,"Of course I'm no angel. There's a hula hoop shortage, and I offered to teach the early morning classes."
2036,1,7,39,47,1.1914893617021276,0.06550379636299898,526,It's a little known verse - blessed is the bling.
2036,2,5,40,47,1.1914893617021276,0.07222061144970149,526,"I'm not one to brag - but - I knew I had you at ""halo."""
2036,2,5,40,47,1.1914893617021276,0.07222061144970149,526,"Wow, those pills really do work don't they."
2036,0,9,38,47,1.1914893617021276,0.058014463349769285,526,"Sure, the accolade is nice, but just try getting through a door with this thing."
2036,3,3,41,47,1.1914893617021276,0.07836380604827888,526,"Then I went to the registration desk and they said, 'just take the f***ing halo and get out.'"
2036,2,5,40,47,1.1914893617021276,0.07222061144970149,526,I won it in a bet with Saint What's-His-Name.
2036,2,5,40,47,1.1914893617021276,0.07222061144970149,526,When I got up here I found out that size IS everything.
2036,2,5,40,47,1.1914893617021276,0.07222061144970149,526,The big halos go on sale every century or so.
2036,2,5,40,47,1.1914893617021276,0.07222061144970149,526,it's a bonus award from my visa account
2036,2,5,40,47,1.1914893617021276,0.07222061144970149,526,"Oh, this is not politically correct"
2036,1,7,39,47,1.1914893617021276,0.06550379636299898,526,PBS ran out of golf umbrellas.
2036,1,7,39,47,1.1914893617021276,0.06550379636299898,526,That's what St. Peter said.
2036,1,7,39,47,1.1914893617021276,0.06550379636299898,526,I cannot bear false witness; I'm overcompensating.
2036,1,7,39,47,1.1914893617021276,0.06550379636299898,526,"Sorry, but this is what 'totally jacked with six-pack abs' means on the dating apps up here."
2036,2,5,40,47,1.1914893617021276,0.07222061144970149,526,Well you know what they say about Angels with big haloes.
2036,1,7,39,47,1.1914893617021276,0.06550379636299898,526,I was heir to the Wham-O fortune.
2036,1,7,39,47,1.1914893617021276,0.06550379636299898,526,It's for good behavior.
2036,1,7,39,47,1.1914893617021276,0.06550379636299898,526,What's a nice girl like you doing in a goody-goody place like this?
2036,3,3,41,47,1.1914893617021276,0.07836380604827888,526,"Oh, I'm no hero, I just tried to help a few friends out when the shooting started!"
2036,1,7,39,47,1.1914893617021276,0.06550379636299898,526,My parents kept me on a curfew until I was 30.
2036,1,7,39,47,1.1914893617021276,0.06550379636299898,526,Rescued orphans from a fire? That sounds pretty cool. I taught my mom how to use her DVR. Hardly even cursed.
2036,2,5,40,47,1.1914893617021276,0.07222061144970149,526,You know what they about angels with big halos.
2036,2,5,40,47,1.1914893617021276,0.07222061144970149,526,"No, I am not trying to be holier than thou.”"
2036,2,5,40,47,1.1914893617021276,0.07222061144970149,526,"Believe me, Angelica. Size really DOES matter."
2036,1,7,39,47,1.1914893617021276,0.06550379636299898,526,Relax! It's a Hula Hoop.
2036,3,3,41,47,1.1914893617021276,0.07836380604827888,526,A little red guy with a long tail said that I would have more fun if I wore it up here.
2036,1,7,39,47,1.1914893617021276,0.06550379636299898,526,Wow! I'd love your help downsizing.
2036,1,7,39,47,1.1914893617021276,0.06550379636299898,526,It's the only size Amazon had left.
2036,1,7,39,47,1.1914893617021276,0.06550379636299898,526,The male version only comes in one size.
2036,1,7,39,47,1.1914893617021276,0.06550379636299898,526,"Ultimately, size does matter."
2036,3,3,41,47,1.1914893617021276,0.07836380604827888,526,There's room for one more.
2036,1,7,39,47,1.1914893617021276,0.06550379636299898,526,These wings are super real and this definitely isn't a hula hoop.
2036,3,3,41,47,1.1914893617021276,0.07836380604827888,526,I was a really good hula hooper.
2036,0,9,38,47,1.1914893617021276,0.058014463349769285,526,They were out of my size.
2036,3,3,41,47,1.1914893617021276,0.07836380604827888,526,"On the bright side, there's a lot less grit in the clams"
2036,2,5,40,47,1.1914893617021276,0.07222061144970149,526,I use to be in man holes.
2036,2,5,40,47,1.1914893617021276,0.07222061144970149,526,I was a Saint .
2036,3,3,41,47,1.1914893617021276,0.07836380604827888,526,The gender pray gap is just a myth.
2036,2,5,40,47,1.1914893617021276,0.07222061144970149,526,"Yes, it's true what they say about a one's halo size..."
2036,3,3,41,47,1.1914893617021276,0.07836380604827888,526,That's nothing. Wait 'til you see these bad boys in my pockets.
2036,3,3,41,47,1.1914893617021276,0.07836380604827888,526,They only had Magnums
2036,1,7,39,47,1.1914893617021276,0.06550379636299898,526,The 6S Plus. Yours?
2036,2,5,40,47,1.1914893617021276,0.07222061144970149,526,Is that a pizza on your head or are you just glad to see me?
2036,1,7,39,47,1.1914893617021276,0.06550379636299898,526,Yeah... I'm Gay.
2036,2,5,40,47,1.1914893617021276,0.07222061144970149,526,"Also, I am told I have huge hands."
2112,4,0,38,42,1.1904761904761905,0.0916875928269015,526,"""I had to run through hoops to get here""!"
2113,3,3,42,48,1.1875,0.07681751656402223,526,I lied at the gate and told them I was Mother Theresa.
2113,0,9,39,48,1.1875,0.05693291124629693,526,I'd feel better if we just cuddled.
2113,2,5,41,48,1.1875,0.0708124708534365,526,Come on over here and we'll make our halos concentric.
2113,1,7,40,48,1.1875,0.06424858913372151,526,They let me recycle my old hula hoop.
2113,1,7,40,48,1.1875,0.06424858913372151,526,"There are no rules, you just wing it."
2113,1,7,40,48,1.1875,0.06424858913372151,526,"You're preaching to the choir there, sister."
2113,3,3,42,48,1.1875,0.07681751656402223,526,It was to make up for my small hands
2113,2,5,41,48,1.1875,0.0708124708534365,526,I know it's awkward. It's really a hula hoop.
2113,2,5,41,48,1.1875,0.0708124708534365,526,Fred! I had no idea we could pick our preferred gender up here!
2113,3,3,42,48,1.1875,0.07681751656402223,526,It seems the Viagra Effect goes to your head up here.
2113,1,7,40,48,1.1875,0.06424858913372151,526,It's not the size that matters. It's how you use it.
2113,1,7,40,48,1.1875,0.06424858913372151,526,"Yes, it's lovely here, but sometimes I miss arguing with agnostics."
2113,3,3,42,48,1.1875,0.07681751656402223,526,It's this big because I'm so humble.
2113,1,7,40,48,1.1875,0.06424858913372151,526,When you've been here long enough you get bonus points.
2113,1,7,40,48,1.1875,0.06424858913372151,526,Are you sure you're in the right place?
2113,1,7,40,48,1.1875,0.06424858913372151,526,My answer is still the same one I gave you in high school.
2113,0,9,39,48,1.1875,0.05693291124629693,526,You wanna bask in my aura tonight
2113,1,7,40,48,1.1875,0.06424858913372151,526,You are an angel not to mention my big halo.
2113,2,5,41,48,1.1875,0.0708124708534365,526,My halo's not the only thing that's oversized.
2113,2,5,41,48,1.1875,0.0708124708534365,526,I fell through the manhole and I saw the light.
2113,1,7,40,48,1.1875,0.06424858913372151,526,E.otherworldly says we're a match made in heaven!
2113,1,7,40,48,1.1875,0.06424858913372151,526,"Yeah, well my ex-wife said I was always Holier than Thou."
2113,2,5,41,48,1.1875,0.0708124708534365,526,If my hands weren't in my pockets you'd understand.
2113,0,9,39,48,1.1875,0.05693291124629693,526,I'd reeeally like to...but there's this reputation I've gotta uphold.
2113,2,5,41,48,1.1875,0.0708124708534365,526,"When I see a pretty girl, it grows larger. Can you imagine that?"
2113,0,9,39,48,1.1875,0.05693291124629693,526,I would be pleased to take you under my wing.
2113,0,9,39,48,1.1875,0.05693291124629693,526,"Yes ma'am, I actually am holier-than-thou!"
2113,1,7,40,48,1.1875,0.06424858913372151,526,I was getting too close to certain angels.
2113,1,7,40,48,1.1875,0.06424858913372151,526,"Sorry, I prefer bad boys."
2113,1,7,40,48,1.1875,0.06424858913372151,526,Really? You can tell it’s getting larger?
2113,2,5,41,48,1.1875,0.0708124708534365,526,"Don't give me that look, but yes, it is true what they say about Angels with Big Halos....."
2113,1,7,40,48,1.1875,0.06424858913372151,526,"Yeah, I decided to go in for the full Cloud 10 package."
2113,2,5,41,48,1.1875,0.0708124708534365,526,"Not exactly what I meant by ""size matters."""
2113,1,7,40,48,1.1875,0.06424858913372151,526,Mine doubles as a lasso...what does yours do?
2113,0,9,39,48,1.1875,0.05693291124629693,526,"Up here, it is the size that counts."
2113,1,7,40,48,1.1875,0.06424858913372151,526,You make me downright upright.
2113,1,7,40,48,1.1875,0.06424858913372151,526,"""Halo,"" he said. "" Well, HALO!"" said she."
2113,0,9,39,48,1.1875,0.05693291124629693,526,"Yes, Heaven knows, I'm happy to see you!"
2113,3,3,42,48,1.1875,0.07681751656402223,526,"Yeah, you know what they say about guys with big halos."
2113,3,3,42,48,1.1875,0.07681751656402223,526,"Big hands, big feet, big halo....."
2113,1,7,40,48,1.1875,0.06424858913372151,526,"Yeah, it's huge...why?"
2113,0,9,39,48,1.1875,0.05693291124629693,526,"If there's no Starbucks, I'm not staying!"
2113,2,5,41,48,1.1875,0.0708124708534365,526,Yes... size will ALWAYS matter...
2113,0,9,39,48,1.1875,0.05693291124629693,526,It's a symbol of the hoops through which I had to jump to get here.
2113,2,5,41,48,1.1875,0.0708124708534365,526,Well you were the one who said I was hole-ier than thou...
2113,3,3,42,48,1.1875,0.07681751656402223,526,"Heavens yes, size does count."
2113,0,9,39,48,1.1875,0.05693291124629693,526,It's how you use it.
2113,1,7,40,48,1.1875,0.06424858913372151,526,"He forgives, but He hasn't really forgotten, has He?"
2113,1,7,40,48,1.1875,0.06424858913372151,526,"""I bought it on Ebay""."
2113,3,3,42,48,1.1875,0.07681751656402223,526,I also use it as a hula-hoop.
2113,3,3,42,48,1.1875,0.07681751656402223,526,I let my wife drive the Maserati.
2113,2,5,41,48,1.1875,0.0708124708534365,526,"Well yes, I did invent the Hula Hoop. How did you guess?"
2113,3,3,42,48,1.1875,0.07681751656402223,526,I guess it gives extra points to remember the toilet seat.
2113,2,5,41,48,1.1875,0.0708124708534365,526,No. My feet are not that large. Why?
2113,3,3,42,48,1.1875,0.07681751656402223,526,"Sir, I think you're exaggerating."
2113,2,5,41,48,1.1875,0.0708124708534365,526,You're wrong. Size DOES matter.
2113,2,5,41,48,1.1875,0.0708124708534365,526,Funny how things are the same but different here.
2113,0,9,39,48,1.1875,0.05693291124629693,526,I'm supposed to work on my 'holier than thou' attitude.
2113,1,7,40,48,1.1875,0.06424858913372151,526,You should see the one they're making for Beyoncé.
2113,1,7,40,48,1.1875,0.06424858913372151,526,There is a reason for my holier than thou attitude.
2113,2,5,41,48,1.1875,0.0708124708534365,526,"I understand that Size Matters here, too"
2113,4,1,43,48,1.1875,0.08238601625129634,526,"I've even named it. I call it ""the Rapture."""
2113,3,3,42,48,1.1875,0.07681751656402223,526,Did you know that I was dying to meet you again?
2113,2,5,41,48,1.1875,0.0708124708534365,526,"No, I'm not holier than thou. I got this so I can use it as a hula hoop."
2113,2,5,41,48,1.1875,0.0708124708534365,526,My family includes charter members of this place.
2113,0,9,39,48,1.1875,0.05693291124629693,526,Is it obvious?
2113,2,5,41,48,1.1875,0.0708124708534365,526,It's a complete myth that men overcompensate when they feel their masculinity is threatened.
2113,2,5,41,48,1.1875,0.0708124708534365,526,"You know what they say about angels with big halos, right?"
2113,2,5,41,48,1.1875,0.0708124708534365,526,it wouldn't be heaven if it wasn't true
2113,1,7,40,48,1.1875,0.06424858913372151,526,It's a side effect of the Viagra.
2113,2,5,41,48,1.1875,0.0708124708534365,526,"Oh, size matters, baby!"
2113,3,3,42,48,1.1875,0.07681751656402223,526,I told you he wouldn't like it.
2113,1,7,40,48,1.1875,0.06424858913372151,526,I'm sorry but I only date double A halo's or better.
2186,3,2,38,43,1.186046511627907,0.0832334769617433,526,"I never buy anything ""off the rack."""
2186,0,8,35,43,1.186046511627907,0.060046253429572344,526,I have seniority.
2186,1,6,36,43,1.186046511627907,0.06865109076336154,526,My halo also serves as my umbrella.
2186,0,8,35,43,1.186046511627907,0.060046253429572344,526,I got full coverage from Verizon.
2186,1,6,36,43,1.186046511627907,0.06865109076336154,526,THIS is who I am to judge!
2186,0,8,35,43,1.186046511627907,0.060046253429572344,526,Have I told you about the power of compound interest?
2192,1,8,45,54,1.1851851851851851,0.05954682150320808,526,"See, even in Heaven: ""Size does matter."""
2193,2,5,42,49,1.183673469387755,0.069457747811776,526,I was holier than thou—clearly.
2193,2,5,42,49,1.183673469387755,0.069457747811776,526,"Hey, I'm serious. My life was all about the hula-hoop, but now that's over thanks to these damn wings."
2193,2,5,42,49,1.183673469387755,0.069457747811776,526,"Honestly, I hadn't noticed."
2193,2,5,42,49,1.183673469387755,0.069457747811776,526,Around here they say that size does matter
2193,1,7,41,49,1.183673469387755,0.06303997616615865,526,I actually brought it with me. It was my favorite dollar store hula hoop.
2193,2,5,42,49,1.183673469387755,0.069457747811776,526,I’m not as good as I look.
2193,1,7,41,49,1.183673469387755,0.06303997616615865,526,Some say my biggest sin is bragging about the size of my halo.
2193,1,7,41,49,1.183673469387755,0.06303997616615865,526,"Welcome, your timing is excellent. I'm as good as it gets"
2193,1,7,41,49,1.183673469387755,0.06303997616615865,526,I asked St. Peter to super-size me.
2202,2,4,38,44,1.1818181818181819,0.07465726673576988,526,"So, as I was saying, I was a career politician . Since I am the only one of my kind up here I got the aggregate Halo."
2202,1,6,37,44,1.1818181818181819,0.06720584069874137,526,"No, smarty pants, I am NOT trying to compensate for any of my earthly shortcomings."
2202,1,6,37,44,1.1818181818181819,0.06720584069874137,526,This is so embarrassing.
2202,2,4,38,44,1.1818181818181819,0.07465726673576988,526,It turns out He's pretty much OK with manspreading.
2202,1,6,37,44,1.1818181818181819,0.06720584069874137,526,"Some angels are ""more equal"" than others."
2202,2,4,38,44,1.1818181818181819,0.07465726673576988,526,After I arrived I told Him I had been hoping for a bigger Hello.
2202,1,6,37,44,1.1818181818181819,0.06720584069874137,526,"Yes, I'm over compensating for shortcomings in my previous life."
2202,3,2,39,44,1.1818181818181819,0.0814296624633013,526,I washed it in cold water
2202,3,2,39,44,1.1818181818181819,0.0814296624633013,526,the bigger the more... innocent?
2211,2,5,43,50,1.18,0.06815348823929464,526,The worst part about gastric bypass surgery isn't the loose halo; its buying new robes!
2212,0,5,23,28,1.1785714285714286,0.07370704611510596,526,I bought it online
2213,2,4,39,45,1.1777777777777778,0.07309112127323451,526,Here you can lie as much as you want -- your nose won't grow.
2213,3,2,40,45,1.1777777777777778,0.07970202644274288,526,I always liked to think that size 'does' matter.
2213,1,6,38,45,1.1777777777777778,0.06581953356624205,526,I lived and died in Texas and I always wore a ten gallon hat.
2213,3,2,40,45,1.1777777777777778,0.07970202644274288,526,It all started with a Hula Hoop.
2213,2,4,39,45,1.1777777777777778,0.07309112127323451,526,You weren't offered the extended coverage option?
2213,1,6,38,45,1.1777777777777778,0.06581953356624205,526,I guess size does matter!
2213,3,2,40,45,1.1777777777777778,0.07970202644274288,526,Marilyn Monroe has an exclamation point.
2213,1,6,38,45,1.1777777777777778,0.06581953356624205,526,It's special recognition for inventing the hoopla hoop.
2213,3,2,40,45,1.1777777777777778,0.07970202644274288,526,Beyonce can see my halo better.
2213,2,4,39,45,1.1777777777777778,0.07309112127323451,526,You'll definitely want to get your parking validated.
2213,1,6,38,45,1.1777777777777778,0.06581953356624205,526,"Yes, Virginia, there is a union."
2213,1,6,38,45,1.1777777777777778,0.06581953356624205,526,"Yes, I have a big one, but I have other attributes as well."
2213,0,8,37,45,1.1777777777777778,0.05763774795025092,526,"But last time I asked you said, ""Not a chance in Hell!"""
2213,1,6,38,45,1.1777777777777778,0.06581953356624205,526,"I really am a bad boy, I swear. Well, I would never swear, but..."
2213,1,6,38,45,1.1777777777777778,0.06581953356624205,526,How could you tell I was lying.
2213,1,6,38,45,1.1777777777777778,0.06581953356624205,526,"Seriously, I'm naturally this big."
2213,2,4,39,45,1.1777777777777778,0.07309112127323451,526,I hope you're one of those girls who thinks size matters.
2213,2,4,39,45,1.1777777777777778,0.07309112127323451,526,I wear a size 14EE. Why did you ask?
2213,0,8,37,45,1.1777777777777778,0.05763774795025092,526,"Why yes, I did invent the Hula Hoop."
2213,1,6,38,45,1.1777777777777778,0.06581953356624205,526,"Honestly, I've seen much bigger."
2213,0,8,37,45,1.1777777777777778,0.05763774795025092,526,"I drove a Porsche, why?"
2213,4,0,41,45,1.1777777777777778,0.08580509325897091,526,If only feeling holier-than-thou were a virtue!
2213,1,6,38,45,1.1777777777777778,0.06581953356624205,526,I had it custommade
2213,2,4,39,45,1.1777777777777778,0.07309112127323451,526,"""That halo will be a lot smaller when I finish with him.""."
2213,1,6,38,45,1.1777777777777778,0.06581953356624205,526,I won't make snap judgements if you don't.
2213,0,8,37,45,1.1777777777777778,0.05763774795025092,526,WHAT DID I KNOW..I ASKED FOR AN EXTRA LARGE.
2213,2,4,39,45,1.1777777777777778,0.07309112127323451,526,"Well, you know what they say about the size of a man's halo."
2213,2,4,39,45,1.1777777777777778,0.07309112127323451,526,"Admit it, halo envy."
2213,1,6,38,45,1.1777777777777778,0.06581953356624205,526,I'm not that innocent.
2213,2,4,39,45,1.1777777777777778,0.07309112127323451,526,"Remember me? I lost some weight, but kept the old halo."
2213,2,4,39,45,1.1777777777777778,0.07309112127323451,526,"Well, you know what they say about guys with big halos?"
2213,1,6,38,45,1.1777777777777778,0.06581953356624205,526,"I was perfect at hula hoop, too."
2213,0,8,37,45,1.1777777777777778,0.05763774795025092,526,It's just a holier-than-thou fashion statement I'm trying out
2213,0,8,37,45,1.1777777777777778,0.05763774795025092,526,Let's ditch the halos and get on with it
2213,1,6,38,45,1.1777777777777778,0.06581953356624205,526,Heaven's got one heck of a weight loss program.
2213,2,4,39,45,1.1777777777777778,0.07309112127323451,526,Actually it's just a hula hoop.
2213,1,6,38,45,1.1777777777777778,0.06581953356624205,526,"You know that thing about big hands? Well, it works for halos too."
2213,1,6,38,45,1.1777777777777778,0.06581953356624205,526,"Hula hooping accident, what about you?"
2213,2,4,39,45,1.1777777777777778,0.07309112127323451,526,"After I lost my third halo, St Peter refused to give me a new one. I found me this hula hoop in lost and found."
2213,1,6,38,45,1.1777777777777778,0.06581953356624205,526,"So we're going to play the ""my halo's bigger than your halo"" game?!"
2213,3,2,40,45,1.1777777777777778,0.07970202644274288,526,You could probably tell by my hands.
2213,0,8,37,45,1.1777777777777778,0.05763774795025092,526,Go to bed with me and I'll tell you.
2213,3,2,40,45,1.1777777777777778,0.07970202644274288,526,You should see the size of my feet.
2213,2,4,39,45,1.1777777777777778,0.07309112127323451,526,You can't tell me that size doesn't matter.
2213,3,2,40,45,1.1777777777777778,0.07970202644274288,526,"I'm the guy who cancelled ""19 Kids and Counting."""
2213,2,4,39,45,1.1777777777777778,0.07309112127323451,526,I demanded the expanded version of humility.
2213,2,4,39,45,1.1777777777777778,0.07309112127323451,526,I'm telling you without 'Pride' that I made Angel of the Month.
2213,2,4,39,45,1.1777777777777778,0.07309112127323451,526,They will say this is a match made in heaven.
2213,2,4,39,45,1.1777777777777778,0.07309112127323451,526,"Yes, that too."
2213,1,6,38,45,1.1777777777777778,0.06581953356624205,526,"Well, size is a respected dimension even around here."
2213,1,6,38,45,1.1777777777777778,0.06581953356624205,526,I used to have a swollen head but I've humbled down!
2213,1,6,38,45,1.1777777777777778,0.06581953356624205,526,I told the greeter 'Supersize me' and he did!
2213,2,4,39,45,1.1777777777777778,0.07309112127323451,526,The Halo supplier made a mistake and sent me a Hula.
2213,1,6,38,45,1.1777777777777778,0.06581953356624205,526,You know what they say about the angel with the big halo.....
2213,0,8,37,45,1.1777777777777778,0.05763774795025092,526,Of course I'm a feminist.
2213,3,2,40,45,1.1777777777777778,0.07970202644274288,526,I used to say Heaven can Wait but now I'm sorry I did.
2269,0,8,38,46,1.173913043478261,0.056503155622080956,526,You appeared less judgmental in your Tinder profile.
2269,2,4,40,46,1.173913043478261,0.07158892194335345,526,"Yes, size matters in heaven."
2269,2,4,40,46,1.173913043478261,0.07158892194335345,526,It was a hula accident. How did you get here?
2269,2,4,40,46,1.173913043478261,0.07158892194335345,526,"And to think, you always said size doesn't matter."
2269,1,6,39,46,1.173913043478261,0.06448868249648403,526,"You know what they say about angels with big halos, don't you?"
2269,1,6,39,46,1.173913043478261,0.06448868249648403,526,I let the size of my halo do the talking.
2269,1,6,39,46,1.173913043478261,0.06448868249648403,526,I hate to brag but I come from a long time of big halos.
2269,2,4,40,46,1.173913043478261,0.07158892194335345,526,How can you reject me based on the size of my halo? I have large hands as well!
2269,1,6,39,46,1.173913043478261,0.06448868249648403,526,You know what they say about male angels with large halos.
2269,2,4,40,46,1.173913043478261,0.07158892194335345,526,It appears that we Republicans have once again thwarted 'equal halos for equal virtues.'
2269,2,4,40,46,1.173913043478261,0.07158892194335345,526,I used to be a lot bigger.
2269,2,4,40,46,1.173913043478261,0.07158892194335345,526,Mine is a hole in the glass ceiling. Yours is just a halo.
2269,2,4,40,46,1.173913043478261,0.07158892194335345,526,My uncontrollable flatulence has created the hole in the ozone layer above my head.
2269,0,8,38,46,1.173913043478261,0.056503155622080956,526,"Yeah, what they say about guys with large halos is true."
2269,1,6,39,46,1.173913043478261,0.06448868249648403,526,Come back and interview again when your halo is more fully developed.
2269,3,2,41,46,1.173913043478261,0.07804586677006528,526,I can fly through it too.
2269,1,6,39,46,1.173913043478261,0.06448868249648403,526,So size does matter?
2269,1,6,39,46,1.173913043478261,0.06448868249648403,526,"It's a bit understated for my taste, but you make it work."
2269,1,6,39,46,1.173913043478261,0.06448868249648403,526,Serving Vatican City helps.
2269,2,4,40,46,1.173913043478261,0.07158892194335345,526,"Yes, as a matter of fact there is a correlation"
2269,2,4,40,46,1.173913043478261,0.07158892194335345,526,Don't laugh. It was the only one in stock when I got here.
2269,0,8,38,46,1.173913043478261,0.056503155622080956,526,I'm really not compensating for anything.
2269,0,8,38,46,1.173913043478261,0.056503155622080956,526,"I know it looks big, but it's comfortable."
2269,1,6,39,46,1.173913043478261,0.06448868249648403,526,"Kylie, you make my halo swell"
2269,2,4,40,46,1.173913043478261,0.07158892194335345,526,'Hula-Hoop-Halo' just had a ring to it.
2269,1,6,39,46,1.173913043478261,0.06448868249648403,526,"Pretty as you are, you're going to get 76% of what male angels earn."
2269,2,4,40,46,1.173913043478261,0.07158892194335345,526,"Believe me, I am really good."
2269,1,6,39,46,1.173913043478261,0.06448868249648403,526,"I know, it looks ridiculous."
2269,1,6,39,46,1.173913043478261,0.06448868249648403,526,There's really no need to overcompensate up here.
2269,1,6,39,46,1.173913043478261,0.06448868249648403,526,Don't act like you're not impressed.
2269,1,6,39,46,1.173913043478261,0.06448868249648403,526,I cannot tell a lie. It's my hula-hoop.
2269,0,8,38,46,1.173913043478261,0.056503155622080956,526,"What do you mean, what am I compensating for?"
2269,2,4,40,46,1.173913043478261,0.07158892194335345,526,"When I look at you, I get... larger than life!"
2269,0,8,38,46,1.173913043478261,0.056503155622080956,526,Don't give me that holier than thou look
2269,1,6,39,46,1.173913043478261,0.06448868249648403,526,I was a professional hula hooper and St. Peter thought it funny to constantly remind me of it.
2269,2,4,40,46,1.173913043478261,0.07158892194335345,526,I'm holier than thou only because I swore off discussing politics on Facebook.
2269,1,6,39,46,1.173913043478261,0.06448868249648403,526,"Sorry, I'm waiting for my husband to die."
2269,1,6,39,46,1.173913043478261,0.06448868249648403,526,I was famous for my ten-gallon hats.
2269,2,4,40,46,1.173913043478261,0.07158892194335345,526,You have beautiful...eh... wings.
2269,2,4,40,46,1.173913043478261,0.07158892194335345,526,You can't argue with God.
2269,2,4,40,46,1.173913043478261,0.07158892194335345,526,"It would be in your best interest to ""Dry Clean Only"""
2269,1,6,39,46,1.173913043478261,0.06448868249648403,526,"Yes, I must humbly admit, it is unusually large."
2269,2,4,40,46,1.173913043478261,0.07158892194335345,526,"It mattered on Earth, of course, but I'm sure it doesn't count for anything here."
2269,2,4,40,46,1.173913043478261,0.07158892194335345,526,Want to do something that will make us lose our wings?
2269,2,4,40,46,1.173913043478261,0.07158892194335345,526,I was a halo of a man when I was on earth
2269,1,6,39,46,1.173913043478261,0.06448868249648403,526,"Well, I wouldn't want to brag, of course, but . . . ."
2269,1,6,39,46,1.173913043478261,0.06448868249648403,526,They need to do something about regulating drones up here.
2269,2,4,40,46,1.173913043478261,0.07158892194335345,526,"I hate to brag, but up here, size does matter."
2269,0,8,38,46,1.173913043478261,0.056503155622080956,526,Dry-clean only.
2269,1,6,39,46,1.173913043478261,0.06448868249648403,526,She was surprised to discover that even in heaven size matters.
2269,1,6,39,46,1.173913043478261,0.06448868249648403,526,I brought the potato salad to the church picnic.
2269,2,4,40,46,1.173913043478261,0.07158892194335345,526,Let's make a cherub.
2269,1,6,39,46,1.173913043478261,0.06448868249648403,526,Beyonce lent it to me.
2269,2,4,40,46,1.173913043478261,0.07158892194335345,526,"You know what they say, big halo small d..."
2269,1,6,39,46,1.173913043478261,0.06448868249648403,526,"My hands are very big too. Very, very big."
2269,1,6,39,46,1.173913043478261,0.06448868249648403,526,I'm on Weight Watchers.
2269,1,6,39,46,1.173913043478261,0.06448868249648403,526,Well Halo to you too.
2269,0,8,38,46,1.173913043478261,0.056503155622080956,526,"What do you mean, 'holier than thou'?"
2269,0,8,38,46,1.173913043478261,0.056503155622080956,526,Not only that but I wear a size fourteen shoe.
2269,1,6,39,46,1.173913043478261,0.06448868249648403,526,My halo doubles as a hula hoop
2269,2,4,40,46,1.173913043478261,0.07158892194335345,526,"Why yes, I do have large hands."
2269,3,2,41,46,1.173913043478261,0.07804586677006528,526,"You're beautiful, but it appears our lifestyles aren't compatible"
2269,3,2,41,46,1.173913043478261,0.07804586677006528,526,I didn't realize there was such a big difference between large and extra large.
2269,1,6,39,46,1.173913043478261,0.06448868249648403,526,Did He not tell you? You'll have to carry that thing around for all eternity.
2269,2,4,40,46,1.173913043478261,0.07158892194335345,526,I like sticking my hands in my pants. like this.
2269,1,6,39,46,1.173913043478261,0.06448868249648403,526,It humors the boss too.
2269,2,4,40,46,1.173913043478261,0.07158892194335345,526,Well maybe God loves you. But God loves me more. Because I’m so humble.
2269,1,6,39,46,1.173913043478261,0.06448868249648403,526,"Until it's fixed, I'm stuck with the hula hoop"
2269,0,8,38,46,1.173913043478261,0.056503155622080956,526,I'm a bachelor; I haven't washed it yet.
2269,0,8,38,46,1.173913043478261,0.056503155622080956,526,I had house seats for HAMILTON.
2269,1,6,39,46,1.173913043478261,0.06448868249648403,526,My head was much bigger before I had some lessons in humility.
2269,3,2,41,46,1.173913043478261,0.07804586677006528,526,You said size mattered.
2269,2,4,40,46,1.173913043478261,0.07158892194335345,526,"Halo, gorgeous!"
2269,1,6,39,46,1.173913043478261,0.06448868249648403,526,I am one of the very few males around here who wasn’t called a no good bastard by a female.
2269,1,6,39,46,1.173913043478261,0.06448868249648403,526,"Yes, in Heaven, size matters, too."
2269,1,6,39,46,1.173913043478261,0.06448868249648403,526,I told you to check the expiration date.
2269,0,8,38,46,1.173913043478261,0.056503155622080956,526,I made it to this year's top five in humility.
2269,1,6,39,46,1.173913043478261,0.06448868249648403,526,"My gluten-free, kale-based snacks blog helped God lose a ton of weight."
2269,1,6,39,46,1.173913043478261,0.06448868249648403,526,"I've got a very big halo, that I can tell you. As far as other things, I guarantee you there's no problem. I guarantee it."
2269,1,6,39,46,1.173913043478261,0.06448868249648403,526,"Your halo is very, very low energy."
2269,1,6,39,46,1.173913043478261,0.06448868249648403,526,It equates to the opposite of small hands.
2269,0,8,38,46,1.173913043478261,0.056503155622080956,526,That's my new halo hoop.
2269,3,2,41,46,1.173913043478261,0.07804586677006528,526,It was a tough choice.
2269,1,6,39,46,1.173913043478261,0.06448868249648403,526,Before you say that size doesn't matter...
2269,3,2,41,46,1.173913043478261,0.07804586677006528,526,Are you a summer intern?
2269,2,4,40,46,1.173913043478261,0.07158892194335345,526,"Mine's a shower, not a grower."
2269,2,4,40,46,1.173913043478261,0.07158892194335345,526,I guess it's because I'm holier than thou.
2269,0,8,38,46,1.173913043478261,0.056503155622080956,526,I see that size does matter.
2269,3,2,41,46,1.173913043478261,0.07804586677006528,526,"Well, you know what they say about large haloes..."
2358,2,3,36,41,1.170731707317073,0.07732130480071882,526,How did you know that I made it myself?
2358,0,7,34,41,1.170731707317073,0.05949419959829497,526,Who says size doesn't matter?
2360,0,8,39,47,1.1702127659574468,0.055411578656325414,526,I leaned in.
2360,1,6,40,47,1.1702127659574468,0.0632100658866106,526,I try not to notice it.
2360,3,2,42,47,1.1702127659574468,0.07645685835683208,526,The William Morris Agency. Why do you ask?
2360,1,6,40,47,1.1702127659574468,0.0632100658866106,526,"and it comes with pockets, too"
2360,0,8,39,47,1.1702127659574468,0.055411578656325414,526,First time here?
2360,1,6,40,47,1.1702127659574468,0.0632100658866106,526,You have to jump through lots of hoops to become a perfect angel.
2360,0,8,39,47,1.1702127659574468,0.055411578656325414,526,My app went viral.
2360,1,6,40,47,1.1702127659574468,0.0632100658866106,526,How aura?
2360,2,4,41,47,1.1702127659574468,0.07014685887189226,526,"Listen, I know you said I'm too good for you but I don't agree..."
2360,2,4,41,47,1.1702127659574468,0.07014685887189226,526,You thought the wage gap was only a problem on earth?
2360,2,4,41,47,1.1702127659574468,0.07014685887189226,526,For the last two years I bet on the Warriors. How did you get here?
2360,2,4,41,47,1.1702127659574468,0.07014685887189226,526,I actually left the bathrobe right there in the hotel.
2360,1,6,40,47,1.1702127659574468,0.0632100658866106,526,Bragging is so much easier here than Earth
2360,1,6,40,47,1.1702127659574468,0.0632100658866106,526,"Well, yes, there is some correlation between the size of my halo and the size of my feet."
2360,2,4,41,47,1.1702127659574468,0.07014685887189226,526,Don't feel bad. I'm just nicer than you.
2360,1,6,40,47,1.1702127659574468,0.0632100658866106,526,I'm dilated you made it here!
2360,1,6,40,47,1.1702127659574468,0.0632100658866106,526,"Hello, I'm Johnny Angel, and together we will see how lovely heaven can be."
2360,2,4,41,47,1.1702127659574468,0.07014685887189226,526,I had just taken a Viagra pill when I died of a heart attach.
2360,2,4,41,47,1.1702127659574468,0.07014685887189226,526,"As it turns out, size really does matter."
2360,1,6,40,47,1.1702127659574468,0.0632100658866106,526,"Yea, it's my attitude, holier than thou."
2360,0,8,39,47,1.1702127659574468,0.055411578656325414,526,It's the only way you can compensate up here.
2360,1,6,40,47,1.1702127659574468,0.0632100658866106,526,"My mother always told me, 'Sanctimonious is as sanctimonious does'."
2360,3,2,42,47,1.1702127659574468,0.07645685835683208,526,They were having a sale at Skymall...
2360,0,8,39,47,1.1702127659574468,0.055411578656325414,526,I come from a family with big heads.
2360,3,2,42,47,1.1702127659574468,0.07645685835683208,526,Still having an after life crisis huh Dave?
2360,1,6,40,47,1.1702127659574468,0.0632100658866106,526,Size doesn't matter.
2360,2,4,41,47,1.1702127659574468,0.07014685887189226,526,"Alas, what happens in Vegas definitely does not stay in Vegas."
2360,0,8,39,47,1.1702127659574468,0.055411578656325414,526,"Oh yeah, it's what you'd think"
2360,0,8,39,47,1.1702127659574468,0.055411578656325414,526,Holier than thou? Maybe a little.
2360,0,8,39,47,1.1702127659574468,0.055411578656325414,526,I was an inventor for Wham-O.
2360,2,4,41,47,1.1702127659574468,0.07014685887189226,526,You know what they say--the larger the halo.....
2360,2,4,41,47,1.1702127659574468,0.07014685887189226,526,"If I told you how I really feel about you, I sure wouldn't be here right now."
2360,0,8,39,47,1.1702127659574468,0.055411578656325414,526,I ordered the recreational model . . .
2360,2,4,41,47,1.1702127659574468,0.07014685887189226,526,"I'm just saying, a plunging neckline may invite some unwanted attention."
2360,2,4,41,47,1.1702127659574468,0.07014685887189226,526,I'm compensating after the fact.
2360,3,2,42,47,1.1702127659574468,0.07645685835683208,526,I worked in a pizza parlor.
2360,2,4,41,47,1.1702127659574468,0.07014685887189226,526,"Eve, she meant nothing to me."
2360,0,8,39,47,1.1702127659574468,0.055411578656325414,526,So you see you can take it with you.
2360,1,6,40,47,1.1702127659574468,0.0632100658866106,526,Excuse me. Would you say this is fostering an excessive sense of entitlement?
2360,0,8,39,47,1.1702127659574468,0.055411578656325414,526,Why do say I think I'm too good for you?
2360,1,6,40,47,1.1702127659574468,0.0632100658866106,526,"I don't like to brag, but Sully Sullenberger had a little help from yours truly."
2360,2,4,41,47,1.1702127659574468,0.07014685887189226,526,Bigger is better.
2360,1,6,40,47,1.1702127659574468,0.0632100658866106,526,Don't tell. It's a hula-hoop.
2360,0,8,39,47,1.1702127659574468,0.055411578656325414,526,Let's go ask Archimedes. I'll bet he'll have the answer!
2360,1,6,40,47,1.1702127659574468,0.0632100658866106,526,"And my hands are slightly larger than normal, too."
2360,1,6,40,47,1.1702127659574468,0.0632100658866106,526,I was wearing a Sombrero at the time of the accident...
2360,2,4,41,47,1.1702127659574468,0.07014685887189226,526,I know. It's so big and round. I call it my J-LO
2360,2,4,41,47,1.1702127659574468,0.07014685887189226,526,"Take it from me, being an angel isn't all that it's cracked up to be..."
2360,1,6,40,47,1.1702127659574468,0.0632100658866106,526,"Greetings, I'm Adam Holier Than Thou."
2360,1,6,40,47,1.1702127659574468,0.0632100658866106,526,Trade ya.
2360,1,6,40,47,1.1702127659574468,0.0632100658866106,526,"Yes, it is - and I've noticed a lot of you girls here have halo envy."
2360,1,6,40,47,1.1702127659574468,0.0632100658866106,526,My wings don't let me use my hula hoop.
2360,1,6,40,47,1.1702127659574468,0.0632100658866106,526,Can we hook up now?
2360,2,4,41,47,1.1702127659574468,0.07014685887189226,526,"It's like pinocchio, except for good deeds"
2360,0,8,39,47,1.1702127659574468,0.055411578656325414,526,"I don't want to play the evangelical card, but . . ."
2360,1,6,40,47,1.1702127659574468,0.0632100658866106,526,I believe the circumference of one's halo is proportional to one's holiness.
2360,1,6,40,47,1.1702127659574468,0.0632100658866106,526,"I remember you, you had a big head when you were our manager!"
2360,1,6,40,47,1.1702127659574468,0.0632100658866106,526,"Up here, hand size is irrelevant; it's all about the halo."
2360,0,8,39,47,1.1702127659574468,0.055411578656325414,526,You're dumping me in Heaven. Who Does That!?
2360,1,6,40,47,1.1702127659574468,0.0632100658866106,526,"Well, if you think THIS is big, you should check out my hands."
2360,2,4,41,47,1.1702127659574468,0.07014685887189226,526,Nobody liked it on America's Got Talent either.
2360,1,6,40,47,1.1702127659574468,0.0632100658866106,526,It tarnishes easily.
2360,1,6,40,47,1.1702127659574468,0.0632100658866106,526,"It's very simple, Sweetheart, I'm a transgender."
2360,2,4,41,47,1.1702127659574468,0.07014685887189226,526,I guess they never discovered the SEC Indictment
2360,1,6,40,47,1.1702127659574468,0.0632100658866106,526,I defeated St Peter in the Mythic Legendary Halo championship match.
2360,0,8,39,47,1.1702127659574468,0.055411578656325414,526,"Where I grew up, bragging was considered a virtue."
2360,0,8,39,47,1.1702127659574468,0.055411578656325414,526,"In another world and in another time, yes size would matter."
2360,3,2,42,47,1.1702127659574468,0.07645685835683208,526,"Well you see Penelope, I got in on the ground floor of the reformation"
2360,0,8,39,47,1.1702127659574468,0.055411578656325414,526,Really it's just hula hoop. I brought it with me.
2360,2,4,41,47,1.1702127659574468,0.07014685887189226,526,"The large halo? Well, I've always been very competitive."
2360,2,4,41,47,1.1702127659574468,0.07014685887189226,526,"Yeah, New Yorkers hate when I call this place ""Los Angeles."""
2360,0,8,39,47,1.1702127659574468,0.055411578656325414,526,...Most Likes...
2360,1,6,40,47,1.1702127659574468,0.0632100658866106,526,"Yes, I hold myself in high esteem. Why do you ask?"
2360,2,4,41,47,1.1702127659574468,0.07014685887189226,526,I was a philanthropist.
2360,1,6,40,47,1.1702127659574468,0.0632100658866106,526,My halo's not fat...he just has a thyroid issue.
2360,0,8,39,47,1.1702127659574468,0.055411578656325414,526,Jezebel. That's an interesting name.
2360,0,8,39,47,1.1702127659574468,0.055411578656325414,526,They fitted me for a Trump halo
2360,3,2,42,47,1.1702127659574468,0.07645685835683208,526,I still think metric is the more perfect system.
2360,0,8,39,47,1.1702127659574468,0.055411578656325414,526,I need all the help I can get
2360,2,4,41,47,1.1702127659574468,0.07014685887189226,526,Are the other six as lovely as you?
2360,2,4,41,47,1.1702127659574468,0.07014685887189226,526,I died while hula-hooping.
2360,0,8,39,47,1.1702127659574468,0.055411578656325414,526,My mother said my halo was my best feature.
2360,1,6,40,47,1.1702127659574468,0.0632100658866106,526,"It's not hegemonic masculinity, it's just that God has favorites"
2360,1,6,40,47,1.1702127659574468,0.0632100658866106,526,"Well you know what they say about a man's ""halo""."
2360,0,8,39,47,1.1702127659574468,0.055411578656325414,526,Not to worry. It grows on you.
2360,0,8,39,47,1.1702127659574468,0.055411578656325414,526,Oh for heaven's sake yes. Size matters.
2360,0,8,39,47,1.1702127659574468,0.055411578656325414,526,There may be some lingering resentment.
2447,3,2,43,48,1.1666666666666667,0.074931016344381,526,I'm hoping to become an archangel.
2447,1,5,36,42,1.1666666666666667,0.06744608262285649,526,"It's not a halo, it's a portal to another world. If ya know what I mean."
2447,1,6,41,48,1.1666666666666667,0.061980703166484186,526,They call me 'Mr. Holier-than-thou' around the water cooler.
2447,1,6,41,48,1.1666666666666667,0.061980703166484186,526,I'm suddenly kinda bummed by this non-corporeal existence thing.
2447,2,4,42,48,1.1666666666666667,0.06876141641725292,526,"You know the saying; big halo, big...."
2447,2,4,42,48,1.1666666666666667,0.06876141641725292,526,It was the Lamborghini that got us here in the first place and you're STILL overcompensating?
2447,1,5,36,42,1.1666666666666667,0.06744608262285649,526,I was an early investor in Halo.
2447,3,2,43,48,1.1666666666666667,0.074931016344381,526,"I requested one with a sprinkler system for.... well.... you know, just in case."
2447,1,6,41,48,1.1666666666666667,0.061980703166484186,526,But mine is platinum.
2447,1,6,41,48,1.1666666666666667,0.061980703166484186,526,"It's got great perks, but I miss going head to head with all those little devils."
2447,3,2,43,48,1.1666666666666667,0.074931016344381,526,It's my old hula hoop.
2447,2,3,37,42,1.1666666666666667,0.07556728291396757,526,I guess it's a man's heaven.
2447,1,6,41,48,1.1666666666666667,0.061980703166484186,526,"It's a rental. Sometimes, I need to feel Godly."
2447,1,5,36,42,1.1666666666666667,0.06744608262285649,526,"If only you hadn’t gone away for that weekend with your boss, Sally"
2461,2,4,43,49,1.163265306122449,0.06742934558367009,526,I lost 130 lbs on the Paleo diet
2461,2,4,43,49,1.163265306122449,0.06742934558367009,526,I've been touched by an allergy.
2461,2,4,43,49,1.163265306122449,0.06742934558367009,526,Wanna go populate a planet?
2464,1,5,37,43,1.1627906976744187,0.06597285053646283,526,"No, it was easy, I asked for ""XL"" in my last confession."
2464,0,7,36,43,1.1627906976744187,0.056964877739143695,526,"I don't like to brag, but since you asked: I was an ace hula-hooper back on Earth."
2464,1,5,37,43,1.1627906976744187,0.06597285053646283,526,It's Heaven's equivalent of a 'Dunce' cap.
2464,0,7,36,43,1.1627906976744187,0.056964877739143695,526,It's actually just a hole in the glass ceiling.
2464,1,5,37,43,1.1627906976744187,0.06597285053646283,526,People laughed when they saw my drawer full of 'Box Tops For Education'...
2464,2,3,38,43,1.1627906976744187,0.0738907079406967,526,"I'm down 350 lbs postmortem, and I've never felt better!"
2464,2,3,38,43,1.1627906976744187,0.0738907079406967,526,No I don't think that I'm overcompensating.
2464,0,7,36,43,1.1627906976744187,0.056964877739143695,526,"Yeah, it's bigger since I went gluten free"
2464,0,7,36,43,1.1627906976744187,0.056964877739143695,526,He likes me.....
2464,1,5,37,43,1.1627906976744187,0.06597285053646283,526,I think we both know that size does matter.
2464,1,5,37,43,1.1627906976744187,0.06597285053646283,526,I must be in heaven because you look like an angel.
2464,1,5,37,43,1.1627906976744187,0.06597285053646283,526,"I sinned less, that's why I have a bigger one."
2464,2,3,38,43,1.1627906976744187,0.0738907079406967,526,C'mon let's give it a whirl.
2464,3,1,39,43,1.1627906976744187,0.0810386107485081,526,You oughta see my feet.
2464,0,7,36,43,1.1627906976744187,0.056964877739143695,526,"I'm confess, this whole heaven and angel thing is still over my head."
2464,1,5,37,43,1.1627906976744187,0.06597285053646283,526,Looks like you'r headed for sainthood.
2464,1,5,37,43,1.1627906976744187,0.06597285053646283,526,"No, seriously, you look like an angel sent from Heaven!"
2464,2,3,38,43,1.1627906976744187,0.0738907079406967,526,I'm sorry. I don't believe we are compatible.
2464,0,7,36,43,1.1627906976744187,0.056964877739143695,526,"I invented the Hula Hoop, why do you ask?"
2464,1,5,37,43,1.1627906976744187,0.06597285053646283,526,"Raaally Dahling, all I can say is if the halo fits..."
2464,1,5,37,43,1.1627906976744187,0.06597285053646283,526,"Actually, this is Hell. Wait 'til you see the wage gap."
2485,1,5,38,44,1.1590909090909092,0.06456212749550704,526,It's the same here. Size does matter.
2485,0,7,37,44,1.1590909090909092,0.055778005112363215,526,"Yes, I know it's a hula hoop."
2485,2,3,39,44,1.1590909090909092,0.07228658768525041,526,"Hey, foreplay on the freeway was your idea."
2485,2,3,39,44,1.1590909090909092,0.07228658768525041,526,"Muhammad & Prince are still in orientation, they let me use their halos."
2485,2,3,39,44,1.1590909090909092,0.07228658768525041,526,gays get the supersize
2485,1,5,38,44,1.1590909090909092,0.06456212749550704,526,"Yes, I do have big hands and feet also. Why do you ask?"
2485,1,5,38,44,1.1590909090909092,0.06456212749550704,526,You look almost devilish today.
2485,2,3,39,44,1.1590909090909092,0.07228658768525041,526,My halo didn't get this big by doing what you're suggesting.
2485,0,7,37,44,1.1590909090909092,0.055778005112363215,526,It doubles as a hula hoop.
2485,0,7,37,44,1.1590909090909092,0.055778005112363215,526,Come on. It's a fair trade. My hula hoop for your Frisbee.
2485,1,5,38,44,1.1590909090909092,0.06456212749550704,526,"Well, Hayllo..."
2485,2,3,39,44,1.1590909090909092,0.07228658768525041,526,Cloud computing copy error.
2485,1,5,38,44,1.1590909090909092,0.06456212749550704,526,Let's just say Trump would never call me Little Marco.
2485,1,5,38,44,1.1590909090909092,0.06456212749550704,526,"Compensating?! No no, I was an ego maniac"
2485,0,7,37,44,1.1590909090909092,0.055778005112363215,526,"Yeah, it makes up not being able to see one's feet."
2485,1,5,38,44,1.1590909090909092,0.06456212749550704,526,I had small hands.
2485,1,5,38,44,1.1590909090909092,0.06456212749550704,526,"Come on, Beth, why the smerk? You know what they say...big halo..."
2485,1,5,38,44,1.1590909090909092,0.06456212749550704,526,God thought it would compensate for my small hands....
2485,2,3,39,44,1.1590909090909092,0.07228658768525041,526,"Yeah, 'I know, rack dry, but how could I guess about some fabrics stretching?"
2485,0,7,37,44,1.1590909090909092,0.055778005112363215,526,Its actually a hula hoop. I was junior champion back in the day.
2485,1,5,38,44,1.1590909090909092,0.06456212749550704,526,"No, I'm not still overcompensating!"
2485,1,5,38,44,1.1590909090909092,0.06456212749550704,526,"Yup, it's true what they say."
2485,1,5,38,44,1.1590909090909092,0.06456212749550704,526,Don't give me that look. I am literally holier than thou.
2485,1,5,38,44,1.1590909090909092,0.06456212749550704,526,"Recycling inititative, the hula hoop seemed a better choice than the Popemobile tire."
2485,2,3,39,44,1.1590909090909092,0.07228658768525041,526,Something tells me that you're overcompensating.
2485,1,5,38,44,1.1590909090909092,0.06456212749550704,526,Well this is what God gave me.
2485,2,3,39,44,1.1590909090909092,0.07228658768525041,526,It's because I'm holier than thou. In other words I'm a Vegan.
2485,0,7,37,44,1.1590909090909092,0.055778005112363215,526,I was a professional Hula Hooper.
2485,0,7,37,44,1.1590909090909092,0.055778005112363215,526,I think he liked my sit-com.
2485,2,3,39,44,1.1590909090909092,0.07228658768525041,526,I knew when I met you I wasn't good enough for you
2485,2,3,39,44,1.1590909090909092,0.07228658768525041,526,"Thank the lord for ""AngelMatch.com!"""
2485,3,1,40,44,1.1590909090909092,0.07926180171815858,526,"not only is my halo bigger than most, but God asks for my counsel frequently"
2485,3,1,40,44,1.1590909090909092,0.07926180171815858,526,"My! Your's is really big, isn't it?"
2485,0,7,37,44,1.1590909090909092,0.055778005112363215,526,"I don't like to rush into things, as you can see."
2485,2,3,39,44,1.1590909090909092,0.07228658768525041,526,You know what they say about big halos...
2485,2,3,39,44,1.1590909090909092,0.07228658768525041,526,It must've been that little blue pill I took before I died.
2485,2,3,39,44,1.1590909090909092,0.07228658768525041,526,I've told you all along that God was a HE!
2485,0,7,37,44,1.1590909090909092,0.055778005112363215,526,"R e a l l y, Holier than thou!"
2485,1,5,38,44,1.1590909090909092,0.06456212749550704,526,My high school taught abstinence-only.
2485,0,7,37,44,1.1590909090909092,0.055778005112363215,526,"Yes, it does make it easier to see where I'm going at night."
2485,2,3,39,44,1.1590909090909092,0.07228658768525041,526,"Wish I could , but I am scheduled to be rightsized in about 20 minutes."
2485,2,3,39,44,1.1590909090909092,0.07228658768525041,526,"Sorry, but Halo Inequality is not a Sin up here."
2485,2,3,39,44,1.1590909090909092,0.07228658768525041,526,It's my God Hole.
2485,1,5,38,44,1.1590909090909092,0.06456212749550704,526,Maybe couples skydiving wasn't such a good idea.
2485,1,5,38,44,1.1590909090909092,0.06456212749550704,526,We could always work something out....
2485,0,7,37,44,1.1590909090909092,0.055778005112363215,526,And what would make you think I earn more than you?
2485,1,5,38,44,1.1590909090909092,0.06456212749550704,526,"I assure you, size doesn't matter."
2485,0,7,37,44,1.1590909090909092,0.055778005112363215,526,I told you buying indulgences would be work
2485,2,3,39,44,1.1590909090909092,0.07228658768525041,526,You know what they say about halo size...
2485,1,5,38,44,1.1590909090909092,0.06456212749550704,526,"OMG! Is that a huge Halo, or are you just happy to see me?"
2485,1,5,38,44,1.1590909090909092,0.06456212749550704,526,Till death do us part seemed long enough to me.
2485,1,5,38,44,1.1590909090909092,0.06456212749550704,526,Ohhh . . . my . . . God!
2485,0,7,37,44,1.1590909090909092,0.055778005112363215,526,"So, you recall me as having an oversized ego?"
2485,1,5,38,44,1.1590909090909092,0.06456212749550704,526,I'm supposed to say size doesn't matter...
2485,1,5,38,44,1.1590909090909092,0.06456212749550704,526,On the terrestrial plane I was something of a chick magnet.
2485,1,5,38,44,1.1590909090909092,0.06456212749550704,526,I was the former US Hoola Hoop champion.
2485,1,5,38,44,1.1590909090909092,0.06456212749550704,526,WOW ! I was afraid you would be some crazy guy with B.O. and a beard.
2485,2,3,39,44,1.1590909090909092,0.07228658768525041,526,"Let me guess, Wall Street?!"
2485,1,5,38,44,1.1590909090909092,0.06456212749550704,526,The devil made me do it!
2485,1,5,38,44,1.1590909090909092,0.06456212749550704,526,"Yes it's big, but do you know how to use it?"
2485,1,5,38,44,1.1590909090909092,0.06456212749550704,526,You know what they say about giant halos ...
2485,2,3,39,44,1.1590909090909092,0.07228658768525041,526,I promise. I won't let it go to my head.
2547,2,2,34,38,1.1578947368421053,0.08024070996398552,526,My. What a big Halo you have...
2548,0,5,27,32,1.15625,0.06521328221627366,526,"I thought it would be different in heaven, thanks be to God!"
2549,0,7,38,45,1.1555555555555554,0.05463890236888291,526,"I'm not compensating for anything, I swear!"
2549,2,3,40,45,1.1555555555555554,0.07075034750641399,526,I gave at the office.
2549,2,3,40,45,1.1555555555555554,0.07075034750641399,526,How can you not find 'holier than thou' attractive?
2549,1,5,39,45,1.1555555555555554,0.06321005190772531,526,I used to own a pizza restaurant.
2549,0,7,38,45,1.1555555555555554,0.05463890236888291,526,I couldn't take my Porsche with me.
2549,1,5,39,45,1.1555555555555554,0.06321005190772531,526,I know it's weird....but I have small hands.
2549,1,5,39,45,1.1555555555555554,0.06321005190772531,526,"I don't mean to brag, but you know what they say about angels with large halos."
2549,2,3,40,45,1.1555555555555554,0.07075034750641399,526,People say I have a holier than thou attitude.
2549,1,5,39,45,1.1555555555555554,0.06321005190772531,526,I have a wide stance.
2549,0,7,38,45,1.1555555555555554,0.05463890236888291,526,You know what they say about angels with huge halos?
2549,2,3,40,45,1.1555555555555554,0.07075034750641399,526,"I prefer highly over heavenly endowed, and you?"
2549,2,3,40,45,1.1555555555555554,0.07075034750641399,526,I never thought I'd die to regret inventing the hula hoop.
2549,0,7,38,45,1.1555555555555554,0.05463890236888291,526,"You know what they say about large halos, don't you?"
2549,1,5,39,45,1.1555555555555554,0.06321005190772531,526,I'm on strict probation; one bad move and out I go through this hole above my head.
2549,1,5,39,45,1.1555555555555554,0.06321005190772531,526,'Glass cloud'? I don't know what you mean.
2549,1,5,39,45,1.1555555555555554,0.06321005190772531,526,You'll love it here. There's no other gated community like it.
2549,2,3,40,45,1.1555555555555554,0.07075034750641399,526,My first hula hoop.
2549,1,5,39,45,1.1555555555555554,0.06321005190772531,526,Up here you can earn a whole 85 cents on the dollar!
2549,1,5,39,45,1.1555555555555554,0.06321005190772531,526,I paid for a heavenly upgrade! It includes extra headroom.
2549,1,5,39,45,1.1555555555555554,0.06321005190772531,526,"If this job has taught me anything, it's to look beyond appearances."
2549,1,5,39,45,1.1555555555555554,0.06321005190772531,526,I don't know… I was playing with a Hula-Hoop and it just sorta stayed up there. So here I am.
2549,1,5,39,45,1.1555555555555554,0.06321005190772531,526,Talk about jumping through hoops.
2549,2,3,40,45,1.1555555555555554,0.07075034750641399,526,"Why, yes. Yes I am."
2549,1,5,39,45,1.1555555555555554,0.06321005190772531,526,Don't give me that look just because I have a swelled halo.
2549,1,5,39,45,1.1555555555555554,0.06321005190772531,526,All they left was the extra-extra large.
2549,1,5,39,45,1.1555555555555554,0.06321005190772531,526,The XL sizes were on sale.
2549,1,5,39,45,1.1555555555555554,0.06321005190772531,526,"No, my hands are also large. I'm just keeping them warm."
2549,2,3,40,45,1.1555555555555554,0.07075034750641399,526,Soon you will have a big enough head to fit that Halo.
2549,1,5,39,45,1.1555555555555554,0.06321005190772531,526,"I got nicknamed, 'Holier than Thou'."
2549,2,3,40,45,1.1555555555555554,0.07075034750641399,526,It's a side effect of my ED treatment.
2549,1,5,39,45,1.1555555555555554,0.06321005190772531,526,"Yes, my halo has grown since you arrived"
2549,0,7,38,45,1.1555555555555554,0.05463890236888291,526,"Yes, Virginia, there is a glass ceiling in Heaven also."
2549,1,5,39,45,1.1555555555555554,0.06321005190772531,526,"Being the ""Guardian Angel of Hula Hoops"" has its perks."
2549,2,3,40,45,1.1555555555555554,0.07075034750641399,526,"I heard St. Peter was bad at geometry, so I told him it 4piR."
2549,0,7,38,45,1.1555555555555554,0.05463890236888291,526,"So I said to Gabriel, ""Believe me, I know die-ameter."" But seriously......"
2549,0,7,38,45,1.1555555555555554,0.05463890236888291,526,Lemme guess. On Earth you drove a muscle car.
2549,2,3,40,45,1.1555555555555554,0.07075034750641399,526,Is that happiness to see me?
2549,2,3,40,45,1.1555555555555554,0.07075034750641399,526,I guess you didn't 'lean in'.
2549,0,7,38,45,1.1555555555555554,0.05463890236888291,526,It's called a 'Morning Glory.'
2549,1,5,39,45,1.1555555555555554,0.06321005190772531,526,"Stand back honey, I don't know how big this thing gets."
2549,1,5,39,45,1.1555555555555554,0.06321005190772531,526,I prefer to call it an areola
2549,1,5,39,45,1.1555555555555554,0.06321005190772531,526,"Look, Honey, size matters!"
2549,1,5,39,45,1.1555555555555554,0.06321005190772531,526,You know what they say about a man with a large halo.
2549,2,3,40,45,1.1555555555555554,0.07075034750641399,526,Don't let the small hands fool you.
2549,0,7,38,45,1.1555555555555554,0.05463890236888291,526,Some are just more holy.
2549,1,5,39,45,1.1555555555555554,0.06321005190772531,526,I was Donald Trump's hairstylist.
2549,1,5,39,45,1.1555555555555554,0.06321005190772531,526,"Oh, Honey. You'll make friends. I mean, being alive wasn't all peaches and cream either."
2549,1,5,39,45,1.1555555555555554,0.06321005190772531,526,I was even my mother's favorite.
2549,1,5,39,45,1.1555555555555554,0.06321005190772531,526,Apparently I have a big head.
2549,3,1,41,45,1.1555555555555554,0.07756102553718168,526,"My halo is huge. So huge, you won't believe how huge it is."
2549,1,5,39,45,1.1555555555555554,0.06321005190772531,526,"Remember, Eve, I was always holier than thou."
2549,1,5,39,45,1.1555555555555554,0.06321005190772531,526,"Up here, size matters!"
2549,1,5,39,45,1.1555555555555554,0.06321005190772531,526,I hula on weekends.
2549,2,3,40,45,1.1555555555555554,0.07075034750641399,526,Mine was very popular in the '50s.
2549,2,3,40,45,1.1555555555555554,0.07075034750641399,526,"I bet you wish you’d liked that post about the sick kid now, huh?"
2549,1,5,39,45,1.1555555555555554,0.06321005190772531,526,You do know what they say about men with big halos.
2549,1,5,39,45,1.1555555555555554,0.06321005190772531,526,This is why it's called heaven.
2549,3,1,41,45,1.1555555555555554,0.07756102553718168,526,I thought I'd dress up!
2549,2,3,40,45,1.1555555555555554,0.07075034750641399,526,I used to have a much bigger head. Dying kinda humbles you.
2549,0,7,38,45,1.1555555555555554,0.05463890236888291,526,Does this make my feet look big?
2549,1,5,39,45,1.1555555555555554,0.06321005190772531,526,"It means I've been more saintly and have had less sex, but I'll take any opportunity to shrink it."
2549,1,5,39,45,1.1555555555555554,0.06321005190772531,526,It's called the 'halo affect'—it makes me ridiculously holier than thou.
2549,1,5,39,45,1.1555555555555554,0.06321005190772531,526,"I know, it's awful. I haven't had a proper sleep in weeks."
2549,3,1,41,45,1.1555555555555554,0.07756102553718168,526,I told you I'm a grower.
2549,1,5,39,45,1.1555555555555554,0.06321005190772531,526,"Well, yeah, obviously THOU."
2549,1,5,39,45,1.1555555555555554,0.06321005190772531,526,I got fifty of them from Costco.
2549,2,3,40,45,1.1555555555555554,0.07075034750641399,526,You know about they say about angels with big halos ....
2549,2,3,40,45,1.1555555555555554,0.07075034750641399,526,"You can say what you like, yet I believe HE decides..:"
2549,3,1,41,45,1.1555555555555554,0.07756102553718168,526,I deleted his account.
2549,0,7,38,45,1.1555555555555554,0.05463890236888291,526,Please give me a chance. I’m a bad boy at heart!
2549,0,7,38,45,1.1555555555555554,0.05463890236888291,526,Hula hoop champion in 1959.
2549,1,5,39,45,1.1555555555555554,0.06321005190772531,526,"Thanks. Wish I could say the same thing about my, um, hands."
2549,2,3,40,45,1.1555555555555554,0.07075034750641399,526,"yea,big hands,big feet,big halo and you know the rest."
2549,1,5,39,45,1.1555555555555554,0.06321005190772531,526,I guess I'm just more hole-y than you.
2549,1,5,39,45,1.1555555555555554,0.06321005190772531,526,I know people in high places plus I was an Eagle Scout.
2549,1,5,39,45,1.1555555555555554,0.06321005190772531,526,"Oh, it definitely grows. But it takes time..."
2549,1,5,39,45,1.1555555555555554,0.06321005190772531,526,I left my harddrive on the cloud.
2549,0,7,38,45,1.1555555555555554,0.05463890236888291,526,It’s a rental; One size fits all.
2549,2,3,40,45,1.1555555555555554,0.07075034750641399,526,"It's the wide screen HD model, with omniscient remote."
2549,0,7,38,45,1.1555555555555554,0.05463890236888291,526,I swear it does not make your butt look big.
2549,1,5,39,45,1.1555555555555554,0.06321005190772531,526,Well HAY-LOOO there!
2549,2,3,40,45,1.1555555555555554,0.07075034750641399,526,It matches my hands
2549,2,3,40,45,1.1555555555555554,0.07075034750641399,526,It's genetic.
2549,1,5,39,45,1.1555555555555554,0.06321005190772531,526,"Ha-lo, beautiful!"
2549,1,5,39,45,1.1555555555555554,0.06321005190772531,526,"Halo, it's me I was wondering if after all these years you'd like to notice me."
2549,2,3,40,45,1.1555555555555554,0.07075034750641399,526,"Oh, I was under the impression that it was til death do us part."
2549,0,7,38,45,1.1555555555555554,0.05463890236888291,526,"No, I don't notice any difference."
2549,0,7,38,45,1.1555555555555554,0.05463890236888291,526,"Well, yeah, it's true, but it's not like it's going to do us any good up here."
2549,2,3,40,45,1.1555555555555554,0.07075034750641399,526,Welcome to heaven for metrics analysts.
2549,1,5,39,45,1.1555555555555554,0.06321005190772531,526,I am sure it will shrink over time.
2549,2,3,40,45,1.1555555555555554,0.07075034750641399,526,Does it make my hands look small?
2549,1,5,39,45,1.1555555555555554,0.06321005190772531,526,"Well ""halo,"" good looking."
2549,1,5,39,45,1.1555555555555554,0.06321005190772531,526,I invented the hula hoop. What did you do?
2549,1,5,39,45,1.1555555555555554,0.06321005190772531,526,"Without a doubt, I'm holier than you."
2549,1,5,39,45,1.1555555555555554,0.06321005190772531,526,"You know what they say, everything's bigger in Texas..."
2549,1,5,39,45,1.1555555555555554,0.06321005190772531,526,I'm on 9 with a 10!
2549,2,3,40,45,1.1555555555555554,0.07075034750641399,526,You're STILL making me jump through hoops.
2549,2,3,40,45,1.1555555555555554,0.07075034750641399,526,And I have small hands!
2549,1,5,39,45,1.1555555555555554,0.06321005190772531,526,"Come, I'll introduce you to Mother Teresa..."
2549,3,1,41,45,1.1555555555555554,0.07756102553718168,526,Let's put it this way. My hands aren't tiny either.
2549,2,3,40,45,1.1555555555555554,0.07075034750641399,526,"Small, yes, but with a great view."
2549,0,7,38,45,1.1555555555555554,0.05463890236888291,526,It was another hula hoop related death.
2549,2,3,40,45,1.1555555555555554,0.07075034750641399,526,Tinder? Never heard of it.
2549,1,5,39,45,1.1555555555555554,0.06321005190772531,526,It just means I've been here a lot longer...
2549,0,7,38,45,1.1555555555555554,0.05463890236888291,526,"If this angel stuff doesn't work out, I could always light my halo on fire and join the circus..."
2549,0,7,38,45,1.1555555555555554,0.05463890236888291,526,What? I'm from Texas.
2549,2,3,40,45,1.1555555555555554,0.07075034750641399,526,"As long as it doesn't last longer than four hours, we're cool."
2549,0,7,38,45,1.1555555555555554,0.05463890236888291,526,I got it at a garage sale.
2549,2,3,40,45,1.1555555555555554,0.07075034750641399,526,God got a good laugh. I asked for a bigger one cause my hands were so small.
2549,1,5,39,45,1.1555555555555554,0.06321005190772531,526,"Wow, those on-line dating services do work!"
2549,1,5,39,45,1.1555555555555554,0.06321005190772531,526,I'm not an idiot. You have a much smaller hole to get through to the next level than I.
2549,0,7,38,45,1.1555555555555554,0.05463890236888291,526,"Yes, as a matter of fact I was a big Donnie Osmond fan. Why do you ask?"
2549,1,5,39,45,1.1555555555555554,0.06321005190772531,526,Told you. My religion was the true one.
2549,2,3,40,45,1.1555555555555554,0.07075034750641399,526,Up here the only thing of size that matters is your halo
2549,1,5,39,45,1.1555555555555554,0.06321005190772531,526,I found my halo on Amazon. They deliver if you specify the cloud number.
2549,1,5,39,45,1.1555555555555554,0.06321005190772531,526,"And if you get tired of being holy, you can use it as a hula hoop."
2549,0,7,38,45,1.1555555555555554,0.05463890236888291,526,My death was caused by a hula hoop.
2549,1,5,39,45,1.1555555555555554,0.06321005190772531,526,"Look, up here, the halo is only related to the size of your ego!"
2549,0,7,38,45,1.1555555555555554,0.05463890236888291,526,What gender halo gap? There is no gender halo gap.
2549,1,5,39,45,1.1555555555555554,0.06321005190772531,526,"Yes, it does mean that."
2549,2,3,40,45,1.1555555555555554,0.07075034750641399,526,Look at my halo. Is that a small halo? I guarantee there is no problem
2549,2,3,40,45,1.1555555555555554,0.07075034750641399,526,Mine is biggest.
2549,1,5,39,45,1.1555555555555554,0.06321005190772531,526,I guarantee you there's no problem.
2549,2,3,40,45,1.1555555555555554,0.07075034750641399,526,"I'm not saying I'm ""Holier than thou,"" I just think my idea is better."
2549,1,5,39,45,1.1555555555555554,0.06321005190772531,526,"As they say, big halo....."
2549,0,7,38,45,1.1555555555555554,0.05463890236888291,526,"You're right, I shouldn't have had that last beer."
2549,1,5,39,45,1.1555555555555554,0.06321005190772531,526,"Yeah, the Man personally designated me a ""Holier Than Thou"" kind of guy."
2549,0,7,38,45,1.1555555555555554,0.05463890236888291,526,"Well, if you wanted a normal angel, your profile should have said ""Spiritual, but not religious""!"
2549,0,7,38,45,1.1555555555555554,0.05463890236888291,526,I've got to be honest: bigger isn't necessarily better.
2549,1,5,39,45,1.1555555555555554,0.06321005190772531,526,"''Just call me archangel of the morning angel."""
2549,0,7,38,45,1.1555555555555554,0.05463890236888291,526,Wham-O dot com
2549,2,3,40,45,1.1555555555555554,0.07075034750641399,526,I'm really not over compensating
2681,1,4,34,39,1.1538461538461537,0.06910319629955256,526,"No it's "" divine compensation"" if you must know."
2682,1,5,40,46,1.1521739130434783,0.061913070618242964,526,Circular reasoning got me here and it's growing on me.
2682,2,3,41,46,1.1521739130434783,0.06927778784183837,526,You know that’s just a Hula Hoop.
2682,3,1,42,46,1.1521739130434783,0.07593151824596947,526,I thought he said Hulu not Halo
2682,2,3,41,46,1.1521739130434783,0.06927778784183837,526,"You know, it's true what they say you can tell about a man from the size of his halo."
2682,2,3,41,46,1.1521739130434783,0.06927778784183837,526,I rather enjoy being thought of as larger than life.
2682,0,7,39,46,1.1521739130434783,0.05354479188959757,526,I went with the 1st class upgrade
2682,1,5,40,46,1.1521739130434783,0.061913070618242964,526,"I think it's time to take a ""cold shower"".?"
2682,0,7,39,46,1.1521739130434783,0.05354479188959757,526,They don't believe in wormholes up here!
2682,3,1,42,46,1.1521739130434783,0.07593151824596947,526,"No, no. I'm not any better than you. I was simply a whiz with a hula hoop down there."
2682,1,5,40,46,1.1521739130434783,0.061913070618242964,526,I am not compensating for any inadequacies.
2682,1,5,40,46,1.1521739130434783,0.061913070618242964,526,"The better to lasso you with, my dear!"
2682,0,7,39,46,1.1521739130434783,0.05354479188959757,526,"Look who thinks he's ""Man's gift to God!"
2682,2,3,41,46,1.1521739130434783,0.06927778784183837,526,Is your halo compensating for something?
2682,2,3,41,46,1.1521739130434783,0.06927778784183837,526,Welcome! Glad you came!
2682,2,3,41,46,1.1521739130434783,0.06927778784183837,526,Being headstrong has it's perks.
2682,0,7,39,46,1.1521739130434783,0.05354479188959757,526,It's especially handy at night
2682,1,5,40,46,1.1521739130434783,0.061913070618242964,526,Apparently envy is no longer one of the seven deadly sins.
2682,1,5,40,46,1.1521739130434783,0.061913070618242964,526,It's based on the gender pay gap
2682,1,5,40,46,1.1521739130434783,0.061913070618242964,526,My name's Charlie. I collect angels.
2682,1,5,40,46,1.1521739130434783,0.061913070618242964,526,I'm afraid my 'bad boy' act won't work any more.
2682,1,5,40,46,1.1521739130434783,0.061913070618242964,526,The Big Guy wanted an angel he can slam dunk.
2682,2,3,41,46,1.1521739130434783,0.06927778784183837,526,"You're Saint Peter!"" Do you know Caitlyn Jenner?"
2682,2,3,41,46,1.1521739130434783,0.06927778784183837,526,The size of my halo is directly related to the fact that I died with you.
2682,1,5,40,46,1.1521739130434783,0.061913070618242964,526,There's plenty of room under here if you want to know what it feels like to have a big one.
2682,1,5,40,46,1.1521739130434783,0.061913070618242964,526,Are you a Virgin? Your halo tells me you are!
2682,2,3,41,46,1.1521739130434783,0.06927778784183837,526,I was the most honest and helpful employee at Costco
2682,1,5,40,46,1.1521739130434783,0.061913070618242964,526,The trickle down effect will work...just give it time.
2682,0,7,39,46,1.1521739130434783,0.05354479188959757,526,So. God is really a guy after all.
2682,3,1,42,46,1.1521739130434783,0.07593151824596947,526,"Of course, he only lets his closest friends call him Jeezy Creezy."
2682,2,3,41,46,1.1521739130434783,0.06927778784183837,526,How did I do it? Clean thinking and no meat on Fridays. That's really it.
2682,0,7,39,46,1.1521739130434783,0.05354479188959757,526,"True, I was a virgin."
2682,0,7,39,46,1.1521739130434783,0.05354479188959757,526,"No, I an not still compensating."
2682,0,7,39,46,1.1521739130434783,0.05354479188959757,526,I know that mine is bigger than yours but remember that envy is one of the seven deadly sins.
2682,1,5,40,46,1.1521739130434783,0.061913070618242964,526,I died during the Hula Hoop craze.
2682,1,5,40,46,1.1521739130434783,0.061913070618242964,526,"Actually the halo size shows your Heaven age, it's like a tree!"
2682,0,7,39,46,1.1521739130434783,0.05354479188959757,526,Be honest. Does it make me look phat?
2682,1,5,40,46,1.1521739130434783,0.061913070618242964,526,I am a believer in equal rights. Your halo should be as large as mine!
2682,2,3,41,46,1.1521739130434783,0.06927778784183837,526,Shit! I coulda had more fun!
2682,2,3,41,46,1.1521739130434783,0.06927778784183837,526,I haven't slept a wink since I had this one installed. It's like an alien beacon up there.
2682,1,5,40,46,1.1521739130434783,0.061913070618242964,526,My name is Trump.
2682,1,5,40,46,1.1521739130434783,0.061913070618242964,526,Is that a halo or a hole in the ceiling?
2682,1,5,40,46,1.1521739130434783,0.061913070618242964,526,It's a NextGen Halo that doubles as a mood ring.
2682,0,7,39,46,1.1521739130434783,0.05354479188959757,526,You know what they say about the size of an angel's halo..
2682,0,7,39,46,1.1521739130434783,0.05354479188959757,526,I know what you're thinking.
2682,0,7,39,46,1.1521739130434783,0.05354479188959757,526,The forecast's calling for rain.
2682,0,7,39,46,1.1521739130434783,0.05354479188959757,526,"Unfortunately, it's not what you think. Hula hoop champion, 6th grade."
2682,1,5,40,46,1.1521739130434783,0.061913070618242964,526,And wait until you see my hands.
2682,2,3,41,46,1.1521739130434783,0.06927778784183837,526,I see you are still using Viagra.
2682,1,5,40,46,1.1521739130434783,0.061913070618242964,526,I still remain holier than thou
2682,0,7,39,46,1.1521739130434783,0.05354479188959757,526,I am just keeping it warm. The Greatest arrives this week.
2682,1,5,40,46,1.1521739130434783,0.061913070618242964,526,I told you to let God win that last round of Halo XBOX 360.
2682,1,5,40,46,1.1521739130434783,0.061913070618242964,526,Hula Hoop inventor..how d'ya guess?
2682,1,5,40,46,1.1521739130434783,0.061913070618242964,526,It was either Hell or the size of the hole I created in the ozone layer.
2682,1,5,40,46,1.1521739130434783,0.061913070618242964,526,My carry-on luggage always fitted into the airline test box.
2682,2,3,41,46,1.1521739130434783,0.06927778784183837,526,"Face it, angel face, you're just jealous."
2682,1,5,40,46,1.1521739130434783,0.061913070618242964,526,"I agree, equal halos for equal good deeds!"
2682,1,5,40,46,1.1521739130434783,0.061913070618242964,526,"You can't fly through yours, can you?"""
2682,1,5,40,46,1.1521739130434783,0.061913070618242964,526,Ringworm is actually quite common.
2682,0,7,39,46,1.1521739130434783,0.05354479188959757,526,"You see, I was the priest who banned hula hoops."
2682,2,3,41,46,1.1521739130434783,0.06927778784183837,526,I got extra credit for trying to ban assault weapons and high-volume bullet magazines.
2682,2,3,41,46,1.1521739130434783,0.06927778784183837,526,I guess that Woman Card doesn't get you everything.
2682,2,3,41,46,1.1521739130434783,0.06927778784183837,526,"Yeah, lets just say the halos get pretty picked over when there is half price sale."
2682,1,5,40,46,1.1521739130434783,0.061913070618242964,526,So Pride and Envy are no longer Sins of Exclusion. Who knew?
2682,0,7,39,46,1.1521739130434783,0.05354479188959757,526,"Seriously, it's not because I'm a man. In life, I was a hula hoop champ."
2682,2,3,41,46,1.1521739130434783,0.06927778784183837,526,isn't it time for equal halos for equal good deeds?
2682,1,5,40,46,1.1521739130434783,0.061913070618242964,526,I had a wider circle of friends. I suppose.
2682,1,5,40,46,1.1521739130434783,0.061913070618242964,526,"Perhaps I should've used another pet name for you besides ""Angel""."
2682,1,5,40,46,1.1521739130434783,0.061913070618242964,526,"Actually, I was Donald Trump's alter ego."
2682,1,5,40,46,1.1521739130434783,0.061913070618242964,526,I would have been here sooner if i knew about the dating service!
2682,2,3,41,46,1.1521739130434783,0.06927778784183837,526,"Well, I really do have 400 years on you."
2682,0,7,39,46,1.1521739130434783,0.05354479188959757,526,"Yes, dear, I'm afraid that size still matters."
2682,2,3,41,46,1.1521739130434783,0.06927778784183837,526,How about coming over here under my ring??
2682,2,3,41,46,1.1521739130434783,0.06927778784183837,526,"I know it's smaller, but I had a better time down there."
2682,2,3,41,46,1.1521739130434783,0.06927778784183837,526,"Well, it's the girth, not the length, that really counts."
2682,1,5,40,46,1.1521739130434783,0.061913070618242964,526,well it is my birthday.
2682,1,5,40,46,1.1521739130434783,0.061913070618242964,526,HE said I should reuse/recycle my old hoola hoop.
2682,2,3,41,46,1.1521739130434783,0.06927778784183837,526,Does my halo look too big?
2682,1,5,40,46,1.1521739130434783,0.061913070618242964,526,Evidently size does matter.
2682,1,5,40,46,1.1521739130434783,0.061913070618242964,526,"Up here, size really does matter."
2682,1,5,40,46,1.1521739130434783,0.061913070618242964,526,Excuse me woman.. is that a frisbee on your head?
2682,3,1,42,46,1.1521739130434783,0.07593151824596947,526,I have big hands too.
2682,0,7,39,46,1.1521739130434783,0.05354479188959757,526,"don't say it , I know , I should have got out more"
2682,1,5,40,46,1.1521739130434783,0.061913070618242964,526,I didn't manspread.
2682,2,3,41,46,1.1521739130434783,0.06927778784183837,526,I got it at Ross
2682,2,3,41,46,1.1521739130434783,0.06927778784183837,526,So much for equal pay for equal work.
2682,1,5,40,46,1.1521739130434783,0.061913070618242964,526,I never used Twitter to complain about my flight.
2682,2,3,41,46,1.1521739130434783,0.06927778784183837,526,I think because it helps balance out my extreme shoe size?
2682,1,5,40,46,1.1521739130434783,0.061913070618242964,526,I admit it--I have a Napoleon complex.
2682,1,5,40,46,1.1521739130434783,0.061913070618242964,526,"The Devil offered me a much better benefit plan, but c'mon it's Hell down there."
2682,1,5,40,46,1.1521739130434783,0.061913070618242964,526,"Oh, the size? Well, it doubles as a portal between here and there."
2682,2,3,41,46,1.1521739130434783,0.06927778784183837,526,I guess I have a pretty big hoop to jump through
2682,2,3,41,46,1.1521739130434783,0.06927778784183837,526,What glass ceiling?
2682,1,5,40,46,1.1521739130434783,0.061913070618242964,526,You'll find that is is a job you eventually grow into.
2682,1,5,40,46,1.1521739130434783,0.061913070618242964,526,"Well, yes. It's really just a hula hoop."
2682,1,5,40,46,1.1521739130434783,0.061913070618242964,526,"Big shoes, ......."
2682,0,7,39,46,1.1521739130434783,0.05354479188959757,526,Where's God?
2682,0,7,39,46,1.1521739130434783,0.05354479188959757,526,The regular size was out-of-stock.
2682,2,3,41,46,1.1521739130434783,0.06927778784183837,526,Let me show you about venn diagrams
2682,1,5,40,46,1.1521739130434783,0.061913070618242964,526,I was really good.
2682,1,5,40,46,1.1521739130434783,0.061913070618242964,526,"Well, yes, I am blessed in that way."
2682,1,5,40,46,1.1521739130434783,0.061913070618242964,526,And they said I didn't have a superego.
2682,2,3,41,46,1.1521739130434783,0.06927778784183837,526,"Yeah, It is proportional to the size of my halo"
2682,1,5,40,46,1.1521739130434783,0.061913070618242964,526,"You know, it's true what they say about the size of a guy's halo."
2682,1,5,40,46,1.1521739130434783,0.061913070618242964,526,I took the prime option.
2682,1,5,40,46,1.1521739130434783,0.061913070618242964,526,"Well, you know what they say about an angel with a big halo..."
2682,1,5,40,46,1.1521739130434783,0.061913070618242964,526,"I know you usually go for more of the ""bad boy type,"" but I think we'd be a match made in heaven."
2682,1,5,40,46,1.1521739130434783,0.061913070618242964,526,"""Could you really help me shrink my halo? How?"
2682,2,3,41,46,1.1521739130434783,0.06927778784183837,526,"You know what they say, Big halo, big . . ."""
2682,1,5,40,46,1.1521739130434783,0.061913070618242964,526,Guess who asked for directions to the heavenly bathroom then put the seat down?
2682,2,3,41,46,1.1521739130434783,0.06927778784183837,526,You'll never believe how very hard I had to work to earn it!
2682,1,5,40,46,1.1521739130434783,0.061913070618242964,526,Your halo is writing checks your body can't cash.
2682,2,3,41,46,1.1521739130434783,0.06927778784183837,526,I was in a hula hoop accident. And you?
2682,1,5,40,46,1.1521739130434783,0.061913070618242964,526,Halooooooooo
2682,3,1,42,46,1.1521739130434783,0.07593151824596947,526,"Halo, Big Spender…"
2682,0,7,39,46,1.1521739130434783,0.05354479188959757,526,"Yes, my halo's smaller, but it slips down and holds my hair in place."
2682,1,5,40,46,1.1521739130434783,0.061913070618242964,526,Am I in the right place?
2682,0,7,39,46,1.1521739130434783,0.05354479188959757,526,It's a Hula Halo..
2682,2,3,41,46,1.1521739130434783,0.06927778784183837,526,He didn't get the memo about my recent bariatric surgery.
2682,2,3,41,46,1.1521739130434783,0.06927778784183837,526,"Once you reach 1 million rotations, you can swap out for the hula hoop."
2682,1,5,40,46,1.1521739130434783,0.061913070618242964,526,That's a myth.
2682,2,3,41,46,1.1521739130434783,0.06927778784183837,526,"And then I said 'Actually, sweetie, all lives matter."
2682,0,7,39,46,1.1521739130434783,0.05354479188959757,526,"Honestly, it's a double edged sword. The 5G halo is great for sending messages to the world but its bulk is a nuisance when your executing judgements"
2682,0,7,39,46,1.1521739130434783,0.05354479188959757,526,"Of course you've heard the old chestnut, ""Big halo, big -----"""
2682,2,3,41,46,1.1521739130434783,0.06927778784183837,526,"Don't get too hopeful, it's really a hula hoop!"
2682,2,3,41,46,1.1521739130434783,0.06927778784183837,526,I was hit by a car in the Costco parking lot.
2682,1,5,40,46,1.1521739130434783,0.061913070618242964,526,"Now all of a sudden, after all of these years, size matters to you."
2682,1,5,40,46,1.1521739130434783,0.061913070618242964,526,Size matters forever.
2682,0,7,39,46,1.1521739130434783,0.05354479188959757,526,"It s not the size that matters, it matters how you use it."
2810,0,6,34,40,1.15,0.057177187489686566,526,I have a big one.
2810,0,6,34,40,1.15,0.057177187489686566,526,What are you talking about? There's no halo gender gap.
2810,2,2,36,40,1.15,0.07637626158259735,526,"I was overjoyed when I first learned I could bring my hula-hoop, now not so much."
2810,2,2,36,40,1.15,0.07637626158259735,526,I'm afraid the glass ceiling stinks to high heaven.
2814,2,3,42,47,1.148936170212766,0.06786504677504616,526,I died during a hula hoop contest
2814,0,7,40,47,1.148936170212766,0.05249310253140096,526,He said it's only because my head is so big.
2814,1,5,41,47,1.148936170212766,0.06066790909183939,526,"Actually, I played the harp in the New York Philharmonic"
2814,1,5,41,47,1.148936170212766,0.06066790909183939,526,"SORRY, I'M A VIRGIN"
2814,1,5,41,47,1.148936170212766,0.06066790909183939,526,"You know what they say about guys with big halos, don't you."
2814,1,5,41,47,1.148936170212766,0.06066790909183939,526,Good grief. I should have swiped left.
2814,2,3,42,47,1.148936170212766,0.06786504677504616,526,"It doesn't quite fit into my Maserati, but I make do."
2814,1,5,41,47,1.148936170212766,0.06066790909183939,526,"I'm sorry to tell you this, Harold, but it's the size of the hands, not the size of the halo."
2814,1,5,41,47,1.148936170212766,0.06066790909183939,526,Size doesn't matter in hell.
2814,2,3,42,47,1.148936170212766,0.06786504677504616,526,Back in the 70's I played harp for Aerosmith.
2814,2,3,42,47,1.148936170212766,0.06786504677504616,526,Don't let the halo give you the wrong impression.
2814,3,1,43,47,1.148936170212766,0.07436890448287321,526,HE had to give me some compensation for having small hands.
2814,1,5,41,47,1.148936170212766,0.06066790909183939,526,You should've seen the size of the planet it came with
2814,0,7,40,47,1.148936170212766,0.05249310253140096,526,I won it at bingo.
2828,2,2,37,41,1.146341463414634,0.07457992610449102,526,Maybe you should have thought of that before you majored in communications.
2828,1,4,36,41,1.146341463414634,0.0658988101761283,526,Not that I have a big head or anything.
2828,1,4,36,41,1.146341463414634,0.0658988101761283,526,You know what we say; Big Hands...Big Halo
2828,1,4,36,41,1.146341463414634,0.0658988101761283,526,"Yeah I've got some connections in the halo department, I can get you a tour of you want..."
2828,2,2,37,41,1.146341463414634,0.07457992610449102,526,"Actually Laurel, this halo is couture, not Prada. But it's not like you would understand with that hand-me-down."
2828,1,4,36,41,1.146341463414634,0.0658988101761283,526,I took the A-Rod route...
2828,1,4,36,41,1.146341463414634,0.0658988101761283,526,Who says size matters?
2828,1,4,36,41,1.146341463414634,0.0658988101761283,526,"Okay, okay, you were right. I lived my life with a big head."
2828,3,0,38,41,1.146341463414634,0.08235094154211772,526,"Apparently once a month they have ""Bad Judgment Day."""
2828,0,6,35,41,1.146341463414634,0.05588506945068099,526,"and you'll be happy to know that, up here, there's no problem with it lasting more than four hours. . . ."
2828,1,4,36,41,1.146341463414634,0.0658988101761283,526,Hula-hoop accident giving a demo at an orphanage.
2828,1,4,36,41,1.146341463414634,0.0658988101761283,526,"If this doesn't prove to you that size really matters, nothing will!"
2840,1,5,42,48,1.1458333333333333,0.059471544937141164,526,"Yeah, it's hard being the new guy in heaven."
2841,0,6,36,42,1.1428571428571428,0.05464943254828616,526,Nice halo. Can I buy you a drink?
2841,1,4,37,42,1.1428571428571428,0.0644049739048166,526,"...and he is wearing our new Donald J. Trump model halo...""The Narcissist""."
2841,0,6,36,42,1.1428571428571428,0.05464943254828616,526,"Hey, I never said I was holier than thou."
2841,1,4,37,42,1.1428571428571428,0.0644049739048166,526,I was really good at Halo.
2841,1,4,37,42,1.1428571428571428,0.0644049739048166,526,I went with the Hula Hoop for nostalgic reasons.
2841,1,4,37,42,1.1428571428571428,0.0644049739048166,526,"""I swiped to the right and ended up here""."
2841,0,6,36,42,1.1428571428571428,0.05464943254828616,526,Big halo ---- Big hands.
2841,2,2,38,42,1.1428571428571428,0.07286591006438153,526,And I have REALLY big hands.
2841,1,4,37,42,1.1428571428571428,0.0644049739048166,526,"Size matters, even up here"
2841,1,4,37,42,1.1428571428571428,0.0644049739048166,526,"Like I said, some men are just bigger than others..."
2841,2,2,38,42,1.1428571428571428,0.07286591006438153,526,Ii's a hula loop.
2841,1,4,37,42,1.1428571428571428,0.0644049739048166,526,"Well, it's pretty clear - size matters after all!"
2841,0,6,36,42,1.1428571428571428,0.05464943254828616,526,I used a very accurate moral compass.
2841,1,4,37,42,1.1428571428571428,0.0644049739048166,526,"Yeah, turns out it's an eternal truth."
2841,0,6,36,42,1.1428571428571428,0.05464943254828616,526,I also have Huuge hands
2841,1,4,37,42,1.1428571428571428,0.0644049739048166,526,"Down there they say you can tell by hand size, but up here, the bigger the halo, the bigger ..."
2841,0,6,36,42,1.1428571428571428,0.05464943254828616,526,I was bigger when I first got in here.
2841,1,4,37,42,1.1428571428571428,0.0644049739048166,526,"Yes, even in heaven size matters."
2841,1,4,37,42,1.1428571428571428,0.0644049739048166,526,What have you done wrong?
2841,0,6,36,42,1.1428571428571428,0.05464943254828616,526,I listened to everything my wife said on the other side.
2841,0,6,36,42,1.1428571428571428,0.05464943254828616,526,"Halo Effect or not, I'll take it 'Baby'"
2841,1,4,37,42,1.1428571428571428,0.0644049739048166,526,"Lord it's hard to be humble, when your perfect in every way."
2841,1,4,37,42,1.1428571428571428,0.0644049739048166,526,Halo from the other side. I must have called a thousand times.
2841,2,2,38,42,1.1428571428571428,0.07286591006438153,526,I knew I would get a greater reward than you...........
2841,2,2,38,42,1.1428571428571428,0.07286591006438153,526,"When I said I was a big Halo fan, I don't think they understood I was talking about the video game."
2841,1,4,37,42,1.1428571428571428,0.0644049739048166,526,I have on the Highest Authority: size DOES matter.
2841,0,6,36,42,1.1428571428571428,0.05464943254828616,526,I cleaned the portasans at Woodstock.
2841,1,4,37,42,1.1428571428571428,0.0644049739048166,526,Could we at least lie in neighboring bath tubs?
2841,0,6,36,42,1.1428571428571428,0.05464943254828616,526,Yeah... you could say that I’m a pretty big deal up here.
2841,0,6,36,42,1.1428571428571428,0.05464943254828616,526,They ran out of halos. Thank God i died while hoola-hooping.
2841,1,4,37,42,1.1428571428571428,0.0644049739048166,526,My father had a large one too.
2841,1,4,37,42,1.1428571428571428,0.0644049739048166,526,My halo doesn't know that viagra doesn't work up here.
2841,2,2,38,42,1.1428571428571428,0.07286591006438153,526,Not after the shape you brought it back in last time
2841,1,4,37,42,1.1428571428571428,0.0644049739048166,526,""" I've been asked that same question for an eternity and the answer is not just 'yes' but 'hell yes'""."
2841,3,0,39,42,1.1428571428571428,0.08044178662449615,526,"Back on Earth, I was called 'goodie goodie', so that defiantly has something to do with it..."
2841,0,6,36,42,1.1428571428571428,0.05464943254828616,526,Now you will finally understand why bigger does not mean better!
2841,2,2,38,42,1.1428571428571428,0.07286591006438153,526,What can I say? I'm Special.
2841,0,6,36,42,1.1428571428571428,0.05464943254828616,526,I picked this up at Trump's House of Huge Halos on my way up.
2841,1,4,37,42,1.1428571428571428,0.0644049739048166,526,"No, not male chauvinism. It's commensurate with your volunteer services."
2841,1,4,37,42,1.1428571428571428,0.0644049739048166,526,little did my wife know we'd find a foolproof place to meet
2841,1,4,37,42,1.1428571428571428,0.0644049739048166,526,Thank God it's you and not my first wife.
2841,0,6,36,42,1.1428571428571428,0.05464943254828616,526,It's all that's left of male chauvinism.
2841,0,6,36,42,1.1428571428571428,0.05464943254828616,526,I also like to hula-hoop
2841,2,2,38,42,1.1428571428571428,0.07286591006438153,526,You know what they say...
2841,1,4,37,42,1.1428571428571428,0.0644049739048166,526,I think we can forget about my chastity now -- for good!
2841,0,6,36,42,1.1428571428571428,0.05464943254828616,526,I paid for a homeless guy's frappe once.
2841,1,4,37,42,1.1428571428571428,0.0644049739048166,526,"Evidently, you've been a loyal follower of the Kardashians..."
2888,1,4,38,43,1.1395348837209303,0.06297704189640278,526,Its' not lifestyle specific.
2888,1,4,38,43,1.1395348837209303,0.06297704189640278,526,"Actually, I spent most of my time on Twitter explaining things to women."
2888,0,6,37,43,1.1395348837209303,0.05346670079545209,526,"""A penny for your thoughts""."
2888,0,6,37,43,1.1395348837209303,0.05346670079545209,526,I musta died and gone to heaven. Are all the men's halos this big?
2888,1,4,38,43,1.1395348837209303,0.06297704189640278,526,My halo? I worked more over-time then you.
2888,2,2,39,43,1.1395348837209303,0.07122869869716944,526,"Turns out, size matters!"
2888,1,4,38,43,1.1395348837209303,0.06297704189640278,526,I have the Hula Hoop concession.
2888,1,4,38,43,1.1395348837209303,0.06297704189640278,526,I usually spend my time on Saturn
2888,0,6,37,43,1.1395348837209303,0.05346670079545209,526,Have you done a lot of good deeds or are you just happy to see me?
2888,1,4,38,43,1.1395348837209303,0.06297704189640278,526,"It's true what they say, I know, about angels and the size of their halos."
2888,1,4,38,43,1.1395348837209303,0.06297704189640278,526,"Yes, I know, I know, I found out earlier today that the Pinocchio effect works slightly differently up here."
2888,0,6,37,43,1.1395348837209303,0.05346670079545209,526,The guys in supplies told me this size halo is worn by single men.
2888,1,4,38,43,1.1395348837209303,0.06297704189640278,526,"You see, mine IS bigger."
2888,2,2,39,43,1.1395348837209303,0.07122869869716944,526,Decide fast! I can't keep this hula hoop up there forever.
2888,1,4,38,43,1.1395348837209303,0.06297704189640278,526,"Of course, Citizen's United has made an impact up here as well."
2888,0,6,37,43,1.1395348837209303,0.05346670079545209,526,Looks like you are upgraded with the new mini iHalo!
2888,1,4,38,43,1.1395348837209303,0.06297704189640278,526,"Well, I was in the hula hoop business, and I guess this is they think this is funny."
2888,2,2,39,43,1.1395348837209303,0.07122869869716944,526,No surprise! Even here you have a bigger halo.
2888,2,2,39,43,1.1395348837209303,0.07122869869716944,526,Yeah...you could say it's similar to the big hands theory.
2888,0,6,37,43,1.1395348837209303,0.05346670079545209,526,Discount shopping again?
2888,1,4,38,43,1.1395348837209303,0.06297704189640278,526,God bless the patriarchy.
2888,1,4,38,43,1.1395348837209303,0.06297704189640278,526,That's not all that's yuuuge.
2888,0,6,37,43,1.1395348837209303,0.05346670079545209,526,I know what you're thinking: It's huge -- really HUGE!
2888,1,4,38,43,1.1395348837209303,0.06297704189640278,526,"""I don't understand why everyone calls me hoola-hoop head""."
2888,3,0,40,43,1.1395348837209303,0.078619000439862,526,"I wish I lie in Heaven because yes, I am compensating."
2888,1,4,38,43,1.1395348837209303,0.06297704189640278,526,You're new here.
2888,1,4,38,43,1.1395348837209303,0.06297704189640278,526,"So, do you ascend here often?"
2888,2,2,39,43,1.1395348837209303,0.07122869869716944,526,"No, there is no relationship. But size does matter, you know. EVERYWHERE!"
2888,1,4,38,43,1.1395348837209303,0.06297704189640278,526,"Yeah sister, disparity even here!"
2888,1,4,38,43,1.1395348837209303,0.06297704189640278,526,"I earned this big halo, and it's not compensating for anything."
2888,1,4,38,43,1.1395348837209303,0.06297704189640278,526,You know what they say about the size of your halo
2888,2,2,39,43,1.1395348837209303,0.07122869869716944,526,"It's kind of embarrassing, now everybody knows I was a porn star."
2888,2,2,39,43,1.1395348837209303,0.07122869869716944,526,It's true what they say about men with big halos.
2888,2,2,39,43,1.1395348837209303,0.07122869869716944,526,What's a bimbo like you doing in a place like this?
2888,2,2,39,43,1.1395348837209303,0.07122869869716944,526,I'm good on my knees.
2888,1,4,38,43,1.1395348837209303,0.06297704189640278,526,Why the attitude? Because I am holier than you.
2888,0,6,37,43,1.1395348837209303,0.05346670079545209,526,Mine is the largest one around!
2888,0,6,37,43,1.1395348837209303,0.05346670079545209,526,I didn't think he would take 'holier-than-thou' so seriously!
2888,1,4,38,43,1.1395348837209303,0.06297704189640278,526,I guarantee you there's no problem. I guarantee it.
2888,1,4,38,43,1.1395348837209303,0.06297704189640278,526,You heard what they say about people with large halos?
2888,1,4,38,43,1.1395348837209303,0.06297704189640278,526,Heaven's really more of a European city.
2888,2,2,39,43,1.1395348837209303,0.07122869869716944,526,IT'S much more reliable than hand size.
2888,2,2,39,43,1.1395348837209303,0.07122869869716944,526,"Am I dead, Angel? Cause this must be heaven!"
2888,2,2,39,43,1.1395348837209303,0.07122869869716944,526,"First, let's talk about our future."
2888,1,4,38,43,1.1395348837209303,0.06297704189640278,526,I'm guessing it's compensation.
2888,1,4,38,43,1.1395348837209303,0.06297704189640278,526,"Halo... Hula — They're very similar, you know. And this way we can keep in shape on our down time."
2888,1,4,38,43,1.1395348837209303,0.06297704189640278,526,I'm new here.
2888,1,4,38,43,1.1395348837209303,0.06297704189640278,526,"""Yeah, it's supposed to represent the size of my a ...hands."
2888,0,6,37,43,1.1395348837209303,0.05346670079545209,526,"No, really: it's okay. My wife and I are separated."
2888,2,2,39,43,1.1395348837209303,0.07122869869716944,526,I deleted until death do us part.
2888,0,6,37,43,1.1395348837209303,0.05346670079545209,526,The halo matches my ego.
2888,1,4,38,43,1.1395348837209303,0.06297704189640278,526,"Holier than thou, shmolier than thou. I prefer, ""Size matters."""
2888,1,4,38,43,1.1395348837209303,0.06297704189640278,526,"I guess the rules are different up here, but down there I was considered an angel for not hitting on every woman"
2888,1,4,38,43,1.1395348837209303,0.06297704189640278,526,Your 'holier-than-thou' attitude is comically inappropriate right now.
2888,1,4,38,43,1.1395348837209303,0.06297704189640278,526,Halo 6 is still in beta.
2888,1,4,38,43,1.1395348837209303,0.06297704189640278,526,I'll just say this: Indulgences aren't cheap.
2888,1,4,38,43,1.1395348837209303,0.06297704189640278,526,Heey-looo
2888,0,6,37,43,1.1395348837209303,0.05346670079545209,526,"No, no. It's just my Hula-Hoop."
2888,2,2,39,43,1.1395348837209303,0.07122869869716944,526,And so what if the eye of my needle was a little bigger?
2888,1,4,38,43,1.1395348837209303,0.06297704189640278,526,What?
2888,1,4,38,43,1.1395348837209303,0.06297704189640278,526,I had a very small penis.
2888,1,4,38,43,1.1395348837209303,0.06297704189640278,526,This has become a lot harder for me now that there's no such thing as real estate.
2888,1,4,38,43,1.1395348837209303,0.06297704189640278,526,"Well, I was blessed with big hands."
2888,1,4,38,43,1.1395348837209303,0.06297704189640278,526,"As the woman said to the gynecologist, ""I'm dilated to meet you!"""
2888,2,2,39,43,1.1395348837209303,0.07122869869716944,526,I have never masturbated.
2888,2,2,39,43,1.1395348837209303,0.07122869869716944,526,Wanna binge watch the rebooted Battlestar Galactica on my Hulu?
2888,1,4,38,43,1.1395348837209303,0.06297704189640278,526,They fit it for my ego. What can I say? God loves me most.
2888,2,2,39,43,1.1395348837209303,0.07122869869716944,526,They call me Pinocc-halo.
2888,2,2,39,43,1.1395348837209303,0.07122869869716944,526,Gender inequality in heaven? Oh heavens!!
2888,1,4,38,43,1.1395348837209303,0.06297704189640278,526,"I've been put on the Trump case, assigned to be the better angel of his nature."
2888,3,0,40,43,1.1395348837209303,0.078619000439862,526,"OMG trust me, it feels great girlfriend... just remember: Relaxation, Communication, Lubrication."
2888,2,2,39,43,1.1395348837209303,0.07122869869716944,526,You know what they say about the size of a man's halo...
2888,2,2,39,43,1.1395348837209303,0.07122869869716944,526,"It just looks like I'm acting ""holier than thou."""
2888,1,4,38,43,1.1395348837209303,0.06297704189640278,526,I'm thinking pizza later to celebrate your Deathday.
2888,0,6,37,43,1.1395348837209303,0.05346670079545209,526,I know we should have fastened our seat belts
2888,0,6,37,43,1.1395348837209303,0.05346670079545209,526,"I told them XL, but I did not know that the sizes ran this big."
2888,2,2,39,43,1.1395348837209303,0.07122869869716944,526,"Why, yes, I did drive a Hummer!"
2888,1,4,38,43,1.1395348837209303,0.06297704189640278,526,"Well, you know what they say about men with big hands ..."
2888,1,4,38,43,1.1395348837209303,0.06297704189640278,526,Holier than thou?
2888,1,4,38,43,1.1395348837209303,0.06297704189640278,526,Wow! So this is what happens when you swipe up instead of right on that dating app.
2888,1,4,38,43,1.1395348837209303,0.06297704189640278,526,Over-compensating has its compensation. Finally.
2888,1,4,38,43,1.1395348837209303,0.06297704189640278,526,See...I honestly did lose your number.
2888,1,4,38,43,1.1395348837209303,0.06297704189640278,526,They're great in snow.
2888,1,4,38,43,1.1395348837209303,0.06297704189640278,526,I was a pornstar when I was alive
2888,1,4,38,43,1.1395348837209303,0.06297704189640278,526,Ever heard of symbolism?
2888,1,4,38,43,1.1395348837209303,0.06297704189640278,526,"I swear, I'm not just blowin' smoke!"
2888,0,6,37,43,1.1395348837209303,0.05346670079545209,526,Not to sound all holier-than-thou but I am on track to become archangel.
2888,2,2,39,43,1.1395348837209303,0.07122869869716944,526,"Yes, it's true what they say about the size of an angel's halo."
2888,1,4,38,43,1.1395348837209303,0.06297704189640278,526,My hands are bigger too.
2888,1,4,38,43,1.1395348837209303,0.06297704189640278,526,I guess this is where we part.
2888,1,4,38,43,1.1395348837209303,0.06297704189640278,526,ETERNALLY large.
2888,1,4,38,43,1.1395348837209303,0.06297704189640278,526,Mine just gets bigger when I polish it . . .
2888,2,2,39,43,1.1395348837209303,0.07122869869716944,526,"Really, size does NOT matter ... I got mine in the 1960""s when EVERYBODY wanted hula halos"
2888,2,2,39,43,1.1395348837209303,0.07122869869716944,526,I've been looking for someone to sin with for a long time.
2888,0,6,37,43,1.1395348837209303,0.05346670079545209,526,Be not afraid. It'll shrink in the wash.
2888,1,4,38,43,1.1395348837209303,0.06297704189640278,526,"Well, you know what they say..."
2888,1,4,38,43,1.1395348837209303,0.06297704189640278,526,I think this is their idea of a joke because down below I sold hula hoops.
2888,1,4,38,43,1.1395348837209303,0.06297704189640278,526,Apparently I have a really big ego
2888,0,6,37,43,1.1395348837209303,0.05346670079545209,526,"Nothing's a secret here, not even arousal."
2888,1,4,38,43,1.1395348837209303,0.06297704189640278,526,I always told you you had an angelic smile!
2888,2,2,39,43,1.1395348837209303,0.07122869869716944,526,"Heylo, Heylo, Heylo."
2888,2,2,39,43,1.1395348837209303,0.07122869869716944,526,Not fair - a celestial glass ceiling.
2888,2,2,39,43,1.1395348837209303,0.07122869869716944,526,"- Don't worry, mine was also that little when I was a woman."
2888,2,2,39,43,1.1395348837209303,0.07122869869716944,526,I upgraded to Even More Headroom.
2888,0,6,37,43,1.1395348837209303,0.05346670079545209,526,I got mine at the Halo Depot
2888,1,4,38,43,1.1395348837209303,0.06297704189640278,526,"When you're the Hula Hoop Champion up here, a trophy just isn't enough."
2888,0,6,37,43,1.1395348837209303,0.05346670079545209,526,"I wouldn't say I was especially blessed , but maybe..."
2888,1,4,38,43,1.1395348837209303,0.06297704189640278,526,"...my eternal mojo, and I thought, ""Screw it! Go for the implant!"""
2888,1,4,38,43,1.1395348837209303,0.06297704189640278,526,"Um, no. Pinocchio lives on a different cloud."
2888,1,4,38,43,1.1395348837209303,0.06297704189640278,526,"Good heavens, what a large nimbus you have!"
2888,1,4,38,43,1.1395348837209303,0.06297704189640278,526,It's hell to be in heaven!
2888,1,4,38,43,1.1395348837209303,0.06297704189640278,526,They didn't update my record after the bariatric surgery.
2888,1,4,38,43,1.1395348837209303,0.06297704189640278,526,Big Hands or Big Halo. You decide...
2888,1,4,38,43,1.1395348837209303,0.06297704189640278,526,Don't worry. I have normal size hands.
2888,1,4,38,43,1.1395348837209303,0.06297704189640278,526,"Turns out, it not the size of your hands after all..."
2888,1,4,38,43,1.1395348837209303,0.06297704189640278,526,Heaven just isn't heaven since they banned steroids.
3004,2,2,40,44,1.1363636363636365,0.06966325746551968,526,I was on Atkins..
3004,2,2,40,44,1.1363636363636365,0.06966325746551968,526,Are you compensating for something?
3004,0,6,38,44,1.1363636363636365,0.05233358898302985,526,And you thought I was just being a wuss.
3004,1,4,39,44,1.1363636363636365,0.06161077006722115,526,I just dropped in to introduce myself.
3004,2,2,40,44,1.1363636363636365,0.06966325746551968,526,"""Yes, size is important!'"
3004,0,6,38,44,1.1363636363636365,0.05233358898302985,526,"You see, the glass ceiling wasn't really a problem. We both made it, didn't we?"
3004,0,6,38,44,1.1363636363636365,0.05233358898302985,526,"Contrary to what you were led to believe on earth, here size does matter."
3004,1,4,39,44,1.1363636363636365,0.06161077006722115,526,it has absolutely nothing to do with the size of the ego
3004,0,6,38,44,1.1363636363636365,0.05233358898302985,526,But I always thought bigger was better!
3004,1,4,39,44,1.1363636363636365,0.06161077006722115,526,Don’t let the size fool you.
3004,1,4,39,44,1.1363636363636365,0.06161077006722115,526,My halo is larger because I remained a virgin longer
3004,0,6,38,44,1.1363636363636365,0.05233358898302985,526,"Honey, you always claimed to be holier than thou. So, I thought I would settle the score."
3004,1,4,39,44,1.1363636363636365,0.06161077006722115,526,"Well, in life I came across as a bit holier-than-thou. I'm not sure if this is vindication or payback."
3004,1,4,39,44,1.1363636363636365,0.06161077006722115,526,You should see my feet.
3004,1,4,39,44,1.1363636363636365,0.06161077006722115,526,"See honey, this is what happens, when you're ""always right""."
3004,2,2,40,44,1.1363636363636365,0.06966325746551968,526,You're right again--I'm the bigger o-hole.
3004,2,2,40,44,1.1363636363636365,0.06966325746551968,526,"I know I'm in Heaven, An Angel with a Small Halo"
3004,0,6,38,44,1.1363636363636365,0.05233358898302985,526,Now I can honestly say that I will love you forever.
3004,1,4,39,44,1.1363636363636365,0.06161077006722115,526,Don't give me that holier-than-thou attitude!
3004,1,4,39,44,1.1363636363636365,0.06161077006722115,526,This is much more accurate than the shoe size analogy.
3004,1,4,39,44,1.1363636363636365,0.06161077006722115,526,I cannot tell a lie. It's my old hula hoop
3004,0,6,38,44,1.1363636363636365,0.05233358898302985,526,I always said that I was holier than you
3004,1,4,39,44,1.1363636363636365,0.06161077006722115,526,"Come on, Mom. I know you think it looks good, but I feel like a dork. All the other kids will make fun of me. Why can't I pick out my own halo?"
3004,1,4,39,44,1.1363636363636365,0.06161077006722115,526,I'm trying to save America.
3004,0,6,38,44,1.1363636363636365,0.05233358898302985,526,"Well my halo is enormously large, so I got that going for me!"
3004,0,6,38,44,1.1363636363636365,0.05233358898302985,526,"As the handsomest and most confident angel you will ever meet, rest assured that my head will grow into it."
3004,2,2,40,44,1.1363636363636365,0.06966325746551968,526,Do you ever wonder what we missed?
3004,0,6,38,44,1.1363636363636365,0.05233358898302985,526,"I am embarrassed to admit, it is a hoolahoop, not a halo."
3004,1,4,39,44,1.1363636363636365,0.06161077006722115,526,"It was always hands down there, but up here it's halos."
3004,1,4,39,44,1.1363636363636365,0.06161077006722115,526,"When he asked for my size, I thought he meant my robe."
3004,0,6,38,44,1.1363636363636365,0.05233358898302985,526,I only said I was a big Halo fan.
3004,0,6,38,44,1.1363636363636365,0.05233358898302985,526,I see now it's possible to be too good.
3004,0,6,38,44,1.1363636363636365,0.05233358898302985,526,I got in off the waiting list. You must have been Early Decision.
3004,0,6,38,44,1.1363636363636365,0.05233358898302985,526,I'm new here. I thought we weren't allowed to take them off.
3004,1,4,39,44,1.1363636363636365,0.06161077006722115,526,I died in a hula hoop mishap.
3004,1,4,39,44,1.1363636363636365,0.06161077006722115,526,I'm related to Donald Trump.
3004,0,6,38,44,1.1363636363636365,0.05233358898302985,526,it's actually the same size as my feet.
3004,1,4,39,44,1.1363636363636365,0.06161077006722115,526,Like our god-given salaries.
3004,1,4,39,44,1.1363636363636365,0.06161077006722115,526,It's not as big as you think.
3004,0,6,38,44,1.1363636363636365,0.05233358898302985,526,God gave it to me for my holier than thou attitude.
3004,0,6,38,44,1.1363636363636365,0.05233358898302985,526,"Yeah, the guy at the front told me they had to give me a temporary model until the new shipment comes in."
3004,0,6,38,44,1.1363636363636365,0.05233358898302985,526,"Well, up here it's big halos that matter."
3004,2,2,40,44,1.1363636363636365,0.06966325746551968,526,Will you marry me again?
3004,1,4,39,44,1.1363636363636365,0.06161077006722115,526,"It's on loan from the big guy Himself. But I assure you when mine arrives, it'll fit exactly the same way."
3004,2,2,40,44,1.1363636363636365,0.06966325746551968,526,...And you know what they say about men with big halos...
3004,0,6,38,44,1.1363636363636365,0.05233358898302985,526,I just wish they'd stop calling me Goody Two Shoes.
3004,1,4,39,44,1.1363636363636365,0.06161077006722115,526,Um...It's not really a halo. Its a reminder of the manhole I fell into that caused me to end up here.
3004,1,4,39,44,1.1363636363636365,0.06161077006722115,526,"Well, Haaa loooo. How did that body get through customs?"
3004,0,6,38,44,1.1363636363636365,0.05233358898302985,526,Don't I know you from somewhere?
3004,2,2,40,44,1.1363636363636365,0.06966325746551968,526,"Yep, up here we're all huge."
3004,2,2,40,44,1.1363636363636365,0.06966325746551968,526,"You know, there is another reason they call me the Big O."
3004,0,6,38,44,1.1363636363636365,0.05233358898302985,526,"As I recall it, we bet double or nothing."
3004,1,4,39,44,1.1363636363636365,0.06161077006722115,526,"You know what they say about an angel with a big halo, don't you?"
3004,1,4,39,44,1.1363636363636365,0.06161077006722115,526,I knew angels were real when I met you.
3004,0,6,38,44,1.1363636363636365,0.05233358898302985,526,"Up here, your halo's only as big as your ego."
3004,1,4,39,44,1.1363636363636365,0.06161077006722115,526,"I don't think I belong here, it's a hula hoop."
3004,1,4,39,44,1.1363636363636365,0.06161077006722115,526,I'm the best narcissist! The absolute best!
3004,1,4,39,44,1.1363636363636365,0.06161077006722115,526,It's my Hester-Prynne punishment for venial vanity.
3004,2,2,40,44,1.1363636363636365,0.06966325746551968,526,Is it too late to say I should have married you?
3004,1,4,39,44,1.1363636363636365,0.06161077006722115,526,It's a hula hoop. He ran out of the regular ones.
3004,0,6,38,44,1.1363636363636365,0.05233358898302985,526,"I've changed my mind, size does matter."
3004,1,4,39,44,1.1363636363636365,0.06161077006722115,526,Yup! You can get yours supersized after an year!
3004,0,6,38,44,1.1363636363636365,0.05233358898302985,526,"Not sure about halos, but I do know fingernails and hair continue to grow up here."
3004,3,0,41,44,1.1363636363636365,0.07687686188404527,526,And that's how I created viagara.
3004,1,4,39,44,1.1363636363636365,0.06161077006722115,526,I told you mine would be bigger than yours.
3004,0,6,38,44,1.1363636363636365,0.05233358898302985,526,"Yes... the myth is true, though I've kept it a secret until now."
3004,0,6,38,44,1.1363636363636365,0.05233358898302985,526,I want to - you want to - but how do we do it with the wings?
3004,2,2,40,44,1.1363636363636365,0.06966325746551968,526,"Well, you know what they say about small hands."
3004,0,6,38,44,1.1363636363636365,0.05233358898302985,526,Honest ... it's nothing like Pinocchio's nose.
3004,2,2,40,44,1.1363636363636365,0.06966325746551968,526,"Size matters, right?"
3004,0,6,38,44,1.1363636363636365,0.05233358898302985,526,And you know what they say about guys with big halos.
3004,0,6,38,44,1.1363636363636365,0.05233358898302985,526,You see? I told you I could mansplain you to death.
3004,1,4,39,44,1.1363636363636365,0.06161077006722115,526,It’s true! He calls me His co-pilot.
3004,1,4,39,44,1.1363636363636365,0.06161077006722115,526,You are not the only one who thought that the cumulus cloud cover would represent a more level playing field.
3004,0,6,38,44,1.1363636363636365,0.05233358898302985,526,I can assure you my intentions are honorable.
3004,0,6,38,44,1.1363636363636365,0.05233358898302985,526,I hope you like a man with a bigger than average halo.
3004,1,4,39,44,1.1363636363636365,0.06161077006722115,526,"It's not that I think I'm more evolved than you, its just you're not as evolved as me."
3004,1,4,39,44,1.1363636363636365,0.06161077006722115,526,It's huge. I'm Trumping.
3004,1,4,39,44,1.1363636363636365,0.06161077006722115,526,I'm thinking pulling the car over first May have been a better idea.
3004,0,6,38,44,1.1363636363636365,0.05233358898302985,526,My mother said it would stay like that if I kept playing with it.
3004,0,6,38,44,1.1363636363636365,0.05233358898302985,526,"I'll have you know, he's the only candidate who can make heaven great again; that's why he's getting my vote."
3004,2,2,40,44,1.1363636363636365,0.06966325746551968,526,Do you have any toilet paper?
3004,1,4,39,44,1.1363636363636365,0.06161077006722115,526,"You, my dear, are as beautiful as this great cloud, designed by me, part of my plan to make heaven great again."
3004,0,6,38,44,1.1363636363636365,0.05233358898302985,526,I know we said 'till death do us part' but I was thinking that we could go a little longer
3004,1,4,39,44,1.1363636363636365,0.06161077006722115,526,I think you've got a bit of a swelled head
3004,0,6,38,44,1.1363636363636365,0.05233358898302985,526,How do you like my new Halo-hoop?
3004,2,2,40,44,1.1363636363636365,0.06966325746551968,526,"Unfortunately, halo size is inversely proportional to that..."
3004,0,6,38,44,1.1363636363636365,0.05233358898302985,526,"But honey, I got it for half-price at the big & tall section in heaven."
3004,1,4,39,44,1.1363636363636365,0.06161077006722115,526,"It happens around demons, too."
3004,1,4,39,44,1.1363636363636365,0.06161077006722115,526,"Yeah, first in my group to get to the last level of Halo."
3004,2,2,40,44,1.1363636363636365,0.06966325746551968,526,If only you had listened
3004,1,4,39,44,1.1363636363636365,0.06161077006722115,526,I'm an angel too! We have so much in common.
3004,1,4,39,44,1.1363636363636365,0.06161077006722115,526,"That's right -- big halo, big feet; everything else in proportion."
3004,1,4,39,44,1.1363636363636365,0.06161077006722115,526,Please don't hate me because I have a bigger halo.
3004,1,4,39,44,1.1363636363636365,0.06161077006722115,526,I bequeathed my estate to the church.
3004,0,6,38,44,1.1363636363636365,0.05233358898302985,526,"What can I say, it's true about sucking up to the boss!"
3004,0,6,38,44,1.1363636363636365,0.05233358898302985,526,You make me feel very good.
3004,2,2,40,44,1.1363636363636365,0.06966325746551968,526,i think we are a match made in heaven
3004,1,4,39,44,1.1363636363636365,0.06161077006722115,526,I have really large hands.
3004,0,6,38,44,1.1363636363636365,0.05233358898302985,526,Let me tell you something - there is no problem with the size of my hands.
3004,0,6,38,44,1.1363636363636365,0.05233358898302985,526,I couldn't fit my whole profile picture on Match.com
3004,2,2,40,44,1.1363636363636365,0.06966325746551968,526,"I wear it as an eternal rebuke to all those who, over the years, used to accuse me of having a ""holier than thou"" attitude."
3004,0,6,38,44,1.1363636363636365,0.05233358898302985,526,Why so large? It doubles as a shower curtain rod.
3004,1,4,39,44,1.1363636363636365,0.06161077006722115,526,"""Ah... I see you've been hanging out with the Kardashians again""."
3004,1,4,39,44,1.1363636363636365,0.06161077006722115,526,I remembered Consumer Reports in my will.
3004,1,4,39,44,1.1363636363636365,0.06161077006722115,526,At last...we can share the same bathroom
3004,0,6,38,44,1.1363636363636365,0.05233358898302985,526,"Sorry to disappoint you, but this is what I got for being the nice guy who finished last."
3004,1,4,39,44,1.1363636363636365,0.06161077006722115,526,I'd like to give you a ring sometime.
3004,1,4,39,44,1.1363636363636365,0.06161077006722115,526,"I asked for regular, but all they had was extra large."" ___________________________________________________________ ""I get a lot of kidding about this."
3004,1,4,39,44,1.1363636363636365,0.06161077006722115,526,Er.. this will change. It's just that you are the first feminist
3004,2,2,40,44,1.1363636363636365,0.06966325746551968,526,A little naughty?
3004,1,4,39,44,1.1363636363636365,0.06161077006722115,526,"The Bigger the Ring, The Better the Sting."
3004,1,4,39,44,1.1363636363636365,0.06161077006722115,526,"Your Halo might be too big for your head, but I really think your cute."
3004,1,4,39,44,1.1363636363636365,0.06161077006722115,526,I got here because I never lied to any woman that I had not met.
3004,1,4,39,44,1.1363636363636365,0.06161077006722115,526,"No, I said to turn left right here."
3004,1,4,39,44,1.1363636363636365,0.06161077006722115,526,They issue shrink-to-fit now
3120,2,2,41,45,1.1333333333333333,0.06816498108607269,526,There's no such thing as halo inequality. I've just been a real good boy.
3120,1,4,40,45,1.1333333333333333,0.06030226891555274,526,How's about I trade you my halo for that dress?
3120,1,4,40,45,1.1333333333333333,0.06030226891555274,526,"Yeah, before I came up, women were only getting $.70 on the dollar."
3120,0,6,39,45,1.1333333333333333,0.05124707431905384,526,"Trust me, I've been there and it's way too warm."
3120,1,4,40,45,1.1333333333333333,0.06030226891555274,526,It doesn't signify anything. Really! Swear to ----Ya know.
3120,2,2,41,45,1.1333333333333333,0.06816498108607269,526,A halo's size says a lot.
3120,1,4,40,45,1.1333333333333333,0.06030226891555274,526,It is how we tell who has been naught and who has been nice.
3120,0,6,39,45,1.1333333333333333,0.05124707431905384,526,"Just a small sign of my rectitude, baby, if you catch my drift!"
3120,0,6,39,45,1.1333333333333333,0.05124707431905384,526,I swear I'm not compensating for anything.
3120,0,6,39,45,1.1333333333333333,0.05124707431905384,526,Now this is how we make pizza in heaven
3120,0,6,39,45,1.1333333333333333,0.05124707431905384,526,How could you tell by just looking at me that I am a serial narcissist?
3120,1,4,40,45,1.1333333333333333,0.06030226891555274,526,"Really, nimbus size means nothing."
3120,1,4,40,45,1.1333333333333333,0.06030226891555274,526,"I have to admit, I hang with the best of them."
3120,1,4,40,45,1.1333333333333333,0.06030226891555274,526,"Well, actually it's not just my halo that's bigger."
3120,2,2,41,45,1.1333333333333333,0.06816498108607269,526,"It's not a halo. By the way, have you seen my fire pole?"
3120,1,4,40,45,1.1333333333333333,0.06030226891555274,526,Happy to see you? How can you tell with this billowy robe?
3120,0,6,39,45,1.1333333333333333,0.05124707431905384,526,Well at least you broke through the cloudy ceiling.
3120,0,6,39,45,1.1333333333333333,0.05124707431905384,526,I was using performance enhancers when I was initially measured.
3120,2,2,41,45,1.1333333333333333,0.06816498108607269,526,In life I was a hula hoop champion...
3120,1,4,40,45,1.1333333333333333,0.06030226891555274,526,I was a very rare perfect human being. This is my reward.
3120,1,4,40,45,1.1333333333333333,0.06030226891555274,526,I lived every one of the Ten Commandments.
3120,1,4,40,45,1.1333333333333333,0.06030226891555274,526,I got promoted
3120,0,6,39,45,1.1333333333333333,0.05124707431905384,526,It keeps off the rain.
3120,1,4,40,45,1.1333333333333333,0.06030226891555274,526,Why is your glory hole bigger than mine?
3120,1,4,40,45,1.1333333333333333,0.06030226891555274,526,I never quite got over my narcissism.
3120,1,4,40,45,1.1333333333333333,0.06030226891555274,526,"Well, in our world size does matter."
3120,1,4,40,45,1.1333333333333333,0.06030226891555274,526,I'm telling you the truth!
3120,1,4,40,45,1.1333333333333333,0.06030226891555274,526,I got it from the Big Guy himself.
3120,1,4,40,45,1.1333333333333333,0.06030226891555274,526,Never. Have. Kids.
3120,1,4,40,45,1.1333333333333333,0.06030226891555274,526,'When I was alive only my penis got bigger'
3120,1,4,40,45,1.1333333333333333,0.06030226891555274,526,"Yes, I was a very good boy in life, which means I have a lot of lost ground to cover. You in?"
3151,0,5,34,39,1.1282051282051282,0.054233552759541476,526,There was a shortage on halos...the hula hoop is temporary
3151,1,3,35,39,1.1282051282051282,0.06550424345215436,526,Are you thinking what I'm thinking?
3151,1,3,35,39,1.1282051282051282,0.06550424345215436,526,".......and my hands are unusually large, too!"
3154,1,3,36,40,1.125,0.06392603899459486,526,"Elite prep school, drugs, Ivy League college, frat parties, drunken hookups, star athlete, rape. Minor time-out. Trust fund, Greenwich estate, Nantucket cottage. I've had a charmed life, wouldn't you say?"
3154,1,3,36,40,1.125,0.06392603899459486,526,She gave me extra points because I always rememberd to put the toilet seat down.
3154,0,5,35,40,1.125,0.05295740910852021,526,Did I mention there's a Hula competition up here?
3154,0,5,35,40,1.125,0.05295740910852021,526,It's not going to work. I'm better than you.
3154,0,5,35,40,1.125,0.05295740910852021,526,Why do you say that I think I'm holier than thou?
3154,1,3,36,40,1.125,0.06392603899459486,526,"It's not the size, it's what you do with it."
3154,0,5,35,40,1.125,0.05295740910852021,526,Wow...this is even better than ChristianSingles.com !
3154,1,3,36,40,1.125,0.06392603899459486,526,You don't see my hands but guys with big halos have big hands and big ...
3154,1,3,36,40,1.125,0.06392603899459486,526,What do you mean there's no such thing as halo envy?
3154,1,3,36,40,1.125,0.06392603899459486,526,So I told God; you either make me an Archangel or I tell Satan about you making sure Hillary won.
3154,1,3,36,40,1.125,0.06392603899459486,526,"Bigger is better for men . . . on Earth, as it is in Heaven!"
3154,0,5,35,40,1.125,0.05295740910852021,526,No... it's not a smoke ring.
3154,0,5,35,40,1.125,0.05295740910852021,526,I think it was a mega-church influence.
3154,1,3,36,40,1.125,0.06392603899459486,526,I'm not sure what it says about us that my hole is bigger than yours.
3154,0,5,35,40,1.125,0.05295740910852021,526,Yes it's true But in heavan every guy has a big one.
3154,2,1,37,40,1.125,0.07327066086497203,526,And here I thought HeavanlyMatch.com was just hyperbole
3154,0,5,35,40,1.125,0.05295740910852021,526,They were out of small.
3154,1,3,36,40,1.125,0.06392603899459486,526,Turns out size does matter.
3154,1,3,36,40,1.125,0.06392603899459486,526,Isn't it wonderful? They knew I was a size queen.
3154,1,3,36,40,1.125,0.06392603899459486,526,"Well, but on the other hand, we have the wings."
3154,1,3,36,40,1.125,0.06392603899459486,526,"You know that size doesn't matter in heaven, right?"
3154,1,3,36,40,1.125,0.06392603899459486,526,How long is eternity ?
3154,0,5,35,40,1.125,0.05295740910852021,526,When it comes to haloes you can't have one that's too big.
3177,2,2,45,49,1.1224489795918366,0.06276408873212902,526,You know what they say: big halo big.....
3178,1,3,37,41,1.1219512195121952,0.06242187264424257,526,"Up here, there is no ""Til death do us part""..."
3178,0,5,36,41,1.1219512195121952,0.051739520574625435,526,Having worked in sewer maintenance for 40 years it's actually quite comforting.
3178,0,5,36,41,1.1219512195121952,0.051739520574625435,526,"Does my ""holier than thou"" attitude make sense to you now?"
3178,0,5,36,41,1.1219512195121952,0.051739520574625435,526,It's true what they say: big halo ...
3178,1,3,37,41,1.1219512195121952,0.06242187264424257,526,Hashtag halo-spreading.
3178,0,5,36,41,1.1219512195121952,0.051739520574625435,526,"You see, I was, uh, a virgin 'til I got married."
3178,0,5,36,41,1.1219512195121952,0.051739520574625435,526,"You know the old saying...""The bigger a guy's halo, the bigger his you-know-what!"""
3178,1,3,37,41,1.1219512195121952,0.06242187264424257,526,I miss my Prius.
3178,0,5,36,41,1.1219512195121952,0.051739520574625435,526,"Size matters everywhere, my dear."
3178,0,5,36,41,1.1219512195121952,0.051739520574625435,526,"The diameter of my halo is in direct proportion to the size of my beach house, which, if you're interested, you can see from right over here."
3178,0,5,36,41,1.1219512195121952,0.051739520574625435,526,"It was a steady diet of cheerios, donuts and bagels that did it. I got more holy by eating more holes."
3178,1,3,37,41,1.1219512195121952,0.06242187264424257,526,Apparently some of us shared more religious quotes and type amen!
3178,0,5,36,41,1.1219512195121952,0.051739520574625435,526,You know what they say about guys with big halos? Big philanthropy.
3178,1,3,37,41,1.1219512195121952,0.06242187264424257,526,But I thought size matters.
3178,0,5,36,41,1.1219512195121952,0.051739520574625435,526,They grow in Purgatory.
3178,2,1,38,41,1.1219512195121952,0.07152623560300088,526,It actually reflects genital size.
3178,1,3,37,41,1.1219512195121952,0.06242187264424257,526,It's not the hands that count.
3178,0,5,36,41,1.1219512195121952,0.051739520574625435,526,"Well, I am no angel"
3178,0,5,36,41,1.1219512195121952,0.051739520574625435,526,I hear our new boss has an equal pay policy.
3178,0,5,36,41,1.1219512195121952,0.051739520574625435,526,"Hi, my name's Richard Knerr and I invented the Hula-Hoop."
3178,1,3,37,41,1.1219512195121952,0.06242187264424257,526,Apparently the glass ceiling is opening up.
3178,0,5,36,41,1.1219512195121952,0.051739520574625435,526,I'm told I was a very shy person.
3178,0,5,36,41,1.1219512195121952,0.051739520574625435,526,"If He knows we're friends, He'll invite you to lunch."
3178,1,3,37,41,1.1219512195121952,0.06242187264424257,526,"Yes, I'd love to eat your angel hair pasta."
3178,0,5,36,41,1.1219512195121952,0.051739520574625435,526,"Well, size doesn't matter here, but I did have small hands in my earthly life."
3178,1,3,37,41,1.1219512195121952,0.06242187264424257,526,"Well, the pills did say, ""Satisfaction Guaranteed in this life and the next!"""
3178,0,5,36,41,1.1219512195121952,0.051739520574625435,526,"It matches the size of my....er, hands."
3178,1,3,37,41,1.1219512195121952,0.06242187264424257,526,"You know what they say, big halo ..."
3178,0,5,36,41,1.1219512195121952,0.051739520574625435,526,My hands are pretty big too.
3178,0,5,36,41,1.1219512195121952,0.051739520574625435,526,I had a hard time figuring out which gender of heaven I relate to.
3178,1,3,37,41,1.1219512195121952,0.06242187264424257,526,Where are the other 71?
3178,1,3,37,41,1.1219512195121952,0.06242187264424257,526,I should've known that being the 'nice' guy wasn't going to get me very far here
3178,1,3,37,41,1.1219512195121952,0.06242187264424257,526,I got here before the market boom.
3178,1,3,37,41,1.1219512195121952,0.06242187264424257,526,I am indeed blessed... big halo... big hands... big... well ... virtue keeps me from sayin'
3178,1,3,37,41,1.1219512195121952,0.06242187264424257,526,It's the basket Steph Curry shoots at.
3178,0,5,36,41,1.1219512195121952,0.051739520574625435,526,"I ""liked"" more Facebook posts than you did."
3178,0,5,36,41,1.1219512195121952,0.051739520574625435,526,They Super-Sized me.
3178,0,5,36,41,1.1219512195121952,0.051739520574625435,526,"I'm here for the New Yorker's ""Really Desperate Anti Trump Cartoon"" campaign."
3178,0,5,36,41,1.1219512195121952,0.051739520574625435,526,I am not being holier than thou.
3178,0,5,36,41,1.1219512195121952,0.051739520574625435,526,You know it's true about big halos ...
3178,0,5,36,41,1.1219512195121952,0.051739520574625435,526,"I know...it doesn't make sense. Even here, not all halos are created equal."
3178,0,5,36,41,1.1219512195121952,0.051739520574625435,526,"Sure my hands are small, but so what?"
3178,1,3,37,41,1.1219512195121952,0.06242187264424257,526,"If I may humbly say, I'm the guy best equipped for lighting up your afterlife."
3178,1,3,37,41,1.1219512195121952,0.06242187264424257,526,So now you tell me that size does matter?
3178,0,5,36,41,1.1219512195121952,0.051739520574625435,526,Really. Size does matter!
3178,0,5,36,41,1.1219512195121952,0.051739520574625435,526,You know what they say about large rings...
3178,1,3,37,41,1.1219512195121952,0.06242187264424257,526,There is no such thing as halo inequality.
3178,1,3,37,41,1.1219512195121952,0.06242187264424257,526,Is it true what they say about Halo size?
3178,0,5,36,41,1.1219512195121952,0.051739520574625435,526,The Blue Fairy's idea of a joke.
3178,1,3,37,41,1.1219512195121952,0.06242187264424257,526,you're compensating aren't you?
3178,1,3,37,41,1.1219512195121952,0.06242187264424257,526,"Not to be halo-ey er than thou, but..."
3178,0,5,36,41,1.1219512195121952,0.051739520574625435,526,I'm not trying to be halo-ier than thou.
3178,1,3,37,41,1.1219512195121952,0.06242187264424257,526,Well I happen to feel that the deluxe package was not a rip-off.
3178,0,5,36,41,1.1219512195121952,0.051739520574625435,526,It goes along with the big hands
3178,1,3,37,41,1.1219512195121952,0.06242187264424257,526,"You know what they say, a big halo means....."
3178,2,1,38,41,1.1219512195121952,0.07152623560300088,526,Hashtag Halobrag.
3234,1,2,30,33,1.121212121212121,0.07226812131946558,526,"Oh, that? I was VERY good at hula-hoop."
3235,0,5,37,42,1.119047619047619,0.05057601944205112,526,When're you off probation?
3235,0,5,37,42,1.119047619047619,0.05057601944205112,526,"Hey, Babe! There's room for two in my heavenly inner circle."
3235,1,3,38,42,1.119047619047619,0.060986670088086975,526,"Of all the gin joints, in heaven she walks into mine…"
3235,2,1,39,42,1.119047619047619,0.06986282354917808,526,"Yeah, it's true-- and I also have really big feet."
3235,1,3,38,42,1.119047619047619,0.060986670088086975,526,I don't mean to brag of course but you know what they say about a man's halo size...
3235,1,3,38,42,1.119047619047619,0.060986670088086975,526,"So you know ""gender has its perks"""
3235,1,3,38,42,1.119047619047619,0.060986670088086975,526,"I guess being a white male up here has its advantages, too"
3235,0,5,37,42,1.119047619047619,0.05057601944205112,526,"Wow, it looked a lot smaller in your profile."
3235,0,5,37,42,1.119047619047619,0.05057601944205112,526,"No, it's not overcompensation!"
3235,1,3,38,42,1.119047619047619,0.060986670088086975,526,Apparently there's a no return policy.
3235,1,3,38,42,1.119047619047619,0.060986670088086975,526,Wanna guess why it looks like a big 'O'?
3235,1,3,38,42,1.119047619047619,0.060986670088086975,526,"Yeah, but my hands are small."
3235,0,5,37,42,1.119047619047619,0.05057601944205112,526,I thought that in Heaven we are all equal. Why is your hallow smaller than mine?
3235,1,3,38,42,1.119047619047619,0.060986670088086975,526,No less is more is a fallacy
3235,1,3,38,42,1.119047619047619,0.060986670088086975,526,"..., and there's nothing wrong with the size of my hands."
3235,1,3,38,42,1.119047619047619,0.060986670088086975,526,Sometimes I feel that I just don't belong here.
3235,1,3,38,42,1.119047619047619,0.060986670088086975,526,I told you so!
3235,0,5,37,42,1.119047619047619,0.05057601944205112,526,"Don't mind me, I'm an astronomer checking out heavenly bodies!"
3235,1,3,38,42,1.119047619047619,0.060986670088086975,526,"Turns out size doesn't matter after all, your conscience does."
3235,2,1,39,42,1.119047619047619,0.06986282354917808,526,"Believe it or not, it's a hula hoop."
3235,1,3,38,42,1.119047619047619,0.060986670088086975,526,"Just friends? You mean even here they prefer ""badboys""?"
3235,0,5,37,42,1.119047619047619,0.05057601944205112,526,I owe it all to my steroids.
3235,1,3,38,42,1.119047619047619,0.060986670088086975,526,I was apparently very good at overcompensating.
3235,0,5,37,42,1.119047619047619,0.05057601944205112,526,Sometimes deed size does matter.
3235,1,3,38,42,1.119047619047619,0.060986670088086975,526,Being endowed with an oversized halo runs in the family.
3235,0,5,37,42,1.119047619047619,0.05057601944205112,526,A large halo is actually a more reliable indicator than large hands. Trust me.
3235,1,3,38,42,1.119047619047619,0.060986670088086975,526,I don't know why but most of the angels I meet up here find me overwhelming.
3235,1,3,38,42,1.119047619047619,0.060986670088086975,526,"Yeah, that comparison holds true up here as well."
3235,0,5,37,42,1.119047619047619,0.05057601944205112,526,Someone slipped a Viagra in my halo.
3235,1,3,38,42,1.119047619047619,0.060986670088086975,526,This is obviously a trap.
3235,2,1,39,42,1.119047619047619,0.06986282354917808,526,I'm a bit of a regular on the 'best saves' list.
3235,0,5,37,42,1.119047619047619,0.05057601944205112,526,"I don't mean to brag, ma'am, but I'm Captain Sully's guardian angel."
3235,1,3,38,42,1.119047619047619,0.060986670088086975,526,I also drive a Porsche
3235,1,3,38,42,1.119047619047619,0.060986670088086975,526,I died in 1958.
3235,0,5,37,42,1.119047619047619,0.05057601944205112,526,It's even signed by Beyoncé.
3235,0,5,37,42,1.119047619047619,0.05057601944205112,526,"This is 6s but I hear, next one's gonna be smaller again."
3235,1,3,38,42,1.119047619047619,0.060986670088086975,526,and god said your hella fine
3235,1,3,38,42,1.119047619047619,0.060986670088086975,526,"Well Celeste, it's not that I'm holier than thou but I can't."
3235,0,5,37,42,1.119047619047619,0.05057601944205112,526,Hula hoop accident.
3235,1,3,38,42,1.119047619047619,0.060986670088086975,526,"Big is better, baby--big is better."
3235,0,5,37,42,1.119047619047619,0.05057601944205112,526,Yes! I sold hula-hoops. How did you know?
3235,1,3,38,42,1.119047619047619,0.060986670088086975,526,"Size doesn't matter up here, if you get my drift."
3235,1,3,38,42,1.119047619047619,0.060986670088086975,526,"Yea, I stole somebody's halo then I hooped it, I hooped it."
3235,0,5,37,42,1.119047619047619,0.05057601944205112,526,"I went on a great diet when l first got here,as you can see."
3235,1,3,38,42,1.119047619047619,0.060986670088086975,526,Aw thanks...but I've heard size doesn't really matter.
3235,0,5,37,42,1.119047619047619,0.05057601944205112,526,Hula...I thought He said to wear my hula.
3235,1,3,38,42,1.119047619047619,0.060986670088086975,526,"Baby, you're no angel and neither am I"
3235,1,3,38,42,1.119047619047619,0.060986670088086975,526,You'll never guess who I got to pay for it.
3235,0,5,37,42,1.119047619047619,0.05057601944205112,526,"It's an aggressive form of ""halo effect""."
3235,0,5,37,42,1.119047619047619,0.05057601944205112,526,I felt the wind beneath my wings.
3235,1,3,38,42,1.119047619047619,0.060986670088086975,526,"It started as a hobby, then fact checking Donald Trump kinda grew on me."
3235,0,5,37,42,1.119047619047619,0.05057601944205112,526,you are off key... you can NOT sing
3235,0,5,37,42,1.119047619047619,0.05057601944205112,526,I always thought that Heaven was the absence of clothing.
3235,1,3,38,42,1.119047619047619,0.060986670088086975,526,Welcome to heaven
3235,2,1,39,42,1.119047619047619,0.06986282354917808,526,"Size matters, especially in halos."
3235,1,3,38,42,1.119047619047619,0.060986670088086975,526,I have a big halo. Women love me.
3235,0,5,37,42,1.119047619047619,0.05057601944205112,526,"Well, the perks aren't what they were since we merged with Amazon."
3235,1,3,38,42,1.119047619047619,0.060986670088086975,526,I have big feet.
3235,1,3,38,42,1.119047619047619,0.060986670088086975,526,I fought for a lot of causes on Facebook.
3235,1,3,38,42,1.119047619047619,0.060986670088086975,526,It's an upgrade. You can read by it. Comes with a power switch.
3235,0,5,37,42,1.119047619047619,0.05057601944205112,526,You should try smoking a cigar
3235,0,5,37,42,1.119047619047619,0.05057601944205112,526,Trojan extra large
3235,1,3,38,42,1.119047619047619,0.060986670088086975,526,My halo is not the only thing that's large.
3235,2,1,39,42,1.119047619047619,0.06986282354917808,526,Oh yeah? Well I can put my head through mine!
3235,1,3,38,42,1.119047619047619,0.060986670088086975,526,Why? What does the size of my hands have to do with anything?
3235,0,5,37,42,1.119047619047619,0.05057601944205112,526,"Apparently, it's genetic."
3235,2,1,39,42,1.119047619047619,0.06986282354917808,526,"'It's not that big, Scott.'"
3235,1,3,38,42,1.119047619047619,0.060986670088086975,526,"Don't be alarmed. Up here, I'm told that size down't matter."
3235,1,3,38,42,1.119047619047619,0.060986670088086975,526,Only when I'm hung over.
3235,0,5,37,42,1.119047619047619,0.05057601944205112,526,"As I was saying, the Gender Halo Gap is a myth!"
3235,1,3,38,42,1.119047619047619,0.060986670088086975,526,``Far be it from me to suggest size matters.''
3235,1,3,38,42,1.119047619047619,0.060986670088086975,526,"It's not as big as Jesus', but it's not bad."
3235,1,3,38,42,1.119047619047619,0.060986670088086975,526,"no, this is not a Hula-Hoop contest, it's heaven."
3235,1,3,38,42,1.119047619047619,0.060986670088086975,526,"And God laid his hand on me, and you know, he has REALLY big hands!"
3235,1,3,38,42,1.119047619047619,0.060986670088086975,526,Making partner was a death benefit.
3235,0,5,37,42,1.119047619047619,0.05057601944205112,526,And you can learn lots more from the size of the halo!
3235,1,3,38,42,1.119047619047619,0.060986670088086975,526,"Hey there Angel Cakes, you know what they say about a big halo."
3235,1,3,38,42,1.119047619047619,0.060986670088086975,526,"Yes, but where do the wings and halos go when we . . .?"
3235,0,5,37,42,1.119047619047619,0.05057601944205112,526,"Sorry, I don't date angels with big halos."
3235,1,3,38,42,1.119047619047619,0.060986670088086975,526,And for my next hula-hoop trick...
3235,0,5,37,42,1.119047619047619,0.05057601944205112,526,"Well, what did you expect?"
3235,1,3,38,42,1.119047619047619,0.060986670088086975,526,They say the size of a man's halo...
3235,2,1,39,42,1.119047619047619,0.06986282354917808,526,Mama insisted that they give me the biggest halo.
3235,1,3,38,42,1.119047619047619,0.060986670088086975,526,"I'm don't want to blow my own trumpet but my halo is huge, really huge."
3235,1,3,38,42,1.119047619047619,0.060986670088086975,526,"Yeah, well you know how it is. Some girls just go a little overboard with the ratings."
3235,2,1,39,42,1.119047619047619,0.06986282354917808,526,I can guarantee you I have big hands too.
3235,0,5,37,42,1.119047619047619,0.05057601944205112,526,Let's party.
3235,1,3,38,42,1.119047619047619,0.060986670088086975,526,'' HALO BABY ''
3235,0,5,37,42,1.119047619047619,0.05057601944205112,526,I guess I was right about Trump and the nuclear button.
3235,0,5,37,42,1.119047619047619,0.05057601944205112,526,I'm not compensating for anything.
3235,0,5,37,42,1.119047619047619,0.05057601944205112,526,Beyoncé wrote that song about me.
3235,1,3,38,42,1.119047619047619,0.060986670088086975,526,I guess they went by the size of my hands.
3235,1,3,38,42,1.119047619047619,0.060986670088086975,526,Yes...You're right. It is a pretty good indicator of the size of my effulgence.
3235,0,5,37,42,1.119047619047619,0.05057601944205112,526,"So how did that ""Saving yourself for pure spiritual love"" work out?"
3235,0,5,37,42,1.119047619047619,0.05057601944205112,526,A few more promotions should get you one like mine.
3235,0,5,37,42,1.119047619047619,0.05057601944205112,526,"No, I do not have small hands!"
3235,1,3,38,42,1.119047619047619,0.060986670088086975,526,Are you trying to compensate for something
3235,1,3,38,42,1.119047619047619,0.060986670088086975,526,"I beg to differ, angel, size does matter."
3235,0,5,37,42,1.119047619047619,0.05057601944205112,526,"You know, it's true what they say about big haloes."
3235,1,3,38,42,1.119047619047619,0.060986670088086975,526,"Back in the day, I was the hula hoop champ in my neighborhood, so I guess it makes sense to kick it up a notch here."
3235,1,3,38,42,1.119047619047619,0.060986670088086975,526,"I know, I know, size doesn't matter."
3235,1,3,38,42,1.119047619047619,0.060986670088086975,526,"So, do you use Tinder often?"
3235,0,5,37,42,1.119047619047619,0.05057601944205112,526,"As I said, I guarantee there's no problem."
3235,0,5,37,42,1.119047619047619,0.05057601944205112,526,Turns out we not only earn more money for the same amount of work that you women do.
3235,0,5,37,42,1.119047619047619,0.05057601944205112,526,"I don't mean to brag, but size does matter up here."
3235,0,5,37,42,1.119047619047619,0.05057601944205112,526,"Especially in heaven, size matters."
3235,0,5,37,42,1.119047619047619,0.05057601944205112,526,"Well, I think size DOES matter."
3235,0,5,37,42,1.119047619047619,0.05057601944205112,526,I used Ivory soap. It's 99 and 44/100 percent pure.
3235,1,3,38,42,1.119047619047619,0.060986670088086975,526,I was a big Oprah fan.
3235,1,3,38,42,1.119047619047619,0.060986670088086975,526,"Yes, everything they say about a man with a big halo is true."
3235,1,3,38,42,1.119047619047619,0.060986670088086975,526,"But now I wouldn't know ""fun"" if it hit me in the face..."
3235,0,5,37,42,1.119047619047619,0.05057601944205112,526,It's really not that much of an accolade.
3235,0,5,37,42,1.119047619047619,0.05057601944205112,526,We refer to it as the 'glass halo' effect.....
3235,2,1,39,42,1.119047619047619,0.06986282354917808,526,"I was a motivation speaker on earth, why do you ask ?"
3235,1,3,38,42,1.119047619047619,0.060986670088086975,526,Of course size matters!
3235,2,1,39,42,1.119047619047619,0.06986282354917808,526,My hands are not small either
3235,0,5,37,42,1.119047619047619,0.05057601944205112,526,This happens whenever I stretch the truth.
3235,1,3,38,42,1.119047619047619,0.060986670088086975,526,Want to find out what else is the same as its radius?
3235,1,3,38,42,1.119047619047619,0.060986670088086975,526,Did it hurt when you fell from heaven?
3235,0,5,37,42,1.119047619047619,0.05057601944205112,526,What makes you think I did something heroic?
3235,1,3,38,42,1.119047619047619,0.060986670088086975,526,"Not Hoopla, Hula Hoop!"
3235,1,3,38,42,1.119047619047619,0.060986670088086975,526,"They say size doesn't matter, but..."
3235,1,3,38,42,1.119047619047619,0.060986670088086975,526,I swear to God it only gets smaller if I lie
3235,0,5,37,42,1.119047619047619,0.05057601944205112,526,"Even for angels, size doesn't matter my friend"
3235,0,5,37,42,1.119047619047619,0.05057601944205112,526,and you know what they say...
3235,1,3,38,42,1.119047619047619,0.060986670088086975,526,"Halo Mackerel, your making me blush!"
3235,0,5,37,42,1.119047619047619,0.05057601944205112,526,"Even when I was on Earth, it was all about size."
3235,0,5,37,42,1.119047619047619,0.05057601944205112,526,You know what they say about guys with big halo's.......
3235,1,3,38,42,1.119047619047619,0.060986670088086975,526,"I tried to trade it in for a smaller one, but they said I'd have to -- uh -- 'see' you first."
3235,0,5,37,42,1.119047619047619,0.05057601944205112,526,You know what that means.
3235,1,3,38,42,1.119047619047619,0.060986670088086975,526,'Tis not the size of the halo in the fight
3235,0,5,37,42,1.119047619047619,0.05057601944205112,526,"Well, yes, it's true what they say about men with big halos."
3235,1,3,38,42,1.119047619047619,0.060986670088086975,526,What are you doing for the next six hours?
3235,0,5,37,42,1.119047619047619,0.05057601944205112,526,"Actually, it signifies the same thing that big hands do."
3235,1,3,38,42,1.119047619047619,0.060986670088086975,526,"""It's bigger cause I only committed near occasions of sin""."
3235,0,5,37,42,1.119047619047619,0.05057601944205112,526,And you know what they say about the size of the halo.
3235,1,3,38,42,1.119047619047619,0.060986670088086975,526,I had small man syndrome when I was alive.
3235,2,1,39,42,1.119047619047619,0.06986282354917808,526,"""As tight as Dick's hatband"" didn't have the same ring after Dick died."
3235,1,3,38,42,1.119047619047619,0.060986670088086975,526,I grew one shop into a national chain of pizzerias . . .
3235,2,1,39,42,1.119047619047619,0.06986282354917808,526,"Don't let the giant halo fool you, I'm a real jackass."
3235,0,5,37,42,1.119047619047619,0.05057601944205112,526,"""It's a great chick magnet""!"
3235,2,1,39,42,1.119047619047619,0.06986282354917808,526,"Apparently, I'm not ""Still Alive"""
3235,0,5,37,42,1.119047619047619,0.05057601944205112,526,I guess you could say 'I'm gifted' in the halo department.
3235,1,3,38,42,1.119047619047619,0.060986670088086975,526,You know what they say about men with large halos.
3235,1,3,38,42,1.119047619047619,0.060986670088086975,526,"To fit through that small hole.......you must be a size four, right?"
3235,2,1,39,42,1.119047619047619,0.06986282354917808,526,"hahahahaha even in death, mine is still bigger than yours."
3381,1,2,31,34,1.1176470588235294,0.07020095781645355,526,Don't worry. I'll explain.
3381,2,2,47,51,1.1176470588235294,0.06037178164055159,526,It's a gilded hula-hoop. Don't tell the boss.
3383,1,3,39,43,1.1162790697674418,0.059615808787130756,526,What? They wouldn't let me bring my big truck.
3383,0,5,38,43,1.1162790697674418,0.04946336973228635,526,"If you accept , I promise to exchange the rings!"
3383,0,5,38,43,1.1162790697674418,0.04946336973228635,526,What have I done?
3383,0,5,38,43,1.1162790697674418,0.04946336973228635,526,"Let's just say that if I decide to run for archangel, there will be no problem in that area."
3383,2,1,40,43,1.1162790697674418,0.06827491757164275,526,Your Place or Mine
3383,1,3,39,43,1.1162790697674418,0.059615808787130756,526,I won the Hula Hoop competition three years in a row.
3383,1,3,39,43,1.1162790697674418,0.059615808787130756,526,I have really big hands as well.
3383,0,5,38,43,1.1162790697674418,0.04946336973228635,526,"You know what having a big halo means, don't you?"
3383,0,5,38,43,1.1162790697674418,0.04946336973228635,526,"Welcome, sister, to LGBTQ Heaven. How's about I trade you my king size halo for that slinky little gown?"
3383,1,3,39,43,1.1162790697674418,0.059615808787130756,526,We all know what he is compensating for.
3383,1,3,39,43,1.1162790697674418,0.059615808787130756,526,Back on earth my shoe size was 13.
3383,1,3,39,43,1.1162790697674418,0.059615808787130756,526,I guess it's because you weren't a hula hoop champ in your formative years.
3383,2,1,40,43,1.1162790697674418,0.06827491757164275,526,Even in heaven women aren't equal.
3383,0,5,38,43,1.1162790697674418,0.04946336973228635,526,"Yes, it hard to fold up. Why do you ask?"
3383,0,5,38,43,1.1162790697674418,0.04946336973228635,526,My claim to fame was being inducted into The Hula-Hoop Hall of Fame.
3383,1,3,39,43,1.1162790697674418,0.059615808787130756,526,"Why is your halo so big?"" ""You gotta do helpful things, like telling people that 15 minutes could save them 15% on car insurance."
3383,1,3,39,43,1.1162790697674418,0.059615808787130756,526,I guess in heaven size really does matter!
3383,1,3,39,43,1.1162790697674418,0.059615808787130756,526,"True, I had a humongous ego, but I was good people."
3383,0,5,38,43,1.1162790697674418,0.04946336973228635,526,This brand runs big.
3383,0,5,38,43,1.1162790697674418,0.04946336973228635,526,"What I am saying is, having met you, I am definitely ready to live a little"
3383,1,3,39,43,1.1162790697674418,0.059615808787130756,526,Mine's actually a lenticular cloud.
3383,1,3,39,43,1.1162790697674418,0.059615808787130756,526,"It allows me to say, ""You're hot."""
3383,1,3,39,43,1.1162790697674418,0.059615808787130756,526,Usually I'm not big on circular logic...
3383,1,3,39,43,1.1162790697674418,0.059615808787130756,526,Every time a bell rings my halo gets a little bigger
3383,0,5,38,43,1.1162790697674418,0.04946336973228635,526,I hope the size of halos determines intelligence.
3383,1,3,39,43,1.1162790697674418,0.059615808787130756,526,Is that why you're hiding your small hands?
3383,1,3,39,43,1.1162790697674418,0.059615808787130756,526,I was doing the hula hoop when struck by lightening.
3383,0,5,38,43,1.1162790697674418,0.04946336973228635,526,The diet plan didn't explain that the halo wouldn't shrink with me.
3383,1,3,39,43,1.1162790697674418,0.059615808787130756,526,The decline of the halo is something I need to get used to.
3383,1,3,39,43,1.1162790697674418,0.059615808787130756,526,"Actually, it's just a projection of the manhole I fell through."
3383,0,5,38,43,1.1162790697674418,0.04946336973228635,526,"All of us angel investors got a golden halo, and as you can see, the growth rate was terrific."
3383,1,3,39,43,1.1162790697674418,0.059615808787130756,526,"Apparently, even being a good Sudoku player was enough for me to wind up here."
3383,1,3,39,43,1.1162790697674418,0.059615808787130756,526,"My hands may be small, but I guarantee you there's no problem."
3383,0,5,38,43,1.1162790697674418,0.04946336973228635,526,"I know that my hands are small but I have a big, very big, everyone agrees that it's big, oh so big, halo."
3383,1,3,39,43,1.1162790697674418,0.059615808787130756,526,"Yes, I was the valedictorian at my seminary university. Why do you ask?"
3383,0,5,38,43,1.1162790697674418,0.04946336973228635,526,When did St. Peter decide to make the change?
3383,1,3,39,43,1.1162790697674418,0.059615808787130756,526,What do you mean you'll not marry me? I lost 3000 kilos for you!
3383,1,3,39,43,1.1162790697674418,0.059615808787130756,526,"Yes, it's huge."
3383,1,3,39,43,1.1162790697674418,0.059615808787130756,526,The standard sizes didn't fit.
3383,0,5,38,43,1.1162790697674418,0.04946336973228635,526,Good things come in small packages. Better things come in bigger packages.
3383,2,1,40,43,1.1162790697674418,0.06827491757164275,526,It's not a myth. That's why this is called Heaven.
3383,1,3,39,43,1.1162790697674418,0.059615808787130756,526,"I have small hands, but a big halo"
3383,1,3,39,43,1.1162790697674418,0.059615808787130756,526,You're still a holier-than-thou showoff.
3383,1,3,39,43,1.1162790697674418,0.059615808787130756,526,"Halo?...You mean, more like Hey whoa!"
3383,0,5,38,43,1.1162790697674418,0.04946336973228635,526,It's not a hoola hoop.
3383,1,3,39,43,1.1162790697674418,0.059615808787130756,526,"That's nothing, you should see the size of my pineal gland."
3383,1,3,39,43,1.1162790697674418,0.059615808787130756,526,Did you bring the rings?
3383,0,5,38,43,1.1162790697674418,0.04946336973228635,526,""".just love the size of your.........halo""."
3383,2,1,40,43,1.1162790697674418,0.06827491757164275,526,"I received an extra perk, I was Trump's press secretary."
3383,2,1,40,43,1.1162790697674418,0.06827491757164275,526,I thought I would never see you again!!!!
3383,1,3,39,43,1.1162790697674418,0.059615808787130756,526,"Yeh, it's True...bigger Halo bigger Harp."
3383,0,5,38,43,1.1162790697674418,0.04946336973228635,526,Well - if you were really good you'd be someplace else.
3383,1,3,39,43,1.1162790697674418,0.059615808787130756,526,Forget it. Size doesn't matter up here.
3383,0,5,38,43,1.1162790697674418,0.04946336973228635,526,"Well that may be, but up here size does matter"
3383,0,5,38,43,1.1162790697674418,0.04946336973228635,526,"'Unfortunately, the size of something else had to be compensated.'"
3383,2,1,40,43,1.1162790697674418,0.06827491757164275,526,Devil's advocate...
3383,1,3,39,43,1.1162790697674418,0.059615808787130756,526,It looks like you have been up to no good.
3383,1,3,39,43,1.1162790697674418,0.059615808787130756,526,I thought it was till death do us part...?
3383,1,3,39,43,1.1162790697674418,0.059615808787130756,526,You know what they say about the size of the halo.
3383,1,3,39,43,1.1162790697674418,0.059615808787130756,526,It's actually a hula hoop. Don't tell The Big Guy I lost mine.
3383,0,5,38,43,1.1162790697674418,0.04946336973228635,526,Sigh. Even here you are overcompensating.
3383,1,3,39,43,1.1162790697674418,0.059615808787130756,526,Things changed when Freud was promoted to president of everything
3383,1,3,39,43,1.1162790697674418,0.059615808787130756,526,Mmmmm....swipe left.
3383,1,3,39,43,1.1162790697674418,0.059615808787130756,526,I don't think size really matters here.
3383,0,5,38,43,1.1162790697674418,0.04946336973228635,526,This proves that Mars is bigger than Venus.
3383,0,5,38,43,1.1162790697674418,0.04946336973228635,526,Sorry honey. I stayed around for the timeshare pitch and they upgraded me.
3383,1,3,39,43,1.1162790697674418,0.059615808787130756,526,They call me mellow halo -- quite rightly
3383,1,3,39,43,1.1162790697674418,0.059615808787130756,526,I call it the Halo Hoop. I use it a lot while they're sleeping.
3383,0,5,38,43,1.1162790697674418,0.04946336973228635,526,I'm interested.in dating but I think your halo is too big for me.
3383,1,3,39,43,1.1162790697674418,0.059615808787130756,526,"Private wake, you know how it is."
3383,0,5,38,43,1.1162790697674418,0.04946336973228635,526,"We are paid the same, this is my own hula hoop."
3383,1,3,39,43,1.1162790697674418,0.059615808787130756,526,"It was a ""one size fits all"" day promotion for those who otherwise wouldn't get in."
3383,1,3,39,43,1.1162790697674418,0.059615808787130756,526,"Up here, we call them rings, not halos or hoops."
3383,0,5,38,43,1.1162790697674418,0.04946336973228635,526,The big halo is for loving the major party presidential candidates as myself.
3383,1,3,39,43,1.1162790697674418,0.059615808787130756,526,"So, size does matter up here too?"
3383,1,3,39,43,1.1162790697674418,0.059615808787130756,526,"I'm sorry. I was on my way to a rehearsal of ""Angels in America,"" and fell through a pothole."
3383,1,3,39,43,1.1162790697674418,0.059615808787130756,526,Little wings don't mean anything.
3383,1,3,39,43,1.1162790697674418,0.059615808787130756,526,"Sorry hun, you're just not good enough."
3383,1,3,39,43,1.1162790697674418,0.059615808787130756,526,"Sometimes a big halo means, well, something else!"
3383,0,5,38,43,1.1162790697674418,0.04946336973228635,526,I used to sell Hula Hoops.
3383,0,5,38,43,1.1162790697674418,0.04946336973228635,526,....and I wear size 16 sandals
3383,1,3,39,43,1.1162790697674418,0.059615808787130756,526,Size REALLY doesn't matter up here....
3383,1,3,39,43,1.1162790697674418,0.059615808787130756,526,I kept misplacing my regular halo so I have to wear this for a while.
3383,0,5,38,43,1.1162790697674418,0.04946336973228635,526,"Yes, you always were good at circular reasoning!"
3383,1,3,39,43,1.1162790697674418,0.059615808787130756,526,Maybe because you kept claiming that size didn't matter
3383,0,5,38,43,1.1162790697674418,0.04946336973228635,526,And sometimes a hula hoop is a hula hoop?
3383,1,3,39,43,1.1162790697674418,0.059615808787130756,526,There's something I saw 2 eagles do that I'd like to show you.
3383,1,3,39,43,1.1162790697674418,0.059615808787130756,526,The priest lied; it is not 'til death do us part'.
3383,0,5,38,43,1.1162790697674418,0.04946336973228635,526,God must have known that I was once the Hula Hoop champ of Venice Beach!
3383,0,5,38,43,1.1162790697674418,0.04946336973228635,526,"Oh, I see your a naughty girl."
3383,0,5,38,43,1.1162790697674418,0.04946336973228635,526,I'm a ten. I'd say you're about a two.
3383,1,3,39,43,1.1162790697674418,0.059615808787130756,526,"Ironically, my halo has only grown since I stopped implying a correlation to other features"
3383,0,5,38,43,1.1162790697674418,0.04946336973228635,526,"Sorry, but I got this as a reward for my vow of eternal chastity."
3383,1,3,39,43,1.1162790697674418,0.059615808787130756,526,Now you know why I prefer not to mention the size of it on my profile.
3383,0,5,38,43,1.1162790697674418,0.04946336973228635,526,Because I'm hole-ier!
3383,2,1,40,43,1.1162790697674418,0.06827491757164275,526,I cant wait to see his hands!
3383,0,5,38,43,1.1162790697674418,0.04946336973228635,526,I finally found a good use for my old hula hoop.
3383,0,5,38,43,1.1162790697674418,0.04946336973228635,526,"I did well for myself, and let's just say I left an orphanage well endowed."
3383,0,5,38,43,1.1162790697674418,0.04946336973228635,526,Not that you need the halo effect...
3383,0,5,38,43,1.1162790697674418,0.04946336973228635,526,I shop XXL.
3383,1,3,39,43,1.1162790697674418,0.059615808787130756,526,"It was that weekend in Las Vegas, wasn't it."
3383,2,1,40,43,1.1162790697674418,0.06827491757164275,526,Cut it out. Size doesn't matter here.
3383,1,3,39,43,1.1162790697674418,0.059615808787130756,526,You were right honey ... It was cyanide
3383,0,5,38,43,1.1162790697674418,0.04946336973228635,526,I can change. I'm working with a therapist on my hyper morality.
3383,0,5,38,43,1.1162790697674418,0.04946336973228635,526,I don't believe what you said last time. Size does matter !
3383,1,3,39,43,1.1162790697674418,0.059615808787130756,526,In haloes this is as big as one can get. And you know what they say about halo sizes.....
3383,0,5,38,43,1.1162790697674418,0.04946336973228635,526,They tell me I'm extra special.
3383,0,5,38,43,1.1162790697674418,0.04946336973228635,526,Wanna halo-hoop?
3383,0,5,38,43,1.1162790697674418,0.04946336973228635,526,"Yeah, I know, I'm still compensating; even here."
3383,0,5,38,43,1.1162790697674418,0.04946336973228635,526,Well mines's bigger than your's here too!
3383,0,5,38,43,1.1162790697674418,0.04946336973228635,526,I guess I hafta tell you. Have you ever heard of Pinocchio's nose?
3383,0,5,38,43,1.1162790697674418,0.04946336973228635,526,They always said I was holier than thou!
3383,0,5,38,43,1.1162790697674418,0.04946336973228635,526,"Oh of course, you think I need a slimmer fit... any more judgments today?"
3383,1,3,39,43,1.1162790697674418,0.059615808787130756,526,I'm not compensating. I putting things in proportion.
3383,0,5,38,43,1.1162790697674418,0.04946336973228635,526,Halo....size matters up here
3383,2,1,40,43,1.1162790697674418,0.06827491757164275,526,They'll enlarge anything you want up here. Anything.
3383,1,3,39,43,1.1162790697674418,0.059615808787130756,526,I learned to hand-toss dough working at my Uncle Luigi's pizzeria.
3383,1,3,39,43,1.1162790697674418,0.059615808787130756,526,Is that a hula hoop?
3383,1,3,39,43,1.1162790697674418,0.059615808787130756,526,Don't let it go to your head. We needed some eye candy.
3383,1,3,39,43,1.1162790697674418,0.059615808787130756,526,"So, yeah, I don't believe in the so-called Mid Afterlife Crisis... How about you?"
3383,0,5,38,43,1.1162790697674418,0.04946336973228635,526,"I like the new rating system, but it does decrease the number of angels that can dance on the point of a pin."
3383,1,3,39,43,1.1162790697674418,0.059615808787130756,526,Yep. He's compensating for something...
3383,1,3,39,43,1.1162790697674418,0.059615808787130756,526,I guess size matters up here too.
3383,1,3,39,43,1.1162790697674418,0.059615808787130756,526,"The myth is actually true, and, ""lasting longer than four hours' up here is an eternal non-problem."
3383,2,1,40,43,1.1162790697674418,0.06827491757164275,526,I was indeed the Lord's vessel many times.
3383,1,3,39,43,1.1162790697674418,0.059615808787130756,526,"No, I hadn't heard that God lost his halo."
3383,0,5,38,43,1.1162790697674418,0.04946336973228635,526,"Look, I'm not trying to be holier than thou..."
3383,2,1,40,43,1.1162790697674418,0.06827491757164275,526,I died at a Trump resort.
3383,1,3,39,43,1.1162790697674418,0.059615808787130756,526,So they took it metaphorically when fitting the halo to the size of your head?
3383,0,5,38,43,1.1162790697674418,0.04946336973228635,526,"Yes ma'am, here size matters."
3383,0,5,38,43,1.1162790697674418,0.04946336973228635,526,Do you know what they say about angels and the size of their halo? Well it's true.
3383,1,3,39,43,1.1162790697674418,0.059615808787130756,526,I wonder if he will notice one of Saturns rings is missing .
3383,0,5,38,43,1.1162790697674418,0.04946336973228635,526,"Around here, size doesn't matter."
3383,1,3,39,43,1.1162790697674418,0.059615808787130756,526,I got bored and they gave me a hula hoop.
3383,1,3,39,43,1.1162790697674418,0.059615808787130756,526,See honey I told you they were not the kind of mushrooms you eat
3383,1,3,39,43,1.1162790697674418,0.059615808787130756,526,It's God's compensation for being born with a small penis.
3383,0,5,38,43,1.1162790697674418,0.04946336973228635,526,You need better proof?
3383,0,5,38,43,1.1162790697674418,0.04946336973228635,526,Heavenly Cubans...make perfect smoke rings.
3383,1,3,39,43,1.1162790697674418,0.059615808787130756,526,"Well, you know what they say around here, 'Big hands, big halo.'"
3383,0,5,38,43,1.1162790697674418,0.04946336973228635,526,"They admitted me to heaven, in spite of my slight inferiority complex."
3383,0,5,38,43,1.1162790697674418,0.04946336973228635,526,Don't hate me because I am different.
3383,1,3,39,43,1.1162790697674418,0.059615808787130756,526,I have a little down time while I'm uploading.
3525,1,3,40,44,1.1136363636363635,0.05830506897872825,526,"You're the most beautiful thing! Hi, my name is Pinocchio."
3525,0,5,39,44,1.1136363636363635,0.048398332783092544,526,I think you'd make a beautiful Victoria's Secret Angel even if you are actually dead.
3525,1,3,40,44,1.1136363636363635,0.05830506897872825,526,Even up here they have swelled heads.
3525,0,5,39,44,1.1136363636363635,0.048398332783092544,526,"Stop worrying about my fidelity, God will not let me remove this wedding ring for eternity."
3525,1,3,40,44,1.1136363636363635,0.05830506897872825,526,"He said ""A ring or a prayer"""
3525,1,3,40,44,1.1136363636363635,0.05830506897872825,526,I prayed to the Porcelain God.
3525,1,3,40,44,1.1136363636363635,0.05830506897872825,526,What made you think Heaven wasn't a patriarchy?
3525,0,5,39,44,1.1136363636363635,0.048398332783092544,526,It's not about how you use it.
3525,1,3,40,44,1.1136363636363635,0.05830506897872825,526,Apparently a heaven free of mansplaining was too much to hope for.
3525,0,5,39,44,1.1136363636363635,0.048398332783092544,526,Damn right my halo's bigger; there's no Title IX up here.
3525,1,3,40,44,1.1136363636363635,0.05830506897872825,526,I'd still rather be back on earth.
3525,0,5,39,44,1.1136363636363635,0.048398332783092544,526,Pinocchio and I react slightly differently...
3525,2,1,41,44,1.1136363636363635,0.06675749786387705,526,It seems your question is finally answered George. Size matters.
3525,1,3,40,44,1.1136363636363635,0.05830506897872825,526,"Well, if you worked as hard as I did, I'm sure your halo would be just as big."
3539,1,3,41,45,1.1111111111111112,0.057050590894718936,526,"I know what they say about angels who display big halos, but I guarantee there is no problem, I guarantee it."
3539,1,3,41,45,1.1111111111111112,0.057050590894718936,526,"I know what you're thinking. Not bad for a guy with such tiny hands, huh?"
3541,1,2,34,37,1.1081081081081081,0.06465180222706,526,I never saw the 'glass ceiling' down there and I certainly don't expect to find it up here!
3541,1,2,34,37,1.1081081081081081,0.06465180222706,526,It's the holier-than-thou halo.
3543,0,4,34,38,1.105263157894737,0.050452767712569575,526,You were a vice president of sales too?
3544,1,2,36,39,1.1025641025641026,0.06141463024552095,526,"So, do you still say that size doesn't matter?"
3544,0,4,35,39,1.1025641025641026,0.04921614717627658,526,"I know same angel rank, different halo size, but trust me progress has been made in the last few millennia."
3544,0,4,35,39,1.1025641025641026,0.04921614717627658,526,Trust me - size matters....
3544,1,2,36,39,1.1025641025641026,0.06141463024552095,526,I think I may be compensating for my small hands.
3544,0,4,35,39,1.1025641025641026,0.04921614717627658,526,You know what they say about big feet? Big Halo
3544,1,2,36,39,1.1025641025641026,0.06141463024552095,526,"Don't take it so hard, Gloria.You will remember that I voted against the ERA."
3544,1,2,36,39,1.1025641025641026,0.06141463024552095,526,"Curiously, size matters, even here."
3544,0,4,35,39,1.1025641025641026,0.04921614717627658,526,"Its a mans heaven, sorry!"
3544,0,4,35,39,1.1025641025641026,0.04921614717627658,526,I'm just working with what god have me.
3544,0,4,35,39,1.1025641025641026,0.04921614717627658,526,I hate to brag!
3544,1,2,36,39,1.1025641025641026,0.06141463024552095,526,"Now, I don't want to appear holier at hand thou, but..."
3544,0,4,35,39,1.1025641025641026,0.04921614717627658,526,"They asked me what I liked to do when I was alive, and I told them I was a big Halo fan"
3544,0,4,35,39,1.1025641025641026,0.04921614717627658,526,Making up for small hands ...
3544,1,2,36,39,1.1025641025641026,0.06141463024552095,526,"You were right darling, size does matter."
3544,1,2,36,39,1.1025641025641026,0.06141463024552095,526,I'm glad you swiped up
3544,1,2,36,39,1.1025641025641026,0.06141463024552095,526,So you really think size matters in heaven? Wrong!
3544,0,4,35,39,1.1025641025641026,0.04921614717627658,526,It's just that I've been 'around' more than you. Get it?
3544,1,2,36,39,1.1025641025641026,0.06141463024552095,526,"I swear it's not a mid-afterlife crisis, I just like the extra coverage."
3544,1,2,36,39,1.1025641025641026,0.06141463024552095,526,we have no quotas and you lived a very good life but our admission policy aims at diversity as an important part of the lifetime experience here.....
3544,2,0,37,39,1.1025641025641026,0.07156315024865238,526,"Size matters, particularly in heaven."
3544,0,4,35,39,1.1025641025641026,0.04921614717627658,526,"My sacrifices are bigger. My miracles are bigger. My, um....well... it's bigger."
3544,0,4,35,39,1.1025641025641026,0.04921614717627658,526,"When it's all said and done, size is ALL that matters!"
3544,0,4,35,39,1.1025641025641026,0.04921614717627658,526,"Given to those who still have a huge ego, I'm proud to say."
3544,1,2,36,39,1.1025641025641026,0.06141463024552095,526,You should see my halo-hoop act. My show is Sunday afternoon. God loves it!
3568,0,4,36,40,1.1,0.04803844614152615,526,Trust me; it's not what you think.
3568,1,2,37,40,1.1,0.05991446895152781,526,It's like big hands.
3568,1,2,37,40,1.1,0.05991446895152781,526,"From the outside, it must look like Swiss cheese."
3568,1,2,37,40,1.1,0.05991446895152781,526,It isn't just my halo that's large.
3568,1,2,37,40,1.1,0.05991446895152781,526,That's how we roll.
3568,1,2,37,40,1.1,0.05991446895152781,526,It was easier to compensate on Earth.
3568,0,4,36,40,1.1,0.04803844614152615,526,"Not all angels are like that, actually."
3568,0,4,36,40,1.1,0.04803844614152615,526,"Alright, I'll give you more of my halo if you'll drop your demand for bigger wings."
3568,1,2,37,40,1.1,0.05991446895152781,526,Two tickets to Hamilton got me here and I see that he took you.
3568,0,4,36,40,1.1,0.04803844614152615,526,yes mine is bigger than yours
3568,0,4,36,40,1.1,0.04803844614152615,526,"'The halos are on back order, but I got this hula hoop same-day delivery on Amazon.'"
3568,1,2,37,40,1.1,0.05991446895152781,526,It's that old glass ceiling thing. Even up here.
3568,0,4,36,40,1.1,0.04803844614152615,526,"That's right; everything is proportional. And, yes, I am happy to see you."
3568,0,4,36,40,1.1,0.04803844614152615,526,It compensates for my small hands.
3568,1,2,37,40,1.1,0.05991446895152781,526,I heard size matters.
3568,1,2,37,40,1.1,0.05991446895152781,526,"Are you the temptation, or the the heaven?"
3568,0,4,36,40,1.1,0.04803844614152615,526,And you really thought that better pay and benefits ended down there?!
3568,0,4,36,40,1.1,0.04803844614152615,526,"Honey, I swear, I was out bowling with the boys."
3568,0,4,36,40,1.1,0.04803844614152615,526,"as I was saying, I am a feminist myself and believe in eqaulity."
3568,1,2,37,40,1.1,0.05991446895152781,526,Sacred Supersizing
3568,0,4,36,40,1.1,0.04803844614152615,526,Your's is not even 71% as big as mine.
3568,1,2,37,40,1.1,0.05991446895152781,526,I always wanted to practice hula hoop but I never had the time.
3568,0,4,36,40,1.1,0.04803844614152615,526,Just imagine what I'm trying to compensate
3568,0,4,36,40,1.1,0.04803844614152615,526,I told you that size mattered!
3568,0,4,36,40,1.1,0.04803844614152615,526,It turns out they didn't need it for Trump.
3568,1,2,37,40,1.1,0.05991446895152781,526,Despite the small hands...
3568,0,4,36,40,1.1,0.04803844614152615,526,The guys down at the halo store have assured me that size matters.
3568,0,4,36,40,1.1,0.04803844614152615,526,I'm considering halo rejuvenation surgery.
3568,0,4,36,40,1.1,0.04803844614152615,526,I was in a hula hoop accident.
3568,0,4,36,40,1.1,0.04803844614152615,526,Make Heaven great again!
3568,0,4,36,40,1.1,0.04803844614152615,526,Mansplangel
3568,1,2,37,40,1.1,0.05991446895152781,526,Let's wing it.
3568,0,4,36,40,1.1,0.04803844614152615,526,I am an elite angel. Check out my CV.
3568,1,2,37,40,1.1,0.05991446895152781,526,"You know what they say about big halos, right?"
3568,0,4,36,40,1.1,0.04803844614152615,526,I used to be a Big Man in Washington
3568,0,4,36,40,1.1,0.04803844614152615,526,Final tangible proof that size matters.
3568,0,4,36,40,1.1,0.04803844614152615,526,Don't get the wrong idea. I really did good works...
3568,0,4,36,40,1.1,0.04803844614152615,526,Now do you believe that men are superior?
3568,0,4,36,40,1.1,0.04803844614152615,526,I can show you how to use the wings...
3568,1,2,37,40,1.1,0.05991446895152781,526,"Yes, I did sleep with a lot of angels."
3568,0,4,36,40,1.1,0.04803844614152615,526,"So, I'm stuck forever with you, aren't I?"
3568,0,4,36,40,1.1,0.04803844614152615,526,"It's simple, the male ego is bigger!"
3568,1,2,37,40,1.1,0.05991446895152781,526,The other angels are saying we were paired together because you need to pay for previous sins.
3568,1,2,37,40,1.1,0.05991446895152781,526,"Seriously, the guys use hulahoops? Don/t you think eventually God will notice?"
3568,0,4,36,40,1.1,0.04803844614152615,526,"Why yes, ma'am, I reckon I do happen to come from where the buffalo roam."
3568,1,2,37,40,1.1,0.05991446895152781,526,"No, I haven't used any hairspray. Why do you ask?"
3568,0,4,36,40,1.1,0.04803844614152615,526,I guess I got my karm-uppance.
3568,0,4,36,40,1.1,0.04803844614152615,526,I don't know.. You just seemed holier in your profile..
3568,1,2,37,40,1.1,0.05991446895152781,526,You can stop overcompensating now.
3568,0,4,36,40,1.1,0.04803844614152615,526,Have you heard what they say about guys with long halos?
3568,1,2,37,40,1.1,0.05991446895152781,526,"Yes, I'm saying size matters."
3568,0,4,36,40,1.1,0.04803844614152615,526,"I know, but my hands are kinda small."
3568,1,2,37,40,1.1,0.05991446895152781,526,"And, I''m gonna build a wall. A Great Big Wall. And God's gonna pay for it!"
3568,1,2,37,40,1.1,0.05991446895152781,526,"My hands are large, too."
3568,1,2,37,40,1.1,0.05991446895152781,526,So you really didn't spend that weekend at Aunt Gloria's?
3568,1,2,37,40,1.1,0.05991446895152781,526,come fly with me heaven can wait
3568,0,4,36,40,1.1,0.04803844614152615,526,I've got big hands and big feet as well. But who's measuring?
3568,0,4,36,40,1.1,0.04803844614152615,526,"Heaven knows, it's about time we travel in the same circle."
3568,0,4,36,40,1.1,0.04803844614152615,526,"Obviously, darling, I'm wholier than thou."
3568,1,2,37,40,1.1,0.05991446895152781,526,"Still with the holier than thou attitude, I see."
3568,1,2,37,40,1.1,0.05991446895152781,526,They say size doesn't matter.
3568,1,2,37,40,1.1,0.05991446895152781,526,It's been a while boo
3568,1,2,37,40,1.1,0.05991446895152781,526,"I got here in the late '50s. It's a hula hoop, actually."
3568,0,4,36,40,1.1,0.04803844614152615,526,"But honey, there was a sale at the big & tall section of the store!"
3568,1,2,37,40,1.1,0.05991446895152781,526,You seem to be compensating for something
3568,1,2,37,40,1.1,0.05991446895152781,526,It doubles as a tanning booth.
3568,0,4,36,40,1.1,0.04803844614152615,526,"You have to understand Betsy, my man-splanning was obviously appreciated by the big MAN upstairs."
3568,1,2,37,40,1.1,0.05991446895152781,526,Your profile said you were more of a strawberry blonde
3568,0,4,36,40,1.1,0.04803844614152615,526,"Trust me honey, bigger is better."
3568,0,4,36,40,1.1,0.04803844614152615,526,"Well, you know what they say—Large halo, big …"
3568,0,4,36,40,1.1,0.04803844614152615,526,"Of course, you've heard what they say about halo size."
3568,0,4,36,40,1.1,0.04803844614152615,526,"First I got looped, then I got hooped."
3568,1,2,37,40,1.1,0.05991446895152781,526,can't get away from him...even when I'm dead.
3568,0,4,36,40,1.1,0.04803844614152615,526,"I know we're both single now, but I'm still more partial to bad boys."
3568,0,4,36,40,1.1,0.04803844614152615,526,"I guess size still does matter, even up here!"
3568,2,0,38,40,1.1,0.06979824404521129,526,"After all, YOU betrayed him some 150,000 years ago."
3568,0,4,36,40,1.1,0.04803844614152615,526,Come here often?
3568,0,4,36,40,1.1,0.04803844614152615,526,"If you like my upgraded halo, you'll love playing my harp!"
3568,0,4,36,40,1.1,0.04803844614152615,526,"Not what you think. It just means that I've been promoted to ""senior status."""
3568,0,4,36,40,1.1,0.04803844614152615,526,"Yeah, missionary is out of the question"
3568,1,2,37,40,1.1,0.05991446895152781,526,"It's not the meat of my halo, it's the motion"
3568,0,4,36,40,1.1,0.04803844614152615,526,"As luck would have it, I can get you into a bigger one."
3568,0,4,36,40,1.1,0.04803844614152615,526,"Everything matches, believe me!"
3568,0,4,36,40,1.1,0.04803844614152615,526,"Yes they really frown upon it here, if you think more highly of yourself than you ought... they call it having a big head?"
3568,1,2,37,40,1.1,0.05991446895152781,526,"Every time I open my mouth, one of these comes out."
3568,0,4,36,40,1.1,0.04803844614152615,526,My mother was attacked by a mosquito when she visited Brazil...
3568,0,4,36,40,1.1,0.04803844614152615,526,"Well, up here there's an unfortunate inverse relationship."
3568,1,2,37,40,1.1,0.05991446895152781,526,How can you be out of my size?
3568,1,2,37,40,1.1,0.05991446895152781,526,It's just a levitating hula hoop.
3568,0,4,36,40,1.1,0.04803844614152615,526,Clearly he is compensating for something.
3568,0,4,36,40,1.1,0.04803844614152615,526,They tend to overcompensate here for what was lacking on Earth.
3568,1,2,37,40,1.1,0.05991446895152781,526,""" Your not happy with my pay grade""?"
3568,1,2,37,40,1.1,0.05991446895152781,526,I got mad at my wife once.
3568,1,2,37,40,1.1,0.05991446895152781,526,"""Mine's bigger than yours."" - Stanley Tigerman"
3568,0,4,36,40,1.1,0.04803844614152615,526,You must be an angel freshman class.
3568,0,4,36,40,1.1,0.04803844614152615,526,"Honey, you can't say I did not earn it."
3568,1,2,37,40,1.1,0.05991446895152781,526,But conversely I have very small hands.
3568,1,2,37,40,1.1,0.05991446895152781,526,I shouldn't have used my hula hoop in the middle of a busy highway. But it's cool. huh?
3568,1,2,37,40,1.1,0.05991446895152781,526,"Up here, for a big crown, we'll need evidence of inner beauty."
3568,1,2,37,40,1.1,0.05991446895152781,526,I was actually a pretty bad dude.
3568,0,4,36,40,1.1,0.04803844614152615,526,Both my hands and my halo are anatomically correct.
3568,1,2,37,40,1.1,0.05991446895152781,526,I didn't get a chance to change out my winter wheels.
3568,0,4,36,40,1.1,0.04803844614152615,526,Actually I bought it from His Holiness...
3568,1,2,37,40,1.1,0.05991446895152781,526,I forgot customer support isn't available on Sunday.
3672,0,4,37,41,1.0975609756097562,0.046915570882125224,526,I'm impressed.
3672,1,2,38,41,1.0975609756097562,0.05848575028430145,526,"Hands matter on earth. Up here, it's haloes."
3672,0,4,37,41,1.0975609756097562,0.046915570882125224,526,God loved my Hula Hoop invention.
3672,1,2,38,41,1.0975609756097562,0.05848575028430145,526,"There's a glass ceiling here, so don't get any funny ideas."
3672,1,2,38,41,1.0975609756097562,0.05848575028430145,526,It compensates for my impure thoughts. It compensates for my impure thoughts.
3672,1,2,38,41,1.0975609756097562,0.05848575028430145,526,"Yes, as a matter of fact, I did vote third party in 1996!"
3672,1,2,38,41,1.0975609756097562,0.05848575028430145,526,"Yes, it's all true."
3672,1,2,38,41,1.0975609756097562,0.05848575028430145,526,It was an add-on to my prearranged funeral.
3672,0,4,37,41,1.0975609756097562,0.046915570882125224,526,"Marketing came up with it. It's called ""supersizing""."
3672,0,4,37,41,1.0975609756097562,0.046915570882125224,526,Manspread? Hey that's how I roll.
3672,0,4,37,41,1.0975609756097562,0.046915570882125224,526,Heaven is just like earth but with better climate.
3672,1,2,38,41,1.0975609756097562,0.05848575028430145,526,Do our votes count?
3672,0,4,37,41,1.0975609756097562,0.046915570882125224,526,You should see the size of my hands!
3672,0,4,37,41,1.0975609756097562,0.046915570882125224,526,"Yes, it's bigger too."
3672,0,4,37,41,1.0975609756097562,0.046915570882125224,526,"You know what they say, the bigger the Halo the bigger the..."
3672,1,2,38,41,1.0975609756097562,0.05848575028430145,526,You and I both know your robe shouldn't be white
3672,0,4,37,41,1.0975609756097562,0.046915570882125224,526,I think you're taking this size matters comment a little too seriously.
3672,1,2,38,41,1.0975609756097562,0.05848575028430145,526,"My name is Trump, Donald Trump."
3672,0,4,37,41,1.0975609756097562,0.046915570882125224,526,I'm not compensating for anything by having a big halo. Its for safety and a smoother ride.
3672,0,4,37,41,1.0975609756097562,0.046915570882125224,526,"Yeah, rumors are swirling that it's to compensate for other things. Not true."
3672,0,4,37,41,1.0975609756097562,0.046915570882125224,526,It proves I'm really good.
3672,0,4,37,41,1.0975609756097562,0.046915570882125224,526,Oh no…you saw that?
3672,1,2,38,41,1.0975609756097562,0.05848575028430145,526,I spent a lifetime to meet you.
3672,1,2,38,41,1.0975609756097562,0.05848575028430145,526,Here our romance can truly last for eternity!
3672,0,4,37,41,1.0975609756097562,0.046915570882125224,526,I bet a former New Yorker cartoonist made your halo?
3672,0,4,37,41,1.0975609756097562,0.046915570882125224,526,...and you should have seen my Porsche.
3672,0,4,37,41,1.0975609756097562,0.046915570882125224,526,Did it hurt when you fell down from Heaven? Because it looked kind of painful.
3672,0,4,37,41,1.0975609756097562,0.046915570882125224,526,"Why yes, my hands are slightly larger than average. Would you like to see them?"
3672,0,4,37,41,1.0975609756097562,0.046915570882125224,526,You probably think I think I'm holier than thou.
3672,1,2,38,41,1.0975609756097562,0.05848575028430145,526,More than about being really good it's about being casual.
3672,0,4,37,41,1.0975609756097562,0.046915570882125224,526,It's true what they say.
3672,1,2,38,41,1.0975609756097562,0.05848575028430145,526,I know that size is not supposed to matter but...
3672,0,4,37,41,1.0975609756097562,0.046915570882125224,526,Now you're mad at me because I actually am holier than thou!
3672,1,2,38,41,1.0975609756097562,0.05848575028430145,526,"Before I died, ""Size matters"" sure meant nothing good for me."
3672,0,4,37,41,1.0975609756097562,0.046915570882125224,526,It must have something to do with what we were doing when we did it.
3672,0,4,37,41,1.0975609756097562,0.046915570882125224,526,My halo's bigger than yours.
3672,1,2,38,41,1.0975609756097562,0.05848575028430145,526,No. I have to admit that I didn't really earn this halo. I went to a Beyoncé Tribute Concert the other night.
3672,1,2,38,41,1.0975609756097562,0.05848575028430145,526,God stole the idea from Pinocchio.
3672,0,4,37,41,1.0975609756097562,0.046915570882125224,526,And you thought you were through the glass ceiling?
3672,0,4,37,41,1.0975609756097562,0.046915570882125224,526,"As you can tell by the size of my halo, I'm just not that kind of guy."
3672,0,4,37,41,1.0975609756097562,0.046915570882125224,526,"You were right, only God knew what an angel you were."
3672,1,2,38,41,1.0975609756097562,0.05848575028430145,526,"I'm not sure if it's an extra-wide halo, or a portal about to suck me up."
3672,0,4,37,41,1.0975609756097562,0.046915570882125224,526,I was actually getting ready to dump you right before the accident.
3672,1,2,38,41,1.0975609756097562,0.05848575028430145,526,That's how they caught my using steroids.
3672,1,2,38,41,1.0975609756097562,0.05848575028430145,526,"Very funny. Truth is, I died in a pop-up store dressing room."
3672,0,4,37,41,1.0975609756097562,0.046915570882125224,526,"They ran out, but fortunately I died in a hula hoop accident."
3672,1,2,38,41,1.0975609756097562,0.05848575028430145,526,Now what?
3672,0,4,37,41,1.0975609756097562,0.046915570882125224,526,Really? I think you need to get back down to earth about your size.
3672,0,4,37,41,1.0975609756097562,0.046915570882125224,526,"Oh yea, it's true what they say about halo size..."
3672,0,4,37,41,1.0975609756097562,0.046915570882125224,526,I guess our “after-prom” wasn’t that sinful after all. Wish I’d known that back then.
3672,0,4,37,41,1.0975609756097562,0.046915570882125224,526,I told you if I ate kale I'd be holier-than-thou!
3672,1,2,38,41,1.0975609756097562,0.05848575028430145,526,"Gotta say, your smile and youthful figure - together with the cute, LITTLE halo - has been much anticipated."
3672,0,4,37,41,1.0975609756097562,0.046915570882125224,526,"All those things they say about a bigger halo... okay, I'll admit it, yes, they're true."
3672,0,4,37,41,1.0975609756097562,0.046915570882125224,526,"Yes, it's a manly halo."
3672,0,4,37,41,1.0975609756097562,0.046915570882125224,526,"Yes, it is true what they say about the size of a man's halo."
3672,0,4,37,41,1.0975609756097562,0.046915570882125224,526,I was a hedge fund manager but I died young.
3672,1,2,38,41,1.0975609756097562,0.05848575028430145,526,"Well if 'size doesn't matter' up here, why am I getting all the free premium channels right now?"
3672,0,4,37,41,1.0975609756097562,0.046915570882125224,526,Just call me angel of the morning.
3672,1,2,38,41,1.0975609756097562,0.05848575028430145,526,"I'm a shower, not a grower."
3672,1,2,38,41,1.0975609756097562,0.05848575028430145,526,I think it just means you are a divine Hulu hooper .
3672,1,2,38,41,1.0975609756097562,0.05848575028430145,526,But I'm honest about my manspreading. That's why I'm here.
3672,1,2,38,41,1.0975609756097562,0.05848575028430145,526,"Well, it's not Trump huge, but..."
3672,1,2,38,41,1.0975609756097562,0.05848575028430145,526,He: I guess I should've listened to you and taken the left turn. She: Told you so.
3672,1,2,38,41,1.0975609756097562,0.05848575028430145,526,"Oh, no, I'm not bigger than most guys, I'm just bigger than ALL guys."
3672,0,4,37,41,1.0975609756097562,0.046915570882125224,526,I was a hoola hoop God in my day.
3672,0,4,37,41,1.0975609756097562,0.046915570882125224,526,"Yeah, but my hands are really small."
3672,0,4,37,41,1.0975609756097562,0.046915570882125224,526,"I'm sorry, but this is still not a gender free environment."
3672,0,4,37,41,1.0975609756097562,0.046915570882125224,526,This is truly a marriage made in heaven.
3672,0,4,37,41,1.0975609756097562,0.046915570882125224,526,I got it because I am humbler than anybody.
3672,1,2,38,41,1.0975609756097562,0.05848575028430145,526,It's not the size of the halo that counts!
3672,0,4,37,41,1.0975609756097562,0.046915570882125224,526,"You know what they say about big halos, don't you?"
3672,1,2,38,41,1.0975609756097562,0.05848575028430145,526,Size doesn't matter up here either.
3672,1,2,38,41,1.0975609756097562,0.05848575028430145,526,Down on earth I was a swing state super delegate.
3672,0,4,37,41,1.0975609756097562,0.046915570882125224,526,They may have over-egged the ambrosia.
3672,0,4,37,41,1.0975609756097562,0.046915570882125224,526,My old hoola hoop was the best I could get.
3672,1,2,38,41,1.0975609756097562,0.05848575028430145,526,Everything is bigger up here.
3672,0,4,37,41,1.0975609756097562,0.046915570882125224,526,I knew it was Heaven when He told me man-spreading was okay here.
3672,0,4,37,41,1.0975609756097562,0.046915570882125224,526,Yes my halo is quite large. But wait 'till you see my hands!
3672,0,4,37,41,1.0975609756097562,0.046915570882125224,526,Size matters!! Your cloud or mine??!!
3672,1,2,38,41,1.0975609756097562,0.05848575028430145,526,I traded my halo for a hoop so I could hula in heaven.
3672,1,2,38,41,1.0975609756097562,0.05848575028430145,526,"So, I see you're acquainted with the good boy in life/bad boy in heaven prerogative...."
3672,2,0,39,41,1.0975609756097562,0.06811824411594605,526,Fine point indeed!
3672,0,4,37,41,1.0975609756097562,0.046915570882125224,526,"Yeah, I got reamed. So what?"
3672,0,4,37,41,1.0975609756097562,0.046915570882125224,526,"Well ma'am, we Texangels is a right special breed."
3672,1,2,38,41,1.0975609756097562,0.05848575028430145,526,Size matters - even in the ethereal world.
3672,0,4,37,41,1.0975609756097562,0.046915570882125224,526,I checked and He said it ain't braggin' if it's true.
3672,1,2,38,41,1.0975609756097562,0.05848575028430145,526,"I have rather large hands, also."
3672,1,2,38,41,1.0975609756097562,0.05848575028430145,526,I let my dad move in with me when Mom died.
3672,1,2,38,41,1.0975609756097562,0.05848575028430145,526,"Yes, bigger is better."
3672,1,2,38,41,1.0975609756097562,0.05848575028430145,526,You have incredible tips!
3672,0,4,37,41,1.0975609756097562,0.046915570882125224,526,"It's not my fault the stereotypes exist.... hands, feet, halo what do you want me to say."
3672,1,2,38,41,1.0975609756097562,0.05848575028430145,526,He said Broadway wouldn't even exist without me.
3672,0,4,37,41,1.0975609756097562,0.046915570882125224,526,I don't like to brag...
3672,0,4,37,41,1.0975609756097562,0.046915570882125224,526,"I am glad that you are impressed. Yes, it is real."
3672,0,4,37,41,1.0975609756097562,0.046915570882125224,526,It must be Father's Day!
3672,0,4,37,41,1.0975609756097562,0.046915570882125224,526,Separate but equal
3672,1,2,38,41,1.0975609756097562,0.05848575028430145,526,"Even above the ceiling, yours is still only 78% of mine."
3672,0,4,37,41,1.0975609756097562,0.046915570882125224,526,"If you say ""yes"" I promise to get you a bigger ring."
3672,1,2,38,41,1.0975609756097562,0.05848575028430145,526,You think that's big? You oughta see the size of my hands.
3672,0,4,37,41,1.0975609756097562,0.046915570882125224,526,"No matter WHAT he said, you can indeed have a small halo and still be a ""10""."
3672,1,2,38,41,1.0975609756097562,0.05848575028430145,526,"You're a lucky gal - every time I swipe right, it's a match."
3672,0,4,37,41,1.0975609756097562,0.046915570882125224,526,Trust me on this: Size matters.
3672,1,2,38,41,1.0975609756097562,0.05848575028430145,526,I guess you weren't being passive aggressive after all.
3672,0,4,37,41,1.0975609756097562,0.046915570882125224,526,Your thoughts are interesting. My whole perspective has changed.
3672,1,2,38,41,1.0975609756097562,0.05848575028430145,526,"I like to think it's relative to how Holy I am, but they say I should have read the size chart."
3672,1,2,38,41,1.0975609756097562,0.05848575028430145,526,"And I was like, ""OMG, is that really, you?"", and he was like, ""DUDE, totally righteous!"""
3672,0,4,37,41,1.0975609756097562,0.046915570882125224,526,"The halo gap is just a myth, you know."
3672,1,2,38,41,1.0975609756097562,0.05848575028430145,526,"No, it's actually not that, rather I was the national president of the Chubby Checker Fan Club."
3672,1,2,38,41,1.0975609756097562,0.05848575028430145,526,I'm too late?
3672,0,4,37,41,1.0975609756097562,0.046915570882125224,526,Remember hula hoops?
3672,1,2,38,41,1.0975609756097562,0.05848575028430145,526,I was #1 in Halo.
3672,1,2,38,41,1.0975609756097562,0.05848575028430145,526,"...so I said ""Go ahead- as hard as you can- I dare you!"
3672,0,4,37,41,1.0975609756097562,0.046915570882125224,526,"God know, size matters."
3672,0,4,37,41,1.0975609756097562,0.046915570882125224,526,I guarantee you there's no problem. There's no problem.
3672,0,4,37,41,1.0975609756097562,0.046915570882125224,526,It is so good to see my little angel.
3672,1,2,38,41,1.0975609756097562,0.05848575028430145,526,In the Bible Ezekiel 23:19-20 clearly states that size matters...
3672,1,2,38,41,1.0975609756097562,0.05848575028430145,526,Welcome! It's defective!!
3672,1,2,38,41,1.0975609756097562,0.05848575028430145,526,On earth I was a hulahoop salesman.
3672,1,2,38,41,1.0975609756097562,0.05848575028430145,526,"If we weren't angels, I would definitely want to date you"
3672,1,2,38,41,1.0975609756097562,0.05848575028430145,526,I'm really not trying to be holier-than-thou.
3672,0,4,37,41,1.0975609756097562,0.046915570882125224,526,God felt we needed more room for error.
3672,0,4,37,41,1.0975609756097562,0.046915570882125224,526,"Thanks, but I think you have the wrong idea. I have a bad case of halotosis."
3672,0,4,37,41,1.0975609756097562,0.046915570882125224,526,Viagra and nitrates don't mix.
3672,0,4,37,41,1.0975609756097562,0.046915570882125224,526,Don't be put off. It only means I was a hula hoop champion.
3672,1,2,38,41,1.0975609756097562,0.05848575028430145,526,"I may have small hands and feet, but up here, there is only one thing that matters."
3672,1,2,38,41,1.0975609756097562,0.05848575028430145,526,Twenty years with you I have to thank for this.
3672,0,4,37,41,1.0975609756097562,0.046915570882125224,526,I can Halosplain everything.
3672,1,2,38,41,1.0975609756097562,0.05848575028430145,526,"If I were you, I would lose that attitude."
3672,0,4,37,41,1.0975609756097562,0.046915570882125224,526,"I know, i know. It was just too easy."
3672,1,2,38,41,1.0975609756097562,0.05848575028430145,526,My halo says hello to you
3672,1,2,38,41,1.0975609756097562,0.05848575028430145,526,Mine is an affect
3672,1,2,38,41,1.0975609756097562,0.05848575028430145,526,"We also invented the Frisbee, no biggie, but Richard got that one..."
3672,1,2,38,41,1.0975609756097562,0.05848575028430145,526,You can see that can't you?
3672,0,4,37,41,1.0975609756097562,0.046915570882125224,526,I'm Gabe. Fifth generation.
3672,0,4,37,41,1.0975609756097562,0.046915570882125224,526,The goal is to get into heaven with the smallest possible halo.
3672,0,4,37,41,1.0975609756097562,0.046915570882125224,526,"Wow, you look great. But, if you used Halo, the shampoo that Glorifies your hair, just think..."
3672,1,2,38,41,1.0975609756097562,0.05848575028430145,526,"""Thy Will Be Done, on Earth as it is in Heaven"", Sorry."
3672,0,4,37,41,1.0975609756097562,0.046915570882125224,526,I'm not that big-headed.
3672,1,2,38,41,1.0975609756097562,0.05848575028430145,526,I never once 'mansplained.'
3811,0,4,38,42,1.0952380952380953,0.045843796413450766,526,Just my luck: up here size really doesn't matter and I'm very well endowed.
3811,1,2,39,42,1.0952380952380953,0.057123496526633864,526,"Yeah, up here we have big halos, not big hands or big feet."
3811,0,4,38,42,1.0952380952380953,0.045843796413450766,526,I promised you I would never even think about it. I guess you did?
3811,1,2,39,42,1.0952380952380953,0.057123496526633864,526,Good girls go to heaven (bad girls go everywhere)
3811,1,2,39,42,1.0952380952380953,0.057123496526633864,526,You've got to be kidding me! So size really doesn't matter?
3811,1,2,39,42,1.0952380952380953,0.057123496526633864,526,I have a saturnine personality disorder.
3811,1,2,39,42,1.0952380952380953,0.057123496526633864,526,But I also have small hands
3811,0,4,38,42,1.0952380952380953,0.045843796413450766,526,"Well, since you asked, I was a champion hula-hooper."
3811,0,4,38,42,1.0952380952380953,0.045843796413450766,526,Let's just say I wasn't sent here for being BAD in bed.
3811,0,4,38,42,1.0952380952380953,0.045843796413450766,526,"Wait, hold on! You were my great-grandmother?"
3811,0,4,38,42,1.0952380952380953,0.045843796413450766,526,"Believe me, I DO have large hands!"
3811,0,4,38,42,1.0952380952380953,0.045843796413450766,526,I shouldn't have mentioned I have feelings of inadequatsey.
3811,0,4,38,42,1.0952380952380953,0.045843796413450766,526,Goodness ain't no hula hoop.
3811,0,4,38,42,1.0952380952380953,0.045843796413450766,526,It's six inches.
3811,1,2,39,42,1.0952380952380953,0.057123496526633864,526,"Yes, even here size matters."
3811,0,4,38,42,1.0952380952380953,0.045843796413450766,526,For the longest time I was saying 'holier than THEE.'
3811,0,4,38,42,1.0952380952380953,0.045843796413450766,526,"Unfortunately, I struck a deal with Donald . . . my alter-ego!"
3811,0,4,38,42,1.0952380952380953,0.045843796413450766,526,"Yeah, it was a 'points' thing."
3811,1,2,39,42,1.0952380952380953,0.057123496526633864,526,I guess we travelled in different c
3811,2,0,40,42,1.0952380952380953,0.06651717102567413,526,My wife doesn't understand the 6 plus either
3811,1,2,39,42,1.0952380952380953,0.057123496526633864,526,Well...you know what they say...when a man has big feet...
3811,0,4,38,42,1.0952380952380953,0.045843796413450766,526,"Uh, I'm afraid it must be platonic, my crown doesn't fold up."
3811,0,4,38,42,1.0952380952380953,0.045843796413450766,526,I've just got a bigger head.
3811,0,4,38,42,1.0952380952380953,0.045843796413450766,526,On Tinder you said you were shorter.
3811,1,2,39,42,1.0952380952380953,0.057123496526633864,526,"Halo angel face, haven't seen you flying around here before."
3811,0,4,38,42,1.0952380952380953,0.045843796413450766,526,"Wow."" You must have big hands!"
3811,1,2,39,42,1.0952380952380953,0.057123496526633864,526,"Hmm. Big halo, little organ."
3811,1,2,39,42,1.0952380952380953,0.057123496526633864,526,Suddenly I feel like a Republican.
3811,0,4,38,42,1.0952380952380953,0.045843796413450766,526,"Yeah, back on Earth I used to take a lot of flak for my holier than thou attitude."
3811,0,4,38,42,1.0952380952380953,0.045843796413450766,526,That's cutting it too close for me.
3811,0,4,38,42,1.0952380952380953,0.045843796413450766,526,I have a degree from Trump U.
3811,0,4,38,42,1.0952380952380953,0.045843796413450766,526,I was at woodstock...
3811,1,2,39,42,1.0952380952380953,0.057123496526633864,526,"It's amazing Grace how my ""wide broadband"" is receiving the Singing Nun."
3811,1,2,39,42,1.0952380952380953,0.057123496526633864,526,"""Bigger is Better"" won't float up here buddy."
3811,0,4,38,42,1.0952380952380953,0.045843796413450766,526,"Peter, darling, my aureole is up here."
3811,0,4,38,42,1.0952380952380953,0.045843796413450766,526,"There's no problem there, I can assure you."
3811,0,4,38,42,1.0952380952380953,0.045843796413450766,526,"I'm not REALLY holier than thou, gorgeous."
3811,0,4,38,42,1.0952380952380953,0.045843796413450766,526,It's not all about size- its how you use it.
3811,0,4,38,42,1.0952380952380953,0.045843796413450766,526,This is heaven. Bigger isn't better.
3811,1,2,39,42,1.0952380952380953,0.057123496526633864,526,"Unfortunately, it's only in relation to the size of a man's foot."
3811,1,2,39,42,1.0952380952380953,0.057123496526633864,526,Angel...shmangel...he's really full of himself.
3811,0,4,38,42,1.0952380952380953,0.045843796413450766,526,"Well, at least you admitted you weren't a virgin"
3811,0,4,38,42,1.0952380952380953,0.045843796413450766,526,"It's a great honor, but it interferes with my barrel roll."
3811,1,2,39,42,1.0952380952380953,0.057123496526633864,526,Everything I did was HUGE.
3811,1,2,39,42,1.0952380952380953,0.057123496526633864,526,"Yes, I do support Trump for President"
3811,0,4,38,42,1.0952380952380953,0.045843796413450766,526,It's temporary since we're all equal here. Just a little recognition for what I had to put up with there.
3811,1,2,39,42,1.0952380952380953,0.057123496526633864,526,It's called a hula hoop halo
3811,0,4,38,42,1.0952380952380953,0.045843796413450766,526,It is amazing how many people still don't believe in the gender pay gap.
3811,1,2,39,42,1.0952380952380953,0.057123496526633864,526,And he referred to my hands: if they're small-- something else must be small. I guarantee you there is no problem.
3811,0,4,38,42,1.0952380952380953,0.045843796413450766,526,My earthly profession revolved around angel hair pasta marketing
3811,1,2,39,42,1.0952380952380953,0.057123496526633864,526,My horse trampled Donald Trump in his previous life.
3811,0,4,38,42,1.0952380952380953,0.045843796413450766,526,It's 'Holier Than Thou'. Politicians love 'em.
3811,2,0,40,42,1.0952380952380953,0.06651717102567413,526,Do you come around here often?
3811,0,4,38,42,1.0952380952380953,0.045843796413450766,526,I was beamed up sooner than I had ever expected!
3811,0,4,38,42,1.0952380952380953,0.045843796413450766,526,"So I said, 'Listen, man, I think my halo is bigger than yours.' And he still wanted to argue!"
3811,0,4,38,42,1.0952380952380953,0.045843796413450766,526,"Yeah, I ordered the Texas halo."
3811,0,4,38,42,1.0952380952380953,0.045843796413450766,526,You have an apple? Sounds like déjà vu
3811,0,4,38,42,1.0952380952380953,0.045843796413450766,526,"If you were minuscule in one area, they compensate."
3811,0,4,38,42,1.0952380952380953,0.045843796413450766,526,"Would you be so kind as to direct me to the other place that begins with ""H""?"
3811,0,4,38,42,1.0952380952380953,0.045843796413450766,526,Are you sure your from Christian Dating.com?
3811,0,4,38,42,1.0952380952380953,0.045843796413450766,526,"Well, Father was Deacon."
3811,1,2,39,42,1.0952380952380953,0.057123496526633864,526,It was widely believed that I tried it in college but I didn't.
3811,0,4,38,42,1.0952380952380953,0.045843796413450766,526,It's not the size but what you do with it that matters.
3811,1,2,39,42,1.0952380952380953,0.057123496526633864,526,It indicates mine is bigger than Donald Trump's hands.
3811,1,2,39,42,1.0952380952380953,0.057123496526633864,526,"I'm sorry, sis, I used to practice on your hula hoop when you weren't around. I guess I was better than you."
3811,1,2,39,42,1.0952380952380953,0.057123496526633864,526,Shhh...It's really difficult to get any sleep with this giant aura hanging above my head.
3811,0,4,38,42,1.0952380952380953,0.045843796413450766,526,And you thought a big head disqualified you from getting in?
3811,1,2,39,42,1.0952380952380953,0.057123496526633864,526,Remember that old saying about the size of a guy's halo? Well...
3811,1,2,39,42,1.0952380952380953,0.057123496526633864,526,"… umm, er, and, ultimately, size does…” “OMG! I’m in the other place!"
3811,1,2,39,42,1.0952380952380953,0.057123496526633864,526,"OK, In a previous life it was a hula hoop. How about yours?"
3811,1,2,39,42,1.0952380952380953,0.057123496526633864,526,I'm C=2piR and you're C=piD.
3811,1,2,39,42,1.0952380952380953,0.057123496526633864,526,"Yes, I am rather proud of it."
3811,1,2,39,42,1.0952380952380953,0.057123496526633864,526,You think it's big?
3811,0,4,38,42,1.0952380952380953,0.045843796413450766,526,In my former life I was the best damn hula hoop salesman west of the Mississippi.
3811,1,2,39,42,1.0952380952380953,0.057123496526633864,526,I thought it was for the time I represented the catholic church; turns out its for when i proved that the doublemint twins weren't related.
3811,1,2,39,42,1.0952380952380953,0.057123496526633864,526,"Yeah, He asked me to show you around, seeing as how you're new and all..."
3811,1,2,39,42,1.0952380952380953,0.057123496526633864,526,"Well, you've finally broken through the glass ceiling."
3811,2,0,40,42,1.0952380952380953,0.06651717102567413,526,He's my cousin 4th removed.
3811,0,4,38,42,1.0952380952380953,0.045843796413450766,526,Who says men have big egos?
3811,0,4,38,42,1.0952380952380953,0.045843796413450766,526,It's gonna be huuuge.
3811,0,4,38,42,1.0952380952380953,0.045843796413450766,526,Wanna play hula hoop?
3811,0,4,38,42,1.0952380952380953,0.045843796413450766,526,It reflects my holier-than-thou W.A.S.P. ego.
3811,0,4,38,42,1.0952380952380953,0.045843796413450766,526,"Needle, halo. Whatever."
3811,1,2,39,42,1.0952380952380953,0.057123496526633864,526,Good start. But you must learn greater generosity in sharing your talent for romance.
3811,0,4,38,42,1.0952380952380953,0.045843796413450766,526,Oh thank you dahling. You are such an angel!
3811,1,2,39,42,1.0952380952380953,0.057123496526633864,526,"Come on baby, you know what they say, 'small hands, big halo...'"
3811,0,4,38,42,1.0952380952380953,0.045843796413450766,526,I'm looking for the choir room?
3811,1,2,39,42,1.0952380952380953,0.057123496526633864,526,"As you can see, we have no glass ceiling here."
3811,0,4,38,42,1.0952380952380953,0.045843796413450766,526,0% down and a low interest rate?! I just couldn't resist!
3811,0,4,38,42,1.0952380952380953,0.045843796413450766,526,Believe me. size does matter.
3811,1,2,39,42,1.0952380952380953,0.057123496526633864,526,Size still matters
3811,0,4,38,42,1.0952380952380953,0.045843796413450766,526,"Hey babe, watcha doin' after eternity?"
3811,1,2,39,42,1.0952380952380953,0.057123496526633864,526,"Yes, Helen, your mother was right. I spent too much time singing my own praises."
3811,0,4,38,42,1.0952380952380953,0.045843796413450766,526,"Charlie, you look pretty bored for an angel!"
3811,1,2,39,42,1.0952380952380953,0.057123496526633864,526,I'm the patron saint of humblebragging.
3811,0,4,38,42,1.0952380952380953,0.045843796413450766,526,Even God said mine's the biggest.
3811,0,4,38,42,1.0952380952380953,0.045843796413450766,526,Do you have faith that size matters?
3811,1,2,39,42,1.0952380952380953,0.057123496526633864,526,"After that night in Rome, I never thought I would see you again."
3811,0,4,38,42,1.0952380952380953,0.045843796413450766,526,So you're telling me that size does matter.
3811,1,2,39,42,1.0952380952380953,0.057123496526633864,526,*Swipe left*
3811,0,4,38,42,1.0952380952380953,0.045843796413450766,526,A marriage made in heaven is actually TRUE!
3811,0,4,38,42,1.0952380952380953,0.045843796413450766,526,I got this for NOT having a holier-than-thou attitude.
3811,1,2,39,42,1.0952380952380953,0.057123496526633864,526,WOW--Heaven is a lot easier than Tinder!
3811,1,2,39,42,1.0952380952380953,0.057123496526633864,526,It's like viagra for heaven.
3811,1,2,39,42,1.0952380952380953,0.057123496526633864,526,"Yes, dear, even in Heaven, size matters."
3811,0,4,38,42,1.0952380952380953,0.045843796413450766,526,"I see we share a belief in the 'hole in the ozone layer' theory, though perhaps not to the same extent."
3811,0,4,38,42,1.0952380952380953,0.045843796413450766,526,"You know what they say: 'Big halo, BIG hello.' '"
3811,0,4,38,42,1.0952380952380953,0.045843796413450766,526,I hope hubby doesn't ask why my halo is smaller.
3811,1,2,39,42,1.0952380952380953,0.057123496526633864,526,I always said size didn't matter.
3811,0,4,38,42,1.0952380952380953,0.045843796413450766,526,"So you see, dear, all sin IS forgiven, but adultery is still worse for women."
3811,0,4,38,42,1.0952380952380953,0.045843796413450766,526,I really am as good as they say....
3811,0,4,38,42,1.0952380952380953,0.045843796413450766,526,Where'd you get those great wings?
3811,0,4,38,42,1.0952380952380953,0.045843796413450766,526,"I'm afraid there's a glass ceiling up here too,, did they tell you that?"
3811,0,4,38,42,1.0952380952380953,0.045843796413450766,526,Honestly. Your wings look perfect.
3811,1,2,39,42,1.0952380952380953,0.057123496526633864,526,"Oh Heavens, no! I just got the credit card."
3811,0,4,38,42,1.0952380952380953,0.045843796413450766,526,I've been too 'holier than thou' recently.
3811,0,4,38,42,1.0952380952380953,0.045843796413450766,526,"No, they don't say that because the hole in it is bigger than thou's."
3811,0,4,38,42,1.0952380952380953,0.045843796413450766,526,Would you go out with a big halo?
3811,0,4,38,42,1.0952380952380953,0.045843796413450766,526,Until death do us part?
3811,0,4,38,42,1.0952380952380953,0.045843796413450766,526,It comes in handy as a hula hoop.
3811,0,4,38,42,1.0952380952380953,0.045843796413450766,526,"Down there it was ""grade inflation""."
3811,0,4,38,42,1.0952380952380953,0.045843796413450766,526,That's from before I learned to be humble!
3811,0,4,38,42,1.0952380952380953,0.045843796413450766,526,"Well, I hear you haven't been much of an angel either, Ginger."
3811,0,4,38,42,1.0952380952380953,0.045843796413450766,526,Yeh I know... You're tired of dating nerds.
3811,2,0,40,42,1.0952380952380953,0.06651717102567413,526,"Well, you know guys have a tendency to over-exaggerate..."
3811,0,4,38,42,1.0952380952380953,0.045843796413450766,526,I took out trash every day this week.
3937,1,2,40,43,1.0930232558139534,0.055823181223160837,526,It's the result of my naturally holier-than-thou W.A.S.P. attitude.
3937,0,4,39,43,1.0930232558139534,0.04481972612369448,526,"Oh no. You're not gonna be an angel, are you?"
3937,1,2,40,43,1.0930232558139534,0.055823181223160837,526,"The scheme was a bit unholy, but I won it from the Jolly Green Giant in a Fitbit challenge."
3937,0,4,39,43,1.0930232558139534,0.04481972612369448,526,Steroids worked for me!
3937,0,4,39,43,1.0930232558139534,0.04481972612369448,526,They say a women only has 78% of the halo a man has.
3937,0,4,39,43,1.0930232558139534,0.04481972612369448,526,I gave Hula Hoops to orphans.
3937,1,2,40,43,1.0930232558139534,0.055823181223160837,526,"Yes, it's true what they say about angels with big halos but the irony is you only get one by not giving in to temptation."
3937,1,2,40,43,1.0930232558139534,0.055823181223160837,526,"With halos, it's who you know Cindy"
3937,0,4,39,43,1.0930232558139534,0.04481972612369448,526,"Now, this is a real double ring ceremony!"
3937,0,4,39,43,1.0930232558139534,0.04481972612369448,526,I don't think we are good together anymore.
3937,1,2,40,43,1.0930232558139534,0.055823181223160837,526,"and there's nothing wrong down there, either."
3937,1,2,40,43,1.0930232558139534,0.055823181223160837,526,"Indeed, I am holier than thou, but I see thine potential."
3937,0,4,39,43,1.0930232558139534,0.04481972612369448,526,"Yeah, I guess you could call it a holey roller."
3937,1,2,40,43,1.0930232558139534,0.055823181223160837,526,"Oh, that was heavenly."
3937,0,4,39,43,1.0930232558139534,0.04481972612369448,526,Do you have a twin?
3937,1,2,40,43,1.0930232558139534,0.055823181223160837,526,"Aloha. Where I'm from we get hula hoops, not halos."
3937,0,4,39,43,1.0930232558139534,0.04481972612369448,526,"Funny,back on earth bigger meant better"
3937,0,4,39,43,1.0930232558139534,0.04481972612369448,526,How many partners did you say you had?
3937,0,4,39,43,1.0930232558139534,0.04481972612369448,526,Wanna play some halo-hoops
3937,0,4,39,43,1.0930232558139534,0.04481972612369448,526,"You bet, I had big hands on earth."
3937,0,4,39,43,1.0930232558139534,0.04481972612369448,526,I guess having a big ego worked in my favor
3937,0,4,39,43,1.0930232558139534,0.04481972612369448,526,Will you fly with me?
3937,1,2,40,43,1.0930232558139534,0.055823181223160837,526,Which one of Charlie's Angels are you?
3937,1,2,40,43,1.0930232558139534,0.055823181223160837,526,"And you said, size doesn't matter!"
3937,1,2,40,43,1.0930232558139534,0.055823181223160837,526,"""Oh,"" He says, ""It's too small,"" He says, ""So, what about this size? Better?"" Then He just walks away, laughing."
3937,1,2,40,43,1.0930232558139534,0.055823181223160837,526,Hate heights hate flights hold me.
3937,1,2,40,43,1.0930232558139534,0.055823181223160837,526,On earth I was hula-hoop champion of Boise Idaho.
3964,1,2,41,44,1.0909090909090908,0.054580679253385125,526,I'M GAY
3964,1,2,41,44,1.0909090909090908,0.054580679253385125,526,My dating app didn't work very well.
3964,1,2,41,44,1.0909090909090908,0.054580679253385125,526,"OK, so I have small hands."
3967,1,1,33,35,1.0857142857142856,0.06313156292770737,526,That's not the only thing that's big.
3968,0,3,33,36,1.0833333333333333,0.04671765921511568,526,"Perhaps, now you can finally see the difference between a halo and a Nimbus"
3968,0,3,33,36,1.0833333333333333,0.04671765921511568,526,I'm a louse but I DID finance 3 dozen Broadway shows.
3968,0,3,33,36,1.0833333333333333,0.04671765921511568,526,"In this realm, my dear, I am looked more upon as hallowed than just haloed"""
3968,1,1,34,36,1.0833333333333333,0.06139903313441727,526,"It is a PONDEROUS halo!"""
3972,1,1,35,37,1.0810810810810811,0.05975900523162883,526,I programmed the halographic image
3972,1,1,35,37,1.0810810810810811,0.05975900523162883,526,I figure God gave me the extra buoyancy so I don't fall again.
3972,1,1,35,37,1.0810810810810811,0.05975900523162883,526,"Big halo, big feet"
3972,1,1,35,37,1.0810810810810811,0.05975900523162883,526,How unfortunate we did not meet under different circumstances!!!
3972,0,3,34,37,1.0810810810810811,0.045493265488117475,526,"Sorry- aureola, not areola."
3972,0,3,34,37,1.0810810810810811,0.045493265488117475,526,It's not what you think................
3972,1,1,35,37,1.0810810810810811,0.05975900523162883,526,Oh no.A holier than you type
3972,0,3,34,37,1.0810810810810811,0.045493265488117475,526,"I cannot thank of anything to say ""except"" (is this a dream)???"
3980,0,3,35,38,1.0789473684210527,0.044331271812937195,526,It's a Mexican style actually
3980,0,3,35,38,1.0789473684210527,0.044331271812937195,526,Mine is a halo. Yours is a hula hoop!
3980,0,3,35,38,1.0789473684210527,0.044331271812937195,526,They're actually back in vogue this millennium.
3980,1,1,36,38,1.0789473684210527,0.058204267603313695,526,You've no idea. It's REALLY big.
3980,0,3,35,38,1.0789473684210527,0.044331271812937195,526,"Arbitration is a legitimate, legally binding, pathway into Heaven."
3980,1,1,36,38,1.0789473684210527,0.058204267603313695,526,I also get great coverage under the clouds.
3980,0,3,35,38,1.0789473684210527,0.044331271812937195,526,You can use my hulu hoop until your halo arrives.
3980,0,3,35,38,1.0789473684210527,0.044331271812937195,526,"Only the willfully ignorant would fail to understand that technically it's not an ""assault halo, high powered halo, or military halo."""
3980,0,3,35,38,1.0789473684210527,0.044331271812937195,526,"Well, one day God strolled by said Hello to everyone and you know Pete is hard of hearing and so now we have to deal with these things !"
3980,0,3,35,38,1.0789473684210527,0.044331271812937195,526,"Sure, we can trade halos and I'll watch you hula hoop."
3980,0,3,35,38,1.0789473684210527,0.044331271812937195,526,Big hands.
3980,0,3,35,38,1.0789473684210527,0.044331271812937195,526,"Well yea, you know, a guy's foot, hand and halo size all are indicative . . . ."
3980,0,3,35,38,1.0789473684210527,0.044331271812937195,526,I just saw my wife skate by.
3980,1,1,36,38,1.0789473684210527,0.058204267603313695,526,"'Can we skip the obvious penis joke please?"" ' ""Can we skip the obvious penis joke please?"""
3980,1,1,36,38,1.0789473684210527,0.058204267603313695,526,"You know what they say: big halo, big oneness with the supreme eternal ineffable."
3980,1,1,36,38,1.0789473684210527,0.058204267603313695,526,"Sorry! Just like earth, the massive halo is earned only by ""the 1%""."
3980,0,3,35,38,1.0789473684210527,0.044331271812937195,526,I'm surprised your big truck didn't have better safety features.
3980,0,3,35,38,1.0789473684210527,0.044331271812937195,526,Your ego is showing.
3980,1,1,36,38,1.0789473684210527,0.058204267603313695,526,I don't think size matters up here.
3980,1,1,36,38,1.0789473684210527,0.058204267603313695,526,"Caption under girl, ""halo"" Cation under boy, ""halo"""
3980,0,3,35,38,1.0789473684210527,0.044331271812937195,526,Lucky you! You have a smaller halo to carry!
3980,0,3,35,38,1.0789473684210527,0.044331271812937195,526,"Yes, indeed ... and you must have tiny feet!"
3980,1,1,36,38,1.0789473684210527,0.058204267603313695,526,Just say no.
3980,0,3,35,38,1.0789473684210527,0.044331271812937195,526,Do we need to take our halos off too?
3980,0,3,35,38,1.0789473684210527,0.044331271812937195,526,It's a perk from my corporate board.
3980,0,3,35,38,1.0789473684210527,0.044331271812937195,526,Yes I know. You're impressed. Lifelong virginity is quite the accomplishment.
3980,0,3,35,38,1.0789473684210527,0.044331271812937195,526,I've always had trouble jumping through hoops.
3980,0,3,35,38,1.0789473684210527,0.044331271812937195,526,"Well, actually, my halo is proportional to my head size."
3980,0,3,35,38,1.0789473684210527,0.044331271812937195,526,It kink of grows on you.
3980,0,3,35,38,1.0789473684210527,0.044331271812937195,526,"Sure, it's convenient, but we just started dating."
3980,0,3,35,38,1.0789473684210527,0.044331271812937195,526,"""I see you did bigger good deeds then I did. No need to be a show off""."
3980,0,3,35,38,1.0789473684210527,0.044331271812937195,526,"My halo's bigger because I'm from Dallas, and you know what they say...everything's bigger in Texas"
3980,1,1,36,38,1.0789473684210527,0.058204267603313695,526,"To be honest,I once guarded Sinatra,then it was on to one of the Beatles,now I'm on leave from a guy named Trump."
3980,1,1,36,38,1.0789473684210527,0.058204267603313695,526,"Finally, some special treatment for professional hula-hoopers."
3980,0,3,35,38,1.0789473684210527,0.044331271812937195,526,"Yeah, I'm big on big."
3980,1,1,36,38,1.0789473684210527,0.058204267603313695,526,It's in a state of arousal
4016,0,3,36,39,1.0769230769230769,0.04322703745761662,526,I'm not really all halo and no angel.
4016,1,1,37,39,1.0769230769230769,0.05672833888524614,526,how honey im never a question of size
4016,0,3,36,39,1.0769230769230769,0.04322703745761662,526,Global Warming? That's nothing. We have a hole in the ozone layer here too...
4016,0,3,36,39,1.0769230769230769,0.04322703745761662,526,I had a head start
4016,0,3,36,39,1.0769230769230769,0.04322703745761662,526,"You got the hula-hoop on top of your head, right?"
4016,1,1,37,39,1.0769230769230769,0.05672833888524614,526,"Halo hula hoop tonight, desire for eternity."
4016,0,3,36,39,1.0769230769230769,0.04322703745761662,526,"Well, ACTUALLY..."
4016,1,1,37,39,1.0769230769230769,0.05672833888524614,526,"So I said, ""Easy, Pinky Ring. It's not a competition."""
4016,0,3,36,39,1.0769230769230769,0.04322703745761662,526,"Yes, Even up here it's true"
4016,0,3,36,39,1.0769230769230769,0.04322703745761662,526,Why do you guys always think a girl likes it big around?
4016,0,3,36,39,1.0769230769230769,0.04322703745761662,526,"I worker for the Hula Hoop company, That's why!"
4016,0,3,36,39,1.0769230769230769,0.04322703745761662,526,And Trump said I had small hands
4016,0,3,36,39,1.0769230769230769,0.04322703745761662,526,"""She still tends to over-compensate occasionally""."
4016,1,1,37,39,1.0769230769230769,0.05672833888524614,526,"Sorry, but you voted for Trump."
4016,1,1,37,39,1.0769230769230769,0.05672833888524614,526,My...what an enchanting halo. But if I remember corectly...hula-hoops eventually fall down!
4016,1,1,37,39,1.0769230769230769,0.05672833888524614,526,"Sorry, Honey, even up here male chauvinism endures!"
4016,0,3,36,39,1.0769230769230769,0.04322703745761662,526,"No, Sarah, I insist. You stay, I'll find another shoulder."
4016,0,3,36,39,1.0769230769230769,0.04322703745761662,526,All the abstaining I did down there and all I get is a little halo envy up here.
4016,1,1,37,39,1.0769230769230769,0.05672833888524614,526,"I'm in heaven and I could hardly speak, as we danced together cheek to cheek."
4016,0,3,36,39,1.0769230769230769,0.04322703745761662,526,"The Boss likes to play cornhole corn toss, he likes to win!"
4016,1,1,37,39,1.0769230769230769,0.05672833888524614,526,I shopped in the 'Big & Tall' section on earth.
4016,1,1,37,39,1.0769230769230769,0.05672833888524614,526,"Pinocchio, welcome upstairs. Watch what you say!"
4016,1,1,37,39,1.0769230769230769,0.05672833888524614,526,"''Down there size matters, up here it's obviously rewarded!"
4016,0,3,36,39,1.0769230769230769,0.04322703745761662,526,I'm like a black hole. I suck up other peoples' positive auras.
4016,0,3,36,39,1.0769230769230769,0.04322703745761662,526,"Is that you, Caitlyn?"
4016,0,3,36,39,1.0769230769230769,0.04322703745761662,526,"Hey, Baby, Would you please help me to shrink my halo?"
4016,1,1,37,39,1.0769230769230769,0.05672833888524614,526,I invented the grain bowl.
4016,1,1,37,39,1.0769230769230769,0.05672833888524614,526,What a small halo you have.
4016,0,3,36,39,1.0769230769230769,0.04322703745761662,526,"Yea...you can say I lost a few ring sizes, the angels haven't resized my halo yet though."
4016,1,1,37,39,1.0769230769230769,0.05672833888524614,526,I was the fifth grade hula hoop champion.
4016,1,1,37,39,1.0769230769230769,0.05672833888524614,526,They're coming in hula hoop size these days.
4016,1,1,37,39,1.0769230769230769,0.05672833888524614,526,But my hands are small!
4016,0,3,36,39,1.0769230769230769,0.04322703745761662,526,"Well, on earth I stayed with this woman till the end. While I was with her she challenged me in every way, by what she said, what she did. I can't say I miss her, maybe you knew her, she went by the name of Joan Rivers."
4016,0,3,36,39,1.0769230769230769,0.04322703745761662,526,I left my modesty at the pearly gates.
4016,0,3,36,39,1.0769230769230769,0.04322703745761662,526,I wish everyone would stop asking me if I also drove a sports car.
4016,1,1,37,39,1.0769230769230769,0.05672833888524614,526,"Actually,"
4016,0,3,36,39,1.0769230769230769,0.04322703745761662,526,I'm still not gonna watch Lord of the Rings with you.
4016,0,3,36,39,1.0769230769230769,0.04322703745761662,526,"I've always had people say, 'Ronald, you have the most beautiful halo and the biggest we've ever seen'."
4016,0,3,36,39,1.0769230769230769,0.04322703745761662,526,It came with the super-ego collection.
4016,0,3,36,39,1.0769230769230769,0.04322703745761662,526,"Yeah, I know...Metallica even did a song about me."
4016,0,3,36,39,1.0769230769230769,0.04322703745761662,526,Up here it's called the Ozone Diet.
4016,0,3,36,39,1.0769230769230769,0.04322703745761662,526,"Yes, I played the ""Man Card"" to get it."
4016,0,3,36,39,1.0769230769230769,0.04322703745761662,526,Just a small halo...not all men die equally
4016,1,1,37,39,1.0769230769230769,0.05672833888524614,526,I swear to God I did not do it! It does not appear that way to me Pinocchio...
4016,1,1,37,39,1.0769230769230769,0.05672833888524614,526,I'm on the hula hooping team.
4016,1,1,37,39,1.0769230769230769,0.05672833888524614,526,My halo is is special It's limited to those who have never had sex.
4016,1,1,37,39,1.0769230769230769,0.05672833888524614,526,Everybody say's I'm compensating for my small penis.
4016,0,3,36,39,1.0769230769230769,0.04322703745761662,526,I had a big head before earning my wings.
4016,1,1,37,39,1.0769230769230769,0.05672833888524614,526,Pardon my extension.
4016,0,3,36,39,1.0769230769230769,0.04322703745761662,526,I always thought I deserved a bigger ring.
4016,0,3,36,39,1.0769230769230769,0.04322703745761662,526,It seems to have a brain of it's own.
4016,1,1,37,39,1.0769230769230769,0.05672833888524614,526,I date back to the HULA HOOP generation of the 1950s.
4016,0,3,36,39,1.0769230769230769,0.04322703745761662,526,"I may have small hands, but...."
4016,0,3,36,39,1.0769230769230769,0.04322703745761662,526,"Size matters, Evermore"
4016,0,3,36,39,1.0769230769230769,0.04322703745761662,526,"Jezebel, how did you get here?"
4016,0,3,36,39,1.0769230769230769,0.04322703745761662,526,"You know what they say, ""the bigger the hoop, the bigger holy!"""
4016,1,1,37,39,1.0769230769230769,0.05672833888524614,526,The halo on top of an angel is just the size of the loophole they used to get into heaven.
4016,0,3,36,39,1.0769230769230769,0.04322703745761662,526,"its a new ""Vision Zero"" promotion"
4016,0,3,36,39,1.0769230769230769,0.04322703745761662,526,"If I knew I'd actually have to wear this ridiculous ring you got me for eternity, then I never would have said ""I do."""
4016,0,3,36,39,1.0769230769230769,0.04322703745761662,526,Is it true you don't have to brag here?
4016,0,3,36,39,1.0769230769230769,0.04322703745761662,526,Even up here you're overcompensating?
4016,0,3,36,39,1.0769230769230769,0.04322703745761662,526,Haaalo from the other side.
4016,0,3,36,39,1.0769230769230769,0.04322703745761662,526,"I'll be straight with you. I'm a member of the PHP, the Pinocchio Halo Program."
4016,1,1,37,39,1.0769230769230769,0.05672833888524614,526,I suppose my halo-lujah was just haloier than most.
4016,1,1,37,39,1.0769230769230769,0.05672833888524614,526,The big halo is about to shrink!
4016,0,3,36,39,1.0769230769230769,0.04322703745761662,526,(Her)Ummmm...so we meet again...I thought you were going to the other place! ....(Him)What other place? (Her) U know! The other place?!
4016,0,3,36,39,1.0769230769230769,0.04322703745761662,526,eharmony.god says we're a Heavenly mismatch.
4016,0,3,36,39,1.0769230769230769,0.04322703745761662,526,I didn't think size mattered in heaven!
4016,0,3,36,39,1.0769230769230769,0.04322703745761662,526,"Yeah baby, you are in heaven. And what you heard about halo size and, let us say the ability of an angel to redeem, is true."
4016,1,1,37,39,1.0769230769230769,0.05672833888524614,526,What? You thought you'd get away from capitalist pricks?
4016,0,3,36,39,1.0769230769230769,0.04322703745761662,526,"Somehow, I thought there might be more of you here!"
4016,0,3,36,39,1.0769230769230769,0.04322703745761662,526,I was hoping size matters in heaven.
4016,0,3,36,39,1.0769230769230769,0.04322703745761662,526,"Benifet of my clean living--on weekends, I get to use it as a hula hoop."
4016,1,1,37,39,1.0769230769230769,0.05672833888524614,526,"He said he didn't need it, would go it alone. . . And do very, very well."
4016,0,3,36,39,1.0769230769230769,0.04322703745761662,526,I drove a Hummer in my past life
4016,1,1,37,39,1.0769230769230769,0.05672833888524614,526,This is how I compensate for small hands.
4016,0,3,36,39,1.0769230769230769,0.04322703745761662,526,"You see, they correlate your halo size to the size of your ego."
4016,1,1,37,39,1.0769230769230769,0.05672833888524614,526,Sure it suits you - but size really does matter
4016,0,3,36,39,1.0769230769230769,0.04322703745761662,526,"You know what they say, Big Head, Big Halo...."
4016,1,1,37,39,1.0769230769230769,0.05672833888524614,526,"You're right, from the 1%."
4016,1,1,37,39,1.0769230769230769,0.05672833888524614,526,"I'm sorry hun, but nothing changes if nothing changes."
4016,0,3,36,39,1.0769230769230769,0.04322703745761662,526,"Mansplaining? No way. I was born with that, ma'am."
4016,1,1,37,39,1.0769230769230769,0.05672833888524614,526,You mean I have to start over because I did not press the submit button?
4016,1,1,37,39,1.0769230769230769,0.05672833888524614,526,"I did succumb to the weaknesses of the flesh, but, I guess God cut me some slack for all my contributions to the church. To be perfectly honest, I would jump your bones right now, but I'm without funds for further contributions."
4016,0,3,36,39,1.0769230769230769,0.04322703745761662,526,I was always better at hula hoop than you were.
4016,0,3,36,39,1.0769230769230769,0.04322703745761662,526,What? They promoted me to director level last week.
4016,1,1,37,39,1.0769230769230769,0.05672833888524614,526,I take it your harp is well-strung.
4103,0,3,37,40,1.075,0.04217636961434866,526,"Hot yoga, baby!"
4103,0,3,37,40,1.075,0.04217636961434866,526,Even up here size matters.
4103,0,3,37,40,1.075,0.04217636961434866,526,"You need to catch up with the times, everything has just grown larger and larger, screens, fruit, corporations, and now halos too!"
4103,0,3,37,40,1.075,0.04217636961434866,526,You feel the Bern up? I just hate your holier than thou attitude.
4103,0,3,37,40,1.075,0.04217636961434866,526,"It is hardly ythe ""blessing"" one would think it should be."
4103,1,1,38,40,1.075,0.055325377864931344,526,"I know. They say it's usually the size of your hand, but not in heaven!"
4103,0,3,37,40,1.075,0.04217636961434866,526,"My ""holier than thou"" attitude is easily explained."
4103,0,3,37,40,1.075,0.04217636961434866,526,Why don't you go to the Boss and ask for a smaller halo?
4103,0,3,37,40,1.075,0.04217636961434866,526,"Oh big hoop, big whoop."
4103,0,3,37,40,1.075,0.04217636961434866,526,Compensating for something?
4103,0,3,37,40,1.075,0.04217636961434866,526,I'm guessing your a Virgo
4103,0,3,37,40,1.075,0.04217636961434866,526,I crossed over with High Honesty
4103,0,3,37,40,1.075,0.04217636961434866,526,I'm a feminist
4103,1,1,38,40,1.075,0.055325377864931344,526,Is that a halo on your head or do you love me?
4103,0,3,37,40,1.075,0.04217636961434866,526,Where were you all my life?
4103,0,3,37,40,1.075,0.04217636961434866,526,"Bummer, I was kinda hoping we wouldn't meet again!"
4103,0,3,37,40,1.075,0.04217636961434866,526,"""As tight as Dick's hatband"" didn't have the same ring after he died."
4103,1,1,38,40,1.075,0.055325377864931344,526,So much for all those people who said the only problem with me is that my halo is too tight.
4103,0,3,37,40,1.075,0.04217636961434866,526,It combines Pilates and Hoola-hooping for a whole new holistic approach to fitness.
4103,1,1,38,40,1.075,0.055325377864931344,526,Where did you get that hula hoop?
4103,1,1,38,40,1.075,0.055325377864931344,526,"Is it actually you, ZEUS!!! Oh my god I am the biggest fan can o have your autograph. Uh I have no hands."
4103,0,3,37,40,1.075,0.04217636961434866,526,This is nothing. You should see the Boss's mancave.
4103,0,3,37,40,1.075,0.04217636961434866,526,"Honey, I told you to stop for directions."
4103,0,3,37,40,1.075,0.04217636961434866,526,"Yes, I supported Trump. Why do you ask?"
4103,1,1,38,40,1.075,0.055325377864931344,526,"That's one of the nice things. I mean, part of the beauty of me is that I'm very rich."
4103,1,1,38,40,1.075,0.055325377864931344,526,The big halos can double as hula hoops.
4103,0,3,37,40,1.075,0.04217636961434866,526,Does this mean I'm going to hell?
4103,1,1,38,40,1.075,0.055325377864931344,526,"No, its the Donald Trump model and it only looks like a hula hoop..."
4103,0,3,37,40,1.075,0.04217636961434866,526,"Well, yeah, and I have big hands, too - really big hands!"
4103,1,1,38,40,1.075,0.055325377864931344,526,Halo there!
4103,0,3,37,40,1.075,0.04217636961434866,526,"No, up here it’s THE standard. No one pays any attention to that trumpery about height or the size of feet, hands, adam’s apples, or noses."
4103,0,3,37,40,1.075,0.04217636961434866,526,How we got pizza.
4103,0,3,37,40,1.075,0.04217636961434866,526,The Super-sized version accommodates one's ego.
4103,0,3,37,40,1.075,0.04217636961434866,526,I never skip Halo Day.
4103,0,3,37,40,1.075,0.04217636961434866,526,A glass what?
4103,0,3,37,40,1.075,0.04217636961434866,526,Mine's big enough for two.
4103,0,3,37,40,1.075,0.04217636961434866,526,"Cute headpiece, but mine doubles as a halo hoop. Wham-O!"
4103,0,3,37,40,1.075,0.04217636961434866,526,We're headed over to the community garden.
4103,0,3,37,40,1.075,0.04217636961434866,526,I spent my whole life dreaming of you.
4103,1,1,38,40,1.075,0.055325377864931344,526,Wanna shag?
4103,0,3,37,40,1.075,0.04217636961434866,526,"Surely, you didn't expect me to wait 10 years for you Billy?"
4103,1,1,38,40,1.075,0.055325377864931344,526,I got here by playing 'portal'.
4103,0,3,37,40,1.075,0.04217636961434866,526,"Pinocchio? No?,,,,,"
4103,0,3,37,40,1.075,0.04217636961434866,526,It's not my attitude. I was a big fundaiser for the Clinton's and Obama.
4103,0,3,37,40,1.075,0.04217636961434866,526,I promised you heaven. I now need to enhance my promise.
4103,0,3,37,40,1.075,0.04217636961434866,526,...And you should have seen the size of my feet when I was mortal.
4103,0,3,37,40,1.075,0.04217636961434866,526,"That's right: big feet, big halo; everything else in proportion."
4103,0,3,37,40,1.075,0.04217636961434866,526,down there i accepted the pay gap but i didnt think there be would be a halo gap up here
4103,0,3,37,40,1.075,0.04217636961434866,526,Their is no truth to the theory that the size of your halo is in direct proportion to your ego.
4103,0,3,37,40,1.075,0.04217636961434866,526,"Nah, I still won't believe it until I see the size of your hands."
4103,1,1,38,40,1.075,0.055325377864931344,526,"That neckline is so last millennium, but we'll let you in anyway."
4103,0,3,37,40,1.075,0.04217636961434866,526,"Its tempting, but I would lose several places in the halo competition ."
4103,0,3,37,40,1.075,0.04217636961434866,526,"Finally, being a straight, white male has its advantages!"
4103,1,1,38,40,1.075,0.055325377864931344,526,Can we go back to the French maid role play?
4103,0,3,37,40,1.075,0.04217636961434866,526,Til death don't us part.
4103,1,1,38,40,1.075,0.055325377864931344,526,"Yeah, I ran into Hulk Hogan over in hell the other day and even he was impressed."
4103,1,1,38,40,1.075,0.055325377864931344,526,God knows we need it.
4103,1,1,38,40,1.075,0.055325377864931344,526,Perfect. We're all single in Heaven. But of course my halo is bigger than yours.
4103,0,3,37,40,1.075,0.04217636961434866,526,"You are kinda cute. But get rid of that funny thing, it's way to big for you."
4103,1,1,38,40,1.075,0.055325377864931344,526,You know what they say: the bigger the size of an angel's halo. . .
4103,0,3,37,40,1.075,0.04217636961434866,526,"Really my first time, right."
4103,1,1,38,40,1.075,0.055325377864931344,526,How do you like me so far? Don't rush. I have lots of time...
4103,0,3,37,40,1.075,0.04217636961434866,526,"The more I mansplain, the larger it grows."
4103,1,1,38,40,1.075,0.055325377864931344,526,I was faithful! Are you sure?
4103,0,3,37,40,1.075,0.04217636961434866,526,I funded my charitable foundation with the fortune I made selling male enhancement products on the Internet.
4103,0,3,37,40,1.075,0.04217636961434866,526,It is my last chance to break the glass ceiling
4103,0,3,37,40,1.075,0.04217636961434866,526,"Not to brag, but I won the hula hoop contest in Not to brag but I won the hula hoop contest for those here 5000 - 6000 years."
4103,0,3,37,40,1.075,0.04217636961434866,526,I wasn't notified that ICloud was not available in my country.
4103,0,3,37,40,1.075,0.04217636961434866,526,Someone got their wings clipped?
4103,0,3,37,40,1.075,0.04217636961434866,526,My monster from the id
4103,1,1,38,40,1.075,0.055325377864931344,526,"Even here, size still matters."
4103,0,3,37,40,1.075,0.04217636961434866,526,Don't judge a man by his halo.
4103,0,3,37,40,1.075,0.04217636961434866,526,You know the old saying.
4103,0,3,37,40,1.075,0.04217636961434866,526,Is it true what they say?
4103,0,3,37,40,1.075,0.04217636961434866,526,"For not being greedy. Anyway, I think it's ironically hilarious."
4103,0,3,37,40,1.075,0.04217636961434866,526,"Darling it's not just a shameless pickup line, many have fallen for this halo"
4103,0,3,37,40,1.075,0.04217636961434866,526,"Did it hurt? When you.....well, crap."
4103,1,1,38,40,1.075,0.055325377864931344,526,"Yes, but you'll notice they took away my over-sized sweat pants."
4103,1,1,38,40,1.075,0.055325377864931344,526,"A hula hoop..?! Well, mine can be used as a diaphragm."
4103,0,3,37,40,1.075,0.04217636961434866,526,Sometimes size can be a detriment
4103,1,1,38,40,1.075,0.055325377864931344,526,Hmm .. I was hoping for more
4103,0,3,37,40,1.075,0.04217636961434866,526,I'm just saying!
4103,0,3,37,40,1.075,0.04217636961434866,526,I got it for pleasing women.
4103,0,3,37,40,1.075,0.04217636961434866,526,"Freedom from sinning is decreed here, I know, but let's ask for just one little exception!"
4103,0,3,37,40,1.075,0.04217636961434866,526,Perhaps we can just reminisce about what once was
4103,0,3,37,40,1.075,0.04217636961434866,526,"I got mine at the ""BIG DICOUNT STORE"" in the mall."
4103,1,1,38,40,1.075,0.055325377864931344,526,"Small halo, large wings, you are my dream angel!"
4103,1,1,38,40,1.075,0.055325377864931344,526,Heaven is retro hetro? Can you refer me to Rebirths?
4103,0,3,37,40,1.075,0.04217636961434866,526,Can I interest you in the Bernie Sanders Revolution?
4103,0,3,37,40,1.075,0.04217636961434866,526,Hey! this beats living in our retirement community.
4103,0,3,37,40,1.075,0.04217636961434866,526,Just call me…trans-halo.
4103,0,3,37,40,1.075,0.04217636961434866,526,"I am Donald Trump, and I approve of this message."
4103,1,1,38,40,1.075,0.055325377864931344,526,Did I know him?
4103,1,1,38,40,1.075,0.055325377864931344,526,I guess I'm still compensating.
4103,0,3,37,40,1.075,0.04217636961434866,526,Do you think I have what it takes to be a guardian?
4103,1,1,38,40,1.075,0.055325377864931344,526,"It's the lack of equal pay for equal work . . . and vox populi, vox Dei!"
4103,0,3,37,40,1.075,0.04217636961434866,526,Where am I from? Orlando.
4103,0,3,37,40,1.075,0.04217636961434866,526,"I paid to be at the front of the line, just like Disneyland."
4103,1,1,38,40,1.075,0.055325377864931344,526,"Uh, could you direct me to the gender-neutral restroom?"
4103,0,3,37,40,1.075,0.04217636961434866,526,"The truth is, it's closer to 92%. (Blau/Kahn, Cornell. 2016)"
4103,0,3,37,40,1.075,0.04217636961434866,526,"One look at you, things just grew, it's why I knew I am no angel, boo-hoo-hoo."
4103,0,3,37,40,1.075,0.04217636961434866,526,I know. You know who we are. I'm gay. God's punishment. Right.
4103,1,1,38,40,1.075,0.055325377864931344,526,"Not even with a female President, girlfriend!"
4103,0,3,37,40,1.075,0.04217636961434866,526,Can we ever be compatible???
4103,1,1,38,40,1.075,0.055325377864931344,526,"The illumination is wonderful with a halo this large but it must also be nice to have a small halo like yours for the times when the soul wants some privacy. Anyway, are you seeing anyone? If not, wanna get together sometime?"
4103,0,3,37,40,1.075,0.04217636961434866,526,What have you done this time?
4103,1,1,38,40,1.075,0.055325377864931344,526,"So, size does matter, even in heaven!"
4210,0,3,38,41,1.0731707317073171,0.04117547077105886,526,"But, how?! I made sure that nobody was watching."
4210,0,3,38,41,1.0731707317073171,0.04117547077105886,526,A freak hula hoop accident. You?.
4210,0,3,38,41,1.0731707317073171,0.04117547077105886,526,"You wanted a bigger halo, yes it is razor sharp."
4210,0,3,38,41,1.0731707317073171,0.04117547077105886,526,"Well, we couldn't do window offices."
4210,1,1,39,41,1.0731707317073171,0.05399010639311867,526,"The last woman who gave me that look, called me a ""spreader"" and knifed me on the subway."
4210,0,3,38,41,1.0731707317073171,0.04117547077105886,526,Cause if you liked it then you should have put a ring on it
4210,0,3,38,41,1.0731707317073171,0.04117547077105886,526,He likes to go off-road.
4210,0,3,38,41,1.0731707317073171,0.04117547077105886,526,"Just the opposite, regrettably. They named this the ""holier-than -thou"" halo for a reason."
4210,1,1,39,41,1.0731707317073171,0.05399010639311867,526,Johnny. I' m sorry but size doesnt matter up here.
4210,0,3,38,41,1.0731707317073171,0.04117547077105886,526,"You've got a big one!"" ""Actually, Hula Hoop Champ 1979"
4210,0,3,38,41,1.0731707317073171,0.04117547077105886,526,"Than thou, moi?"
4210,1,1,39,41,1.0731707317073171,0.05399010639311867,526,You were great in that - I was the lighting director.
4210,0,3,38,41,1.0731707317073171,0.04117547077105886,526,Maybe it explains the small hands?
4210,1,1,39,41,1.0731707317073171,0.05399010639311867,526,Frank! Is that YOU?
4210,0,3,38,41,1.0731707317073171,0.04117547077105886,526,I guess I've always been hole-y.
4210,0,3,38,41,1.0731707317073171,0.04117547077105886,526,I had to be very good. I have small hands.
4210,0,3,38,41,1.0731707317073171,0.04117547077105886,526,"Oh St. Peter's gay, alright--he was definitely flirting with me. Just take one look at this ridiculous halo I got. I heard from Linda that's why they make him stand outside the gates."
4210,0,3,38,41,1.0731707317073171,0.04117547077105886,526,"No, it is not indicative of the size of anything else!"
4210,1,1,39,41,1.0731707317073171,0.05399010639311867,526,"No, the restrooms are not gender specific."
4210,1,1,39,41,1.0731707317073171,0.05399010639311867,526,Compensating much?
4210,1,1,39,41,1.0731707317073171,0.05399010639311867,526,"You were right, Bigger isn't always better-A W K W A R D !"
4210,0,3,38,41,1.0731707317073171,0.04117547077105886,526,I have waited all my life to marry you.
4210,0,3,38,41,1.0731707317073171,0.04117547077105886,526,These wings are detachable.
4233,1,1,40,42,1.0714285714285714,0.05271774316741633,526,I biggie sized it.
4233,0,3,39,42,1.0714285714285714,0.04022089331224806,526,Because I have finally faced the reality that you will be taller than me for all eternity!!
4233,0,3,39,42,1.0714285714285714,0.04022089331224806,526,"$18.95 for my large pizza, how much for your small?"
4233,0,3,39,42,1.0714285714285714,0.04022089331224806,526,"Actually, no; my halo size is not proportional to my tendency to 'mangelsplain.'"
4233,1,1,40,42,1.0714285714285714,0.05271774316741633,526,I'm sorry. It appears that my attitude reflected reality. I AM holier than thou.
4238,0,2,32,34,1.0588235294117647,0.0409594484601642,526,"Your ring is bigger than mine."" ""Of course. Because I am Zeus, king of the gods."
4238,0,2,32,34,1.0588235294117647,0.0409594484601642,526,I understand what She said but I would still like to make a case for bigger is better.
4240,0,2,33,35,1.0571428571428572,0.039807459772527774,526,You can tell I am Mr. Right based on the size of my halo!
4240,0,2,33,35,1.0571428571428572,0.039807459772527774,526,Just wait until you see the orthopedist.
4242,1,0,35,36,1.0555555555555556,0.05555555555555553,526,You see I'm special. My waist and halo are the same size.
4242,0,2,34,36,1.0555555555555556,0.0387184473576205,526,"Yeah, so, I've been working sort of behind the scenes on getting out the vote, particularly in areas traditionally underrepresented in the, you know, political arena, as well as. . . ."
4242,0,2,34,36,1.0555555555555556,0.0387184473576205,526,So I told Pete that perfection is in the eye of the beholder. I'm sure you agree with me.
4242,1,0,35,36,1.0555555555555556,0.05555555555555553,526,It's the biggest one here.
4242,0,2,34,36,1.0555555555555556,0.0387184473576205,526,Sorry about those herpes.
4242,0,2,34,36,1.0555555555555556,0.0387184473576205,526,So size does matter after all.
4242,1,0,35,36,1.0555555555555556,0.05555555555555553,526,See? I KNEW you were dishonest about having an affair during our final years of marriage. Your halo grows when you tell lies...
4242,0,2,34,36,1.0555555555555556,0.0387184473576205,526,It has to be this wide so it doesn't crush my giant angel nuts.
4242,0,2,34,36,1.0555555555555556,0.0387184473576205,526,"I'm not saying anything, but... when you flood the entire planet, people wonder if you're compensating for something."
4242,0,2,34,36,1.0555555555555556,0.0387184473576205,526,"Of course, I will always treat you as an equal."
4242,1,0,35,36,1.0555555555555556,0.05555555555555553,526,I used to work for Colgate.
4242,1,0,35,36,1.0555555555555556,0.05555555555555553,526,Turns out what he actually said was that the meek would inherit wide girth.
4242,0,2,34,36,1.0555555555555556,0.0387184473576205,526,"And then Gabriel shot back at me, 'well, you always did have that ""holier-than-thou"" attitude...'"
4255,0,2,35,37,1.054054054054054,0.03768738858261605,526,It's just a lot easier for a woman to remain pure. That's why.
4255,0,2,35,37,1.054054054054054,0.03768738858261605,526,"Brace yourself for a little too much ""in your face"" reality up here!"
4255,0,2,35,37,1.054054054054054,0.03768738858261605,526,"And then, she made me an Archangel."
4255,0,2,35,37,1.054054054054054,0.03768738858261605,526,"If we were on earth these days, I could demand equality now"
4255,0,2,35,37,1.054054054054054,0.03768738858261605,526,It was all that time off for good behavior.
4255,0,2,35,37,1.054054054054054,0.03768738858261605,526,As a Boy Scout I did my duty to God and my Country.
4255,0,2,35,37,1.054054054054054,0.03768738858261605,526,It’s obvious which candidates we are guardian angels of.
4255,0,2,35,37,1.054054054054054,0.03768738858261605,526,"I was hit by lightning while pulling a Macy's Thanksgiving Parade balloon, but it doesn't mean I'm too good for you."
4255,1,0,36,37,1.054054054054054,0.05405405405405408,526,Bruce's would have been bigger.
4255,0,2,35,37,1.054054054054054,0.03768738858261605,526,It's actually a portal to a higher level ... so good luck.
4255,0,2,35,37,1.054054054054054,0.03768738858261605,526,This is just temporary until one in my size comes back from the fallen angel department.
4255,0,2,35,37,1.054054054054054,0.03768738858261605,526,Great. I make it all the way here and I still have to deal with manspreading.
4255,0,2,35,37,1.054054054054054,0.03768738858261605,526,Yes... You are right... Large halo... Large hands... and Large... Well... you know...
4255,0,2,35,37,1.054054054054054,0.03768738858261605,526,"I was going to stretch my lobes, but they were having a special."
4255,1,0,36,37,1.054054054054054,0.05405405405405408,526,"Sorry, I'm really into the big ""O""."
4255,0,2,35,37,1.054054054054054,0.03768738858261605,526,"Halo, everybody, Halo! Halo is the shampoo that glorifies your hair! So, Halo, everybody! Halo!"
4255,0,2,35,37,1.054054054054054,0.03768738858261605,526,Halo.” “Smoke ring.
4255,0,2,35,37,1.054054054054054,0.03768738858261605,526,"It's the only one they had that would fit a guy who graduated valedictorian, was the most brilliant student ever to graduate from Yale, and who had a career that was the envy of every Nobel Laureate."
4255,1,0,36,37,1.054054054054054,0.05405405405405408,526,"It's om the ""Mom's View"" setting."
4255,0,2,35,37,1.054054054054054,0.03768738858261605,526,"Since yours is bigger than mine, you go first."
4255,0,2,35,37,1.054054054054054,0.03768738858261605,526,Wow! It wasn't hard to get God' forgiveness!
4255,0,2,35,37,1.054054054054054,0.03768738858261605,526,Do you really think we'll succeed this time? It seems to me the only thing different is my halo's bigger...
4255,0,2,35,37,1.054054054054054,0.03768738858261605,526,"Purity, can still be very revealing."
4255,0,2,35,37,1.054054054054054,0.03768738858261605,526,How much do the gates of heaven weight? Enough to break the ice?
4255,0,2,35,37,1.054054054054054,0.03768738858261605,526,"You know what they say you can tell from the size of a man's halo? Well, don't mention it up here, or we'll spend eternity screaming in a lake of fire."
4255,0,2,35,37,1.054054054054054,0.03768738858261605,526,"If I don't get control of my overhead, I'm going down ... going down!"""
4255,0,2,35,37,1.054054054054054,0.03768738858261605,526,I borrowed this from the BFG
4255,0,2,35,37,1.054054054054054,0.03768738858261605,526,Don't you think the hula-hoop halo is over-kill? Ooops sorry.
4255,0,2,35,37,1.054054054054054,0.03768738858261605,526,Have you heard from Adam and Eve?
4255,0,2,35,37,1.054054054054054,0.03768738858261605,526,"I got into a prank war with the apostles, and now I'm bumping halos with everyone."
4255,0,2,35,37,1.054054054054054,0.03768738858261605,526,Bigger is not necessarily better.
4255,0,2,35,37,1.054054054054054,0.03768738858261605,526,"We good boys play the long game, Julie..."
4255,0,2,35,37,1.054054054054054,0.03768738858261605,526,"Big head, big halo"
4255,0,2,35,37,1.054054054054054,0.03768738858261605,526,It's just us on angeldate...everyone else cheated.
4255,0,2,35,37,1.054054054054054,0.03768738858261605,526,....you see it's all in proportion.....
4255,0,2,35,37,1.054054054054054,0.03768738858261605,526,It's now called Halo to the Chief.
4255,1,0,36,37,1.054054054054054,0.05405405405405408,526,I used to drive a heavy-duty F-150.
4255,0,2,35,37,1.054054054054054,0.03768738858261605,526,"You have to wait at least 10 years before you increase your gauge. If you get a blowout, you're outta here."
4255,0,2,35,37,1.054054054054054,0.03768738858261605,526,At first I hated it. Then I discovered the joys of hoola-hoop.
4255,0,2,35,37,1.054054054054054,0.03768738858261605,526,You're hot enough for that not to matter.
4255,1,0,36,37,1.054054054054054,0.05405405405405408,526,"You can""t hula hoop with that size."
4296,0,2,36,38,1.0526315789473684,0.0367097806559429,526,"Gender quality? That's for humans, not for us, sweet heart!"
4296,0,2,36,38,1.0526315789473684,0.0367097806559429,526,You make my halo shrink!
4296,0,2,36,38,1.0526315789473684,0.0367097806559429,526,I'm afraid it's the inverse...
4296,0,2,36,38,1.0526315789473684,0.0367097806559429,526,Couldn't be helped. Only ones left on the rack were XL. I couldn't wait for a rain-check.
4296,0,2,36,38,1.0526315789473684,0.0367097806559429,526,"We're in heaven, so let's sin away."
4296,0,2,36,38,1.0526315789473684,0.0367097806559429,526,"Understandable response to the crack in the glass ceiling, right?"
4296,0,2,36,38,1.0526315789473684,0.0367097806559429,526,"Oh, I didn't expect to see you here."
4296,0,2,36,38,1.0526315789473684,0.0367097806559429,526,"Cynthia, will you merry me to love each other till death us ...hmm: what is it up here?"
4296,0,2,36,38,1.0526315789473684,0.0367097806559429,526,There's a new patron saint of gymnasts in town.
4296,1,0,37,38,1.0526315789473684,0.0526315789473684,526,"I told you we would be together someday, sweetheart."
4296,0,2,36,38,1.0526315789473684,0.0367097806559429,526,"You can stretch yours out, just like mine. You just pull it down over your head, wriggle it over your wings, and slide it to pin your wrists against your thighs. Here, let me help you with that!"
4296,0,2,36,38,1.0526315789473684,0.0367097806559429,526,Welcome Mr. Trump.
4296,0,2,36,38,1.0526315789473684,0.0367097806559429,526,This was a limited edition early bird on Kickstarter.
4296,0,2,36,38,1.0526315789473684,0.0367097806559429,526,Do you know where they keep the books of inspirational hymns?
4296,0,2,36,38,1.0526315789473684,0.0367097806559429,526,That Snapple had turned.
4296,0,2,36,38,1.0526315789473684,0.0367097806559429,526,I just won a bet with the Big Guy regarding the USA election.
4296,0,2,36,38,1.0526315789473684,0.0367097806559429,526,Yup - I'm the Hula Hoop guy.
4296,0,2,36,38,1.0526315789473684,0.0367097806559429,526,"I confess. It's Halo-Large, for daily use."
4296,0,2,36,38,1.0526315789473684,0.0367097806559429,526,This Halo model is hard to live up too!
4296,1,0,37,38,1.0526315789473684,0.0526315789473684,526,Conditional entry. Guess which cardinal sin St. Peter says ...
4296,0,2,36,38,1.0526315789473684,0.0367097806559429,526,"I know mine's a bit grubby, but it's so awkward getting it off with these damned wings."
4296,0,2,36,38,1.0526315789473684,0.0367097806559429,526,Angie greets her Rodeo husband in Heaven
4296,0,2,36,38,1.0526315789473684,0.0367097806559429,526,"Of course, you know what they say...big halo, big..."
4296,0,2,36,38,1.0526315789473684,0.0367097806559429,526,Even God thinks he has a big head!
4296,0,2,36,38,1.0526315789473684,0.0367097806559429,526,"My halo is bigger than your halo, so there!"
4296,0,2,36,38,1.0526315789473684,0.0367097806559429,526,...and then Jesus and Paul told me my explanation was quite the Revelation...
4296,0,2,36,38,1.0526315789473684,0.0367097806559429,526,"Even with Halos, ""Size Does Matter""."
4296,0,2,36,38,1.0526315789473684,0.0367097806559429,526,Size matters in the hula hooping community.
4296,1,0,37,38,1.0526315789473684,0.0526315789473684,526,You know what they say about the size of a halo; it's all true.
4296,0,2,36,38,1.0526315789473684,0.0367097806559429,526,"Ok, so your wings are bigger."
4296,0,2,36,38,1.0526315789473684,0.0367097806559429,526,"I said I was a Giants fan, not a giant!"
4296,0,2,36,38,1.0526315789473684,0.0367097806559429,526,"I told you, Bob. It's how you use it."
4296,0,2,36,38,1.0526315789473684,0.0367097806559429,526,"It's okay, but I've totally lost my break-dance head spins."
4296,0,2,36,38,1.0526315789473684,0.0367097806559429,526,I gotta leave now.
4296,0,2,36,38,1.0526315789473684,0.0367097806559429,526,It turns out size does matter after all.
4296,0,2,36,38,1.0526315789473684,0.0367097806559429,526,"Personally, I'm pleased you broke the internet."
4296,0,2,36,38,1.0526315789473684,0.0367097806559429,526,"Once again, Archangel Gabriel attracts a comely angel with his ""holier than thou"" look."
4296,0,2,36,38,1.0526315789473684,0.0367097806559429,526,my ego is too big for heaven
4296,0,2,36,38,1.0526315789473684,0.0367097806559429,526,I am sorry but you need a Calvin Klein gown to get in
4296,0,2,36,38,1.0526315789473684,0.0367097806559429,526,Naw. I really wasn't very good at hula hoops.
4296,0,2,36,38,1.0526315789473684,0.0367097806559429,526,My twin brother was a huge jerk.
4296,0,2,36,38,1.0526315789473684,0.0367097806559429,526,"""See, I told you our behavior was blessed""."
4296,0,2,36,38,1.0526315789473684,0.0367097806559429,526,You're right. Size still doesn't matter.
4296,0,2,36,38,1.0526315789473684,0.0367097806559429,526,He remembered I used to be the hoola-hoop champion
4296,0,2,36,38,1.0526315789473684,0.0367097806559429,526,"A date?! Well...I would, but your halo is a little too hole-y."
4296,0,2,36,38,1.0526315789473684,0.0367097806559429,526,I knew it! So it WAS more than once.
4296,0,2,36,38,1.0526315789473684,0.0367097806559429,526,Why would you think legacy is how I got here?
4296,0,2,36,38,1.0526315789473684,0.0367097806559429,526,It's called the penis effect...
4296,1,0,37,38,1.0526315789473684,0.0526315789473684,526,My halo size matches my hand size which matches my 'special purpose' size!
4296,0,2,36,38,1.0526315789473684,0.0367097806559429,526,"He actually apologized for the small hands faux pas, and hoped this would make up for it."
4296,0,2,36,38,1.0526315789473684,0.0367097806559429,526,You must be overcompensating for something!
4296,0,2,36,38,1.0526315789473684,0.0367097806559429,526,"FLIRTING IN HEAVEN: ""Same with me when I got here. There's no gain without pain. You got to stretch that baby, and get it limber, so you can toss it around like a hula hoop. You wanna see?"""
4296,0,2,36,38,1.0526315789473684,0.0367097806559429,526,I was yhhhuge down there too.
4296,1,0,37,38,1.0526315789473684,0.0526315789473684,526,People prefer men
4296,0,2,36,38,1.0526315789473684,0.0367097806559429,526,HALO - R-US....NO DOUBT....
4296,0,2,36,38,1.0526315789473684,0.0367097806559429,526,Your halo is only 70% as big as mine.
4296,0,2,36,38,1.0526315789473684,0.0367097806559429,526,I'm very important here and would like to take you under my wing!
4296,0,2,36,38,1.0526315789473684,0.0367097806559429,526,"Since we live forever, it just keeps getting bigger. Kinda like our ears before we died."
4296,0,2,36,38,1.0526315789473684,0.0367097806559429,526,"Mine's a halo hoop, not a thought-equivalent balloon."
4296,0,2,36,38,1.0526315789473684,0.0367097806559429,526,"You'd think that up here, our halos would be equal."
4296,0,2,36,38,1.0526315789473684,0.0367097806559429,526,"I apologize. Heaven knows why my order for a small,humble halo got switched to this horrendous hula hoop."
4296,0,2,36,38,1.0526315789473684,0.0367097806559429,526,Maybe it's because I served 15 years in the peace corps
4296,0,2,36,38,1.0526315789473684,0.0367097806559429,526,"Unfortunately, size doesn't matter here."
4296,1,0,37,38,1.0526315789473684,0.0526315789473684,526,So much for breaking the glass ceiling!
4296,0,2,36,38,1.0526315789473684,0.0367097806559429,526,"You know what they say. The bigger the halo, the bigger the . . . Oh, never mind."
4296,0,2,36,38,1.0526315789473684,0.0367097806559429,526,I opted for the super-size me.
4296,0,2,36,38,1.0526315789473684,0.0367097806559429,526,It is sort of like the size of your hands
4296,0,2,36,38,1.0526315789473684,0.0367097806559429,526,"That's right, another glass ceiling mountain to climb. Don't worry, this time you have all eternity to get there."
4296,0,2,36,38,1.0526315789473684,0.0367097806559429,526,"But Gabriel, I can't find my sword anywhere."
4296,0,2,36,38,1.0526315789473684,0.0367097806559429,526,...but I'd have to leave here.
4296,0,2,36,38,1.0526315789473684,0.0367097806559429,526,It's the hole in my imagination
4296,0,2,36,38,1.0526315789473684,0.0367097806559429,526,Wow! You must be best friends with the halo- maker!
4296,0,2,36,38,1.0526315789473684,0.0367097806559429,526,"Sorry I'm late, I was having sudden misgivings on murder-suicide."
4296,0,2,36,38,1.0526315789473684,0.0367097806559429,526,His standards were a bit higher in the 30's.
4296,0,2,36,38,1.0526315789473684,0.0367097806559429,526,Want a Bite of My Apple?
4296,0,2,36,38,1.0526315789473684,0.0367097806559429,526,What's a nice girl like you doing in a place like this?
4296,0,2,36,38,1.0526315789473684,0.0367097806559429,526,I was a fisherman.
4296,0,2,36,38,1.0526315789473684,0.0367097806559429,526,I opted for the hula hoop to try to get in shape!
4296,0,2,36,38,1.0526315789473684,0.0367097806559429,526,You mean size counts...up here?
4296,0,2,36,38,1.0526315789473684,0.0367097806559429,526,"You know what they say: Big halo, big goldenrod."
4296,0,2,36,38,1.0526315789473684,0.0367097806559429,526,"My fingers are big, too!"
4296,1,0,37,38,1.0526315789473684,0.0526315789473684,526,See Alice?
4296,0,2,36,38,1.0526315789473684,0.0367097806559429,526,"Size does matter, I promise I won't disappoint."
4296,0,2,36,38,1.0526315789473684,0.0367097806559429,526,"Hi Darling!!! You know what they say about an Angle that has a BIG HALO, also has a BIG ****. Do want to go my cloud and listen to some harp music on my stereo???"
4296,0,2,36,38,1.0526315789473684,0.0367097806559429,526,I died selling Viagra.
4296,1,0,37,38,1.0526315789473684,0.0526315789473684,526,I just never found the right woman – until now !
4296,0,2,36,38,1.0526315789473684,0.0367097806559429,526,I knew it!
4296,0,2,36,38,1.0526315789473684,0.0367097806559429,526,It's a new filter.
4296,0,2,36,38,1.0526315789473684,0.0367097806559429,526,So size really does matter!
4296,0,2,36,38,1.0526315789473684,0.0367097806559429,526,Because I almost choked on my last one.
4296,0,2,36,38,1.0526315789473684,0.0367097806559429,526,Yah Gods my wing-angel
4296,1,0,37,38,1.0526315789473684,0.0526315789473684,526,Why were we so dishonest?
4296,0,2,36,38,1.0526315789473684,0.0367097806559429,526,Why yes I did marketing for a fast food chain
4296,1,0,37,38,1.0526315789473684,0.0526315789473684,526,I'm a throwback from the glass ceiling.
4296,0,2,36,38,1.0526315789473684,0.0367097806559429,526,I guess you could say I followed all of The Rules.
4296,0,2,36,38,1.0526315789473684,0.0367097806559429,526,"And so, finally being big in some ways is paying off."
4296,0,2,36,38,1.0526315789473684,0.0367097806559429,526,""" I thought you said size doesn't matter! "" Bridgebody.squarespace.com"
4296,0,2,36,38,1.0526315789473684,0.0367097806559429,526,"With this enlarged halo, it takes me about five full minutes to harp."
4296,1,0,37,38,1.0526315789473684,0.0526315789473684,526,That's not even 79%
4296,0,2,36,38,1.0526315789473684,0.0367097806559429,526,"The fewer sexual partners, the larger the halo."
4296,0,2,36,38,1.0526315789473684,0.0367097806559429,526,Is it true what they say about the size of a man's halo?
4296,0,2,36,38,1.0526315789473684,0.0367097806559429,526,Are we allowed to hula hoop?
4296,0,2,36,38,1.0526315789473684,0.0367097806559429,526,It's not an invisible ceiling that will prevent you from rising in the angelic ranks; it merely indicates that yours is a more focused spirituality.
4296,1,0,37,38,1.0526315789473684,0.0526315789473684,526,You’re in heaven. Of course I also have big hands.
4296,0,2,36,38,1.0526315789473684,0.0367097806559429,526,I'd say yours is about 73% as big as mine.
4296,0,2,36,38,1.0526315789473684,0.0367097806559429,526,I've been spending some time lately under halogen lamps
4296,0,2,36,38,1.0526315789473684,0.0367097806559429,526,"It seems the more recommendations, the smaller the halo."
4296,0,2,36,38,1.0526315789473684,0.0367097806559429,526,HE told me he doesn't like my holier than thou attitude.
4296,0,2,36,38,1.0526315789473684,0.0367097806559429,526,I won it in a prayer card game.
4296,1,0,37,38,1.0526315789473684,0.0526315789473684,526,"As for my missing rib, dear Eve, up here all is forgiven."
4296,0,2,36,38,1.0526315789473684,0.0367097806559429,526,I just decided which one I want to break first.
4296,0,2,36,38,1.0526315789473684,0.0367097806559429,526,There's no halo gap.
4296,0,2,36,38,1.0526315789473684,0.0367097806559429,526,I'm a fan of Donald Trump and tend to exaggerate.
4296,0,2,36,38,1.0526315789473684,0.0367097806559429,526,"In heaven, you see, we get to keep our favorite girl, trade in our orange hair, forget all the stupid things we ever said, and still be on top."
4296,0,2,36,38,1.0526315789473684,0.0367097806559429,526,"""No, I'm afraid I didn't have a clue that you were always hot for me""."
4296,0,2,36,38,1.0526315789473684,0.0367097806559429,526,"Mr., in case you are wondering.....In heaven, men's glass ceiling is much bigger than that of women's"
4296,0,2,36,38,1.0526315789473684,0.0367097806559429,526,So this is Atkins-Heaven?
4296,0,2,36,38,1.0526315789473684,0.0367097806559429,526,I flew in from Hawaii
4296,0,2,36,38,1.0526315789473684,0.0367097806559429,526,...And how much did you smoke Whitney?
4296,0,2,36,38,1.0526315789473684,0.0367097806559429,526,"'R' is reverse and 'D' is drive. There, I've said it. Now give me a kiss."
4296,0,2,36,38,1.0526315789473684,0.0367097806559429,526,Our wedding will be a double wing ceremony.
4296,1,0,37,38,1.0526315789473684,0.0526315789473684,526,"In the other life, my thinking was cloudy."
4296,0,2,36,38,1.0526315789473684,0.0367097806559429,526,Mine is getting big
4296,0,2,36,38,1.0526315789473684,0.0367097806559429,526,I was such a selfless player in the NBA God made mine more like a basketball hoop.
4296,0,2,36,38,1.0526315789473684,0.0367097806559429,526,"I pray it won't fade away, ahooo, ahooo."
4296,0,2,36,38,1.0526315789473684,0.0367097806559429,526,"'Well, just because you're a politician don't think you are holier than thou.'"
4422,0,2,37,39,1.0512820512820513,0.03578157512432619,526,Wingsplaining.
4422,1,0,38,39,1.0512820512820513,0.05128205128205128,526,I just wanted to tell you how much I loved your brownies.
4422,0,2,37,39,1.0512820512820513,0.03578157512432619,526,"Why me? Look upward, angel."
4422,0,2,37,39,1.0512820512820513,0.03578157512432619,526,The size of my halo is based on the amount of money I paid to my wife's ring.
4422,0,2,37,39,1.0512820512820513,0.03578157512432619,526,I brought my hula hoop with me.
4422,0,2,37,39,1.0512820512820513,0.03578157512432619,526,I'm really into CrossFit.
4422,0,2,37,39,1.0512820512820513,0.03578157512432619,526,We're not permitted to brag but it's a fact that the size of your halo is proportional...
4422,0,2,37,39,1.0512820512820513,0.03578157512432619,526,Oh Lord. Even angels explain things to me.
4422,0,2,37,39,1.0512820512820513,0.03578157512432619,526,You may appear with a wider field but females live longer.
4422,0,2,37,39,1.0512820512820513,0.03578157512432619,526,"Bad Tinder Dates in Heaven: ""Its not the only reason they call me Big O."""
4422,0,2,37,39,1.0512820512820513,0.03578157512432619,526,What happened to the glass ozone?
4422,0,2,37,39,1.0512820512820513,0.03578157512432619,526,I received this for not watching Adam and Eve's escapades.
4422,0,2,37,39,1.0512820512820513,0.03578157512432619,526,I will hire a virologist to tell you why.
4422,0,2,37,39,1.0512820512820513,0.03578157512432619,526,So it was Christ with K- just my luck.
4422,1,0,38,39,1.0512820512820513,0.05128205128205128,526,"Oh Grace, I hope falling for you isn't as bad as falling from you."
4422,0,2,37,39,1.0512820512820513,0.03578157512432619,526,"Please don't send me elsewhere, please don't send me elsewhere."
4422,1,0,38,39,1.0512820512820513,0.05128205128205128,526,"The ""Halo Supersizer"" app unlocked my ""beam me up to headquarters"" function."
4422,0,2,37,39,1.0512820512820513,0.03578157512432619,526,"...yeah, you always hear that. But, looks like up here size REALLY doesn't matter..."
4422,0,2,37,39,1.0512820512820513,0.03578157512432619,526,You sure we're not over compensating just a little?
4422,0,2,37,39,1.0512820512820513,0.03578157512432619,526,"I'm Sid Colgate and it's the original ring of confidence, so pucker up baby - minty heaven!"
4422,0,2,37,39,1.0512820512820513,0.03578157512432619,526,It's hard to find magnum hats.
4422,0,2,37,39,1.0512820512820513,0.03578157512432619,526,"Who do you want to watch over, Clinton or Trump?"
4422,0,2,37,39,1.0512820512820513,0.03578157512432619,526,I can offer you a great deal on this hula hoop.
4422,0,2,37,39,1.0512820512820513,0.03578157512432619,526,Angel and ANGEL
4422,0,2,37,39,1.0512820512820513,0.03578157512432619,526,You seem incredulous but Bill Cunningham said that big halos are a thing.
4422,0,2,37,39,1.0512820512820513,0.03578157512432619,526,My name is Johnny Angel.
4422,0,2,37,39,1.0512820512820513,0.03578157512432619,526,Look at this halo! Is this a small halo? I guarantee you there's no problem.
4422,0,2,37,39,1.0512820512820513,0.03578157512432619,526,Is there anything to eat around here?
4422,1,0,38,39,1.0512820512820513,0.05128205128205128,526,It's an 'O.' I'm from Orlando.
4422,0,2,37,39,1.0512820512820513,0.03578157512432619,526,"When it falls, and it will, I'll have a hula hoop we can share."
4422,0,2,37,39,1.0512820512820513,0.03578157512432619,526,"Lord knows I need a hobby, so this doubles as a hula hoop."
4422,0,2,37,39,1.0512820512820513,0.03578157512432619,526,My skills as a lobbyist with the leaders down there helped me with the powers that be up here.
4422,0,2,37,39,1.0512820512820513,0.03578157512432619,526,hey bro
4422,0,2,37,39,1.0512820512820513,0.03578157512432619,526,"So you see, dear, while all sing is forgiven, Adultery is still worse for women."
4422,0,2,37,39,1.0512820512820513,0.03578157512432619,526,Of course my halo is bigger! I earned it by putting up with you all tho
4422,0,2,37,39,1.0512820512820513,0.03578157512432619,526,"Sorry, but even up here, I'm still just a show-er."
4422,0,2,37,39,1.0512820512820513,0.03578157512432619,526,My mystic chord swells surely as you touch the better angel of my nature.
4422,1,0,38,39,1.0512820512820513,0.05128205128205128,526,I don't think you can handle the mansplation for my manspread.
4422,0,2,37,39,1.0512820512820513,0.03578157512432619,526,I am sorry that it turns out god is a man.
4422,0,2,37,39,1.0512820512820513,0.03578157512432619,526,It must have been my Low T
4422,0,2,37,39,1.0512820512820513,0.03578157512432619,526,"Because He's God, the Father."
4422,0,2,37,39,1.0512820512820513,0.03578157512432619,526,I honestly do not feel anymore blessed than Kanye West
4422,0,2,37,39,1.0512820512820513,0.03578157512432619,526,"Remember Adam and Eve? Sorry, I’m Steve."
4422,0,2,37,39,1.0512820512820513,0.03578157512432619,526,Its size doesn't mean I want to lord it over you.
4422,1,0,38,39,1.0512820512820513,0.05128205128205128,526,A size 48. Want to hear how over lunch?
4422,0,2,37,39,1.0512820512820513,0.03578157512432619,526,"Hm, your halo, more than four hours? Better call your maker."
4422,0,2,37,39,1.0512820512820513,0.03578157512432619,526,Whoever confused it for theirs at Peter's luau must have the tiniest waist!
4422,0,2,37,39,1.0512820512820513,0.03578157512432619,526,What's five hours in an eternity though?
4422,0,2,37,39,1.0512820512820513,0.03578157512432619,526,Well Hello. I certainly hope size matters.
4422,0,2,37,39,1.0512820512820513,0.03578157512432619,526,Incognito browsing? What's that?
4422,0,2,37,39,1.0512820512820513,0.03578157512432619,526,Trust me. It's God who wills it.
4422,0,2,37,39,1.0512820512820513,0.03578157512432619,526,...and my halo isn't the only thing that's big. ;)
4422,0,2,37,39,1.0512820512820513,0.03578157512432619,526,"No, I'm not hiding small hands."
4422,0,2,37,39,1.0512820512820513,0.03578157512432619,526,This is one place bigger doesn't mean better.
4422,0,2,37,39,1.0512820512820513,0.03578157512432619,526,It's nearly impossible to use this hula hoop with these wings .
4422,0,2,37,39,1.0512820512820513,0.03578157512432619,526,Where's a good place to get a bite to eat?
4422,0,2,37,39,1.0512820512820513,0.03578157512432619,526,"All I said was ""I'll miss my lifted truck with 37"" tires"" and they handed me this halo."
4422,1,0,38,39,1.0512820512820513,0.05128205128205128,526,I guess you don't get around much.
4422,1,0,38,39,1.0512820512820513,0.05128205128205128,526,"I wish I could marry you, but I fear that change is inevitable."
4422,0,2,37,39,1.0512820512820513,0.03578157512432619,526,You know the amazing thing is that my angel ring is the same height as others. Go Hoosiers.
4422,0,2,37,39,1.0512820512820513,0.03578157512432619,526,It suits you.
4422,0,2,37,39,1.0512820512820513,0.03578157512432619,526,Thinking of getting you a hula hoop my angel.
4422,0,2,37,39,1.0512820512820513,0.03578157512432619,526,"I had better warn you, this is a rented outfit."
4422,0,2,37,39,1.0512820512820513,0.03578157512432619,526,Angelsplaining.
4422,0,2,37,39,1.0512820512820513,0.03578157512432619,526,I'll let you wear the larger halo 'cause you have the male ego.
4422,0,2,37,39,1.0512820512820513,0.03578157512432619,526,Everything they say about large haloes is true.
4422,0,2,37,39,1.0512820512820513,0.03578157512432619,526,Everything I know about life here in the sewers I learned from Ed Norton.
4422,0,2,37,39,1.0512820512820513,0.03578157512432619,526,"Yeah, I worked for Goldman Sachs...why do you ask?"
4422,0,2,37,39,1.0512820512820513,0.03578157512432619,526,You always thought things were bigger than they really are.
4422,0,2,37,39,1.0512820512820513,0.03578157512432619,526,Trump said if you want the Equal Pay Act you can go to hell
4422,1,0,38,39,1.0512820512820513,0.05128205128205128,526,"Honestly, Janice, I don't find St. Peter at all atractive..."
4422,0,2,37,39,1.0512820512820513,0.03578157512432619,526,"Hi, I'm Richard. I invented the Hula Hoop."
4422,0,2,37,39,1.0512820512820513,0.03578157512432619,526,Wait until you see my beautiful hands.
4422,0,2,37,39,1.0512820512820513,0.03578157512432619,526,So much for the glass ceiling?
4422,0,2,37,39,1.0512820512820513,0.03578157512432619,526,You know what they say: flat flip flies straight.
4422,0,2,37,39,1.0512820512820513,0.03578157512432619,526,Second wives have to grow into the job.
4422,0,2,37,39,1.0512820512820513,0.03578157512432619,526,Good in bed ? You bet I'm good in bed !
4422,0,2,37,39,1.0512820512820513,0.03578157512432619,526,It's the robe. It's actually an optical illusion... Don't act like you're not impressed!
4422,0,2,37,39,1.0512820512820513,0.03578157512432619,526,"They say size doesn't matter, but I say it does."
4422,0,2,37,39,1.0512820512820513,0.03578157512432619,526,"Well, you know what they say...size matters."
4422,0,2,37,39,1.0512820512820513,0.03578157512432619,526,Wow! what a big halo you have! Big ego or do you hoopla hoop?
4422,0,2,37,39,1.0512820512820513,0.03578157512432619,526,Turns out I was just dying to shed those pounds.
4422,0,2,37,39,1.0512820512820513,0.03578157512432619,526,You feel the Bern up here? I just hate your holier than thou attitude.
4422,0,2,37,39,1.0512820512820513,0.03578157512432619,526,It's just not fair that I make less than you.
4422,0,2,37,39,1.0512820512820513,0.03578157512432619,526,Lets just say you must have a big ego...
4422,0,2,37,39,1.0512820512820513,0.03578157512432619,526,Do you come here often?
4422,0,2,37,39,1.0512820512820513,0.03578157512432619,526,(thinking) Right buddy - ain't no way I'm gonna spend any time here with you!
4422,1,0,38,39,1.0512820512820513,0.05128205128205128,526,"Listen Ted, you've taken the 'holier than thou' schtick too far this time."
4422,0,2,37,39,1.0512820512820513,0.03578157512432619,526,"I hope bigger is better in heaven, too."
4422,0,2,37,39,1.0512820512820513,0.03578157512432619,526,Looking at your smile I guess size does matter
4422,0,2,37,39,1.0512820512820513,0.03578157512432619,526,I like to think it's more tunic than dress.
4422,0,2,37,39,1.0512820512820513,0.03578157512432619,526,"Well, if you're going to quote statistics, let's be honest - that halo is a lot less than 78% of mine."
4422,1,0,38,39,1.0512820512820513,0.05128205128205128,526,Like my levitating hula hoop?
4422,0,2,37,39,1.0512820512820513,0.03578157512432619,526,"Could I get your number?"" ""Mhhm... no."
4422,0,2,37,39,1.0512820512820513,0.03578157512432619,526,Your halo looks a little too big for you to be an angel.
4422,0,2,37,39,1.0512820512820513,0.03578157512432619,526,Lancelot said you dragons knew how to parry!
4422,0,2,37,39,1.0512820512820513,0.03578157512432619,526,"D = 1 / F, where D is the diameter of a spirit's halo, and F the level of romantic stimulation of the past sentient being"
4422,0,2,37,39,1.0512820512820513,0.03578157512432619,526,Apparently it's a reflection of my ego.
4422,0,2,37,39,1.0512820512820513,0.03578157512432619,526,"Yes, Solar Tubes come with an enlarged, special blessing."
4422,0,2,37,39,1.0512820512820513,0.03578157512432619,526,My therapist says I have a small penis.
4422,0,2,37,39,1.0512820512820513,0.03578157512432619,526,"Sure, THAT'S nice, but you have no plans for the future."
4422,0,2,37,39,1.0512820512820513,0.03578157512432619,526,"No, it doesn't mean I have penis envy!"
4422,0,2,37,39,1.0512820512820513,0.03578157512432619,526,What a day! You are here and not in Hollywood.
4422,0,2,37,39,1.0512820512820513,0.03578157512432619,526,I was the hula hoop champion in graduate school!
4422,0,2,37,39,1.0512820512820513,0.03578157512432619,526,They're so ... my hands ... I'm telling you ... they so justify the size of my hoop thing.
4422,0,2,37,39,1.0512820512820513,0.03578157512432619,526,What do you *mean* they only come in two sizes?
4422,0,2,37,39,1.0512820512820513,0.03578157512432619,526,"I don't care how big your halo is, still not gonna sleep with you."
4422,0,2,37,39,1.0512820512820513,0.03578157512432619,526,Let's compare after elections.
4422,0,2,37,39,1.0512820512820513,0.03578157512432619,526,"I figured if Viagra works for mortals, why not..."
4422,1,0,38,39,1.0512820512820513,0.05128205128205128,526,It's bigger because I ate angle hair pasta all my life.
4422,0,2,37,39,1.0512820512820513,0.03578157512432619,526,Just tell me it wasn't my brother.
4422,0,2,37,39,1.0512820512820513,0.03578157512432619,526,"Don't blame me, this comes standard in Trump's heaven."
4422,0,2,37,39,1.0512820512820513,0.03578157512432619,526,Come into my circle of love.
4422,0,2,37,39,1.0512820512820513,0.03578157512432619,526,I have friend coming up later in case this date doesn't work out
4422,0,2,37,39,1.0512820512820513,0.03578157512432619,526,"Well, you know the old saying about the size of your halo and..?"
4422,0,2,37,39,1.0512820512820513,0.03578157512432619,526,"It was supposed to look more like a parachute, but I guess that I can""t complain."
4422,1,0,38,39,1.0512820512820513,0.05128205128205128,526,"So, as a former hedge fund manager I knew, my rate of return on virtue would be divine with a beautiful commodity like you."
4422,0,2,37,39,1.0512820512820513,0.03578157512432619,526,You'll notice I don't have to take my hands out of my pockets.
4422,0,2,37,39,1.0512820512820513,0.03578157512432619,526,I saw it on an infomercial - Hulation- levitating hula hoop.
4422,0,2,37,39,1.0512820512820513,0.03578157512432619,526,"Looking a little loose, Larry."
4422,0,2,37,39,1.0512820512820513,0.03578157512432619,526,I did.
4422,0,2,37,39,1.0512820512820513,0.03578157512432619,526,"I performed three miracles, but they'd already met this year's quota."
4544,0,2,38,40,1.05,0.03489912202260563,526,"Actually, there's an inverse relationship between size and chauvinism."
4544,0,2,38,40,1.05,0.03489912202260563,526,"This halo comes from a lot of flying time."" ""This halo comes with a lot flying time."
4544,0,2,38,40,1.05,0.03489912202260563,526,I guess it's better than the alternative
4544,0,2,38,40,1.05,0.03489912202260563,526,"I said ""halo hoop,"" loser."
4544,1,0,39,40,1.05,0.04999999999999999,526,"Is that you, Donald? Yes, Hillary."
4544,1,0,39,40,1.05,0.04999999999999999,526,"No, it's not overcompensation for my Trump-like physical shortcomings."
4544,0,2,38,40,1.05,0.03489912202260563,526,You know?! There are 70 more of us.
4544,0,2,38,40,1.05,0.03489912202260563,526,"In regards to my aura, would you consider a pre-nup?"
4544,0,2,38,40,1.05,0.03489912202260563,526,"Wow I still feel it, the desire to touch, my halo is swelling."
4544,0,2,38,40,1.05,0.03489912202260563,526,"Really..., Do I have to vote for you too?"
4544,0,2,38,40,1.05,0.03489912202260563,526,I feel my neck heavy
4544,0,2,38,40,1.05,0.03489912202260563,526,"Alas, yes, size still matters even up here to us males."
4544,0,2,38,40,1.05,0.03489912202260563,526,Maybe up here they’ll think that YOU married up.
4544,0,2,38,40,1.05,0.03489912202260563,526,"Before my passing, I graduated summa cum laude—non-credentialed—from Trump University."
4544,1,0,39,40,1.05,0.04999999999999999,526,Mine is bigger than yours!
4544,1,0,39,40,1.05,0.04999999999999999,526,UFO's were my thing.
4544,0,2,38,40,1.05,0.03489912202260563,526,"I know you've seen a lot of these, but never one as big as this."
4544,0,2,38,40,1.05,0.03489912202260563,526,You may know that the size of my halo is akin to the size of other parts of my anatomy.
4544,0,2,38,40,1.05,0.03489912202260563,526,"It's not that I'm holier than thou, it's just that size does matter."
4544,1,0,39,40,1.05,0.04999999999999999,526,I'm a virgin and I got a big halo.
4544,1,0,39,40,1.05,0.04999999999999999,526,Taking you under my wing is really an honor for you.
4544,0,2,38,40,1.05,0.03489912202260563,526,Let me know if you really want to be an angelic host.
4544,0,2,38,40,1.05,0.03489912202260563,526,Don't look at me like that! It's not the way it looks. It's ah...ah...a hoola hoop.
4544,0,2,38,40,1.05,0.03489912202260563,526,"Like I said before, we were on a break."
4544,0,2,38,40,1.05,0.03489912202260563,526,I could use your grandiose halo as a hula hoop!
4544,0,2,38,40,1.05,0.03489912202260563,526,You know what they say about the size of a man angel's halo . . .
4570,0,2,39,41,1.048780487804878,0.034059122057973054,526,Looks like my 'holier than thou' attitude panned out.
4571,0,1,32,33,1.0303030303030303,0.030772872744833184,526,"I kind of hate guys that my Dad likes too much, though."
4571,0,1,32,33,1.0303030303030303,0.030772872744833184,526,"Hi Angel Face! Haven't we ""halo-ed"" somewhere before?"
4571,0,1,32,33,1.0303030303030303,0.030772872744833184,526,"Well, it's really in how you use it..."
4574,0,1,33,34,1.0294117647058822,0.029854071701326604,526,Did I tell you Cain was my brother?
4574,0,1,33,34,1.0294117647058822,0.029854071701326604,526,"Yes, angels can ask each other out; we can also use floss and mouthwash."
4574,0,1,33,34,1.0294117647058822,0.029854071701326604,526,Please contest winner news TV snow
4574,0,1,33,34,1.0294117647058822,0.029854071701326604,526,I hope you are in to some kinky stuff.
4574,0,1,33,34,1.0294117647058822,0.029854071701326604,526,Want to play with my halo?
4574,0,1,33,34,1.0294117647058822,0.029854071701326604,526,It always happens when I meet someone with LL initials.
4574,0,1,33,34,1.0294117647058822,0.029854071701326604,526,"The Big Guy is amused by this phenomenon. He says He's going to try too somehow work it into the new ""humans"" He's creating."
4574,0,1,33,34,1.0294117647058822,0.029854071701326604,526,Take a guess. It is either for men only or I have a helium hula hoop.
4574,0,1,33,34,1.0294117647058822,0.029854071701326604,526,I wanted the larger halo
4583,0,1,34,35,1.0285714285714285,0.028988551782622423,526,You can always go feel the Bern.
4583,0,1,34,35,1.0285714285714285,0.028988551782622423,526,I'd like you to think I'm big everywhere!
4583,0,1,34,35,1.0285714285714285,0.028988551782622423,526,My feet aren't the only thing that is proportionally bigger.
4583,0,1,34,35,1.0285714285714285,0.028988551782622423,526,"Yes, Edward Thorndike would be proud."
4583,0,1,34,35,1.0285714285714285,0.028988551782622423,526,I've really lost a lot of weight with the flying around
4583,0,1,34,35,1.0285714285714285,0.028988551782622423,526,Is it true what they say about big halos.
4583,0,1,34,35,1.0285714285714285,0.028988551782622423,526,Up here men's appendages are small but our Halos are large .
4583,0,1,34,35,1.0285714285714285,0.028988551782622423,526,This isn't like mortal sign you can try to disguise...
4583,0,1,34,35,1.0285714285714285,0.028988551782622423,526,"And then I told him, 'I believe it's pronounce HU-LA."
4583,0,1,34,35,1.0285714285714285,0.028988551782622423,526,It's because I do well with heavenly Angels.
4583,0,1,34,35,1.0285714285714285,0.028988551782622423,526,The size of this Halo makes me look silly.
4583,0,1,34,35,1.0285714285714285,0.028988551782622423,526,People don't always have the same heart you do...
4583,0,1,34,35,1.0285714285714285,0.028988551782622423,526,"You're right, bigger doesn't, necessarily, mean better...but, in this case, it, necessarily, does!"
4583,0,1,34,35,1.0285714285714285,0.028988551782622423,526,I was Costco good.
4583,0,1,34,35,1.0285714285714285,0.028988551782622423,526,They convinced me it was more in keeping with the spirit than socks.
4583,0,1,34,35,1.0285714285714285,0.028988551782622423,526,"Well I don't want to brag, but I'm one of the nicest you'll ever meet!"
4583,0,1,34,35,1.0285714285714285,0.028988551782622423,526,Yeah. Now I know how it feels.
4583,0,1,34,35,1.0285714285714285,0.028988551782622423,526,"All of her people said if we voted the right way, there'd be a special place in heaven for Super Delegates like me. Now you're telling me there's no sex?!"
4583,0,1,34,35,1.0285714285714285,0.028988551782622423,526,I just love your ego. Your ego is quite overwhelming!
4583,0,1,34,35,1.0285714285714285,0.028988551782622423,526,Think of it this way - you don't have to worry about carrying yours if we get married! Mine's good for both of us!
4583,0,1,34,35,1.0285714285714285,0.028988551782622423,526,"If I stop drinking RedBull, will my wings disappear?"
4583,0,1,34,35,1.0285714285714285,0.028988551782622423,526,They're sized to match our egos. You'll note that mine is bigger than yours.
4583,0,1,34,35,1.0285714285714285,0.028988551782622423,526,"I guess Janice didn't make it, I'm not surprised."
4583,0,1,34,35,1.0285714285714285,0.028988551782622423,526,"In Heaven, halo size indicates the same thing that hand size means on Earth. I'm just sayin'."
4583,0,1,34,35,1.0285714285714285,0.028988551782622423,526,Hi Angel want to hula hoop?
4583,0,1,34,35,1.0285714285714285,0.028988551782622423,526,This diet agrees with me.
4583,0,1,34,35,1.0285714285714285,0.028988551782622423,526,"It's a great honor, but I've had to adopt His neck routine."
4583,0,1,34,35,1.0285714285714285,0.028988551782622423,526,“Are you a lucky little lady in the City of Light? Or just another lost angel... City of Night? ” ? Jim Morrison
4583,0,1,34,35,1.0285714285714285,0.028988551782622423,526,Size matters ... I think?
4583,0,1,34,35,1.0285714285714285,0.028988551782622423,526,I'm a Trump.
4583,0,1,34,35,1.0285714285714285,0.028988551782622423,526,I have the best of both worlds - I'm heavenly and huge.
4583,0,1,34,35,1.0285714285714285,0.028988551782622423,526,"I tipped the guy at the gate and asked for an upgrade. I don't know basketball, but he gave me the best view in the house and kept calling me ""hoops."" Slam dunk, as they say!"
4583,0,1,34,35,1.0285714285714285,0.028988551782622423,526,The size of your halo correlates to the abundance of your emotion being felt at that precise moment.
4616,0,1,35,36,1.0277777777777777,0.028171808490950554,526,You mean size doesn't matter up here?
4616,0,1,35,36,1.0277777777777777,0.028171808490950554,526,My skylight is bigger than your skylight
4616,0,1,35,36,1.0277777777777777,0.028171808490950554,526,"Hillary and Donald for President, for sure!"
4616,0,1,35,36,1.0277777777777777,0.028171808490950554,526,"The cable company gave me a really great package, including international stations."
4616,0,1,35,36,1.0277777777777777,0.028171808490950554,526,"Well, I guess it's because Halo is my favorite video game."
4616,0,1,35,36,1.0277777777777777,0.028171808490950554,526,Heaven hath no joy like a woman scorned.
4616,0,1,35,36,1.0277777777777777,0.028171808490950554,526,Nope. . . I'll check the fladravian.
4616,0,1,35,36,1.0277777777777777,0.028171808490950554,526,You must be confusing me with another ex-boyfriends. One who did always say that size matters.
4616,0,1,35,36,1.0277777777777777,0.028171808490950554,526,Don't laugh. It's the last one. They don't make halos anymore.
4616,0,1,35,36,1.0277777777777777,0.028171808490950554,526,BOB: Once I helped a cat that's probably why I'm here Sarah: Oh brother........
4616,0,1,35,36,1.0277777777777777,0.028171808490950554,526,Why is your Aura so much smaller than mine?
4616,0,1,35,36,1.0277777777777777,0.028171808490950554,526,"Rosie, the ring is supposed to go round."
4616,0,1,35,36,1.0277777777777777,0.028171808490950554,526,Yet my penis is still the same size it was on earth.
4616,0,1,35,36,1.0277777777777777,0.028171808490950554,526,Too much goodness spoils its representation.
4616,0,1,35,36,1.0277777777777777,0.028171808490950554,526,"I did inherit some from my father, but the vast amount came from my own noblesse oblige"
4616,0,1,35,36,1.0277777777777777,0.028171808490950554,526,Does your halo reflect the size of your fingers?
4616,0,1,35,36,1.0277777777777777,0.028171808490950554,526,You got bad directions. The Victoria's Secret fashion show is shooting in Studio A.
4616,0,1,35,36,1.0277777777777777,0.028171808490950554,526,"Female angel's thought: ""Is he compensating for something?"""
4616,0,1,35,36,1.0277777777777777,0.028171808490950554,526,"Soooo, I see your halo matches your size."
4616,0,1,35,36,1.0277777777777777,0.028171808490950554,526,"Look, I'm just visiting my grandma."
4616,0,1,35,36,1.0277777777777777,0.028171808490950554,526,'Mine's bigger'
4616,0,1,35,36,1.0277777777777777,0.028171808490950554,526,You mean halo size and virtue are NOT correlated?
4616,0,1,35,36,1.0277777777777777,0.028171808490950554,526,"I had said I miss you. But believe me, not so soon."
4616,0,1,35,36,1.0277777777777777,0.028171808490950554,526,My financial adviser had me consolidate my accounts.
4616,0,1,35,36,1.0277777777777777,0.028171808490950554,526,But didn't you say size doesn't matter?
4616,0,1,35,36,1.0277777777777777,0.028171808490950554,526,The boy is now in Neverland.
4616,0,1,35,36,1.0277777777777777,0.028171808490950554,526,I posted my political opinions on Facebook.
4616,0,1,35,36,1.0277777777777777,0.028171808490950554,526,It gets bigger every time I pay more taxes.
4616,0,1,35,36,1.0277777777777777,0.028171808490950554,526,"Well Cricket, I was a Fortune 500 CEO making $30M per year, 6'4"", abs of steel...."
4616,0,1,35,36,1.0277777777777777,0.028171808490950554,526,"Girl, your halo looks like a hula hoop!"
4616,0,1,35,36,1.0277777777777777,0.028171808490950554,526,One of the benefits of male pattern baldness.
4616,0,1,35,36,1.0277777777777777,0.028171808490950554,526,"I lived at this freegan house in West Philly way back when, and, I don't know, the big gauge just felt right. I'm not part of 'the scene' or whatever anymore, but I don't regret anything. It was a part of my life, you know?"
4616,0,1,35,36,1.0277777777777777,0.028171808490950554,526,Let me take you away from all this.
4616,0,1,35,36,1.0277777777777777,0.028171808490950554,526,Impressive isn't it?
4616,0,1,35,36,1.0277777777777777,0.028171808490950554,526,Right. But you only get to 77 percent after you've been here a while.
4616,0,1,35,36,1.0277777777777777,0.028171808490950554,526,"yes , you were late to call , but nothing beats the ring of an apple..."
4616,0,1,35,36,1.0277777777777777,0.028171808490950554,526,"Yeah, the ""one big part means..."" line is what got me up here."
4616,0,1,35,36,1.0277777777777777,0.028171808490950554,526,"Sorry. Size did matter down there, but definitely doesn't matter up here."
4616,0,1,35,36,1.0277777777777777,0.028171808490950554,526,"The bigger your successful interventions, the bigger the halo."
4616,0,1,35,36,1.0277777777777777,0.028171808490950554,526,"On the plus side, we've banned that Eric Clapton song up here."
4616,0,1,35,36,1.0277777777777777,0.028171808490950554,526,"Yes, I swiped right too."
4616,0,1,35,36,1.0277777777777777,0.028171808490950554,526,"okay how we about just give each other massages? or you could just rub it over my pants, that's okay right?"
4616,0,1,35,36,1.0277777777777777,0.028171808490950554,526,Higher? My glass ceiling is larger than yours!
4616,0,1,35,36,1.0277777777777777,0.028171808490950554,526,Foam parties ... whoever thought they'd make a comeback?
4616,0,1,35,36,1.0277777777777777,0.028171808490950554,526,I have yuge hands.
4616,0,1,35,36,1.0277777777777777,0.028171808490950554,526,Darn that stick shift!
4616,0,1,35,36,1.0277777777777777,0.028171808490950554,526,"You know what they say about guys with big halos, great lovers."
4616,0,1,35,36,1.0277777777777777,0.028171808490950554,526,You only get the big ones when your really really good!
4616,0,1,35,36,1.0277777777777777,0.028171808490950554,526,"""Eagle scout as a youth, high school valedictorian, multi-millionaire as an adult. Need I go on?"
4616,0,1,35,36,1.0277777777777777,0.028171808490950554,526,"You know what they say about gaping halos, right?"
4616,0,1,35,36,1.0277777777777777,0.028171808490950554,526,"Barbie, does this mean that we're together forever?"
4667,0,1,36,37,1.027027027027027,0.02739983121755955,526,"I'm sorry, but I've moved on."
4667,0,1,36,37,1.027027027027027,0.02739983121755955,526,I used to wear my hair like Trump.
4667,0,1,36,37,1.027027027027027,0.02739983121755955,526,You never know who to trust in the world today.
4667,0,1,36,37,1.027027027027027,0.02739983121755955,526,Good job Clarence. The boss must have assigned you Charlie Sheen this time.
4667,0,1,36,37,1.027027027027027,0.02739983121755955,526,I'm reaall good in the sack...
4667,0,1,36,37,1.027027027027027,0.02739983121755955,526,"Men never pay attention. I told my husband John, I said John dear, we need new wheels for the baby's stroller."
4667,0,1,36,37,1.027027027027027,0.02739983121755955,526,"hear about that clinic bombing? yup, that was me"
4667,0,1,36,37,1.027027027027027,0.02739983121755955,526,Oh Donald... Oh Hillary....Oh Donald...Oh Hillary...Oh Donald...Oh Hillary
4667,0,1,36,37,1.027027027027027,0.02739983121755955,526,You said size doesn't matter!
4667,0,1,36,37,1.027027027027027,0.02739983121755955,526,"Carol, I know that you thought there would be no man-splaining in heaven. Well actually...."
4667,0,1,36,37,1.027027027027027,0.02739983121755955,526,Did you lose your hula hoop?
4667,0,1,36,37,1.027027027027027,0.02739983121755955,526,So I take it that you're not voting for me?
4667,0,1,36,37,1.027027027027027,0.02739983121755955,526,"Actually, it's about ethics in prophesying."
4667,0,1,36,37,1.027027027027027,0.02739983121755955,526,Heaven?
4667,0,1,36,37,1.027027027027027,0.02739983121755955,526,I got it in Williamsburg.
4667,0,1,36,37,1.027027027027027,0.02739983121755955,526,I don't know anything about raising squid. If that's where this is going.
4667,0,1,36,37,1.027027027027027,0.02739983121755955,526,There is no glass ceiling for archangels
4667,0,1,36,37,1.027027027027027,0.02739983121755955,526,It's the last time you'll crash the car!
4667,0,1,36,37,1.027027027027027,0.02739983121755955,526,How high can you fly?
4667,0,1,36,37,1.027027027027027,0.02739983121755955,526,It's not me; it's you.
4667,0,1,36,37,1.027027027027027,0.02739983121755955,526,Even up here the male is exalted but not prettier.
4667,0,1,36,37,1.027027027027027,0.02739983121755955,526,Ooh. Size does count!!
4667,0,1,36,37,1.027027027027027,0.02739983121755955,526,It turns out Trump really was the more skilled negotiator.
4667,0,1,36,37,1.027027027027027,0.02739983121755955,526,The elephant yoni is attracted to the elephant lingam.
4667,0,1,36,37,1.027027027027027,0.02739983121755955,526,You know what they say about big halos and body parts!
4667,0,1,36,37,1.027027027027027,0.02739983121755955,526,I was a lawyer and had a house in the Hamptons. Come here often?
4667,0,1,36,37,1.027027027027027,0.02739983121755955,526,You just act. You don't think.
4667,0,1,36,37,1.027027027027027,0.02739983121755955,526,"great burden.""Yes, Angelina, being holier than thou is a"
4667,0,1,36,37,1.027027027027027,0.02739983121755955,526,"I know, but I was a bigger sinner."
4667,0,1,36,37,1.027027027027027,0.02739983121755955,526,I never used Tinder.
4667,0,1,36,37,1.027027027027027,0.02739983121755955,526,It's a risk.
4667,0,1,36,37,1.027027027027027,0.02739983121755955,526,Up here it's not about hands.
4667,0,1,36,37,1.027027027027027,0.02739983121755955,526,Wasn't I good enough for you?
4667,0,1,36,37,1.027027027027027,0.02739983121755955,526,"I would love to stay and chat, but there are 49 beautiful souls that need me right now."
4667,0,1,36,37,1.027027027027027,0.02739983121755955,526,I'm sorry - but your halo is so obvious.
4667,0,1,36,37,1.027027027027027,0.02739983121755955,526,Let me know when my halo stops shrinking.
4667,0,1,36,37,1.027027027027027,0.02739983121755955,526,You're washing your hair this Friday?
4667,0,1,36,37,1.027027027027027,0.02739983121755955,526,"My God, it 's your vaginal ring personified."
4667,0,1,36,37,1.027027027027027,0.02739983121755955,526,You're no good.
4667,0,1,36,37,1.027027027027027,0.02739983121755955,526,Really? We dated before you're not that good.
4667,0,1,36,37,1.027027027027027,0.02739983121755955,526,Do you think I was born dead yesterday? I've seen Pinocchio!
4667,0,1,36,37,1.027027027027027,0.02739983121755955,526,You have to be in double digits.
4667,0,1,36,37,1.027027027027027,0.02739983121755955,526,"Now, the thing most folks don't understand about the Black Afterlives Matter movement is..."
4667,0,1,36,37,1.027027027027027,0.02739983121755955,526,And you know what they say about men with small hands.
4667,0,1,36,37,1.027027027027027,0.02739983121755955,526,Trump's hands.
4667,0,1,36,37,1.027027027027027,0.02739983121755955,526,"If you had a blue dress on, I'd really be worried!"
4667,0,1,36,37,1.027027027027027,0.02739983121755955,526,Don't tempt me...I wat to keep my big halo!
4667,0,1,36,37,1.027027027027027,0.02739983121755955,526,I'm told the big hands myth works differently up here.
4667,0,1,36,37,1.027027027027027,0.02739983121755955,526,"More experience, bigger halo"
4667,0,1,36,37,1.027027027027027,0.02739983121755955,526,Obviously women should go to hell.
4667,0,1,36,37,1.027027027027027,0.02739983121755955,526,It's my male enhancement halo that got me in
4667,0,1,36,37,1.027027027027027,0.02739983121755955,526,"Sorry, I asked for dollars instead of pennies."
4667,0,1,36,37,1.027027027027027,0.02739983121755955,526,I also voted for Donald Trump.
4667,0,1,36,37,1.027027027027027,0.02739983121755955,526,"Even here, size does matter to some."
4667,0,1,36,37,1.027027027027027,0.02739983121755955,526,That's the strangest hat I've ever seen.
4667,0,1,36,37,1.027027027027027,0.02739983121755955,526,"Yah. In my time on earth, I was big into Hoola-hoopin."
4667,0,1,36,37,1.027027027027027,0.02739983121755955,526,Better really IS bigger.ti
4667,0,1,36,37,1.027027027027027,0.02739983121755955,526,"Hmm, I see my ... halo is not as big as yours"
4667,0,1,36,37,1.027027027027027,0.02739983121755955,526,Give me break! If the American election campaign has taught us anything up here it's that size doesn't matter down there.
4667,0,1,36,37,1.027027027027027,0.02739983121755955,526,They ran out of stock and had to improvise with a hula-hoop.
4667,0,1,36,37,1.027027027027027,0.02739983121755955,526,"""Hula Hoop""."
4667,0,1,36,37,1.027027027027027,0.02739983121755955,526,Mine is a bigger umbrella.
4667,0,1,36,37,1.027027027027027,0.02739983121755955,526,Your halo is smaller because you choose to spend more time with your family...
4667,0,1,36,37,1.027027027027027,0.02739983121755955,526,Blah Blah Blah...
4667,0,1,36,37,1.027027027027027,0.02739983121755955,526,"What do you mean, ""Why are my hands in my pockets?"" Can't you see how big my halo is?"
4667,0,1,36,37,1.027027027027027,0.02739983121755955,526,"I should not brag but the bigger the halo., the bigger the...what was it called again?"
4733,0,1,37,38,1.0263157894736843,0.02666903735313325,526,Yeah you know the bell-wings connection? This weirdly gets bigger whenever somebody falls into an open manhole. You'll get used to it.
4733,0,1,37,38,1.0263157894736843,0.02666903735313325,526,"Well, you know we angels don't have pockets."
4733,0,1,37,38,1.0263157894736843,0.02666903735313325,526,Well . . . er . . . yeah. That's exactly what it means. My name is Gil by the way. Welcome.
4733,0,1,37,38,1.0263157894736843,0.02666903735313325,526,You're looking good. I didn't know angles flew so high.
4733,0,1,37,38,1.0263157894736843,0.02666903735313325,526,"Whomever said, bigger isn't better, had no clue what they were talking about!"
4733,0,1,37,38,1.0263157894736843,0.02666903735313325,526,I thought that a hula-hoop is out of fashion nowadays
4733,0,1,37,38,1.0263157894736843,0.02666903735313325,526,How did you find your stylist?
4733,0,1,37,38,1.0263157894736843,0.02666903735313325,526,It's because God thought I was really good in the chorus.
4733,0,1,37,38,1.0263157894736843,0.02666903735313325,526,"Yup, large halo means large...."
4733,0,1,37,38,1.0263157894736843,0.02666903735313325,526,I see that we are going get along quite well and often!
4733,0,1,37,38,1.0263157894736843,0.02666903735313325,526,"My wife loves your eyes. I love other things also!"""
4733,0,1,37,38,1.0263157894736843,0.02666903735313325,526,"Ah, but the rest of us drinkers didn't rape her."
4733,0,1,37,38,1.0263157894736843,0.02666903735313325,526,I know...It's obvious I'm not the bad boy type.
4733,0,1,37,38,1.0263157894736843,0.02666903735313325,526,"No, really, it's the same size as my shoes."
4733,0,1,37,38,1.0263157894736843,0.02666903735313325,526,"Jealous, babe?"
4748,0,1,38,39,1.0256410256410255,0.025976216673306556,526,jrjrjr
4748,0,1,38,39,1.0256410256410255,0.025976216673306556,526,"Ya know, Hector. Whenever you pop one of those blue pills everything on you swells. Look at the SIZE of your halo..!!"
4748,0,1,38,39,1.0256410256410255,0.025976216673306556,526,It must be my karma.
4748,0,1,38,39,1.0256410256410255,0.025976216673306556,526,I was wrongfully imprisoned for a bit in the 80s
4748,0,1,38,39,1.0256410256410255,0.025976216673306556,526,Too bad Date Night is many moons away
4753,0,0,33,33,1.0,0.030772872744833184,526,Why a hula hoop?
4753,0,0,36,36,1.0,0.028171808490950554,526,When Bae farts in an elevator...
4753,0,0,36,36,1.0,0.028171808490950554,526,"Of course, once a bragger, always a bragger."
4753,0,0,33,33,1.0,0.030772872744833184,526,"Yeah, but so what?"
4753,0,0,36,36,1.0,0.028171808490950554,526,"I found out ""I'm a pilot"" pick up line doesn't work up here."
4753,0,0,36,36,1.0,0.028171808490950554,526,"There's a saying up here: the bigger the halo, the better the slip."
4753,0,0,36,36,1.0,0.028171808490950554,526,The halo is a Geppetto.
4753,0,0,36,36,1.0,0.028171808490950554,526,"You're a jet, but I'm still piston."
4753,0,0,36,36,1.0,0.028171808490950554,526,Mine is a converted hula hoop
4753,0,0,36,36,1.0,0.028171808490950554,526,"Actually, I'm not more blessed. The comparative of ""holy"" and ""Holley"" has same spelling."
4753,0,0,36,36,1.0,0.028171808490950554,526,Overcompensating. HE said it’s mine to bare.
4753,0,0,36,36,1.0,0.028171808490950554,526,I remember that fateful night...the car was stalled...
4753,0,0,36,36,1.0,0.028171808490950554,526,I owe it all to Gloria Steinem
4753,0,0,35,35,1.0,0.028988551782622423,526,"Donald, St. Peter told me your where on the way, but I never knew that small fingers reflected a HUGE halo"
4753,0,0,36,36,1.0,0.028171808490950554,526,... and that's why I'm pro-life.
4753,0,0,37,37,1.0,0.02739983121755955,526,It's the only was I've found to overcompensate up here.
4753,0,0,36,36,1.0,0.028171808490950554,526,That's right--we have to wait till everyone gets here.
4753,0,0,36,36,1.0,0.028171808490950554,526,I don't think that will get you any perks from the Boss.
4753,0,0,36,36,1.0,0.028171808490950554,526,Yes...the curse of a size 15 shoe...uh...sandal...here in The Cloud....sorry...
4753,0,0,36,36,1.0,0.028171808490950554,526,"Obviously, it will take less time for your halo to reach this circumference."
4753,0,0,36,36,1.0,0.028171808490950554,526,it's a vapor cloud thing! You haven't soared through yet.
4753,0,0,35,35,1.0,0.028988551782622423,526,You wouldn't believe what our daycare charges for parking.
4753,0,0,36,36,1.0,0.028171808490950554,526,Your halo or mine.
4753,0,0,36,36,1.0,0.028171808490950554,526,"Damn, I've lost my halo through the portal again."
4753,0,0,34,34,1.0,0.029854071701326604,526,I didn't pick this Halo
4753,0,0,36,36,1.0,0.028171808490950554,526,"Oh, Match.com is so much better than those other sites!"
4753,0,0,33,33,1.0,0.030772872744833184,526,"Believe me, I have no problems in that department, I guarantee it. Actually, I have a slightly smaller than large halo."
4753,0,0,36,36,1.0,0.028171808490950554,526,"Feel it? Til Hades do us part, we're a marriage made in heaven."
4753,0,0,36,36,1.0,0.028171808490950554,526,I always knew we were meant for each other.
4753,0,0,36,36,1.0,0.028171808490950554,526,"...hope he can't read my mind. ""Oh honey! Our glorious reunion at last!"" ....If I had even a CLUE he would be here, I would have lived longer or at least been a really bad girl..."
4753,0,0,36,36,1.0,0.028171808490950554,526,"I know he was your best friend, but what was I supposed to do when you were off saving the world?"
4753,0,0,36,36,1.0,0.028171808490950554,526,"Yes I am smug. I don't need such a big halo, I am naturally good and God knows it."
4753,0,0,35,35,1.0,0.028988551782622423,526,What happens in Las Vegas stays in Las Vegas?....ya right.
4753,0,0,35,35,1.0,0.028988551782622423,526,I love an USA without terrorist attacks and gun violence.” “So do I.
4753,0,0,36,36,1.0,0.028171808490950554,526,I've been told that size matters.
4753,0,0,37,37,1.0,0.02739983121755955,526,"It's good to have big hands, here and down below."
4753,0,0,35,35,1.0,0.028988551782622423,526,Jerry's competitive nature received divine dispensation and conspicuous consecration was part of his eternal reward.
4753,0,0,36,36,1.0,0.028171808490950554,526,I just asked the Big Guy for more J. Lo. on movie night.
4753,0,0,36,36,1.0,0.028171808490950554,526,Nice to meet you; I'm Richard Knerr.
4753,0,0,36,36,1.0,0.028171808490950554,526,I never cheated in the hula hoop marathon.
4753,0,0,36,36,1.0,0.028171808490950554,526,Is that really your hair or did you scalp an angel?
4753,0,0,37,37,1.0,0.02739983121755955,526,"Oh, that's loop to go to hell.""What!?"
4753,0,0,35,35,1.0,0.028988551782622423,526,"Hi, Hillary. It's me, Bernie. Things are a little different up here. Aren't they?"
4753,0,0,36,36,1.0,0.028171808490950554,526,(Feb. 2017) Obviously our new President Hillary Clinton's bill is still pending but she'll keep at it and I'll be grandfathered in...its in the fine print!
4753,0,0,36,36,1.0,0.028171808490950554,526,Forget what St. Paul said -- Allah il Allah il Allah.
4753,0,0,37,37,1.0,0.02739983121755955,526,They only an extra-large.
4753,0,0,35,35,1.0,0.028988551782622423,526,NOT ON YOUR LIFE!
4753,0,0,36,36,1.0,0.028171808490950554,526,Your is so much bigger than mine.
4753,0,0,37,37,1.0,0.02739983121755955,526,It IS over-compensation. For my ENORMOUS unmentionable which Paradise forbade me.
4753,0,0,37,37,1.0,0.02739983121755955,526,Just remember mines a halo yours is a hoopla hoop!!!!!!!
4753,0,0,35,35,1.0,0.028988551782622423,526,"Hey, did you fall from heaven, because I- wait..."
4753,0,0,32,32,1.0,0.031750031750047626,526,You will text while driving. Hope you're satisfied.
4753,0,0,36,36,1.0,0.028171808490950554,526,"It's the score. And yes, like in golf."
4753,0,0,35,35,1.0,0.028988551782622423,526,a e i O u and sometimes y.
4753,0,0,35,35,1.0,0.028988551782622423,526,"Stick with me, I'm in my 49th shade."
4753,0,0,36,36,1.0,0.028171808490950554,526,I'll take the Pinot.
4753,0,0,36,36,1.0,0.028171808490950554,526,Want to fly over to the next cloud for a milkshake?
4753,0,0,35,35,1.0,0.028988551782622423,526,"Good girls may go to heaven but, unfortunately, the hotties must have gone to hell."
4753,0,0,36,36,1.0,0.028171808490950554,526,"It's not the size of the halo, it's how you use it that counts. However, mine is Yuuuuge."
4753,0,0,33,33,1.0,0.030772872744833184,526,"Halo it's me. I've thought about us for a long, long time"
4753,0,0,36,36,1.0,0.028171808490950554,526,It got caught in a propeller.
4753,0,0,34,34,1.0,0.029854071701326604,526,"Big halo, big..."
4753,0,0,35,35,1.0,0.028988551782622423,526,Say 'That's what she said' again. I dare ya.
4753,0,0,35,35,1.0,0.028988551782622423,526,You know what they say about haloes...
4753,0,0,35,35,1.0,0.028988551782622423,526,"Sorry - ""I cannot give you a ring for there is no jewelry store here."
4753,0,0,35,35,1.0,0.028988551782622423,526,"Hey, Big Halo, wanna come fly with me? Let's fly, let's fly away down to Acapulco Bay."
4753,0,0,36,36,1.0,0.028171808490950554,526,"Bae, you should have had the angel food cake."
4753,0,0,35,35,1.0,0.028988551782622423,526,Actually it's pronounced like heave. Heave-en.
4753,0,0,37,37,1.0,0.02739983121755955,526,"""No- it's real; besides, that was just 20 minutes of action""."
4753,0,0,36,36,1.0,0.028171808490950554,526,I just knew you were coming !
4753,0,0,38,38,1.0,0.02666903735313325,526,"I developed the video game, Halo, so they decided I deserved a bigger one when I arrived."
4753,0,0,37,37,1.0,0.02739983121755955,526,"Yeah, it's Donald Trump's kid. Obviously compensating for his tiny little binky."
4753,0,0,37,37,1.0,0.02739983121755955,526,It's all about the girth.
4753,0,0,36,36,1.0,0.028171808490950554,526,They told me I flirted too much in College!
4753,0,0,36,36,1.0,0.028171808490950554,526,"You told me that He liked a bigger halo, but he said that its good that my head was big enough to fit into it."
4753,0,0,36,36,1.0,0.028171808490950554,526,Ok---do you have a cigarette?
4753,0,0,36,36,1.0,0.028171808490950554,526,"Upgrade your firmware , eeeesh , sorry I meant to say software ..."
4753,0,0,36,36,1.0,0.028171808490950554,526,"Well I was killed by the bigger guy, so I get the bigger halo."
4753,0,0,36,36,1.0,0.028171808490950554,526,"My ring is bigger than yours, ha, ha!"
4753,0,0,36,36,1.0,0.028171808490950554,526,Pray tell....still wearing that same old dress!
4753,0,0,36,36,1.0,0.028171808490950554,526,Who's more of an angle now? I have the bigger halo.
4753,0,0,36,36,1.0,0.028171808490950554,526,I worked in product development at McDonalds.
4753,0,0,36,36,1.0,0.028171808490950554,526,I've been told Size really does matter.
4753,0,0,36,36,1.0,0.028171808490950554,526,My hole in the sky gives me more mobility
4753,0,0,36,36,1.0,0.028171808490950554,526,"No that we feel younger and happy, can we try to unite the DNC and GOP"
4753,0,0,35,35,1.0,0.028988551782622423,526,"No more Porsches for you, naughty girl."
4753,0,0,36,36,1.0,0.028171808490950554,526,I won the Mine Is Bigger Then Yours contest.
4753,0,0,35,35,1.0,0.028988551782622423,526,"This way, it's better for hula-hooping."
4753,0,0,36,36,1.0,0.028171808490950554,526,They knew I played bowling.
4753,0,0,35,35,1.0,0.028988551782622423,526,God only knows. But it must have something to do with the better angels of our nature.
4753,0,0,36,36,1.0,0.028171808490950554,526,I moved to Westchester for this?
4753,0,0,36,36,1.0,0.028171808490950554,526,"I hear it's directly proportional to the amount of times you posted about social justice on Facebook."" ""Really? I thought it was about ego."
4753,0,0,35,35,1.0,0.028988551782622423,526,Halos were based on self-review so as a mediocre white man what did you expect.
4753,0,0,36,36,1.0,0.028171808490950554,526,Can you help me hide from Donald Trump?
4753,0,0,37,37,1.0,0.02739983121755955,526,"Sup Angel I am willing to shrink my halo down a few notches if you know what I mean."" ""Yeah Ted, that is the problem with all you guys and your big halos. Nothin but a bunch of amateurs"
4753,0,0,36,36,1.0,0.028171808490950554,526,Divine justice -- a match made in heaven and I'm stuck at halo's length!
4753,0,0,36,36,1.0,0.028171808490950554,526,"Well, God said it wasn't immaculate this time..."
4753,0,0,37,37,1.0,0.02739983121755955,526,"I was in the never-Hillary camp,"" says female angel. Male angel responds, ""I was in the never-Trump camp. Wait, what are BOTH of us doing here?"
4753,0,0,34,34,1.0,0.029854071701326604,526,"Now that you're here, together we'll fight the old patriarchy."
4753,0,0,37,37,1.0,0.02739983121755955,526,looks like a transgender halo to me dear
4753,0,0,35,35,1.0,0.028988551782622423,526,"— Halo, I'm Meg, what's your name?"
4753,0,0,34,34,1.0,0.029854071701326604,526,"I always believed, one day, she would be president."
4753,0,0,36,36,1.0,0.028171808490950554,526,This place increased their cover.
4753,0,0,36,36,1.0,0.028171808490950554,526,........ and the worst part is I had three kids with her too....9
4753,0,0,36,36,1.0,0.028171808490950554,526,You're a devil in heaven.
4753,0,0,36,36,1.0,0.028171808490950554,526,The woman god is trying to punch the man god during he is closing his eyes!
4753,0,0,36,36,1.0,0.028171808490950554,526,"Before your wingspan, the frontal assault on you. Badda-Bing!"
4753,0,0,36,36,1.0,0.028171808490950554,526,Salam! Are you one of the seventy-two virgins I was promised?
4753,0,0,36,36,1.0,0.028171808490950554,526,It's probably symbolic due to me being the tenth child born into a Catholic family.
4753,0,0,36,36,1.0,0.028171808490950554,526,'97 was the last year I'd work detail on Clinton
4753,0,0,36,36,1.0,0.028171808490950554,526,Mine takes more work than yours to keep it clean.
4753,0,0,35,35,1.0,0.028988551782622423,526,I had halo envy.
4753,0,0,37,37,1.0,0.02739983121755955,526,*girl angel* That halo so doesn't look good on you.
4753,0,0,36,36,1.0,0.028171808490950554,526,"I don't usually tell this story, but, I was Hula Champion of the World until I got my wings..."
4753,0,0,36,36,1.0,0.028171808490950554,526,Just hold on to me and you'll grow too
4753,0,0,36,36,1.0,0.028171808490950554,526,"Just keep it low profile. It is difficult at first, but you'll get used to it."
4753,0,0,36,36,1.0,0.028171808490950554,526,My achievements were greater than you. I am going to be a president next year.
4753,0,0,36,36,1.0,0.028171808490950554,526,"Ah hi, John, new here. Appears this is my ""big enough to spoil you for heaven"" phase."
4753,0,0,36,36,1.0,0.028171808490950554,526,My brother will be here in a minute. He just stopped off to go to the bathroom.
4753,0,0,36,36,1.0,0.028171808490950554,526,"So you have your wings, don't expect a bigger Halo!"
4753,0,0,33,33,1.0,0.030772872744833184,526,"You are a beautiful little angel,who inspires the importance of heavenly bliss."
4753,0,0,36,36,1.0,0.028171808490950554,526,"If we get to a hill, I'm turning around."
4753,0,0,37,37,1.0,0.02739983121755955,526,Check out my custom made 20 inch cast aluminum halo wheel.
4753,0,0,36,36,1.0,0.028171808490950554,526,not to be holier than though...but or You new around here? I haven't seen you round this cloud before
4753,0,0,37,37,1.0,0.02739983121755955,526,"""You know what they say about a big halo, right gorgeous?"" Proving for all eternity that once a smarmy guy . . ."
4753,0,0,36,36,1.0,0.028171808490950554,526,"""eve"
4753,0,0,33,33,1.0,0.030772872744833184,526,I was a curator at Dia Beacon.
4753,0,0,35,35,1.0,0.028988551782622423,526,It's the dollar halo to your 79 cents one
4753,0,0,36,36,1.0,0.028171808490950554,526,I really thought angels don't have gender but this is too much!
4753,0,0,36,36,1.0,0.028171808490950554,526,i didn't know you could sing in heaven brother.
4753,0,0,35,35,1.0,0.028988551782622423,526,"Don't know, even the saints' are smaller"
4753,0,0,36,36,1.0,0.028171808490950554,526,I'm always imagining it's bigger.
4753,0,0,36,36,1.0,0.028171808490950554,526,There's nothing I can do. He can't stop eating cheeseburgers. And each one adds another inch to my figure.
