rank,funny,somewhat_funny,unfunny,count,score,precision,contest,caption
1,39,56,80,175,1.7657142857142858,0.05993819633405312,527,"Well, your profile pic doesn't look much like you either."
2,38,38,74,150,1.76,0.06800447412574094,527,"You voted ‘Leave,’ didn’t you?"
3,39,33,82,154,1.7207792207792207,0.0680133609598613,527,"Well, I never believed in you either."
4,34,26,73,133,1.7067669172932332,0.07377923854935436,527,We have observed you in the barn. So many questions.
5,36,19,81,136,1.6691176470588236,0.074575886588349,527,"Greetings, and let go of my penis."
6,29,31,74,134,1.664179104477612,0.07022418678873209,527,Probe you? I hardly know you.
7,30,30,76,136,1.661764705882353,0.07018539736900173,527,Your cows speak highly of you.
8,27,32,71,130,1.6615384615384616,0.07039698839733113,527,"You look surprised, John. Have I really changed that much since high school?"
9,23,29,63,115,1.6521739130434783,0.07415270518240542,527,Thank God we found you. What the hell is quinoa?
10,30,25,76,131,1.6488549618320612,0.07263488606159674,527,"Welcome aboard! First stop, Uranus."
11,28,25,73,126,1.6428571428571428,0.07343221533790947,527,"Think of us as ""Proctologists Without Borders""."
12,18,44,63,125,1.64,0.06465790872963897,527,We said we would return when Cleveland won a championship.
13,23,35,69,127,1.6377952755905512,0.06861539847737756,527,Keep me from your leader.
14,28,19,71,118,1.6355932203389831,0.07769052950152211,527,"If you enjoyed your anal probe as much as we did, please ""Like"" us on Facebook."
15,24,30,69,123,1.6341463414634145,0.07141707684331744,527,I had a great time tonight. Can I call you?
16,22,31,66,119,1.6302521008403361,0.07147254358370729,527,I'm sure we can settle this without involving the insurance companies.
17,23,26,67,116,1.6206896551724137,0.07413182918301663,527,"Wow, small universe! My name is also John."
18,24,27,70,121,1.6198347107438016,0.07259096919136375,527,You've been served.
19,25,19,69,113,1.6106194690265487,0.07793319077779282,527,"Just remember, what happens on Vega stays on Vega."
20,20,30,65,115,1.608695652173913,0.07169693417281371,527,"We've met your leaders and, well, you should come with us."
21,18,35,66,119,1.596638655462185,0.06784715990669968,527,"We've seen your leaders, and we have absolutely no interest in being taken to them."
22,19,29,65,113,1.592920353982301,0.07181629550808487,527,"Yes, it is nice to meet you Earthling, but please let go of my reproductive organ."
22,19,29,65,113,1.592920353982301,0.07181629550808487,527,"Thank you for a great weekend, but I'm just not good at long distance relationships."
24,18,29,63,110,1.5909090909090908,0.07225136197330992,527,Are you the one who grows the weed?
25,15,33,61,109,1.5779816513761469,0.06933201253060937,527,Hate to probe and run...
26,9,40,52,101,1.5742574257425743,0.06501566399755249,527,"You're right, it's more like a tureen than a saucer."
27,14,31,58,103,1.5728155339805825,0.07116279032965835,527,"We came in peace, but now we just want to leave."
28,20,21,66,107,1.5700934579439252,0.07641240408877602,527,"Sorry about all the circles, my wife was driving."
28,22,17,68,107,1.5700934579439252,0.07868625664712174,527,We learned everything about you from Facebook; the probing was just for me.
30,22,15,67,104,1.5673076923076923,0.08056515168694917,527,We don’t probe any more. You fill out a short questionnaire when you leave.
31,17,26,63,106,1.5660377358490567,0.07344539496893901,527,What happens on Vega stays on Vega.
32,15,27,59,101,1.5643564356435644,0.0736809305154022,527,We're planning on building a wall around your planet and we want you to pay for it.
33,16,26,61,103,1.5631067961165048,0.0738770271235363,527,I hear you hire illegal aliens.
34,18,19,61,98,1.5612244897959184,0.07953463232076563,527,Can you direct us to a planet with intelligent life?
35,11,32,55,98,1.5510204081632653,0.06974820057311763,527,"Excuse me, do you have jumper cables?"
36,22,11,67,100,1.55,0.08333333333333333,527,"So you must be the interstellar legend, the Farmer in the Dell."
36,17,21,62,100,1.55,0.07703468981143129,527,We come to take your jobs.
38,16,24,62,102,1.5490196078431373,0.07454964245738935,527,'Is that what you're wearing? '
39,19,15,63,97,1.5463917525773196,0.08162416300058307,527,Welcome. I am a genetically modified potato from the future.
40,16,23,62,101,1.5445544554455446,0.07515627609642908,527,"Sorry about the crop circles, I needed to jot something down."
41,10,31,53,94,1.5425531914893618,0.07040246691523941,527,"Sorry you had to climb the stairs, our abduction beam is broken."
42,11,31,56,98,1.5408163265306123,0.06981742193934723,527,"Not to worry. What happens on Venus, stays on Venus."
42,11,31,56,98,1.5408163265306123,0.06981742193934723,527,"You look just like all our movies, too!"
42,14,25,59,98,1.5408163265306123,0.07420008566997251,527,What do I have to do to get you into this spaceship today?
42,10,33,55,98,1.5408163265306123,0.06829406248373308,527,Remember that what happens on Venus stays on Venus.
42,15,23,60,98,1.5408163265306123,0.07560453788732568,527,"Getting so many volunteers is nice, but truthfully I miss the abductions."
47,15,24,61,100,1.54,0.0744271048704297,527,I have travelled the galaxy in search of another species that wears one-piece clothing.
47,16,22,62,100,1.54,0.07577211981602562,527,"Well, no. The truth is we won't probe you anywhere unless your primary care physician has made a referral to us for that sort of thing."
47,18,18,64,100,1.54,0.07839294959021854,527,Welcome aboard. It's good to eat you.
50,16,23,63,102,1.5392156862745099,0.07460706441653131,527,Your crop circle design won. Please come with us.
51,18,16,63,97,1.5360824742268042,0.08035287251608195,527,Take me to your lesser of two evils
52,13,27,59,99,1.5353535353535352,0.07223660035084459,527,We just come down here once in a while to feel good about ourselves.
53,10,30,54,94,1.5319148936170213,0.07046293901282416,527,Lets keep in touch on Spacebook.
53,15,20,59,94,1.5319148936170213,0.07815963645866598,527,"Hello, do you have a moment to talk about Jesus Christ?"
55,15,21,60,96,1.53125,0.07688155192447528,527,"In our civilization, we reproduce through handshakes."
56,13,24,58,95,1.5263157894736843,0.07459049121923327,527,"Don't worry Sir, I will have her home by 11 p.m."
56,14,22,59,95,1.5263157894736843,0.07607697119404792,527,E. I. E. I. O. Signal received.
58,11,26,55,92,1.5217391304347827,0.07327937246229366,527,"Honey, dinner's here."
59,13,24,59,96,1.5208333333333333,0.07401275178576044,527,"Nah, we're a weather balloon."
59,17,16,63,96,1.5208333333333333,0.07971875820255059,527,EIEIO
61,15,15,57,87,1.5172413793103448,0.08314531416731243,527,Can I use your bathroom? It's been a long trip.
62,12,23,56,91,1.5164835164835164,0.07553252113571869,527,Welcome. We've heard amazing jokes about your daughter.
63,14,20,59,93,1.5161290322580645,0.07737648805449929,527,We heard you had universal health care.
63,10,28,55,93,1.5161290322580645,0.07107815797318978,527,Congratulations! You're our one millionth abductee!
63,15,18,60,93,1.5161290322580645,0.07887252369706867,527,"No, anal probe is just a common alien surname"
66,18,13,64,95,1.5157894736842106,0.0817818882397686,527,Since you did have polyps removed I will have to see you again in 5 years.
66,12,25,58,95,1.5157894736842106,0.07310603429034505,527,"Where I'm from, everybody is genetically modified."
68,15,20,62,97,1.5154639175257731,0.07631071474640018,527,We've come to bring the Kardashians home.
69,16,14,60,90,1.511111111111111,0.08247792341770609,527,It's nothing you've done -- We're just going in a different direction with our abductions.
69,9,28,53,90,1.511111111111111,0.07109706478002936,527,"You should have no more problems with your satellite service now, sir."
69,10,26,54,90,1.511111111111111,0.07283186466425955,527,We're not from around here.
69,11,24,55,90,1.511111111111111,0.07452629335080571,527,Your cows said very nice things about you.
73,13,21,58,92,1.5108695652173914,0.07649538865683334,527,Take me from my leaders.
73,13,21,58,92,1.5108695652173914,0.07649538865683334,527,Pull my finger.
75,13,22,59,94,1.5106382978723405,0.07524030115035443,527,Would you like to watch a 30-minute video about a time-share opportunity?
76,16,12,59,87,1.5057471264367817,0.08475567227308224,527,I speak your language... E I E I O!
77,13,19,57,89,1.5056179775280898,0.07848735203472189,527,"We live fifty seven light years away, so we just started receiving Bonanza."
77,17,11,61,89,1.5056179775280898,0.08474499919803569,527,"'Oh no, it's an earthling!' Just kidding, we've probed you and erased your memory like 50 times. Come on in."
77,15,15,59,89,1.5056179775280898,0.08167612661756626,527,We come in peace - and for the cronuts.
77,10,25,54,89,1.5056179775280898,0.07344505827271725,527,Are you the farmer who has the daughter' we've heard so much about?
77,11,23,55,89,1.5056179775280898,0.07516341663067219,527,Sorry about the crop circles. We were just messing with you.
82,15,16,60,91,1.5054945054945055,0.08025238937804632,527,We've come for all the extra gluten.
82,14,18,59,91,1.5054945054945055,0.07871623566130001,527,We're here to help. We understand there's something the matter with Kansas.
82,12,22,57,91,1.5054945054945055,0.07555028304569633,527,"Hi, we're the new owners."
85,14,19,60,93,1.5053763440860215,0.07739272826625426,527,There's a two drink minimum.
86,14,20,61,95,1.5052631578947369,0.07612343987670361,527,Your race isn't as orange as your television signals had us believe.
86,9,30,56,95,1.5052631578947369,0.06837365918242709,527,I suppose my dating profile was a bit misleading.
88,13,19,58,90,1.5,0.0778134393008702,527,"Take me to your leader - just kidding, we're abducting you."
88,11,22,55,88,1.5,0.07580980435789034,527,Sorry we do have a dress code.
88,11,22,55,88,1.5,0.07580980435789034,527,Is there a gender neutral bathroom around here?
88,17,11,62,90,1.5,0.08398620658405477,527,Then it's agreed--we'll take you away from here no matter who wins in November.
92,16,17,66,99,1.494949494949495,0.07647907647907648,527,Welcome aboard--Just a reminder that Economy class is self-probing.
93,12,24,61,97,1.4948453608247423,0.07198061878231413,527,"Don't worry, we're not Mexican or Muslim."
94,12,21,58,91,1.4945054945054945,0.07555028304569633,527,I bet your almanac didn't predict this.
95,12,20,57,89,1.4943820224719102,0.07684335894863775,527,"And you've only had clear liquids for the past 24 hours, correct?"
95,16,12,61,89,1.4943820224719102,0.08322470951683696,527,"Don’t worry, you won’t remember a thing."
95,8,28,53,89,1.4943820224719102,0.06988169542059264,527,It was so nice of your wife to volunteer you.
98,11,21,55,87,1.4942528735632183,0.07646556709168151,527,"Congratulations, just attend one timeshare presentation, and we’ll have you home by yesterday!"
99,8,26,51,85,1.4941176470588236,0.07222655263306024,527,I don't probe on the first abduction.
99,15,12,58,85,1.4941176470588236,0.08471988679750293,527,E-I-E-I-O' I presume?
101,16,12,62,90,1.488888888888889,0.08247792341770609,527,"Whoa, wait, you guys are the masters of this planet? We had our money on Jack Russell terriers!"
102,10,23,55,88,1.4886363636363635,0.07405679670635239,527,We're looking forward to meeting your daughter...
103,13,16,57,86,1.4883720930232558,0.08059998344582292,527,Klaatu barada nikto . . . just messing with you.
103,14,14,58,86,1.4883720930232558,0.08227973713305385,527,"Congratulations, you've won the Caption Contest."
103,13,16,57,86,1.4883720930232558,0.08059998344582292,527,Does Earth still have any leaders worth taking me to?
106,12,17,55,84,1.4880952380952381,0.08032858441548751,527,You look like the type of gentleman who knows a good deal on a time share when he sees one. Am I right?
106,11,19,54,84,1.4880952380952381,0.07852273391541612,527,We come seeking peas.
108,8,26,53,87,1.4827586206896552,0.07100694207926107,527,"What I meant was, we would like to have you stay for dinner."
108,15,12,60,87,1.4827586206896552,0.08314531416731243,527,I come in peace. And also for your job.
108,11,20,56,87,1.4827586206896552,0.07644547365628225,527,"And, I promise to make the universe great again."
108,12,18,57,87,1.4827586206896552,0.07817428380800989,527,Actually we can't claim any credit for the pyramids but we shared some ideas with that guy who developed the lava lamp
112,9,23,53,85,1.4823529411764707,0.07411809167978328,527,"Hello there, is this your first ride with Uber?"
113,12,16,55,83,1.4819277108433735,0.08106230807906749,527,Our intelligence says you're supposed to introduce me to your daughter and offer me a place to sleep tonight.
113,10,20,53,83,1.4819277108433735,0.0773523178099076,527,"Before annihilating your planet, may I use your facilities?"
115,7,24,48,79,1.481012658227848,0.0739763190388416,527,Are you organic?
116,14,14,60,88,1.4772727272727273,0.08077678120756704,527,"Normally, I say, 'Take me to your leader,' but we've been following your election process, so don't bother."
117,8,24,52,84,1.4761904761904763,0.07280186819496158,527,I should have called first.
117,15,10,59,84,1.4761904761904763,0.08548768414918383,527,Just stopped by to let you know that we will be using crop SQUARES from now on...
119,13,13,56,82,1.475609756097561,0.08362750202823561,527,"Alien? No, no, no. I'm Mexican. I just used this to get over your wall."
120,8,22,50,80,1.475,0.07542076066469036,527,Do they still think you're Amish?
121,7,28,54,89,1.4719101123595506,0.06796676402000262,527,Come on in. I have candy.
122,14,13,60,87,1.471264367816092,0.08148429324342787,527,Another choosing anal probes over President Trump!
123,6,28,51,85,1.4705882352941178,0.06816571358209496,527,We heard you hire alien workers.
123,12,16,57,85,1.4705882352941178,0.07954392985680157,527,Your GMO corn called us: we need to replace your field management chip.
123,8,24,53,85,1.4705882352941178,0.07215808061327615,527,I got your friend request.
123,16,8,61,85,1.4705882352941178,0.08629997077830025,527,"Thank God you’re still here.....you haven’t noticed any keys rattling around in your anus, have you?"
127,12,15,56,83,1.4698795180722892,0.08101862049406781,527,We have come to take your jobs.
128,9,20,52,81,1.4691358024691359,0.07675200514750397,527,You're over analyzing it. Sometimes a crop circle is just a crop circle.
128,12,14,55,81,1.4691358024691359,0.0825638917450504,527,Mr. Hoffa will see you now.
130,12,13,54,79,1.4683544303797469,0.08418508503306028,527,"Congrats, you're our one millionth abductee!"
130,8,21,50,79,1.4683544303797469,0.07608448437579868,527,"Oh, no thank you. Just tell your leaders that we say, ""Hi."""
130,11,15,53,79,1.4683544303797469,0.08223477729768885,527,Mr. MacDonald? My name is EIEIO. I hear you've been trying to reach me for some time.
133,10,19,55,84,1.4642857142857142,0.07658523308314387,527,"So... can I, uh, call you?"
133,14,11,59,84,1.4642857142857142,0.0837421331050203,527,"You're welcome aboard, so long as you stay away from my daughters."
133,12,15,57,84,1.4642857142857142,0.08024351308167661,527,"Hi! You're Craigslist ad said, ""M, F or surprise me."
133,8,23,53,84,1.4642857142857142,0.07274320903774967,527,Does your planet have species neutral bathrooms?
133,13,13,58,84,1.4642857142857142,0.082011481661619,527,"Sir I know you are very confused right now but please, can I use your bathroom?"
138,9,20,53,82,1.4634146341463414,0.07602580021195411,527,"I'm Glen, your Uber driver."
138,10,18,54,82,1.4634146341463414,0.0779810003790686,527,"While you've been growing broccoli, we've been growing you."
138,9,20,53,82,1.4634146341463414,0.07602580021195411,527,"Hello, Mr. Anderson, do not be alarmed. Your H.M.O. has outsourced to us your annual 'After-50' colonoscopy."
138,9,20,53,82,1.4634146341463414,0.07602580021195411,527,Come help make Mars great again.
138,8,22,52,82,1.4634146341463414,0.0740189717276296,527,"I'm sorry , my wife insists you take off your shoes."
138,12,14,56,82,1.4634146341463414,0.08175123647153579,527,Our new menu is farmer-to-table.
138,6,26,50,82,1.4634146341463414,0.0698325134239844,527,"Actually...we're looking for ""the farmer's daughter"" we've heard so much about."
145,9,19,52,80,1.4625,0.0774264657267572,527,Just kidding. I'm from Monsanto.
145,8,21,51,80,1.4625,0.07535517167875191,527,I came as soon as I heard about the ball field.
145,8,21,51,80,1.4625,0.07535517167875191,527,Can we do crop squares this time?
145,9,19,52,80,1.4625,0.0774264657267572,527,"Wish I could invite you in, but we've got a strict ban on illegal aliens."
149,13,10,55,78,1.4615384615384615,0.08692839592494779,527,We are collecting two Mennonite . Is anyone else home?
149,6,24,48,78,1.4615384615384615,0.07228792213836381,527,"I know, my profile picture is a couple years old."
149,8,20,50,78,1.4615384615384615,0.07675639617050044,527,Would you consider yourself free-range?
152,11,17,57,85,1.4588235294117646,0.07769966811242938,527,Hey Fred. Come on in. Your cows have been asking about you.
153,10,18,55,83,1.4578313253012047,0.0772378065438506,527,We heard America is gonna be great again!
153,8,22,53,83,1.4578313253012047,0.07333458965020934,527,You seem surprised yet we spelled everything out pretty clearly in the crop circles.
153,14,10,59,83,1.4578313253012047,0.08450510162579943,527,That's what you're wearing?
153,14,10,59,83,1.4578313253012047,0.08450510162579943,527,We're just here for Dick Cheney--sorry about the wait.
153,11,16,56,83,1.4578313253012047,0.07911723655421517,527,I'm sorry for your loss. Alf was a hero to us all.
153,7,24,52,83,1.4578313253012047,0.07130290091499954,527,So the three day vacation is free and all I need to do is attend a 30 minute presentation.
159,13,11,57,81,1.4567901234567902,0.08434457309825186,527,"You don't have 'Hamilton' tickets, do you?"
159,11,15,55,81,1.4567901234567902,0.08060225220494194,527,Thank God you're here! You heard we're looking for an alternative Republican candidate?
159,10,17,54,81,1.4567901234567902,0.07866435714604439,527,Bring two of each.
162,11,14,54,79,1.4556962025316456,0.08215980255732015,527,I'll call you. Promise.
162,8,20,51,79,1.4556962025316456,0.0760034428285226,527,We always buy local...
162,9,18,52,79,1.4556962025316456,0.07810949536779516,527,"Just make it look like an abduction, okay?"
165,8,24,56,88,1.4545454545454546,0.07028284940773348,527,"So, how many steps is that for mankind?"
165,10,15,52,77,1.4545454545454546,0.08173079559055774,527,Whaddya say to a latté after the probe?
167,5,24,46,75,1.4533333333333334,0.07176873100975628,527,Mind if I hook up to your septic tank?
168,9,19,54,82,1.451219512195122,0.07594122639133905,527,"So, it's agreed, 2 tickets to ""Hamilton"" for a trip to Alpha Centauri."
168,7,23,52,82,1.451219512195122,0.07186683255380011,527,We saw your sign for farm-fresh strawberries and had to stop.
168,14,9,59,82,1.451219512195122,0.0852797776561494,527,Take us to Lucy Ricardo.
168,10,17,55,82,1.451219512195122,0.0778985493322754,527,Are you the Nigerian prince who has been sending me emails?
168,9,19,54,82,1.451219512195122,0.07594122639133905,527,So your people are free-range?
168,10,17,55,82,1.451219512195122,0.0778985493322754,527,"Hi, Are you Jack? I am Jonathan, your Uber Driver"
174,7,22,51,80,1.45,0.07313071356019156,527,"Thanks for the directions, the GPS on this thing never works."
174,7,22,51,80,1.45,0.07313071356019156,527,"On second thought, I can do without meeting your leader."
174,12,12,56,80,1.45,0.08324890237616016,527,"Look, we enjoy a good gag as much as anyone, but this is the last crop circle we're going to do for you."
174,10,16,54,80,1.45,0.07935658986139954,527,Congratulations you are our 1 millionth abduction
174,9,18,53,80,1.45,0.07733700704208724,527,We have to prove our gender in order to use your restrooms?
174,6,24,50,80,1.45,0.07093409314018369,527,May I use your restroom?
174,10,16,54,80,1.45,0.07935658986139954,527,Eee I eee I oh.
181,8,13,44,65,1.4461538461538461,0.08779009392702561,527,That was fast. Uber said you were two light years away.
182,8,20,53,81,1.4444444444444444,0.07453559924999299,527,You look nothing like your profile pic
182,10,16,55,81,1.4444444444444444,0.07856742013183861,527,Do NOT take me to your leader.
182,5,26,50,81,1.4444444444444444,0.06804138174397717,527,"What happens on Venus, stays on Venus."
182,10,16,55,81,1.4444444444444444,0.07856742013183861,527,"The crop circles? Oh, we were just messing with you."
182,13,10,58,81,1.4444444444444444,0.08425417160057279,527,Thanks so much. Our regular sitter cancelled and we have Hamilton tickets.
182,9,18,54,81,1.4444444444444444,0.07657804862272345,527,So we’re agreed: That’s a ‘yes’ to the cup of sugar but ‘no’ to the probing.
188,12,11,56,79,1.4430379746835442,0.08401410107728391,527,Is this your first time using Uber?
188,10,15,54,79,1.4430379746835442,0.08005766228274379,527,"We could have Skyped this meeting, you realize."
190,8,18,51,77,1.4415584415584415,0.07732167872281914,527,Do not be afraid. I am not from Mexico.
191,8,17,50,75,1.44,0.07882012821997063,527,"Yes, I promise to come back and get you if he wins."
191,10,13,52,75,1.44,0.0832666399786453,527,"Can you get me four tickets to ""Hamilton""?"
193,7,22,53,82,1.4390243902439024,0.07175177395595515,527,We were told we could get some guns here...
193,9,18,55,82,1.4390243902439024,0.07583235002511231,527,"And remember, please take a moment to complete the Abductee Experience survey for 10% less probing at your next abduction."
193,12,12,58,82,1.4390243902439024,0.08157136554630033,527,E-I-E-I-O
193,11,14,57,82,1.4390243902439024,0.0797042881834837,527,Thanks for coming. We have the results of your probe.
197,12,8,53,73,1.4383561643835616,0.0893624921953467,527,"Hi, it's Me--without the beard and sandals!"
198,9,17,54,80,1.4375,0.07722183645392315,527,We too love bacon.
198,9,17,54,80,1.4375,0.07722183645392315,527,So this is your first time riding with Uber?
198,11,13,56,80,1.4375,0.0812165218272829,527,"Don't worry, we'll have her home by nine."
198,10,15,55,80,1.4375,0.0792443545088165,527,Lucky you. This happens to be Dress Down Friday.
198,10,15,55,80,1.4375,0.0792443545088165,527,Ignore the kids. We don't like them playing with their food.
198,8,19,53,80,1.4375,0.07514490221641068,527,Do you mind? The wife's a nut for vacation photos.
198,11,13,56,80,1.4375,0.0812165218272829,527,I bought the farm
205,15,4,59,78,1.435897435897436,0.09048973866564881,527,Looks like you got the memo on the one-piece suit. Just kidding. Come on in.
205,8,18,52,78,1.435897435897436,0.07653359048662939,527,"Remember, tell them you got the seeds from Monsanto."
205,12,10,56,78,1.435897435897436,0.0847902813108697,527,I was the closest Uber driver tonight.
205,9,16,53,78,1.435897435897436,0.07867903663476963,527,"I'm so happy to eat you. I mean, happy to meet you."
205,8,18,52,78,1.435897435897436,0.07653359048662939,527,What does EIEIO stand for?
205,7,20,51,78,1.435897435897436,0.07432624125956294,527,Ahhh! Nothing beats farm fresh to table.
211,12,9,55,76,1.4342105263157894,0.08652253801459789,527,"Good evening, kind sir. I was wondering if I could share the word of Glork with you?"
211,7,19,50,76,1.4342105263157894,0.07570841181516923,527,"Kids, set the table. Dinner's here."
211,7,19,50,76,1.4342105263157894,0.07570841181516923,527,"Greetings, I am Bort and I will be your Uber driver tonight."
211,9,15,52,76,1.4342105263157894,0.08020921396909565,527,Just a quick x-ray. I haven't seen my watch since your probing.
211,11,11,54,76,1.4342105263157894,0.08447054156038708,527,"You had me at ""ZXQRPBYMWK""."
216,8,18,53,79,1.4303797468354431,0.07575979803933318,527,We'll keep your resume on file.
216,7,20,52,79,1.4303797468354431,0.07358652766734848,527,"Welcome aboard, sir. You know, we honestly didn't think he'd win either. Hilary is already inside with the others."
216,9,16,54,79,1.4303797468354431,0.0778724402069414,527,We heard you were outstanding in your field.
219,7,19,51,77,1.4285714285714286,0.07493120889064774,527,We want to pick your brain for a minute.
219,11,11,55,77,1.4285714285714286,0.08355680740937169,527,"I could eat a horse! Just kidding, your offspring will suffice."
219,8,17,52,77,1.4285714285714286,0.07717803810328507,527,I'll have her back by curfew.
222,7,18,50,75,1.4266666666666667,0.07634283350929691,527,"But no shoes inside the ship, if you don't mind."
222,9,14,52,75,1.4266666666666667,0.08092557660560071,527,Welcome to Trump University!
224,9,16,55,80,1.425,0.0770808387097762,527,"OK, I'll take you from your leaders."
224,6,22,52,80,1.425,0.07065471397999526,527,Come; we'll take you from farm to table.
226,7,17,49,73,1.4246575342465753,0.07782676049798773,527,Buy local... Ha! Good one.
227,7,19,52,78,1.4230769230769231,0.07416811543421603,527,"You're 100% organic, right?"
227,9,15,54,78,1.4230769230769231,0.07852967600253971,527,"It's just as you thought, your wife IS one of ours."
227,7,19,52,78,1.4230769230769231,0.07416811543421603,527,"Ah, Mr Jones, my 2 o'clock colonoscopy, come right in."
227,11,11,56,78,1.4230769230769231,0.08266142195162461,527,Have my daughter home by midnight or I'll melt your whole planet.
227,9,15,54,78,1.4230769230769231,0.07852967600253971,527,"'Come on in, great costume!'"
227,8,17,53,78,1.4230769230769231,0.07638003456443004,527,"So sorry about your cattle, wife and crops. It's my first invasion."
227,9,15,54,78,1.4230769230769231,0.07852967600253971,527,Take me to your superdelegates.
227,10,13,55,78,1.4230769230769231,0.0806220214709616,527,Welcome aboard! I'm the head of community relations. It's my job to find the person least likely to be believed.
227,8,17,53,78,1.4230769230769231,0.07638003456443004,527,"Good evening sir, can I take a moment to tell you about L. Ron Hubbard"
236,14,4,58,76,1.4210526315789473,0.0903466188742718,527,"We’ve paid for your 20th century vintage LP club, but so far your Voyager’s only delivered the sound effects one."
236,7,18,51,76,1.4210526315789473,0.07554052681267011,527,"We would have made contact sooner, but we were waiting for Cleveland to win a championship."
236,8,16,52,76,1.4210526315789473,0.07782832636076782,527,"No, no—don’t take me to your leader."
236,8,16,52,76,1.4210526315789473,0.07782832636076782,527,Greetings American voter. Your application for refugee status has been approved.
240,7,15,47,69,1.4202898550724639,0.08103601627746519,527,"No, it's too late to change your mind to Remain."
241,9,13,52,74,1.4189189189189189,0.08164986234534165,527,Thanks for getting abducted on such short notice.
242,9,12,51,72,1.4166666666666667,0.08333333333333333,527,You look familiar. Have we probed you before?
242,5,20,47,72,1.4166666666666667,0.0733450694834178,527,So we agree. Squares. Not Circles ... squares.
242,10,10,52,72,1.4166666666666667,0.08564858872844146,527,Take me to your least-disapproved-of leader.
242,9,12,51,72,1.4166666666666667,0.08333333333333333,527,Can I use your outhouse?
246,8,16,53,77,1.4155844155844155,0.07700531568288535,527,"No, you can't go with us. We simply need to use your Wi-Fi."
246,9,14,54,77,1.4155844155844155,0.07919332132875263,527,"Congratulations, you just bought the farm."
246,5,22,50,77,1.4155844155844155,0.07003233642001473,527,Please don't take me to your leaders.
246,8,16,53,77,1.4155844155844155,0.07700531568288535,527,We hear you can explain Daylight Saving Time!
250,8,11,46,65,1.4153846153846155,0.08741013982587317,527,There's been a terrible misunderstanding. I meant to swipe left...
251,9,11,50,70,1.4142857142857144,0.08510827872054014,527,"Fear not, my farm-fresh, cage-free friend."
251,5,19,46,70,1.4142857142857144,0.07474693576983732,527,"Sir, bovine number 141 and I are in love and I've come to ask your permission to marry her."
251,9,11,50,70,1.4142857142857144,0.08510827872054014,527,We don't usually do this but your probe results raised some red flags.
254,8,15,52,75,1.4133333333333333,0.07848413699442557,527,I normally request that you take me to your leader but I understand you are having issues.
254,8,15,52,75,1.4133333333333333,0.07848413699442557,527,"We came to destroy your planet, but there's no rush. Why don't you come in for a beer?"
254,6,19,50,75,1.4133333333333333,0.07374984094246603,527,I come from the future. Can I interest you in a reverse mortgage?
254,6,19,50,75,1.4133333333333333,0.07374984094246603,527,Congratulations! Your crop circles are the only ones that make sense.
258,9,10,49,68,1.411764705882353,0.08698262094602864,527,Let me start by telling you the difference between term and whole life insurance.
259,10,10,53,73,1.4109589041095891,0.08465980008100073,527,"Yes, just square dancing. I promise!"
259,7,16,50,73,1.4109589041095891,0.07762557077625572,527,We'll always have Kansas.
259,10,10,53,73,1.4109589041095891,0.08465980008100073,527,You look like you haven't been probed in ages.
259,5,20,48,73,1.4109589041095891,0.07255821270351921,527,Is this Area 51?
259,7,16,50,73,1.4109589041095891,0.07762557077625572,527,I'm here to enter the Miss Universe pageant.
259,6,18,49,73,1.4109589041095891,0.07513462407262254,527,Greetings! I represent Future Farmers of America.
259,8,14,51,73,1.4109589041095891,0.08003903261624706,527,No doubt the first thing you’re wondering is how I got my head stuck in a goldfish bowl.
259,11,8,54,73,1.4109589041095891,0.0868780711892258,527,My name is Cwqqyfteh. That is pronounced Shyrui7fuy.
267,5,19,47,71,1.408450704225352,0.07391730870812922,527,Welcome......We LOVE the Amish!......I have one of your quilts!
267,7,15,49,71,1.408450704225352,0.079174475056649,527,I'm here in Iowa to launch my 2020 campaign for President.
269,7,17,52,76,1.4078947368421053,0.07534163495389115,527,Roswell's become so touristy that we decided to go somewhere else this year.
269,9,13,54,76,1.4078947368421053,0.07986311002891326,527,... When you've both lied on your online dating profiles.
269,5,21,50,76,1.4078947368421053,0.07053089799201823,527,"Welcome aboard. We know you could have flown with anybody, but thank you for choosing us."
269,10,11,55,76,1.4078947368421053,0.08203044274214763,527,I see you got our ad for a free physical.
269,7,17,52,76,1.4078947368421053,0.07534163495389115,527,We offer universal health care
269,8,15,53,76,1.4078947368421053,0.07763529577780875,527,"Thanks, again, and tell your chickens we like what they're saying about time, we're going to test the theory, and we will get back to them."
269,7,17,52,76,1.4078947368421053,0.07534163495389115,527,"When you awake you will spread the message: ""There is no reason to search for life on other planets."""
269,7,17,52,76,1.4078947368421053,0.07534163495389115,527,"Don't worry, you'll be free-range."
269,9,13,54,76,1.4078947368421053,0.07986311002891326,527,Let's give 'em somethin' to talk about
269,8,15,53,76,1.4078947368421053,0.07763529577780875,527,"It was a lovely evening, but let's just leave it that I'll call you."
279,7,14,48,69,1.4057971014492754,0.08080699269294483,527,Is it true you taste just like chicken?
280,8,14,52,74,1.4054054054054055,0.07914509641260337,527,"Hello, we're here to make America great again!"
280,8,14,52,74,1.4054054054054055,0.07914509641260337,527,"You can come aboard, but stay away from my daughter."
280,8,14,52,74,1.4054054054054055,0.07914509641260337,527,It's like Airbnb. With anal probes.
280,8,14,52,74,1.4054054054054055,0.07914509641260337,527,"Nice to meet you, you're not a Jehovah's witness are you?"
280,4,22,48,74,1.4054054054054055,0.06915933269182098,527,Are you satisfied with your current provider of telecommunication services?
280,6,18,50,74,1.4054054054054055,0.07432011700925349,527,We came for your moving stairs technology.
280,8,14,52,74,1.4054054054054055,0.07914509641260337,527,"Welcome aboard. This is not the rapture, I am not your father and we only go as far as Albuquerque."
287,8,13,51,72,1.4027777777777777,0.08073343912752434,527,"This exciting timeshare promotion entitles you to a free weekend’s stay, by simply participating in our 60 minute probe!"
287,6,17,49,72,1.4027777777777777,0.07573252656487271,527,Do you know who did your neighbor's crop circles?
287,9,11,52,72,1.4027777777777777,0.08312114352008726,527,"Despite what you've been told, not all aliens speak Spanish."
287,9,11,52,72,1.4027777777777777,0.08312114352008726,527,"No, try the farm down the road. We don't use illegal aliens."
291,9,13,55,77,1.4025974025974026,0.07899691597789894,527,"Don't look so shocked, I told you I was going to shave off my mustache."
291,8,15,54,77,1.4025974025974026,0.07680331525631552,527,I promise I will bring you back if he doesn't get elected
291,8,15,54,77,1.4025974025974026,0.07680331525631552,527,"Congrats, you're our millionth probing!"
294,6,16,48,70,1.4,0.07721873425053444,527,Really sorry about the crop circles. Your neighbor Ned said that you would think it was hilarious.
294,6,16,48,70,1.4,0.07721873425053444,527,"Or you can stay here with Trump, your choice!"
294,9,10,51,70,1.4,0.08488208847630566,527,Come on in for your free personality test
294,7,14,49,70,1.4,0.07985494095046906,527,We were looking for signs of intelligence. Guess you'll have to do.
298,10,11,57,78,1.3974358974358974,0.08025048944103501,527,"We did a survey, and nine out of ten abductees said the tractor beam felt too impersonal."
299,8,13,52,73,1.3972602739726028,0.0798107684609522,527,Smoking or non-smoking?
299,6,17,50,73,1.3972602739726028,0.07489141309066996,527,Can you take me to this Green Giant?
299,5,19,49,73,1.3972602739726028,0.07230633617403248,527,We just watched a Trump speech and decided not to colonize your planet.
299,4,21,48,73,1.3972602739726028,0.06962534557980321,527,Sorry about the cow.
299,7,15,51,73,1.3972602739726028,0.07739018838665886,527,Oh? Didn't you get my telepathy?
299,12,5,56,73,1.3972602739726028,0.08883596556321331,527,"We don't want to hurt you, abduct you, or probe you. We just wanted to see how well people on this planet shook hands."
299,8,13,52,73,1.3972602739726028,0.0798107684609522,527,I'm so glad you got my corn maze message.
299,7,15,51,73,1.3972602739726028,0.07739018838665886,527,"Enter, entrée."
299,11,7,55,73,1.3972602739726028,0.08666782144338951,527,Could you hold on a minute? I'm right in the middle of coordinating an invasion.
299,4,21,48,73,1.3972602739726028,0.06962534557980321,527,Meals are available for purchase and it's $50 for a window seat but we don't have any windows.
309,4,19,45,68,1.3970588235294117,0.07300073328300495,527,"The total flight, including the layover, will take .02 seconds, but we do have in-flight entertainment."
309,11,5,52,68,1.3970588235294117,0.09166230413467126,527,"Greetings human -- we come from a planet 200 light years away. All we need is to perform an anal probe, and we'll be on our way."
311,9,12,55,76,1.394736842105263,0.0796460313180082,527,Don't worry. We'll have you back by bedtime... for your great grandchildren.
312,6,16,49,71,1.3943661971830985,0.07633156847497467,527,Why does the cheese stand alone?
312,11,6,54,71,1.3943661971830985,0.08853575989653782,527,We'll call you next week with the results of your anal probe.
312,8,12,51,71,1.3943661971830985,0.08143302352051535,527,"Hi, you must be Hank. I'm *#@($*&@5, but I like to go by Steve."
312,7,14,50,71,1.3943661971830985,0.07892352521758818,527,"No not from Syria, I'm from Sirius."
312,7,14,50,71,1.3943661971830985,0.07892352521758818,527,Most people just threatened to move to Canada
312,5,18,48,71,1.3943661971830985,0.07364844776998507,527,I'm visiting all the swing planets.
312,7,14,50,71,1.3943661971830985,0.07892352521758818,527,I want to sell you on a little idea we're calling Nebrexit.
312,8,12,51,71,1.3943661971830985,0.08143302352051535,527,"Quick question for you. If you were brought on an alien ship and forced to submit to a battery of medical experiments, you wouldn't tell anybody, right?"
312,7,14,50,71,1.3943661971830985,0.07892352521758818,527,"Actually, we do know Jesus. Come on in."
312,5,18,48,71,1.3943661971830985,0.07364844776998507,527,"That's okay, you won't remember me this time either."
322,6,17,51,74,1.3918918918918919,0.0740672407503884,527,Let me be the first to welcome you to your abduction.
322,6,17,51,74,1.3918918918918919,0.0740672407503884,527,Wipe your feet.
324,8,11,50,69,1.391304347826087,0.08314315376023791,527,"Do we serve humans? Why yes, c'mon in!"
325,9,10,53,72,1.3888888888888888,0.08287563404364384,527,The citizens of Ee-i-ee-i-oh are grateful for your patronage.
325,5,18,49,72,1.3888888888888888,0.07282462146292913,527,Did you know you can bring one item for the overhead bin?
325,6,16,50,72,1.3888888888888888,0.07546298296481649,527,"""Given your current presidential candidates, I think it's best you come with me."
325,8,12,52,72,1.3888888888888888,0.08048064619153299,527,I am the only true outsider running for President
325,6,16,50,72,1.3888888888888888,0.07546298296481649,527,"Sorry about the circles, the wife's just learning on the clutch."
325,4,20,48,72,1.3888888888888888,0.07008701152488708,527,"We work hard, we'll accept low wages, and just let him try to deport us."
331,5,16,46,67,1.3880597014925373,0.07654698506753517,527,"Welcome, Neighbor. And, please accept my apologies for incinerating your entire corn crop."
332,7,15,53,75,1.3866666666666667,0.075679107601288,527,"Hi, it's nice to eat you."
332,4,21,50,75,1.3866666666666667,0.06816337907004204,527,The bad news-We taken over the earth. The good news-We have no middle seats. Welcome aboard.
332,10,9,56,75,1.3866666666666667,0.08251308022615812,527,Take me to your leader. Just kidding – they’ve all been evaporated.
335,6,15,49,70,1.3857142857142857,0.07693092581620721,527,My planet has a very liberal definition of locally grown.
335,8,11,51,70,1.3857142857142857,0.08213723088122253,527,"My GPS tells me this is India, but my gut tells me this is Indiana."
335,5,17,48,70,1.3857142857142857,0.07419089345728716,527,So long and thanks for all the Amish.
335,5,17,48,70,1.3857142857142857,0.07419089345728716,527,My planet still enjoys dairy and gluten.
335,6,15,49,70,1.3857142857142857,0.07693092581620721,527,"Actually, it's the political atmosphere I can't tolerate."
335,7,13,50,70,1.3857142857142857,0.07957666757214087,527,Nope You stopped at the wrong MacDonald's for that.
335,9,9,52,70,1.3857142857142857,0.08462034844990593,527,But I just had a colonoscopy.
335,7,13,50,70,1.3857142857142857,0.07957666757214087,527,The whole galaxy is going absolutely berserk for your heirloom tomatoes.
343,7,11,47,65,1.3846153846153846,0.08404528224389292,527,"Yes, technically 'illegal aliens,' but we prefer 'undocumented agricultural workers.'"
344,5,14,44,63,1.380952380952381,0.0797736539022967,527,"Well, you're not going to be in Kansas anymore."
344,6,12,45,63,1.380952380952381,0.08292085761146409,527,"Yeah? Well, I never saw a guy in bib overalls and a straw hat before, either."
346,5,17,49,71,1.380281690140845,0.07333997124030393,527,We wanted to come before your president banned all aliens.
346,8,11,52,71,1.380281690140845,0.08115414248387567,527,Are you ready for an Earxit?
346,7,13,51,71,1.380281690140845,0.07863574476897683,527,So we have a deal. No GMOs in our UFOs.
346,3,21,47,71,1.380281690140845,0.06763078003162133,527,"Of all the species I've encountered, you earthlings definitely have the coolest hats."
346,2,23,46,71,1.380281690140845,0.06458721174322377,527,Could I possibly borrow a cup of plutonium?
346,9,9,53,71,1.380281690140845,0.08359670644956489,527,"Let's get that free prostate exam started, shall we?"
346,6,15,50,71,1.380281690140845,0.07603397838105104,527,We admired the lovely patterns you made in your field
346,5,17,49,71,1.380281690140845,0.07333997124030393,527,"The crop circles are ours, but you'll have to talk to that neighbor kid about the cow tipping."
346,5,17,49,71,1.380281690140845,0.07333997124030393,527,"Pardon me, do you have any Grey Poupon?"
346,5,17,49,71,1.380281690140845,0.07333997124030393,527,We just need to use your bathroom.
346,3,21,47,71,1.380281690140845,0.06763078003162133,527,You're free range?
357,7,11,48,66,1.378787878787879,0.0829669845172413,527,Parking in New York is near impossible.
358,7,12,50,69,1.3768115942028984,0.08023157360396053,527,"Howdy! 'Just passin' by and saw your ""U-pick-it"" sign."
358,5,16,48,69,1.3768115942028984,0.07473011764982479,527,We're here to probe the people who demoted Pluto.
358,3,20,46,69,1.3768115942028984,0.06879008333288725,527,"Hi, so sorry, but do you have a phone charger I can use for like five minutes?"
358,2,22,45,69,1.3768115942028984,0.06561873288505372,527,Have you heard the good news?
358,5,16,48,69,1.3768115942028984,0.07473011764982479,527,Do you have time to talk about our overlord and savior?
358,5,16,48,69,1.3768115942028984,0.07473011764982479,527,"I know you wanted a tractor, but I think you're really going to like what this baby can do."
358,8,10,51,69,1.3768115942028984,0.0828454154583902,527,You won the Tour of the Galaxy! But first we have a short presentation about timeshare opportunities.
358,2,22,45,69,1.3768115942028984,0.06561873288505372,527,Come in and I'll show you how we make those crop circles.
358,4,18,47,69,1.3768115942028984,0.07182153593770545,527,I hope you've eaten. We no longer serve meals on these flights.
358,8,10,51,69,1.3768115942028984,0.0828454154583902,527,We're here for the Anybody-But-Trump rally on Thursday.
358,5,16,48,69,1.3768115942028984,0.07473011764982479,527,Amazon Same-Hour Delivery...Where do want your peat moss?
369,7,13,52,72,1.375,0.07771557427654395,527,We're so excited to have you for dinner.
369,9,9,54,72,1.375,0.08259650778690071,527,Go to www.et.md for the results of your procedure.
369,6,15,51,72,1.375,0.07515633159224681,527,We've heard great things about your daughter.
372,6,16,53,75,1.3733333333333333,0.07296385217163168,527,"Take me to your leader. No, not that one. No, not that one. No, definitely not that one. Heck, is that Carter guy still around?"
373,7,11,49,67,1.373134328358209,0.08191461974440718,527,"Sorry about the steps, the dang ""beam-up"" button is busted."
373,6,13,48,67,1.373134328358209,0.07910575765073763,527,"I'll need your shoes, your belt and your laptop, please."
373,5,15,47,67,1.373134328358209,0.07619341742646572,527,Did you advertise a goat for sale on Craig's List?
373,6,13,48,67,1.373134328358209,0.07910575765073763,527,Thank you for choosing Uber Universe.
373,7,11,49,67,1.373134328358209,0.08191461974440718,527,"We used to say, ""Take me to your leader,"" but we've been watching the campaign coverage."
378,6,14,50,70,1.3714285714285714,0.07660343572569561,527,I just wanted to apologize for the circles and the cows
378,8,10,52,70,1.3714285714285714,0.08183057933851659,527,We heard that you're all gluten free
378,8,10,52,70,1.3714285714285714,0.08183057933851659,527,"Let's change things up. Tonight, you anally probe me."
381,8,11,54,73,1.36986301369863,0.07925367560598073,527,I'd like to thank you personally for destroying your planet for us.
382,3,18,44,65,1.3692307692307693,0.07128366535711785,527,"The folks in town weren’t able to help us, but they said you could fix just about anything."
383,10,5,53,68,1.3676470588235294,0.08865498664500654,527,You'd rather come with us than stay with the orange-haired one?
383,6,13,49,68,1.3676470588235294,0.0781266945795663,527,"Yes, I'm your Uber driver. Where to?"
383,3,19,46,68,1.3676470588235294,0.06918696204926,527,"No, seriously ...the guys are playing poker... C'mon in."""
383,6,13,49,68,1.3676470588235294,0.0781266945795663,527,"Nice going George, you had 'em fooled for years. Now it's time to take you home."
383,6,13,49,68,1.3676470588235294,0.0781266945795663,527,I remember when you were a microbe.
383,7,11,50,68,1.3676470588235294,0.08088734121420482,527,Alpha Centauri...and we'd sure like to use your restroom.
383,6,13,49,68,1.3676470588235294,0.0781266945795663,527,Welcome aboard! You're just in time to be part of our harvest.
383,5,15,48,68,1.3676470588235294,0.07526485795611701,527,I've seen the candidates. DON'T take me to your leader.
383,4,17,47,68,1.3676470588235294,0.07228981449955524,527,Thanks for volunteering. Did you abstain from solid foods like we asked?
383,5,15,48,68,1.3676470588235294,0.07526485795611701,527,It's actually my first time using Uber...
383,5,15,48,68,1.3676470588235294,0.07526485795611701,527,Greetings! We're here to make Earth great again.
383,4,17,47,68,1.3676470588235294,0.07228981449955524,527,"So long, and thanks for all the chickens!"
383,3,19,46,68,1.3676470588235294,0.06918696204926,527,And your wife is OK with this?
383,6,13,49,68,1.3676470588235294,0.0781266945795663,527,It's okay. We're legal aliens.
397,2,19,42,63,1.3650793650793651,0.06901244461931115,527,"After reviewing your planet, we've decided we're not interested in taking over, but thank you for your time."
398,7,10,49,66,1.3636363636363635,0.08260435551925986,527,"The pleasure is all mine, and I will see you again the next time you select ""same day shipping."""
398,6,12,48,66,1.3636363636363635,0.07973254720972991,527,"Hi, Mr. Stinson - You called Uber?"
398,7,10,49,66,1.3636363636363635,0.08260435551925986,527,"We prefer the term ""guest worker""."
398,5,14,47,66,1.3636363636363635,0.07675336226088955,527,Thank goodness - we're out of ethanol.
398,4,16,46,66,1.3636363636363635,0.07365377215153938,527,"Oh, thank goodness. You look just like your profile picture."
398,5,14,47,66,1.3636363636363635,0.07675336226088955,527,We come in peace. Please do not take me to your leader.
404,6,13,50,69,1.3623188405797102,0.07717026075112264,527,We heard the one about your daughter!
404,4,17,48,69,1.3623188405797102,0.07143342512707324,527,"Thanks for coming on short notice, especially on a 4th of July weekend. Let me show you where the leak is."
404,9,7,53,69,1.3623188405797102,0.08505305122635451,527,"So, again, you're sure you can supply us with all the ethanol we're going to need for a full-on invasion?"
404,6,13,50,69,1.3623188405797102,0.07717026075112264,527,You look surprised to see us. Didn't you receive the crop circles?
404,9,7,53,69,1.3623188405797102,0.08505305122635451,527,We wanted to get here before you built the wall.
409,4,15,45,64,1.359375,0.07508985193150429,527,"Hi, you called for an Uber?"
409,5,13,46,64,1.359375,0.07832316138363532,527,"Evening friend, do you have a few minutes to talk about the lord?"
409,4,15,45,64,1.359375,0.07508985193150429,527,You looked different on your Tinder profile.
409,6,11,47,64,1.359375,0.08142818526259031,527,We're here to provide the second opinion you requested from your HMO.
409,3,17,44,64,1.359375,0.07171090654191657,527,Welcome to the time share presentation!
414,4,16,47,67,1.3582089552238805,0.07274887114566478,527,"I know, I look nothing like my profile pic."
414,7,10,50,67,1.3582089552238805,0.08154293566023545,527,Look at the bright side---you'll miss the fall elections.
414,7,10,50,67,1.3582089552238805,0.08154293566023545,527,You look like a man who could fix our tractor beam.
414,5,14,48,67,1.3582089552238805,0.07579368237090822,527,You're a Homo what?
414,3,18,46,67,1.3582089552238805,0.06957092940729591,527,Thank you for responding to our crop circle.
414,6,12,49,67,1.3582089552238805,0.07872081250670442,527,Congratulations! The free flight that you won also includes a complementary medical exam.
414,6,12,49,67,1.3582089552238805,0.07872081250670442,527,"Did you say, ""We come for peace,"" or ""We come for peas?"" The peas I can help you with."
414,6,12,49,67,1.3582089552238805,0.07872081250670442,527,You must be here for the open house.
414,7,10,50,67,1.3582089552238805,0.08154293566023545,527,Welcome...we need your expertise on how you can make money by not growing things.
423,6,10,46,62,1.3548387096774193,0.0832216659692613,527,Welcome aboard! Ready to Earthxit?
423,6,10,46,62,1.3548387096774193,0.0832216659692613,527,You have been randomly selected for additional probing.
423,7,8,47,62,1.3548387096774193,0.08634041010136512,527,"I came to experience ""Minnesota nice."""
423,7,8,47,62,1.3548387096774193,0.08634041010136512,527,You'll find that we are very welcoming to foreign workers.
423,3,16,43,62,1.3548387096774193,0.07307108523473209,527,The chef wants to know if you are certified organic.
428,6,11,48,65,1.353846153846154,0.08035608621452375,527,"Welcome aboard, earthling with the scent of cow dung."
428,4,15,46,65,1.353846153846154,0.07413205872075532,527,"Sorry to pull you out of bed so late, but we need some work done on our tractor beam."
428,3,17,45,65,1.353846153846154,0.07081520245969988,527,NOW do you see how silly that wall would be?
428,6,11,48,65,1.353846153846154,0.08035608621452375,527,Thumb war?
428,4,15,46,65,1.353846153846154,0.07413205872075532,527,It's always nice to meet a fellow Mason.
428,6,11,48,65,1.353846153846154,0.08035608621452375,527,We enjoyed having your leader for dinner.
428,6,11,48,65,1.353846153846154,0.08035608621452375,527,Uber for MacDonald?
428,6,11,48,65,1.353846153846154,0.08035608621452375,527,And tell your wife her apple pie is out of this world.
428,7,9,49,65,1.353846153846154,0.08329387626041428,527,Your daughter is crazy. Good luck to you sir.
428,5,13,47,65,1.353846153846154,0.07730673554708377,527,So... Can I count on your vote in November?
438,6,12,50,68,1.3529411764705883,0.0777332110449888,527,You were smart to book now. We're expecting quite a rush after your election.
438,5,14,49,68,1.3529411764705883,0.07485633264187075,527,C'mon in. You're my first Uber fare.
438,6,12,50,68,1.3529411764705883,0.0777332110449888,527,"Congratulations, you're our crop circle contest winner."
438,7,10,51,68,1.3529411764705883,0.08050735160306251,527,"At long last, another libertarian!"
438,6,12,50,68,1.3529411764705883,0.0777332110449888,527,Take me to your presumptive leader
438,3,18,47,68,1.3529411764705883,0.06874232619748678,527,"Pleased to meet you, sir. Your daughter speaks highly of you."
438,6,12,50,68,1.3529411764705883,0.0777332110449888,527,"Unfortunately, Pluto cannot grant you asylum at this time, as we've met our quota for Trump refugees."
438,5,14,49,68,1.3529411764705883,0.07485633264187075,527,Can you tell me how to get to the nearest Walmart?
438,2,20,46,68,1.3529411764705883,0.06547156518876965,527,We need two of everything.
438,4,16,48,68,1.3529411764705883,0.07186437903312072,527,Why? You're the only person we could find without a cell phone to take pictures of us.
448,6,10,47,63,1.3492063492063493,0.0820835004988049,527,Did you have any problems finding the place?
448,5,12,46,63,1.3492063492063493,0.07890290415466353,527,Thanks for coming! I have a few probing questions for you!
448,6,10,47,63,1.3492063492063493,0.0820835004988049,527,"Congratulations, you may have already won $10,000!"
448,4,14,45,63,1.3492063492063493,0.07558859380847571,527,First time using Airbnb?
448,4,14,45,63,1.3492063492063493,0.07558859380847571,527,"Sorry about the stairs, this is an older model."
448,8,6,49,63,1.3492063492063493,0.0881008887261183,527,"We, too, dabble in genetic modification of a sort."
448,8,6,49,63,1.3492063492063493,0.0881008887261183,527,E I E I O
448,3,16,44,63,1.3492063492063493,0.07212213768216695,527,You call an Uber?
448,6,10,47,63,1.3492063492063493,0.0820835004988049,527,And we guarantee that you won't be in Kansas anymore.
448,5,12,46,63,1.3492063492063493,0.07890290415466353,527,Take me to your orange leader
448,5,12,46,63,1.3492063492063493,0.07890290415466353,527,"Yes, we have line dancing."
448,6,10,47,63,1.3492063492063493,0.0820835004988049,527,"So, same time next week for some more probing?"
448,8,6,49,63,1.3492063492063493,0.0881008887261183,527,"Why don't we spice things up - pretend this is our first time, alright?"
461,5,13,48,66,1.3484848484848484,0.0763149658048288,527,"Boy am I glad to see you,my wife keeps complaining that I'm afraid to stop and ask directions"
461,8,7,51,66,1.3484848484848484,0.08498573647614985,527,Your table is ready.
461,5,13,48,66,1.3484848484848484,0.0763149658048288,527,"Nothing personal, but we're discontinuing Earth as one of our failed science experiments."
461,6,11,49,66,1.3484848484848484,0.0793106201715297,527,"Greetings, earthman. My name is Eieio."
461,6,11,49,66,1.3484848484848484,0.0793106201715297,527,"Oh, we never land in cities - no parking."
461,4,15,47,66,1.3484848484848484,0.07319681372567881,527,We've come for no purpose whatsoever.
461,5,13,48,66,1.3484848484848484,0.0763149658048288,527,I'm your Uber ride.
461,6,11,49,66,1.3484848484848484,0.0793106201715297,527,Valet?
461,5,13,48,66,1.3484848484848484,0.0763149658048288,527,Greetings... The crop-grower and the circle-maker finally meet!
461,2,19,45,66,1.3484848484848484,0.06652347410644448,527,Please come in. I have just a few probing questions.
461,5,13,48,66,1.3484848484848484,0.0763149658048288,527,Come on up - we've got plenty of space!
461,6,11,49,66,1.3484848484848484,0.0793106201715297,527,"Bob, we're taking farm-to-table to the next dimension!"
461,6,11,49,66,1.3484848484848484,0.0793106201715297,527,Greetings! Is there a restroom?
461,5,13,48,66,1.3484848484848484,0.0763149658048288,527,"Greetings, earthling. I have just opened a farm-to-table restaurant."
461,7,9,50,66,1.3484848484848484,0.08219717110821467,527,Welcome to Myspace.
461,8,7,51,66,1.3484848484848484,0.08498573647614985,527,"I'm not the leader, but I am the only one that makes any sense."
477,6,12,51,69,1.3478260869565217,0.0767689566230365,527,Did you bring the bacon seeds?
478,6,9,46,61,1.3442622950819672,0.08391136978406379,527,Surrender to me if you want to make Earth great again!
478,5,11,45,61,1.3442622950819672,0.08058951477460452,527,I just wanted to meet the guy who finally asked for a crop *triangle*.
478,6,9,46,61,1.3442622950819672,0.08391136978406379,527,We've come to take you from your leaders.
478,2,17,42,61,1.3442622950819672,0.06968016668544297,527,"Just a meet and greet, we don't do abductions anymore."
478,7,7,47,61,1.3442622950819672,0.08710663617928079,527,Welcome to Uber of the Third Kind.
478,6,9,46,61,1.3442622950819672,0.08391136978406379,527,"No, I'm from Jersey."
484,4,14,46,64,1.34375,0.07459796344937072,527,"Ok, your satellite internet should be up and running now"
484,7,8,49,64,1.34375,0.08398185154477655,527,"I can't bring you, but we'll always have Iowa, and this corn field. And the best probing ever."
484,5,12,47,64,1.34375,0.07785170452100196,527,You'd be surprised what else you're entitled to under the new Farm Bill
484,4,14,46,64,1.34375,0.07459796344937072,527,"Sorry we took so long coming back for you, but you seem to have adapted well."
484,6,10,48,64,1.34375,0.08097480869293328,527,We're banning all future visits until we figure out what's going on here
484,4,14,46,64,1.34375,0.07459796344937072,527,You'll notice that our probes are more gentle this time-- thanks to your survey feedback!
484,6,10,48,64,1.34375,0.08097480869293328,527,You the man.
484,5,12,47,64,1.34375,0.07785170452100196,527,We're looking to start a farm-to-table restaurant.
484,8,6,50,64,1.34375,0.086884884386875,527,I can make America great again.
484,6,10,48,64,1.34375,0.08097480869293328,527,Congratulations on being our one millionth abductee!
484,2,18,44,64,1.34375,0.06762242718751049,527,Welcome! Our timeshare presentation only takes an hour but I'm sure it'll be well worth your time....
484,6,10,48,64,1.34375,0.08097480869293328,527,You requested an Uber?
484,5,12,47,64,1.34375,0.07785170452100196,527,Are you the one who ordered an Über?
484,6,10,48,64,1.34375,0.08097480869293328,527,"Sorry about the ladder, but people only get beamed up in the movies."
484,5,12,47,64,1.34375,0.07785170452100196,527,I don't want no trouble…just gimme back Dorothy & Toto.
484,5,12,47,64,1.34375,0.07785170452100196,527,We come in peace to learn about government subsidies.
484,3,16,45,64,1.34375,0.07119567686848623,527,"Congratulations, you're our 1000th alien abduction."
484,5,12,47,64,1.34375,0.07785170452100196,527,"No, really. Do you have a phone?"
484,5,12,47,64,1.34375,0.07785170452100196,527,Can I use your bathroom?
484,4,14,46,64,1.34375,0.07459796344937072,527,"You’re a life saver, thanks for the jumper cables."
484,7,8,49,64,1.34375,0.08398185154477655,527,I hope my questions won't be too probing.
484,4,14,46,64,1.34375,0.07459796344937072,527,Welcome aboard. We've upgraded you from Coach to Probe.
484,5,12,47,64,1.34375,0.07785170452100196,527,Pardon the mess - we've been on the road for light years
484,5,12,47,64,1.34375,0.07785170452100196,527,"Don't worry, we're not Muslim!"
484,8,6,50,64,1.34375,0.086884884386875,527,"Among my people, a handshake means you consent to an anal probe."
509,6,11,50,67,1.3432835820895523,0.07829087585382129,527,Did you remember to fast?
509,8,7,52,67,1.3432835820895523,0.08386912012597741,527,"Greetings Earthman, we've come for the dancing cats"
509,5,13,49,67,1.3432835820895523,0.07534704511515279,527,Welcome aboard. The luxury cruise you won will begin right after a brief time-share information presentation.
509,6,11,50,67,1.3432835820895523,0.07829087585382129,527,Howdy stranger. I'd like to talk to you about Jesus.
509,7,9,51,67,1.3432835820895523,0.08112795619471776,527,"No, seriously, there's no anal probe tonight, just a 90 minute presentation about our fabulous time share opportunities!"
509,4,15,48,67,1.3432835820895523,0.07228342253387898,527,Publish these predictions in the form of an almanac. We'll see you next year.
509,7,9,51,67,1.3432835820895523,0.08112795619471776,527,Take me away from my leaders.
509,6,11,50,67,1.3432835820895523,0.07829087585382129,527,Circles? What circles?
509,5,13,49,67,1.3432835820895523,0.07534704511515279,527,It's OK. We heard about the election. We are here to help.
509,3,17,47,67,1.3432835820895523,0.06908407297516336,527,Nice to meet you and all. Peace among worlds and stuff... but can you show me where the bathroom is?
509,4,15,48,67,1.3432835820895523,0.07228342253387898,527,I'm pro immigration.
509,2,19,46,67,1.3432835820895523,0.06572918000754392,527,"We have searched the universe for the answer, which is it, the chicken or the egg ?"
509,4,15,48,67,1.3432835820895523,0.07228342253387898,527,"Excuse me sir, do you have a moment to talk about our Lord and Savior Jesus Christ?"
509,6,11,50,67,1.3432835820895523,0.07829087585382129,527,Greetings. We too have green thumbs.
523,6,13,54,73,1.3424657534246576,0.07355709449126488,527,I told them I would leave if he got elected.
524,4,13,45,62,1.3387096774193548,0.07607348581711208,527,Take me to your pantsuited leader.
524,7,7,48,62,1.3387096774193548,0.08586988665233102,527,We've always admired your crop circles.
524,3,15,44,62,1.3387096774193548,0.07251451244126066,527,"Please come in, We planned on having you for dinner."
524,3,15,44,62,1.3387096774193548,0.07251451244126066,527,"Welcome to our two-day seminar ""Opportunities in Interstellar Real Estate""!"
524,6,9,47,62,1.3387096774193548,0.08273340742355272,527,"Just kidding, Sir. This craft is much more than the manure spreader of the future."
524,6,9,47,62,1.3387096774193548,0.08273340742355272,527,"I have that kind of face, but no, I'm pretty sure we've never met before."
524,7,7,48,62,1.3387096774193548,0.08586988665233102,527,"Hello again, Fred. And how's Stumpy, that delicious wife of yours ?"
524,5,11,46,62,1.3387096774193548,0.07947324061681996,527,Canada built a wall and this is your only other option earthling.
524,3,15,44,62,1.3387096774193548,0.07251451244126066,527,"Nice to meet you, though I was expecting baseball players."
524,3,15,44,62,1.3387096774193548,0.07251451244126066,527,"Nice to eat you, I mean meet you"
524,6,9,47,62,1.3387096774193548,0.08273340742355272,527,"Yes, we offer crop circles. Let me grab you a brochure."
524,1,19,42,62,1.3387096774193548,0.06481290808973574,527,"You do realize that no one is going to believe you, right?"
524,3,15,44,62,1.3387096774193548,0.07251451244126066,527,"Crop circles, sure. But let me show you what else this baby can do."
524,6,9,47,62,1.3387096774193548,0.08273340742355272,527,"Take me to your leader; but first, can you introduce me to Scarlett Johansson?"
524,7,7,48,62,1.3387096774193548,0.08586988665233102,527,"You may stay the night, Earthling, but make no tactile contact with my female offspring."
524,6,9,47,62,1.3387096774193548,0.08273340742355272,527,"Greetings! We understand this planet is a source for something called ""bacon."
524,5,11,46,62,1.3387096774193548,0.07947324061681996,527,Thanks for not shooting me.
541,5,12,48,65,1.3384615384615384,0.07682686290553145,527,"Would you like to schedule your next anal probe now, or will you call us when you're ready?"
541,3,16,46,65,1.3384615384615384,0.07029102647114255,527,Are you Siri?
541,3,16,46,65,1.3384615384615384,0.07029102647114255,527,"Aha, the farmer! But where's the farmer's daughter we've heard so much about?"
541,3,16,46,65,1.3384615384615384,0.07029102647114255,527,"It's nice to finally meet you, Mr. MacDonald! My kids have told me so much about you."
541,5,12,48,65,1.3384615384615384,0.07682686290553145,527,You're my Uber Driver?
541,4,14,47,65,1.3384615384615384,0.07363149891952556,527,"Good to see you, Tom. You didn't tell anyone about our conversation in 1969 did you?"
541,6,10,49,65,1.3384615384615384,0.07989453106861918,527,"Mr. McDonald, my name is E-I-E-I-Oh."
541,5,12,48,65,1.3384615384615384,0.07682686290553145,527,"But, I didn't vote Leave!"
541,7,8,50,65,1.3384615384615384,0.08284868934053083,527,They say Canada's full. Can I come in?
541,6,10,49,65,1.3384615384615384,0.07989453106861918,527,Wow! A farmer!? My friends won't believe this!
541,6,10,49,65,1.3384615384615384,0.07989453106861918,527,We just wanted to let you know we won't be able to make it to the square dance Friday night.
541,4,14,47,65,1.3384615384615384,0.07363149891952556,527,We'll give you a courtesy call before your next appointment.
541,4,14,47,65,1.3384615384615384,0.07363149891952556,527,Just come with us. We watched all the presidential debates and we don't want to be taken to ANY of your leaders.
541,6,10,49,65,1.3384615384615384,0.07989453106861918,527,Joe Smith? THE Joe Smith?
541,5,12,48,65,1.3384615384615384,0.07682686290553145,527,I am wondering if you would like to join our Neighborhood Watch.
541,5,12,48,65,1.3384615384615384,0.07682686290553145,527,Welcome aboard! Perhaps you could explain what on earth is going on down here.
541,7,8,50,65,1.3384615384615384,0.08284868934053083,527,A dozen ears please.
541,4,14,47,65,1.3384615384615384,0.07363149891952556,527,got milk?
541,4,14,47,65,1.3384615384615384,0.07363149891952556,527,Welcome aboard. Your first time using Uber?
541,6,10,49,65,1.3384615384615384,0.07989453106861918,527,"First, you should know we just ran out of toilet paper."
541,4,14,47,65,1.3384615384615384,0.07363149891952556,527,The chickens asked me to have a word with you.
541,6,10,49,65,1.3384615384615384,0.07989453106861918,527,"And you can call it ""kale."""
541,3,16,46,65,1.3384615384615384,0.07029102647114255,527,Trick or treat?
541,2,18,45,65,1.3384615384615384,0.06678367443917438,527,Finally....someone who looks like their Tinder photo.
541,4,14,47,65,1.3384615384615384,0.07363149891952556,527,Greetings! I'm here to Make America Great Again!
541,4,14,47,65,1.3384615384615384,0.07363149891952556,527,Welcome to our farmers market Earthling. We grow things that are out of this world.
541,8,6,51,65,1.3384615384615384,0.08570107675060458,527,"Relax, I was nervous the first time I tried Airbnb too."
541,6,10,49,65,1.3384615384615384,0.07989453106861918,527,One small shake for a gleep; one giant reach for gleepzook.
541,5,12,48,65,1.3384615384615384,0.07682686290553145,527,Have we got some spectacular viruses for you!
541,6,10,49,65,1.3384615384615384,0.07989453106861918,527,We saw your crop circles and came as soon as we could.
541,3,16,46,65,1.3384615384615384,0.07029102647114255,527,My mom sent me back to apologize for ruining your crops.
541,5,12,48,65,1.3384615384615384,0.07682686290553145,527,Mars? Don't be silly. I'm from Monsanto.
573,5,13,50,68,1.338235294117647,0.07440219498649935,527,Can you take us to Jeff Goldblum?
573,4,15,49,68,1.338235294117647,0.07139121133609308,527,"We take full responsibility for the crop circles, Mr. Johnson, but we had nothing to do with the cattle mutilations."
575,2,17,44,63,1.3333333333333333,0.06788442333021306,527,"Sorry, we're looking for forms of intelligent life, not Trump supporters."
575,6,9,48,63,1.3333333333333333,0.0815869230407957,527,We'd like to partner with you on some crop circles.
575,5,11,47,63,1.3333333333333333,0.07838618016696206,527,Mr. Smith? 10 am colonoscopy? Come right in.
575,7,8,51,66,1.3333333333333333,0.08174476547282207,527,And Monsanto wants to thank you personally for your business.
575,4,13,46,63,1.3333333333333333,0.07504905376532171,527,Don't be afraid. We only want your wife's mac 'n cheese recipe.
575,6,8,46,60,1.3333333333333333,0.08459496942031544,527,Just arrived from Mars. Tell Elon Musk he's nuts.
575,6,9,48,63,1.3333333333333333,0.0815869230407957,527,"Hi Josh, I'll be your Uber driver tonight."
575,7,7,49,63,1.3333333333333333,0.08466675133346033,527,"Can you imagine if I'd opened the door naked, like in the pornos? Haha come on in."
575,3,15,45,63,1.3333333333333333,0.07155646512351531,527,Take me to your heirloom tomatoes.
575,7,7,49,63,1.3333333333333333,0.08466675133346033,527,The bad news? Trump won. The good news? It's no longer your problem.
575,4,13,46,63,1.3333333333333333,0.07504905376532171,527,"Hello Joe Smith, what a strange name."
575,4,12,44,60,1.3333333333333333,0.0776296679652776,527,Do you hire illegal aliens?
575,7,8,51,66,1.3333333333333333,0.08174476547282207,527,So kind of you to accept our invitation. Abduction is not our thing.
575,5,11,47,63,1.3333333333333333,0.07838618016696206,527,I suppose you've been wondering about those crop circles.
575,7,7,49,63,1.3333333333333333,0.08466675133346033,527,Welcome to our intergalactic evacuation service in the event of a Trump victory.
575,6,9,48,63,1.3333333333333333,0.0815869230407957,527,The bad news...We've taken over the earth. The good news...There are no middle seats. Welcome aboard.
575,8,5,50,63,1.3333333333333333,0.08763841367493648,527,We. Are. Martians. Bum ba-dum bum bum bum.
575,3,15,45,63,1.3333333333333333,0.07155646512351531,527,"You realize no one is going to believe you, right?"
575,4,13,46,63,1.3333333333333333,0.07504905376532171,527,"Outhouse is fine, dude. It's been ten light years."
575,4,13,46,63,1.3333333333333333,0.07504905376532171,527,My Son wants to apologize for the crop circles.
575,5,11,47,63,1.3333333333333333,0.07838618016696206,527,We just had to stop and ask how you made those crop circles?
575,2,17,44,63,1.3333333333333333,0.06788442333021306,527,"Congratulations! You have been selected to receive free crop circles, more than fifteen minutes of fame, and a great story for the grand kids."
575,6,9,48,63,1.3333333333333333,0.0815869230407957,527,Take me to your daughter.
575,6,10,50,66,1.3333333333333333,0.07884165279854435,527,"It's okay, I'm a legal alien."
575,5,11,47,63,1.3333333333333333,0.07838618016696206,527,You won't be in Kansas any more...
575,5,11,47,63,1.3333333333333333,0.07838618016696206,527,Do you know Alex Trebek? I've GOTTA meet Alex Trebek!
575,5,10,45,60,1.3333333333333333,0.08118705007457577,527,"My name's Kevin, I will be your Uber driver"
575,2,17,44,63,1.3333333333333333,0.06788442333021306,527,Welcome aboard. Would you like to arrive last year or the next year?
575,7,8,51,66,1.3333333333333333,0.08174476547282207,527,Take me to your third-party candidate.
575,5,11,47,63,1.3333333333333333,0.07838618016696206,527,Thanks for being available to be probed on such short notice.
575,3,15,45,63,1.3333333333333333,0.07155646512351531,527,"And when you see the kitchen, you'll die."
575,5,10,45,60,1.3333333333333333,0.08118705007457577,527,Last time we visited Earth we picked up a cow and no one knows how to milk her.
575,9,3,51,63,1.3333333333333333,0.09051256444028409,527,"Since we are not allowed to take pictures of your people, we will have to use the anal probe."
575,3,15,45,63,1.3333333333333333,0.07155646512351531,527,Do you have any fluids or sharp objects?
575,6,8,46,60,1.3333333333333333,0.08459496942031544,527,"Yes, of course, we are tourists from New York."
575,5,11,47,63,1.3333333333333333,0.07838618016696206,527,Hell yes I'd like to hear about Amway products......come on in!
575,6,9,48,63,1.3333333333333333,0.0815869230407957,527,"Actually, it's the political climate I can't handle"
575,7,7,49,63,1.3333333333333333,0.08466675133346033,527,It was actually very easy to fly my spaceship over that wall.
575,3,13,41,57,1.3333333333333333,0.07647191129018727,527,You don't look anything like your Tinder pic.
575,8,6,52,66,1.3333333333333333,0.0845482533728944,527,"Come on in, pull up a probe . . . I mean, a chair."
575,7,8,51,66,1.3333333333333333,0.08174476547282207,527,We just heard about Trump. We came as fast as we could.
575,4,12,44,60,1.3333333333333333,0.0776296679652776,527,"So what is this ""kale"" we've heard so much about?"
575,2,16,42,60,1.3333333333333333,0.06997443708651314,527,I'm sorry but your wife has chosen to stay on board .
575,1,19,43,63,1.3333333333333333,0.06400204809830924,527,"We are building an intergalactic wall, and we'd like Earth to pay for it."
575,9,3,51,63,1.3333333333333333,0.09051256444028409,527,"...I just wanted you to know that there wasn't any way to make change for my twenty at the farmstand, so I took the rest of the tomatoes to make it fair."
575,5,11,47,63,1.3333333333333333,0.07838618016696206,527,Tag. You're it.
621,6,10,51,67,1.328358208955224,0.07781520194811217,527,"""Take you to our leaders?"" Now really isn't the best time, buddy."
622,7,7,50,64,1.328125,0.08349593511396561,527,My first Facebook friend!
622,5,11,48,64,1.328125,0.07732727648438203,527,We try to eat local whenever we can.
622,1,19,44,64,1.328125,0.0632090239156173,527,You Amish don't squeal. We admire that.
622,6,9,49,64,1.328125,0.080470736510385,527,We can't figure out how to grow pot
622,2,17,45,64,1.328125,0.06701800094300654,527,I just need to check your ID before you come aboard.
622,5,11,48,64,1.328125,0.07732727648438203,527,"Yeah, well, the movies are wrong. We just want to learn about your irrigation system."
622,2,17,45,64,1.328125,0.06701800094300654,527,"Greetings, I'm the ship's TSA agent, and before I let you on I'll need you to take off your hat and shoes."
622,4,13,47,64,1.328125,0.07405049589611347,527,Nice to meet you but where's that daughter I've heard so much about?
622,6,9,49,64,1.328125,0.080470736510385,527,I'm so sorry but your wife has requested that you stay here.
622,5,11,48,64,1.328125,0.07732727648438203,527,"Hi, I'm Fred, your Uber driver. Where to?"
622,5,11,48,64,1.328125,0.07732727648438203,527,"Well, thanks for dropping by! And, again, I hope there aren't any hard feelings about the probe."
622,5,11,48,64,1.328125,0.07732727648438203,527,"Yeah, I just started as a Lyft driver a few weeks ago."
622,3,15,46,64,1.328125,0.07062183937301952,527,Does this planet have shampoo? They only let us bring a 4oz bottle.
622,9,3,52,64,1.328125,0.08923919919306228,527,"Okay, I can live with that--you don't have to go if Bernie goes third-party AND wins in November."
622,5,11,48,64,1.328125,0.07732727648438203,527,We're here for the moonshine.
622,2,17,45,64,1.328125,0.06701800094300654,527,Hi. Do you have a cell phone charger?
622,6,9,49,64,1.328125,0.080470736510385,527,"I'm getting that question a lot; no, you don't get to come back if he loses in November."
622,3,15,46,64,1.328125,0.07062183937301952,527,"Sorry, probe’s busted"
622,5,11,48,64,1.328125,0.07732727648438203,527,Political asylum? Welcome aboard
622,2,17,45,64,1.328125,0.06701800094300654,527,"No, no, no...I said ""probing questions""...""subjected to an intense round of probing questions."""
622,3,15,46,64,1.328125,0.07062183937301952,527,Can I buy your hat?
622,6,9,49,64,1.328125,0.080470736510385,527,Welcome! We're looking for a few good spe– A Few Good Men!
622,4,13,47,64,1.328125,0.07405049589611347,527,Could I trouble you for a cup of sugar and some plutonium-239?
622,6,9,49,64,1.328125,0.080470736510385,527,You don't have to be lonely / With FarmersOnly.Com.
622,3,15,46,64,1.328125,0.07062183937301952,527,I hope you'll choose to sign up for our frequent abductee program.
622,7,7,50,64,1.328125,0.08349593511396561,527,"It's a completely probe free probecess, I probemise."
622,4,13,47,64,1.328125,0.07405049589611347,527,"As part of our rebranding, this is an invitation, not an abduction."
622,6,9,49,64,1.328125,0.080470736510385,527,"O.K. You can come on board. But no matter what, you can't touch my daughter."
622,6,9,49,64,1.328125,0.080470736510385,527,"Don't worry, on our planet we have a three party system!"
651,0,20,41,61,1.3278688524590163,0.06060402462518807,527,I think you'll find our time shares to be surprisingly affordable with a variety of planets to choose from.
651,6,8,47,61,1.3278688524590163,0.0833758737607023,527,"Thanks for taking the stairs, the beam is busted again."
651,4,12,45,61,1.3278688524590163,0.07654175429461477,527,"Sorry about the yard, Jerry's still learning to park."
651,5,10,46,61,1.3278688524590163,0.08003179516872573,527,"Farmer Brown, I presume?.."
651,5,10,46,61,1.3278688524590163,0.08003179516872573,527,Have you accepted Jesus Christ as your lord and savior?
651,5,10,46,61,1.3278688524590163,0.08003179516872573,527,"OK, you can sleep in the barn, just stay away from my daughter!"
657,4,11,43,58,1.3275862068965518,0.07927351258160108,527,Let's just say a wall won't stop everybody.
658,2,14,39,55,1.3272727272727274,0.07364737831740681,527,We have come to work the fields and do the jobs that none of your citizens want.
659,4,13,48,65,1.323076923076923,0.07307692307692308,527,"Okay. Is it ""Ah-mish"" or ""Ay-mish""?"
659,4,13,48,65,1.323076923076923,0.07307692307692308,527,Looks like Trump will need to build another fence...only much higher.
659,4,13,48,65,1.323076923076923,0.07307692307692308,527,Take me to your restroom.
659,5,11,49,65,1.323076923076923,0.07629551701875914,527,We'd like you to help us with our mid-western accent.
663,6,8,48,62,1.3225806451612903,0.08219037872229688,527,We're Amish. You can't park here.
663,8,4,50,62,1.3225806451612903,0.08839060930924623,527,We hope you enjoy your stay at our Airbnb.
663,6,8,48,62,1.3225806451612903,0.08219037872229688,527,"Rest assured, we have declared this a 'free range' planet."
663,4,12,46,62,1.3225806451612903,0.07548256020412515,527,"Don't worry, I promise to have you back by the morning milking."
663,2,16,44,62,1.3225806451612903,0.06811736515327178,527,"We're happy to welcome aboard our gold, platinum, and preferred abductees."
663,6,8,48,62,1.3225806451612903,0.08219037872229688,527,"wait, what probes!? I was here to apologize for the circles!"
663,2,16,44,62,1.3225806451612903,0.06811736515327178,527,Relax! That was over fifty years ago! We're vegetarians now.
663,5,10,47,62,1.3225806451612903,0.07890777924097209,527,My frequent flyer miles finally paid off!
663,2,16,44,62,1.3225806451612903,0.06811736515327178,527,Do you have a restroom I can use?
663,5,10,47,62,1.3225806451612903,0.07890777924097209,527,"We, too, liquefy our produce into a sugary slime."
663,2,16,44,62,1.3225806451612903,0.06811736515327178,527,"First, let me apologize about the sheep."
663,4,12,46,62,1.3225806451612903,0.07548256020412515,527,Welcome to Uber everywhere.
663,4,12,46,62,1.3225806451612903,0.07548256020412515,527,Did you find a set of keys?
663,2,16,44,62,1.3225806451612903,0.06811736515327178,527,Give a big moo to your family.
663,3,14,45,62,1.3225806451612903,0.07189434028626156,527,"Welcome, Sir! You will be completing our set of The Village People."
663,6,8,48,62,1.3225806451612903,0.08219037872229688,527,.....and next time we will buy you dinner first.
663,3,14,45,62,1.3225806451612903,0.07189434028626156,527,"I was heading to England, but aliens aren't welcome there."
663,5,10,47,62,1.3225806451612903,0.07890777924097209,527,"Abduction? No, we learned a long time ago that was not the best way to sell time shares."
681,5,9,45,59,1.3220338983050848,0.0817712950300013,527,We have come to take back Donald Trump.
681,4,11,44,59,1.3220338983050848,0.0781158828596312,527,"Hi! If you can use a pitcher with a 250 mph fastball, I'm your guy."
681,1,17,41,59,1.3220338983050848,0.0659449053916066,527,Sorry. Google Maps said there was a worm hole here.
681,6,7,46,59,1.3220338983050848,0.085270148509472,527,Thank you so much for allowing me to dissect your brain. Please accept the crop circle as a gift.
681,5,9,45,59,1.3220338983050848,0.0817712950300013,527,Congratulations! You're our millionth abductee!
681,5,9,45,59,1.3220338983050848,0.0817712950300013,527,"Well, thanks for the invite, but without intelligent life down here, we probably won't stay."
681,3,13,43,59,1.3220338983050848,0.07428080249294383,527,Your crop circle should be ready in about a week
681,5,9,45,59,1.3220338983050848,0.0817712950300013,527,"Hi! I'm Jim, the new Chief extraterrestrial Officer at Monsanto."
681,2,15,42,59,1.3220338983050848,0.07023662921191362,527,Monsanto was simply a decoy.
681,3,13,43,59,1.3220338983050848,0.07428080249294383,527,"""Hi, I'm the Green Party candidate for President""."
691,5,13,54,72,1.3194444444444444,0.0708388948075996,527,It's a deal. Six crop circles and a mysterious glowing rock.
692,7,7,52,66,1.3181818181818181,0.0812463831982259,527,Please confirm that you are not genetically modified.
692,5,11,50,66,1.3181818181818181,0.07528993193244386,527,Just wanted to ask you if it's ok to park here?
694,4,12,47,63,1.3174603174603174,0.0744510438067211,527,"Dinner was great, Norm. It's just my planet isn't looking for anything serious right now."
694,5,10,48,63,1.3174603174603174,0.07781382071333852,527,Take me to your demagogue.
694,4,12,47,63,1.3174603174603174,0.0744510438067211,527,Fair well Jebidiah. No one must know where the McNuggets recipe came from.
694,5,10,48,63,1.3174603174603174,0.07781382071333852,527,Quick! Matt Damen's in a peck of trouble.
694,5,10,48,63,1.3174603174603174,0.07781382071333852,527,"Greetings, working class white male. I hear you are the most important person in America."
694,5,10,48,63,1.3174603174603174,0.07781382071333852,527,You look nothing like your picture on DateAFarmer.com.
694,7,6,50,63,1.3174603174603174,0.08413712756091785,527,From your farm to our saucer.
694,4,12,47,63,1.3174603174603174,0.0744510438067211,527,Runs on pure corn ethanol.
694,4,12,47,63,1.3174603174603174,0.0744510438067211,527,Hello. I'm here to do your crop circles.
694,6,8,49,63,1.3174603174603174,0.08103717334720453,527,We are here for the farm to table
694,6,8,49,63,1.3174603174603174,0.08103717334720453,527,Aboard pardner welcome howdy.
694,5,10,48,63,1.3174603174603174,0.07781382071333852,527,Welcome to our Airbnb!
694,4,12,47,63,1.3174603174603174,0.0744510438067211,527,We are offering free transport to another planet if Trump wins the election.
694,4,12,47,63,1.3174603174603174,0.0744510438067211,527,It's the one with the rings.
694,3,14,46,63,1.3174603174603174,0.07092901489385721,527,The rest of the universe congratulates you for being the one redneck not voting for Trump.
694,4,12,47,63,1.3174603174603174,0.0744510438067211,527,"Hello, poorly educated white male. I am presidential candidate. Best in universe. Nothing to fear."
694,3,14,46,63,1.3174603174603174,0.07092901489385721,527,Does your planet have Wi-Fi?
694,5,10,48,63,1.3174603174603174,0.07781382071333852,527,"Our planet, Z-Z-X-Z-X, won't survive without a massive infusion of E-I-E-I-O."
694,5,10,48,63,1.3174603174603174,0.07781382071333852,527,Sorry for the inconvenience. The transport beam is on the fritz.
694,6,8,49,63,1.3174603174603174,0.08103717334720453,527,Do you prefer your crop circles in corn or wheat?
694,2,16,45,63,1.3174603174603174,0.06722270735187427,527,"Come in, come in, don't be a stranger."
694,5,10,48,63,1.3174603174603174,0.07781382071333852,527,Good-bye Mr. Jones. It was a wonderful stay. We'll give you a great review on AirBnb.
694,7,6,50,63,1.3174603174603174,0.08413712756091785,527,"Of course you are welcome to come, but you do realize there is a very good chance he's not going to win, don't you?"
694,5,10,48,63,1.3174603174603174,0.07781382071333852,527,Greetings. I have come from a blue state.
694,2,16,45,63,1.3174603174603174,0.06722270735187427,527,Did you sign the medical release form?
694,5,10,48,63,1.3174603174603174,0.07781382071333852,527,Hi I am your space Uber driver.
694,3,14,46,63,1.3174603174603174,0.07092901489385721,527,Welcome—please tell us all about this...kale.
721,3,13,44,60,1.3166666666666667,0.07322925331102074,527,We heard about Trump. Come with us.
721,4,11,45,60,1.3166666666666667,0.07699022854818702,527,Enter first and then tell me again how you feel about illegal aliens.
721,5,9,46,60,1.3166666666666667,0.08057584652558421,527,You left your tractor high beams on.
721,3,13,44,60,1.3166666666666667,0.07322925331102074,527,Have you flown with us in the past?
721,3,13,44,60,1.3166666666666667,0.07322925331102074,527,I don't know how else to say this... It's a disaster here. No way we can colonize. Great meeting you though.
721,2,15,43,60,1.3166666666666667,0.06926436160881881,527,Welcome. Do you have more than 3 ounces of liquid on you?
721,5,9,46,60,1.3166666666666667,0.08057584652558421,527,"Luke, I am your father."
721,5,9,46,60,1.3166666666666667,0.08057584652558421,527,I have to warn you...our probe is out of order.
721,1,17,42,60,1.3166666666666667,0.06505828185300302,527,Greetings fellow superdelegate.
721,3,13,44,60,1.3166666666666667,0.07322925331102074,527,Our dating service pledges to match Americans who cannot live with a Trump presidency with single Martians looking for love.
721,4,11,45,60,1.3166666666666667,0.07699022854818702,527,You were highly recommended by Airbnb.
721,3,13,44,60,1.3166666666666667,0.07322925331102074,527,"Hello, my name is Lofor and I'll be your prober this evening."
721,5,9,46,60,1.3166666666666667,0.08057584652558421,527,I'm thinking you'd be wanting the OTHER Elron Hubbard.
721,2,15,43,60,1.3166666666666667,0.06926436160881881,527,Of course this may not be the ACTUAL unit you get but it is representative of what our vacation properties offer.
721,4,11,45,60,1.3166666666666667,0.07699022854818702,527,Boy am I glad you were home. Thanks for coming over so quickly. You wouldn't have some bailing wire and some duct tape would ya?
721,3,13,44,60,1.3166666666666667,0.07322925331102074,527,We'll have your circles finished by Tuesday.
721,3,13,44,60,1.3166666666666667,0.07322925331102074,527,So if Trump gets elected you are coming back for me right?
738,2,16,46,64,1.3125,0.06634969288573796,527,Remember its gonna be sore for at least a few days.
738,4,12,48,64,1.3125,0.07344620642412539,527,"Well, now that you're here, we can start dinner."
738,2,16,46,64,1.3125,0.06634969288573796,527,"I would have been here 25,000 years ago but my GPS messed up."
741,4,11,46,61,1.3114754098360655,0.07589532483264116,527,"I don't know what you've heard, but the probe thing is largely galactic myth."
741,6,7,48,61,1.3114754098360655,0.08278282736362359,527,"If I'm being honest, the stairs are a bit of a disappointment."
741,3,13,45,61,1.3114754098360655,0.07220562473949259,527,Sorry about those crop circles... c'mon in!
741,3,13,45,61,1.3114754098360655,0.07220562473949259,527,Would you be interested in a policy that will protect you against damage from crop circles?
741,3,13,45,61,1.3114754098360655,0.07220562473949259,527,Did you bring the Mars bars?
741,4,11,46,61,1.3114754098360655,0.07589532483264116,527,"We are here to bring you temporary fame and untrusting speculation from neighbors near and far....oh, and a perfect circle of ruined crops. Damn glad to meet you."
741,5,9,47,61,1.3114754098360655,0.07941377977960633,527,We're gonna make American great again.
741,6,7,48,61,1.3114754098360655,0.08278282736362359,527,I have come here to make you great again.
741,4,11,46,61,1.3114754098360655,0.07589532483264116,527,No problem. We can get rid of those crop circles for an additional $29.95.
741,8,3,50,61,1.3114754098360655,0.08913973682471188,527,"Klaatu barada nikto. Which means, what's with all the guns?"
741,4,11,46,61,1.3114754098360655,0.07589532483264116,527,You must tell me where can I get a pair of overalls like that?
741,4,11,46,61,1.3114754098360655,0.07589532483264116,527,Oh the farmer and the Martian should be friends Oh the farmer and the Martian should be friends ...
741,5,9,47,61,1.3114754098360655,0.07941377977960633,527,"Trust me, I work for Monsanto."
741,5,9,47,61,1.3114754098360655,0.07941377977960633,527,Welcome and don't worry! We're all green in here.
741,3,13,45,61,1.3114754098360655,0.07220562473949259,527,"Ok, you can stay the night; but, keep away from my daughter."
741,2,15,44,61,1.3114754098360655,0.0683169390165333,527,"Greetings, Earthling, I am the only true outsider running for President."
741,4,11,46,61,1.3114754098360655,0.07589532483264116,527,Pleased to meet you. For light years now we've been enjoying the stories about your daughter.
741,5,9,47,61,1.3114754098360655,0.07941377977960633,527,"You're definitely organic, right?"
741,4,11,46,61,1.3114754098360655,0.07589532483264116,527,Have you heard the word of God today?
741,6,7,48,61,1.3114754098360655,0.08278282736362359,527,"It's called ""To Serve Man"". C'mon in, I'll autograph a copy for you."
741,7,5,49,61,1.3114754098360655,0.08602002437657874,527,Thanks for the casserole.
741,4,11,46,61,1.3114754098360655,0.07589532483264116,527,Is there any intelligent life on this planet?
741,4,11,46,61,1.3114754098360655,0.07589532483264116,527,"Welcome earthling, I hope you're corn fed!"
741,8,3,50,61,1.3114754098360655,0.08913973682471188,527,We know all of you. Iowa is the most important place in the universe.
741,8,3,50,61,1.3114754098360655,0.08913973682471188,527,"Howdy neighbor, I'm going to eat your kids."
741,4,11,46,61,1.3114754098360655,0.07589532483264116,527,"Don't worry, we're vegans."
741,5,9,47,61,1.3114754098360655,0.07941377977960633,527,Oh hi! Well this is embarrassing--the crop circles are nowhere near done.
741,5,9,47,61,1.3114754098360655,0.07941377977960633,527,I'll have her back by midnight.
741,5,9,47,61,1.3114754098360655,0.07941377977960633,527,"Call me old-fashioned, but I'd like to take your cows for the night."
741,4,11,46,61,1.3114754098360655,0.07589532483264116,527,Have we got some seeds for you!
741,6,7,48,61,1.3114754098360655,0.08278282736362359,527,Welcome to Uber deluxe.
772,4,10,44,58,1.3103448275862069,0.07857971146342174,527,We've been watching the election coverage and would like to save a few members of your species.
772,4,10,44,58,1.3103448275862069,0.07857971146342174,527,You'll prefer our alienable rights.
772,3,12,43,58,1.3103448275862069,0.07463116223213098,527,"A lot of guys have wanted to date my daughter, but you're the first one with his own vehicle."
772,3,12,43,58,1.3103448275862069,0.07463116223213098,527,Time to come home. You've been undercover long enough.
772,4,10,44,58,1.3103448275862069,0.07857971146342174,527,Hello sir do you have a moment to talk about our lord and savior Jesus Christ
777,3,13,46,62,1.3064516129032258,0.07120890709167331,527,I've been watching your presidential campaign on the trip over -- don't take me to your leader.
777,3,13,46,62,1.3064516129032258,0.07120890709167331,527,"Again, thanks so much for your WiFi password."
777,5,9,48,62,1.3064516129032258,0.07828377806886798,527,"Not to stereotype, but could you please wipe your feet before you enter...?"
777,4,11,47,62,1.3064516129032258,0.07483000186397945,527,Welcome aboard. We have satellite TV!
777,4,11,47,62,1.3064516129032258,0.07483000186397945,527,I found you on Ancestry.com
777,5,9,48,62,1.3064516129032258,0.07828377806886798,527,My only demand is that you not take me to your leader.
777,3,13,46,62,1.3064516129032258,0.07120890709167331,527,"Well, its not really an 'abduction' if you volunteer. But welcome aboard nonetheless."
777,8,3,51,62,1.3064516129032258,0.08783400308567063,527,"Hi, Bill! You probably don’t recognize me. I’m the great-great grandson of your first crop of GMO asparagus back in ’02."
777,3,13,46,62,1.3064516129032258,0.07120890709167331,527,I leave crop circles because saying goodbye is always too hard.
777,3,13,46,62,1.3064516129032258,0.07120890709167331,527,I went on Ancestry.com.
777,6,7,49,62,1.3064516129032258,0.08159148631143069,527,We've been monitoring you developments. Mind if I have a last look around?
777,5,9,48,62,1.3064516129032258,0.07828377806886798,527,We are the third party with the best chance.
777,3,13,46,62,1.3064516129032258,0.07120890709167331,527,You looked taller in your Grindr profile.
777,5,9,48,62,1.3064516129032258,0.07828377806886798,527,Nice meeting you too.. now get off my porch.
777,2,15,45,62,1.3064516129032258,0.0673935287651415,527,Pleased to meet you Mister Godot.
777,5,9,48,62,1.3064516129032258,0.07828377806886798,527,"We've decided that Iowa should vote first in our election, too."
777,4,11,47,62,1.3064516129032258,0.07483000186397945,527,""" My sat nav is on the blink, can you show me the way to Roswell""?"
777,4,11,47,62,1.3064516129032258,0.07483000186397945,527,"You realize you're shaking my penis right? Haha, just kidding. It's my great uncle Larry's penis. I had it grafted on last year. Best decision ever."
777,1,17,44,62,1.3064516129032258,0.06334877259778084,527,We heard you make moonshine.
777,7,5,50,62,1.3064516129032258,0.08477022689766137,527,We're into the farm-to-operating-table movement.
777,6,7,49,62,1.3064516129032258,0.08159148631143069,527,"Hi, we're the circle jerks."
777,4,11,47,62,1.3064516129032258,0.07483000186397945,527,I'd like to apologize for the crop circles in your corn fields. Our youngsters are always trying to look cool to their friends as soon as they learn to drive.
777,3,13,46,62,1.3064516129032258,0.07120890709167331,527,We've seen the latest polls and changed our mind on taking us to your leader.
777,8,3,51,62,1.3064516129032258,0.08783400308567063,527,Welcome. You're here for the vivisection?
801,5,8,46,59,1.305084745762712,0.08110227356494051,527,Does your farm use alien labor?
801,2,14,43,59,1.305084745762712,0.0694565919806808,527,Can I use your outhouse? I don't think I can hold it in one more light year.
801,5,8,46,59,1.305084745762712,0.08110227356494051,527,Can I come in and tell you about the Good News?
801,6,6,47,59,1.305084745762712,0.08462879127901062,527,Take us to your subsidies.
801,2,14,43,59,1.305084745762712,0.0694565919806808,527,Have you considered your family's financial future should something unexpected happen to you?
801,4,10,45,59,1.305084745762712,0.07741527782975759,527,Don't be scared. We are just trying to understand how Trump won the nomination.
801,3,12,44,59,1.305084745762712,0.07354367209702453,527,Don't be a stranger.
801,3,12,44,59,1.305084745762712,0.07354367209702453,527,We've been monitoring your candidates and are offering refuge on our planet.
801,3,12,44,59,1.305084745762712,0.07354367209702453,527,"Please, what’s the answer? The Chicken or the Egg??"
801,5,8,46,59,1.305084745762712,0.08110227356494051,527,But Trump said nobody could get over his wall.
801,3,12,44,59,1.305084745762712,0.07354367209702453,527,"Hello, I'd like to talk to you about genetically modified crops."
801,5,8,46,59,1.305084745762712,0.08110227356494051,527,"Once again, let me say how sorry I am about the whole crop circle thing. My bad."
801,5,8,46,59,1.305084745762712,0.08110227356494051,527,We heard about your presidential candidates; welcome aboard.
801,3,12,44,59,1.305084745762712,0.07354367209702453,527,"Pardon me, would you have any Grey Poupon?"
801,1,16,42,59,1.305084745762712,0.0651134750541459,527,You don't look anything like your OKCupid profile
816,3,11,42,56,1.3035714285714286,0.07610503190500345,527,We saw that Matt Damon movie and realized having a farmer aboard couldn't hurt.
817,3,10,40,53,1.3018867924528301,0.07893019118245996,527,"As a frequent flier, today's flight earns you 3.14 billion miles."
818,6,7,50,63,1.3015873015873016,0.08043316115047185,527,You're the first specimen to avoid the fatal selfie.
818,3,13,47,63,1.3015873015873016,0.07023813139859228,527,"This 6 month spa getaway will involve relaxing physical probing, rejuvenating mind melds, and complimentary cucumber masks."
818,5,9,49,63,1.3015873015873016,0.07718458811550716,527,Welcome aboard. I wanted to be the first to reach out to voters for the 2056 Iowa Caucuses. Have you decided who you are caucusing for?
818,4,11,48,63,1.3015873015873016,0.07379314244876146,527,Was that E-I-E-I-O ?
818,2,15,46,63,1.3015873015873016,0.06649332547157367,527,Have you prepped for your probe?
823,4,10,46,60,1.3,0.0762837403353298,527,You can stay the night but you'll have to stay asway from my daughter.
823,4,10,46,60,1.3,0.0762837403353298,527,Can you do anything other than circles?
823,2,14,44,60,1.3,0.06847821213147406,527,You're gonna love what I did with corn field 4
823,6,6,48,60,1.3,0.08336157713463008,527,I saw you with the cows earlier....please wipe your feet.
823,6,6,48,60,1.3,0.08336157713463008,527,"In 4 to 6 weeks, a youngling will burst from your chest. But you should be fine until then."
823,6,6,48,60,1.3,0.08336157713463008,527,We saw the crop circles and we love your work.
823,1,16,43,60,1.3,0.06422066478409214,527,A good Yelp review would be fantastic.
823,3,12,45,60,1.3,0.07248611789946811,527,We're here to rescue you from Donald Trump.
823,4,10,46,60,1.3,0.0762837403353298,527,Come in! I told them you were real!
823,2,14,44,60,1.3,0.06847821213147406,527,Thank God you're here. We had no idea the horse was pregnant when we abducted her.
823,2,14,44,60,1.3,0.06847821213147406,527,Are meals included?
823,5,8,47,60,1.3,0.07990106877232901,527,Am I the first superdelegate you've ever met?
823,4,10,46,60,1.3,0.0762837403353298,527,"'You're late, but that's ok. Did you bring the guacamole?'"
823,4,10,46,60,1.3,0.0762837403353298,527,So this is why those city folk are so excited about Uber.
823,5,8,47,60,1.3,0.07990106877232901,527,Aunt Clara always said I was the good looking one in the family. Now I know why...
823,2,14,44,60,1.3,0.06847821213147406,527,"Congratulations, you have just won the Publishers Clearing House Sweepstakes!"
823,5,8,47,60,1.3,0.07990106877232901,527,"Careful with that grip, you'll damage my probing hand."
840,0,17,40,57,1.2982456140350878,0.06113439056466399,527,Do you have the wifi password?
840,4,9,44,57,1.2982456140350878,0.07901695624277917,527,"Take me to your leader, unless it is Trump."
842,4,10,47,61,1.2950819672131149,0.0751837904540555,527,Yes. We do have single payer health and a generous farm subsidy program.
842,6,6,49,61,1.2950819672131149,0.08213098393360885,527,We're investigating important things about Kansas your government is hiding from you.
842,5,8,48,61,1.2950819672131149,0.07873404876208907,527,We're into sustainable food sources too...is your wife around?
842,3,12,46,61,1.2950819672131149,0.07145735973017497,527,Do you have wifi?
842,3,12,46,61,1.2950819672131149,0.07145735973017497,527,"You're not from around here, are you?"
842,3,12,46,61,1.2950819672131149,0.07145735973017497,527,We've run out of toilet paper...
842,2,14,45,61,1.2950819672131149,0.06752559642221562,527,Have no fear. All I seek is a fresh green salad.
842,4,10,47,61,1.2950819672131149,0.0751837904540555,527,You called for a crop duster?
842,3,12,46,61,1.2950819672131149,0.07145735973017497,527,You ordered an Uber?
842,3,12,46,61,1.2950819672131149,0.07145735973017497,527,I look weird? You're not exactly Matt Damon yourself.
842,1,16,44,61,1.2950819672131149,0.06335028085765876,527,Well we can't all be as handsome as Matt Damon.
842,7,4,50,61,1.2950819672131149,0.08539289554368332,527,Greetings! I come from a place called New York.
842,1,16,44,61,1.2950819672131149,0.06335028085765876,527,"Don't worry, we have WiFi."
855,4,9,45,58,1.293103448275862,0.07781273644985365,527,"I greet you from.........gosh, it's been so long I've totally forgotten."
855,3,11,44,58,1.293103448275862,0.07382317573945477,527,Park it up front and I'll throw in an extra twenty bucks.
855,4,9,45,58,1.293103448275862,0.07781273644985365,527,"Dorothy, I never thought you'd ever come back."
855,6,5,47,58,1.293103448275862,0.08523346355115637,527,Old MacDonald I presume.
855,4,9,45,58,1.293103448275862,0.07781273644985365,527,Welcome--we're thrilled to have you for dinner!
855,5,7,46,58,1.293103448275862,0.08160749126992167,527,"Remember, vote against illegal aliens."
855,3,11,44,58,1.293103448275862,0.07382317573945477,527,We've come to investigate claims that your wife makes the best rhubarb pie in the universe.
855,3,11,44,58,1.293103448275862,0.07382317573945477,527,Why are you surprised again?
855,5,7,46,58,1.293103448275862,0.08160749126992167,527,Let me answer your question with another question: do you really care why we're here for Justin Bieber?
855,5,7,46,58,1.293103448275862,0.08160749126992167,527,Mr. Trump will see you now.
865,3,10,42,55,1.290909090909091,0.07642133462374844,527,Nice hat!
865,3,10,42,55,1.290909090909091,0.07642133462374844,527,"We used to have to snatch you, but in this political climate, more than enough of you come willingly. Welcome..."
865,3,10,42,55,1.290909090909091,0.07642133462374844,527,"You can turn your phone back on at 32,000,000 feet."
865,3,10,42,55,1.290909090909091,0.07642133462374844,527,We are hoping that you can explain about the subsidies for not growing things.
865,4,8,43,55,1.290909090909091,0.08070700749671991,527,Just take me out of range of election coverage.
865,1,14,40,55,1.290909090909091,0.06703296979004872,527,"Hi, there. I'm your Green Party candidate."
865,3,10,42,55,1.290909090909091,0.07642133462374844,527,Here's my information. Sorry again about the circles.
865,4,8,43,55,1.290909090909091,0.08070700749671991,527,"Likewise. By the way, any idea where I can get tickets to Hamilton?"
873,3,12,47,62,1.2903225806451613,0.07045630820994753,527,You look different than your profile picture online.
873,5,8,49,62,1.2903225806451613,0.07759982491037164,527,What shall we do first--crop circle or your wife?
873,5,8,49,62,1.2903225806451613,0.07759982491037164,527,What? You were expecting June Lockhart?
876,3,11,45,59,1.2881355932203389,0.07273100989192272,527,We understand Iowa is a good place to start our campaign...
876,2,13,44,59,1.2881355932203389,0.0685955265593542,527,Welcome. We've been looking forward to genetically modifying you.
876,5,7,47,59,1.2881355932203389,0.08036608035599811,527,Want to see what's over the rainbow?
876,4,9,46,59,1.2881355932203389,0.07664367772910466,527,"Hi there, we're here to serve man."
876,4,9,46,59,1.2881355932203389,0.07664367772910466,527,"We have travelled far, and must know: how many licks DOES it take to get to the center of a Tootsie Pop?"
876,5,7,47,59,1.2881355932203389,0.08036608035599811,527,"I appreciate your concern, but that was not my cow that jumped over your moon."
876,5,7,47,59,1.2881355932203389,0.08036608035599811,527,"Just go along with it. We'll be back in Tulsa in an hour and you'll be $10,000 richer."
876,4,9,46,59,1.2881355932203389,0.07664367772910466,527,Welcome. We love high fructose corn syrup and gluten.
876,5,7,47,59,1.2881355932203389,0.08036608035599811,527,"Remember, a vote for Quyclane is a vote to make this Galaxy great again."
876,2,13,44,59,1.2881355932203389,0.0685955265593542,527,This flight doesn't require you to empty your pockets or remove your shoes.
876,3,11,45,59,1.2881355932203389,0.07273100989192272,527,"Oh, you earthlings and your probing."
876,2,13,44,59,1.2881355932203389,0.0685955265593542,527,"I don't mean to be rude, but we were just sitting down to dinner."
876,3,11,45,59,1.2881355932203389,0.07273100989192272,527,Sorry we vaporized your cows and obliterated your corn field. No hard feelings then?
876,2,13,44,59,1.2881355932203389,0.0685955265593542,527,"Come in, we have candy."
876,4,9,46,59,1.2881355932203389,0.07664367772910466,527,"Well, we're heading home. We do not care for your loud, orange leader with the helmet made of hair. Give my best to Gladys."
876,7,3,49,59,1.2881355932203389,0.08733621209827301,527,Trump won. Take me with you.
876,5,7,47,59,1.2881355932203389,0.08036608035599811,527,Oh yes please! Earth is getting much too scary.
876,6,5,48,59,1.2881355932203389,0.08392353905627811,527,Any chance you'd be willing to run for president?
876,4,9,46,59,1.2881355932203389,0.07664367772910466,527,Take me to your zucchini.
876,3,11,45,59,1.2881355932203389,0.07273100989192272,527,"Howdy, neighbor. Just flew in from, uh, Nebraska. Yes, that's it, Nebraska."
876,4,9,46,59,1.2881355932203389,0.07664367772910466,527,We saw those magnificent crop circles and we simply have to learn how you do it.
876,5,7,47,59,1.2881355932203389,0.08036608035599811,527,Welcome! We're all about farm to saucer here.
876,4,9,46,59,1.2881355932203389,0.07664367772910466,527,"No, we don't do that any more."
876,3,11,45,59,1.2881355932203389,0.07273100989192272,527,"Thanks, but no one really needs to be taken to anyone's leader anymore."
876,3,11,45,59,1.2881355932203389,0.07273100989192272,527,We've been craving an organic farmer.
876,5,7,47,59,1.2881355932203389,0.08036608035599811,527,"If he gets elected, there will be a long line."
876,4,9,46,59,1.2881355932203389,0.07664367772910466,527,Congratulations! You may already be a winner.
876,6,5,48,59,1.2881355932203389,0.08392353905627811,527,"I know I've refused in the past, but now they've elected Trump. Please can I come with you?"
876,5,7,47,59,1.2881355932203389,0.08036608035599811,527,I thought you aliens was from Mexico.
876,5,7,47,59,1.2881355932203389,0.08036608035599811,527,"Unless I misread your crop circles, you are need of migrant workers?"
876,1,15,43,59,1.2881355932203389,0.06419417986088129,527,We loved your website.
876,5,7,47,59,1.2881355932203389,0.08036608035599811,527,You're a little shorter than you looked in your profile.
876,3,11,45,59,1.2881355932203389,0.07273100989192272,527,Can I have my cows back?
876,4,9,46,59,1.2881355932203389,0.07664367772910466,527,We no longer ask probing questions. Too much information.
910,1,14,41,56,1.2857142857142858,0.06602973412408396,527,"What do you mean, am I free range?"
910,5,6,45,56,1.2857142857142858,0.08341060116016318,527,"Forget your wife, man! Save the chickens!"
910,3,10,43,56,1.2857142857142858,0.07522384653285497,527,A cookbook? Don't be silly! To Serve Man is our motto. Come. Come inside.
910,5,6,45,56,1.2857142857142858,0.08341060116016318,527,"Wow, I no idea Uber worked way out here."
910,4,8,44,56,1.2857142857142858,0.07942277844893847,527,Just saw your cow; she's quite the jumper.
910,3,10,43,56,1.2857142857142858,0.07522384653285497,527,Hi. I'm here to destroy the earth.
910,2,12,42,56,1.2857142857142858,0.07077624204383748,527,"Whoa! Lots of questions there buddy. Let's take them one at a time. No, we are not from Tesla. Yes, you can use United miles. No, we do not stop in Des Moines."
910,3,10,43,56,1.2857142857142858,0.07522384653285497,527,"Bob, your heirloom carrots really are out of this world."
910,2,12,42,56,1.2857142857142858,0.07077624204383748,527,Mind if we take some earth rocks to sell in our gift shop back home?
910,3,10,43,56,1.2857142857142858,0.07522384653285497,527,Help us meet our skyrocketing demand for kale.
910,3,10,43,56,1.2857142857142858,0.07522384653285497,527,"I'm sorry, but we can't take any more refugees from Earth."
910,6,4,46,56,1.2857142857142858,0.08721627735262762,527,I'm sorry but this staircase is for deliveries only. The visitors entrance is around the front.
910,4,8,44,56,1.2857142857142858,0.07942277844893847,527,"When I heard this planet still grew gmo corn, well I just had to see it with my own eyes."
910,4,8,44,56,1.2857142857142858,0.07942277844893847,527,"Good evening, may I see some ID please?"
924,3,11,46,60,1.2833333333333334,0.0716696228532331,527,"Communications, this is the Captain speaking. Please type in 'ee ii ee ii oh' into the universal translator...and make it snappy."
924,1,15,44,60,1.2833333333333334,0.06329764084940143,527,We've come 25 trillion miles to meet Justin Bieber. We are a far less advanced civilization than you.
924,4,9,47,60,1.2833333333333334,0.07550832133836045,527,"Don't take us to your leader, explain to us your electoral process."
924,2,13,45,60,1.2833333333333334,0.06761333513821251,527,As a poor vacuum cleaner salesman with broken down transportation it won't be any trouble to share a bunk with your daughter tonight.
924,5,7,48,60,1.2833333333333334,0.07916109109120167,527,Hay Charlie! I finished that crop circle you ordered. Want to fly up and take a look?
924,5,7,48,60,1.2833333333333334,0.07916109109120167,527,"Now that the election is over, we thought you might want to come along with us."
924,3,11,46,60,1.2833333333333334,0.0716696228532331,527,"And if you vote for me, I promise not to blow up your planet."
924,5,7,48,60,1.2833333333333334,0.07916109109120167,527,Did you bring the show tunes?
924,2,13,45,60,1.2833333333333334,0.06761333513821251,527,"Just so you know, there will be butt stuff..."
924,5,7,48,60,1.2833333333333334,0.07916109109120167,527,Come back for me if Trump gets elected.
924,2,13,45,60,1.2833333333333334,0.06761333513821251,527,Hello my name is Scott and I'll be probing you today.
924,4,9,47,60,1.2833333333333334,0.07550832133836045,527,'I'm guessing you've not flown with us before?'
924,5,7,48,60,1.2833333333333334,0.07916109109120167,527,"Oh, the spaceman and the farmer can be friends."
924,3,11,46,60,1.2833333333333334,0.0716696228532331,527,I didn't know you delivered.
924,5,7,48,60,1.2833333333333334,0.07916109109120167,527,"Remember: Crop Circles are geometrical and symmetrical. Good luck, Dwight!"
924,2,13,45,60,1.2833333333333334,0.06761333513821251,527,I never shook hands with my lunch before.
924,3,11,46,60,1.2833333333333334,0.0716696228532331,527,Which bathroom am I supposed to use?
924,4,9,47,60,1.2833333333333334,0.07550832133836045,527,Just in time for dinner.
924,7,3,50,60,1.2833333333333334,0.08600245255557767,527,"My solar system ran out of Uranium. Mind if I dig some out of Uranus?...Ha, ha! Got you!"
924,6,5,49,60,1.2833333333333334,0.08265258673606023,527,They'll never believe you.
924,2,13,45,60,1.2833333333333334,0.06761333513821251,527,Who in the world thought that wall could keep us out?
924,6,5,49,60,1.2833333333333334,0.08265258673606023,527,"Greetings, our planet has depleted its store of folksy wisdom. We will give you plutonium in return for rambling stories about moral dilemmas."
924,4,9,47,60,1.2833333333333334,0.07550832133836045,527,Back home there's this joke about a guy who runs out of intergalactic supernucleon fuel late at night out in the country and ends up sleeping with the farmer's daughter.
924,2,13,45,60,1.2833333333333334,0.06761333513821251,527,You grow weed? Welcome aboard!
924,4,9,47,60,1.2833333333333334,0.07550832133836045,527,"One trip with us, and you'll have more travel miles than you can use in a lifetime."
924,3,11,46,60,1.2833333333333334,0.0716696228532331,527,"Excuse me sir, do you have a second to talk about probing?"
924,3,11,46,60,1.2833333333333334,0.0716696228532331,527,Do you have any kale?
951,3,10,44,57,1.280701754385965,0.0740621646906627,527,Oshkosh b'gosh!
951,2,12,43,57,1.280701754385965,0.0697039297502425,527,"Your favorite movie is ET? No way, mine is Field of Dreams!"
951,4,8,45,57,1.280701754385965,0.07817781433825675,527,Welcome aboard! Ever ride Uber before?
951,2,12,43,57,1.280701754385965,0.0697039297502425,527,"Bob, don't you remember me from the Future Farmers of America?"
951,1,14,42,57,1.280701754385965,0.06505437269382161,527,"So, you're the exchange student?"
951,3,10,44,57,1.280701754385965,0.0740621646906627,527,"Are you one of them ""illegal aliens""?"
951,5,6,46,57,1.280701754385965,0.08208737461234245,527,"Hey, your crop circle is the symbol for free beer!"
951,4,8,45,57,1.280701754385965,0.07817781433825675,527,We'll take a dozen ears of sweet corn and a bushel of Jersey tomatoes.
951,2,12,43,57,1.280701754385965,0.0697039297502425,527,"Greetings, Earthling. Do you know of a way for us to acquire reasonably priced Hamilton tickets?"
951,4,8,45,57,1.280701754385965,0.07817781433825675,527,We came to tell you that the galaxy is very concerned about your upcoming election.
951,4,8,45,57,1.280701754385965,0.07817781433825675,527,Welcome to rural Uber.
951,4,8,45,57,1.280701754385965,0.07817781433825675,527,I got to tell you this is my first Uber and it's awesome.
951,3,10,44,57,1.280701754385965,0.0740621646906627,527,"Yes, I'm organic."
951,3,10,44,57,1.280701754385965,0.0740621646906627,527,Sorry I doodled on your crops when I was bored.
951,5,6,46,57,1.280701754385965,0.08208737461234245,527,"Nah man it's cool, I'm good to drive."
951,4,8,45,57,1.280701754385965,0.07817781433825675,527,You've been upgraded
951,5,6,46,57,1.280701754385965,0.08208737461234245,527,glymph dink bindlflit flinkin trump.
951,4,8,45,57,1.280701754385965,0.07817781433825675,527,I'm told that wearing this get-up lends an air of gravitas.
951,3,10,44,57,1.280701754385965,0.0740621646906627,527,Your daughter's joined the 500 light year club
951,4,8,45,57,1.280701754385965,0.07817781433825675,527,We'll return you on November 9th.
951,2,12,43,57,1.280701754385965,0.0697039297502425,527,"Really, it's just like a pin prick."
951,2,12,43,57,1.280701754385965,0.0697039297502425,527,Welcome aboard. I'm glad you checked your bags! The overhead bins are full.
951,3,10,44,57,1.280701754385965,0.0740621646906627,527,Tell me you have a bathroom.
951,4,8,45,57,1.280701754385965,0.07817781433825675,527,"As a matter of fact, I do have wifi."
951,2,12,43,57,1.280701754385965,0.0697039297502425,527,Can't wait to meet your daughter.
951,3,10,44,57,1.280701754385965,0.0740621646906627,527,I haven't done one of these home swaps before. I hope you left your wifi password.
951,3,10,44,57,1.280701754385965,0.0740621646906627,527,"Hello , the airbnb ad said .........."
951,3,10,44,57,1.280701754385965,0.0740621646906627,527,"Yes, you look a little different than your Tinder profile picture too."
951,4,8,45,57,1.280701754385965,0.07817781433825675,527,I know! What were the chances of you being bipedal too!?
951,2,12,43,57,1.280701754385965,0.0697039297502425,527,"We're still pre-boarding our Space Plus passengers, sir."
951,3,10,44,57,1.280701754385965,0.0740621646906627,527,Have you by chance seen Dorothy?
951,5,6,46,57,1.280701754385965,0.08208737461234245,527,"Oh, you're home. Sorry, I was just going to leave some mysterious crop circles."
951,4,8,45,57,1.280701754385965,0.07817781433825675,527,"Don't be a stranger, now that you know where we are."
951,6,4,47,57,1.280701754385965,0.08581901588102221,527,Do you have a few minutes to discuss the Book of Dwoxoto?
951,4,8,45,57,1.280701754385965,0.07817781433825675,527,"See, I told you. If you built it, we would come."
951,5,6,46,57,1.280701754385965,0.08208737461234245,527,I shall take these corn nuts back to my planet for an unforgettable feast.
951,3,10,44,57,1.280701754385965,0.0740621646906627,527,"Good to see you Jim, I love what you've done with the place."
951,3,10,44,57,1.280701754385965,0.0740621646906627,527,"It's not all milk and honey, but there are no ads for Hillary or Donald."
951,5,6,46,57,1.280701754385965,0.08208737461234245,527,"Don't worry, the Trump experiment is almost over."
951,2,12,43,57,1.280701754385965,0.0697039297502425,527,We heard you had a really attractive daughter.
951,2,12,43,57,1.280701754385965,0.0697039297502425,527,"Sorry, you're looking for Roswell, New Mexico. This is Iowa."
951,3,10,44,57,1.280701754385965,0.0740621646906627,527,Take me to Steven Spielberg.
951,5,6,46,57,1.280701754385965,0.08208737461234245,527,"Hi, we have been looking forward to having you for dinner."
951,4,8,45,57,1.280701754385965,0.07817781433825675,527,"Your illegal aliens start at sunrise, boss."
951,4,8,45,57,1.280701754385965,0.07817781433825675,527,Rod Serling sent me.
951,4,8,45,57,1.280701754385965,0.07817781433825675,527,You're welcome to spend the night---just don't touch my daughter.
951,4,8,45,57,1.280701754385965,0.07817781433825675,527,Told you. You can fix anything with baling wire!
951,4,8,45,57,1.280701754385965,0.07817781433825675,527,We've come to learn about your inalienable rights.
999,6,5,50,61,1.278688524590164,0.08141893128825868,527,"So, are you the guy who shows all the porn on local cable access?"
999,3,11,47,61,1.278688524590164,0.0706377951937,527,I guess you're here about the crop circles.
999,2,13,46,61,1.278688524590164,0.06665770789935259,527,"Your wife's peach cobbler was wonderful. Oh, and sorry about that death ray incident."
999,4,9,48,61,1.278688524590164,0.07440528339613257,527,"I think I've seen enough. I wish you luck, human."
999,1,15,45,61,1.278688524590164,0.06242436972019596,527,Your government is broken. I can fix it. It will be great. Vote for me.
999,2,13,46,61,1.278688524590164,0.06665770789935259,527,Of course you'll be fully reimbursed for the cows.
1005,3,9,42,54,1.2777777777777777,0.07669203238507481,527,PLEASE tell me you have toilet paper in your outhouse!!
1005,0,15,39,54,1.2777777777777777,0.061524237278109795,527,We've been looking forward to having you for dinner tonight.
1005,4,7,43,54,1.2777777777777777,0.08112015687189036,527,Greetings. We're here to pick up the one you call Donald and take him back home. We laughed out loud at his comments about aliens.
1005,4,7,43,54,1.2777777777777777,0.08112015687189036,527,"We're here to take Donald Trump back, you seen him around?"
1005,4,7,43,54,1.2777777777777777,0.08112015687189036,527,"We welcome the tired, the poor and the undocumented."
1010,3,10,45,58,1.2758620689655173,0.07293477784903855,527,Your movies told me to come here
1010,2,12,44,58,1.2758620689655173,0.06866237064311606,527,"Welcome back, Mr. MacDonald. You probably don't remember me from our last visit."
1010,1,14,43,58,1.2758620689655173,0.06410585359213843,527,We appreciate your letting us park here. Finding a spot in the city is impossible.
1010,2,12,44,58,1.2758620689655173,0.06866237064311606,527,"Yes, as a matter of fact, we do accept Muslims."
1010,4,8,46,58,1.2758620689655173,0.0769704001382646,527,"Thanks for applying, but we're only accepting grass-fed humans this trip."
1010,4,8,46,58,1.2758620689655173,0.0769704001382646,527,"Congratulations! Your crop circle won our ""Tell us what's so funny about an expiring planet"" Contest"
1010,4,8,46,58,1.2758620689655173,0.0769704001382646,527,"Let's just keep this little GMO secret between us, okay?"
1010,3,10,45,58,1.2758620689655173,0.07293477784903855,527,Come on in. I'll get your cows.
1010,4,8,46,58,1.2758620689655173,0.0769704001382646,527,You're in Kansas!
1010,4,8,46,58,1.2758620689655173,0.0769704001382646,527,"""airbnb""...you were expecting us?"
1010,4,8,46,58,1.2758620689655173,0.0769704001382646,527,You really went all out this Halloween.
1010,4,8,46,58,1.2758620689655173,0.0769704001382646,527,Sorry about the stairs. We need your help with the tractor beam.
1010,4,8,46,58,1.2758620689655173,0.0769704001382646,527,Hello. You don't happen to have a spare microspanx hydromoximetamorph calipution switch do you?
1010,3,10,45,58,1.2758620689655173,0.07293477784903855,527,"Evening, sir. Pleasure to probe you."
1010,3,10,45,58,1.2758620689655173,0.07293477784903855,527,Don't worry. I'm very down to earth.
1010,3,10,45,58,1.2758620689655173,0.07293477784903855,527,I gotta get a bigger scarecrow.
1010,3,10,45,58,1.2758620689655173,0.07293477784903855,527,"No butt stuff, I promise."
1010,5,6,47,58,1.2758620689655173,0.08080472247957123,527,"Sir, do you have a moment to talk about our Lord and Savior Xzlphzyx?"
1010,4,8,46,58,1.2758620689655173,0.0769704001382646,527,We've come for the free-range chickens.
1010,4,8,46,58,1.2758620689655173,0.0769704001382646,527,"No, please don't take me to your President, a simple crop circle or cow will do"
1010,4,8,46,58,1.2758620689655173,0.0769704001382646,527,"Don't worry, we're only probing the outer reaches of the galaxy."
1010,4,8,46,58,1.2758620689655173,0.0769704001382646,527,"Welcome sir, any snags with - you know, immigration ? Not a one. I flew in under the radar but over the wall."
1010,2,12,44,58,1.2758620689655173,0.06866237064311606,527,I was hoping you would send your daughter.
1010,3,10,45,58,1.2758620689655173,0.07293477784903855,527,I'm opening a farmer to table restaurant on my home planet.
1010,4,8,46,58,1.2758620689655173,0.0769704001382646,527,"Come on, there's lots of space."
1010,2,12,44,58,1.2758620689655173,0.06866237064311606,527,Why are you asking if I'm legal or illegal? We just put you guys here to feed our pet mosquitoes.
1010,1,14,43,58,1.2758620689655173,0.06410585359213843,527,Wanna get outta here?
1010,3,10,45,58,1.2758620689655173,0.07293477784903855,527,"To us, everywhere is 'flyover country'."
1010,3,10,45,58,1.2758620689655173,0.07293477784903855,527,"Who did you expect, Mork?"
1010,5,6,47,58,1.2758620689655173,0.08080472247957123,527,"I don't know your laws, so I can't say if I'm illegal."
1010,3,10,45,58,1.2758620689655173,0.07293477784903855,527,"Go south on I-95 and then west on I-4. You will see a big yellow arch with ""Disney World"" written on it in big red letters."
1010,3,10,45,58,1.2758620689655173,0.07293477784903855,527,Mi casa es su casa.
1010,4,8,46,58,1.2758620689655173,0.0769704001382646,527,"Sorry, it's standing room only--I'm filled with British remainders."""
1010,3,10,45,58,1.2758620689655173,0.07293477784903855,527,"Dude, your crop circles are awesome."
1010,3,10,45,58,1.2758620689655173,0.07293477784903855,527,We seek the earthling knows as Old McDonald.
1010,3,10,45,58,1.2758620689655173,0.07293477784903855,527,"Do not be alarmed, Farmer. We are only interested in your seed."
1010,3,10,45,58,1.2758620689655173,0.07293477784903855,527,Welcome aboard. We are taking America back.
1010,4,8,46,58,1.2758620689655173,0.0769704001382646,527,"Welcome aboard. Would you prefer steak, fish or Venution?"
1010,5,6,47,58,1.2758620689655173,0.08080472247957123,527,Do you have time to hear about our lord and saviour Xabnar the Great?
1010,4,8,46,58,1.2758620689655173,0.0769704001382646,527,I understand you are a man who knows how to fix things.
1010,3,10,45,58,1.2758620689655173,0.07293477784903855,527,"Thanks again. We'r fanatic about ""locally sourced."""
1010,4,8,46,58,1.2758620689655173,0.0769704001382646,527,Forget Trump. I'm the outsider candidate of your dreams.
1010,3,10,45,58,1.2758620689655173,0.07293477784903855,527,"No, you're not invading at all, come in!"
1010,4,8,46,58,1.2758620689655173,0.0769704001382646,527,We saw your clever corn row messages.
1010,2,12,44,58,1.2758620689655173,0.06866237064311606,527,"You DO know, don't you, that nobody's going to believe you when you talk about this?"
1010,2,12,44,58,1.2758620689655173,0.06866237064311606,527,You'll be getting quite a few miles credited to your travel awards card.
1010,2,12,44,58,1.2758620689655173,0.06866237064311606,527,Do you validate?
1057,5,5,45,55,1.2727272727272727,0.08390529154462702,527,We come in peas.
1057,1,13,41,55,1.2727272727272727,0.06592795503870998,527,"No, we are not taking your farm by eminent domain. We are taking your farm by eminent dominance."
1057,5,5,45,55,1.2727272727272727,0.08390529154462702,527,We're her to serve mankind - with fava beans and a nice Chianti.
1057,3,9,43,55,1.2727272727272727,0.07545393695750746,527,Greetings! Did you order something from Amazon?
1057,5,5,45,55,1.2727272727272727,0.08390529154462702,527,Greetings Google earthling.
1057,4,7,44,55,1.2727272727272727,0.079791586497501,527,We're hoping to use your farm for an intergalactic music festival.
1057,3,9,43,55,1.2727272727272727,0.07545393695750746,527,"Ah, you saw our ad in the Enquirer."
1057,3,9,43,55,1.2727272727272727,0.07545393695750746,527,"Boy, are we glad to see you. We are totally out of weed."
1057,2,11,42,55,1.2727272727272727,0.07085122390606133,527,"Pardon me, but do you happen to have a vehicle recharging station we might use?"
1057,2,11,42,55,1.2727272727272727,0.07085122390606133,527,We're here to rescue you.
1057,4,7,44,55,1.2727272727272727,0.079791586497501,527,We know about Trump. You're welcome to bring your family.
1057,1,13,41,55,1.2727272727272727,0.06592795503870998,527,And don't forget to give us a 5-Star review!
1057,4,7,44,55,1.2727272727272727,0.079791586497501,527,"Congratulations, Farmer Bob! You're our one millionth abductee."
1057,2,11,42,55,1.2727272727272727,0.07085122390606133,527,"Sure, I promise not to go near your daughter."
1057,3,9,43,55,1.2727272727272727,0.07545393695750746,527,"Finally, someone who can tell us why organic costs more!"
1057,4,7,44,55,1.2727272727272727,0.079791586497501,527,"Gosh, Larry, it's been almost 20 years since we did the last crop circle here."
1057,3,9,43,55,1.2727272727272727,0.07545393695750746,527,"Yes, I'm your Uber driver"
1057,3,9,43,55,1.2727272727272727,0.07545393695750746,527,Thank you for letting us use your farm. We'll call it Woodstock.
1057,4,7,44,55,1.2727272727272727,0.079791586497501,527,Please leave your boots at the door.
1057,3,9,43,55,1.2727272727272727,0.07545393695750746,527,Would you have any grey poupon?
1077,5,6,48,59,1.271186440677966,0.07956085076239691,527,Welcome to life after Brexit.
1077,4,8,47,59,1.271186440677966,0.0757989144915183,527,Howdy...looks like rain...lives of the cowboys...make America great again...I'm with her
1077,3,10,46,59,1.271186440677966,0.07184025265927597,527,"Welcome aboard, and thank you again for calling on us to help you with your crop circling needs. Now, which irritating neighbor do you want to mystify first?"
1080,3,9,44,56,1.2678571428571428,0.07425417662209718,527,"Oy, do I have crop circles for you!"
1080,5,5,46,56,1.2678571428571428,0.08253716765510495,527,I'm sorry. We should have spelled out our name in the Yellow Pages listing. We're not the United Farmer's Organization.
1080,3,9,44,56,1.2678571428571428,0.07425417662209718,527,"Nice meeting you, I love your hat"
1080,1,13,42,56,1.2678571428571428,0.06492288846873887,527,Parking wasn't a problem.
1080,3,9,44,56,1.2678571428571428,0.07425417662209718,527,"Welcome aboard. Yes, Canada overbooked and, by November, not a prayer."
1080,2,11,43,56,1.2678571428571428,0.06974476393590386,527,"Everyone is going to think you're crazy from now on, but the membership perks are amazing."
1080,2,11,43,56,1.2678571428571428,0.06974476393590386,527,"Come on, I'll take you for a spin."
1080,3,9,44,56,1.2678571428571428,0.07425417662209718,527,"Have you heard about our Lord, Fnerb Bingbot?"
1080,4,7,45,56,1.2678571428571428,0.07850498961961752,527,Welcome Brother. Tonight we'll show you which God is right and why.
1080,2,11,43,56,1.2678571428571428,0.06974476393590386,527,"Greetings, specimen."
1080,4,7,45,56,1.2678571428571428,0.07850498961961752,527,"Thank God you've come. We found your cow over the moon. And all she'll tell us is, ""Moo. Moo."""
1080,2,11,43,56,1.2678571428571428,0.06974476393590386,527,"Welcome,now please remove your shoes and hat and do you have any liquids on your person."
1080,3,9,44,56,1.2678571428571428,0.07425417662209718,527,If he gets elected we'll be back for you.
1080,0,15,41,56,1.2678571428571428,0.05971290310957638,527,"Hello! Can you grow what you call ""pot""?"
1080,2,11,43,56,1.2678571428571428,0.06974476393590386,527,I was non-compliant with your admonition to avoid contact with your daughter.
1080,2,11,43,56,1.2678571428571428,0.06974476393590386,527,"""Alien"" has negative connotations. We prefer crop circle specialists."
1080,2,11,43,56,1.2678571428571428,0.06974476393590386,527,You're our first foray into farm to table!
1080,2,11,43,56,1.2678571428571428,0.06974476393590386,527,"Sorry to trouble you, but I don’t suppose you have any uranium fuel lying around?"
1080,4,7,45,56,1.2678571428571428,0.07850498961961752,527,"Hey, sorry about the fence,, and the cows. Listen, we're here to take back Donald Trump."
1080,1,13,42,56,1.2678571428571428,0.06492288846873887,527,Please wipe your feet
1080,3,9,44,56,1.2678571428571428,0.07425417662209718,527,"As soon as we heard about Trump's nomination, we added extra shuttles to the schedule."
1080,2,11,43,56,1.2678571428571428,0.06974476393590386,527,"It could never work between us, we're from two different worlds"
1080,3,9,44,56,1.2678571428571428,0.07425417662209718,527,Thanks for the jump.
1080,2,11,43,56,1.2678571428571428,0.06974476393590386,527,May I interest you in Uber-plus?
1080,4,7,45,56,1.2678571428571428,0.07850498961961752,527,Thanks for meeting me here. Zorgon and Hedron told me they had abducted you in 1965 and I should call you for a 'good time.'
1080,2,11,43,56,1.2678571428571428,0.06974476393590386,527,I thought small farmers didn't exist.
1080,3,9,44,56,1.2678571428571428,0.07425417662209718,527,"By the way, do you mind chipping in for gas?"
1080,4,7,45,56,1.2678571428571428,0.07850498961961752,527,Can I borrow a cup of sugar?
1080,4,7,45,56,1.2678571428571428,0.07850498961961752,527,We're here to tell you about a wonderful plutonium extraction opportunity right here on your land!
1080,2,11,43,56,1.2678571428571428,0.06974476393590386,527,"... but the one we really like is ""Game of Thrones."""
1080,5,5,46,56,1.2678571428571428,0.08253716765510495,527,Your daughter can make America great again.
1080,4,7,45,56,1.2678571428571428,0.07850498961961752,527,We just don't want to be in Kansas anymore.
1080,2,11,43,56,1.2678571428571428,0.06974476393590386,527,Do you know where I can get my green card?
1080,2,11,43,56,1.2678571428571428,0.06974476393590386,527,Take me to your farmer's market.
1080,3,9,44,56,1.2678571428571428,0.07425417662209718,527,We have much anticipation to experience your 'fast food'.
1080,4,7,45,56,1.2678571428571428,0.07850498961961752,527,Greetings! I saw your ad on Craig's list for crop circles.
1080,4,7,45,56,1.2678571428571428,0.07850498961961752,527,"Greetings, genetically modified farmer."
1080,3,9,44,56,1.2678571428571428,0.07425417662209718,527,So YOU'RE the man to see about a horse.
1080,3,9,44,56,1.2678571428571428,0.07425417662209718,527,So what are your thoughts on anal?
1119,0,14,39,53,1.2641509433962264,0.061139063192526995,527,"If we could just keep this between the two of us, that would be great!"
1119,1,12,40,53,1.2641509433962264,0.06681073606086448,527,Think of us as an emerging market with no government regulations.
1119,3,8,42,53,1.2641509433962264,0.07690938345133104,527,We heard you need intelligent life this election cycle.
1122,4,7,46,57,1.263157894736842,0.07725845935738523,527,"Good to see you again David, I think you'll see we have a lot to offer in our new emigration package."
1122,2,11,44,57,1.263157894736842,0.0686712218487231,527,We're bypassing your leader. You'll do just fine.
1122,2,11,44,57,1.263157894736842,0.0686712218487231,527,We're not looking for citizenship—just a few ripe tomatoes.
1122,2,11,44,57,1.263157894736842,0.0686712218487231,527,We're here to serve man. You're just in time for dinner!
1122,4,7,46,57,1.263157894736842,0.07725845935738523,527,You're right. I'm not from around these parts.
1122,1,13,43,57,1.263157894736842,0.06394662066252167,527,"Mind taking your shoes off, we just had the carpets cleaned."
1122,2,11,44,57,1.263157894736842,0.0686712218487231,527,Get in we know where Dorothy is.
1122,3,9,45,57,1.263157894736842,0.07309106050835933,527,"Thank you for volunteering to leave Earth before the 2016 election, but we are already filled to capacity."
1122,1,13,43,57,1.263157894736842,0.06394662066252167,527,Ninety-five percent of our DNA is shared with corn.
1122,4,7,46,57,1.263157894736842,0.07725845935738523,527,Sure I've got candy!
1122,3,9,45,57,1.263157894736842,0.07309106050835933,527,"Thank you for coming, our interpreters think they've finally cracked the meaning of ""EIEIO"", but would love confirmation."
1122,2,11,44,57,1.263157894736842,0.0686712218487231,527,"We won't bother you again. But, if you'd like, you can follow us on Snapchat."
1122,5,5,47,57,1.263157894736842,0.08121228945373259,527,"First, I want to apologize for the cattle mutilations. It was just some cow-tipping that got a little out of hand."
1122,3,9,45,57,1.263157894736842,0.07309106050835933,527,Hi. Is there a Starbuck's around?
1122,4,7,46,57,1.263157894736842,0.07725845935738523,527,"Fred, I sold the farm and we're moving to New York."
1122,2,11,44,57,1.263157894736842,0.0686712218487231,527,"I am being serious, Trump's our leader."
1122,2,11,44,57,1.263157894736842,0.0686712218487231,527,I'd love to hear about the Latter-Day Saints.
1122,2,11,44,57,1.263157894736842,0.0686712218487231,527,We like to stop for local organic produce.
1122,1,13,43,57,1.263157894736842,0.06394662066252167,527,Can you tell me the way to Area 51?
1122,4,7,46,57,1.263157894736842,0.07725845935738523,527,"If you'll step right this way, Mr. Brown, we'll get you set up for your first auditing session."
1122,3,9,45,57,1.263157894736842,0.07309106050835933,527,"I'm running as an Independent, and I'd really appreciate your vote."
1122,2,11,44,57,1.263157894736842,0.0686712218487231,527,I promise. This time no probing.
1122,4,7,46,57,1.263157894736842,0.07725845935738523,527,Did you call for an Uber pool?
1122,3,9,45,57,1.263157894736842,0.07309106050835933,527,"You're not bringing her back, are you?"
1122,4,7,46,57,1.263157894736842,0.07725845935738523,527,There is no Trump in outer space. You'll be safe with us.
1122,3,9,45,57,1.263157894736842,0.07309106050835933,527,Congratulations. You've just won a vacation abduction package.
1122,2,11,44,57,1.263157894736842,0.0686712218487231,527,"Hello, friend. Have you found Jesus?"
1122,3,9,45,57,1.263157894736842,0.07309106050835933,527,Welcome to Trump U
1122,3,9,45,57,1.263157894736842,0.07309106050835933,527,Do you have any heirloom tomatoes?
1122,5,5,47,57,1.263157894736842,0.08121228945373259,527,Greetings. I'm the Monsanto representative you asked to meet with.
1122,2,11,44,57,1.263157894736842,0.0686712218487231,527,"Hey, man."
1122,4,7,46,57,1.263157894736842,0.07725845935738523,527,"Goodbye, We voted Earthxit"
1122,4,7,46,57,1.263157894736842,0.07725845935738523,527,"You can stay the night, just stay away from my robot daughter."
1122,3,9,45,57,1.263157894736842,0.07309106050835933,527,"If you upgrade to business class, your first mind probe is free."
1122,3,9,45,57,1.263157894736842,0.07309106050835933,527,"Hi, I'm here to pick up the Stair Climber you advertised on Craig's List."
1122,3,9,45,57,1.263157894736842,0.07309106050835933,527,I was wondering if I could borrow your telephone to let my wife know I'm running late and it would also be great if I could use your bathroom and have a glass of water.
1122,3,9,45,57,1.263157894736842,0.07309106050835933,527,"Don't worry, I won't have her out too late"
1122,3,9,45,57,1.263157894736842,0.07309106050835933,527,"We're looking for locally sourced food supplies, grown within 10 light years."
1122,1,13,43,57,1.263157894736842,0.06394662066252167,527,May we serve you farm-to-table?
1122,4,7,46,57,1.263157894736842,0.07725845935738523,527,"Greeting Earthling, I've come to take back Donald Trump."
1122,3,9,45,57,1.263157894736842,0.07309106050835933,527,You must be the neighbor...say have you heard of Amway?
1122,2,11,44,57,1.263157894736842,0.0686712218487231,527,"Congratulations, you're our ten thousandth abductee."
1122,2,11,44,57,1.263157894736842,0.0686712218487231,527,Is it too late to run for President?
1165,2,10,42,54,1.2592592592592593,0.0708596766166785,527,"No, I'm his son, Klaat3"
1165,3,8,43,54,1.2592592592592593,0.07563005877154262,527,Are you binary or analog?
1165,3,8,43,54,1.2592592592592593,0.07563005877154262,527,We need milk.
1165,1,12,41,54,1.2592592592592593,0.06574406247451946,527,Aren't we friends on Facebook?
1165,1,12,41,54,1.2592592592592593,0.06574406247451946,527,Can we hover here tonight? My wife is air sick.
1165,4,6,44,54,1.2592592592592593,0.08011690089708742,527,Can I borrow some Grey Poupon?
1165,1,12,41,54,1.2592592592592593,0.06574406247451946,527,"Say, I was wonderin' if you could just get me the hell out of here."
1165,3,8,43,54,1.2592592592592593,0.07563005877154262,527,Can you tell us how to get farm subsidies?
1165,2,10,42,54,1.2592592592592593,0.0708596766166785,527,I need more space
1165,2,10,42,54,1.2592592592592593,0.0708596766166785,527,Welcome! We were expecting you for supper.
1165,4,6,44,54,1.2592592592592593,0.08011690089708742,527,"It's OK, I work for the government."
1165,2,10,42,54,1.2592592592592593,0.0708596766166785,527,"Yes, we were happy to see your request for crop dusters on Craigslist."
1165,4,6,44,54,1.2592592592592593,0.08011690089708742,527,"Oh, you do not look like your Facebook picture."
1165,3,8,43,54,1.2592592592592593,0.07563005877154262,527,Greetings from Monsanto. Thanks for signing up for our new off-site facility.
1165,3,8,43,54,1.2592592592592593,0.07563005877154262,527,We're into farmer-to-table cuisine.
1165,2,10,42,54,1.2592592592592593,0.0708596766166785,527,Take me away from your leader...
1165,4,6,44,54,1.2592592592592593,0.08011690089708742,527,"I assure you, your caucuses are the biggest mystery out there."
1165,2,10,42,54,1.2592592592592593,0.0708596766166785,527,"You'll want to book soon, as we expect to be at full capacity after your Election Day"
1165,3,8,43,54,1.2592592592592593,0.07563005877154262,527,"Hi, we're new around here, and the missus sent me to borrow a cup of sugar."
1165,5,4,45,54,1.2592592592592593,0.08436545400174449,527,We need an outhouse built. I'll leave it at that.
1165,3,8,43,54,1.2592592592592593,0.07563005877154262,527,"Our immigration reform is stuck in committee, so we'll have to forgo the abduction."
1186,1,11,39,51,1.2549019607843137,0.06769677059463557,527,Welcome aboard. We've been hoping to meet you since next year.
1187,3,8,44,55,1.2545454545454546,0.0743917278364524,527,"Oh, 'undocumented person' is the preferred nomenclature, please."
1187,2,10,43,55,1.2545454545454546,0.06971892495651474,527,"Congratulations, you've won first class seats!"
1187,2,10,43,55,1.2545454545454546,0.06971892495651474,527,I am so sorry. My GPS says this is Area 51.
1187,4,6,45,55,1.2545454545454546,0.0787878787878788,527,"Yes, Of course you will receive a mule with your 40 acres"
1187,3,8,44,55,1.2545454545454546,0.0743917278364524,527,We'll return your cows once we've rebuilt our planet.
1187,2,10,43,55,1.2545454545454546,0.06971892495651474,527,"Farmer in the dell, I presume."
1187,4,6,45,55,1.2545454545454546,0.0787878787878788,527,I wanted to rent the airbnb loft you're advertising for the summer.
1187,4,6,45,55,1.2545454545454546,0.0787878787878788,527,"Welcome, Mr. Joad. Thanks for answering our seasonal help wanted flyer."
1187,3,8,44,55,1.2545454545454546,0.0743917278364524,527,Pleasure to have you join the team. We pride ourselves on doing things a little differently around here.
1187,4,6,45,55,1.2545454545454546,0.0787878787878788,527,"yes, we could call it thee ""stairway to heaven"" but we are afraid of lawsuits."
1187,4,6,45,55,1.2545454545454546,0.0787878787878788,527,"So November 9, I'll need 10 seats, but only if Trump wins."
1187,4,6,45,55,1.2545454545454546,0.0787878787878788,527,It's a deal. I'll finish the crop circles in time for Halloween.
1187,3,8,44,55,1.2545454545454546,0.0743917278364524,527,PLEEEASE ... Don't take me to your leader
1187,3,8,44,55,1.2545454545454546,0.0743917278364524,527,Don't worry we're nothing like the ones in Men in Black
1187,3,8,44,55,1.2545454545454546,0.0743917278364524,527,Seems a tad far to travel for locally sourced vegetables.
1187,3,8,44,55,1.2545454545454546,0.0743917278364524,527,"Excuse me, sir. Do you have a moment to learn about our galactic overlord and savior?"
1187,4,6,45,55,1.2545454545454546,0.0787878787878788,527,"welcome! Are you Old Macdonald or the Farmer in the Dell?"""
1187,3,8,44,55,1.2545454545454546,0.0743917278364524,527,"For a dairy farmer, the Milky Way is a must-see."
1187,5,4,46,55,1.2545454545454546,0.08295137441473863,527,Take to me your leader. ...Unless it's Trump.
1187,2,10,43,55,1.2545454545454546,0.06971892495651474,527,Got ethanol?
1187,3,8,44,55,1.2545454545454546,0.0743917278364524,527,Nice to meet you too. Do you have any spare tickets to 'Hamilton?'
1187,3,8,44,55,1.2545454545454546,0.0743917278364524,527,I just fly for Uber in my spare time.
1187,4,6,45,55,1.2545454545454546,0.0787878787878788,527,Just need you to sign our standard waiver of liability form and you'll be good to go.
1187,6,2,47,55,1.2545454545454546,0.0869156556133291,527,"Gort, you crazy bastard, what brings you back?"
1187,2,10,43,55,1.2545454545454546,0.06971892495651474,527,I like what you're doing with crop circles
1187,3,8,44,55,1.2545454545454546,0.0743917278364524,527,Well you might say my profile pic is a few years old but it's all relative.
1187,2,10,43,55,1.2545454545454546,0.06971892495651474,527,"Before you enter, I am required by law to ask if you are allergic to anal probes."
1187,4,6,45,55,1.2545454545454546,0.0787878787878788,527,"This won't make Trump happy, He thought the wall would keep out All the Aliens"
1187,2,10,43,55,1.2545454545454546,0.06971892495651474,527,If you leak this... Disney will sue your ass.
1187,4,6,45,55,1.2545454545454546,0.0787878787878788,527,Hey Bob! C'mon in. The Cardinal Orioles game is on.
1187,1,12,42,55,1.2545454545454546,0.06470956516382613,527,"Welcome Aboard! I can take you to a galaxy where - for the next four months - there is no election coverage."""
1187,3,8,44,55,1.2545454545454546,0.0743917278364524,527,"Dude, there's a hole in your ozone layer."
1219,4,6,46,56,1.25,0.07750157099371281,527,I got the name of a politician you might be interested in taking.
1219,3,8,45,56,1.25,0.07319250547113999,527,I hear you're looking for a new crop duster.
1219,4,6,46,56,1.25,0.07750157099371281,527,Trump sent us to check if there are any illegal aliens working on your farm
1219,4,6,46,56,1.25,0.07750157099371281,527,We appreciate your interest in our new line of genetically modified seeds.
1219,3,8,45,56,1.25,0.07319250547113999,527,And for another $50.00 you can plug into the barn.
1219,3,8,45,56,1.25,0.07319250547113999,527,My name is Zultan and I'd like to earn your vote.
1219,4,5,43,52,1.25,0.08181113518415854,527,Take me to your tractor.
1219,2,10,44,56,1.25,0.06861335298462105,527,It's ok - we all have green cards.
1219,2,10,44,56,1.25,0.06861335298462105,527,"Sorry, my GPS took me the wrong way around Mars. Kansas has always been on my bucket list."
1219,3,8,45,56,1.25,0.07319250547113999,527,Welcome Vern. Let's review this year's GMOs.
1219,2,10,44,56,1.25,0.06861335298462105,527,Thank God you showed up. Now get me outta here!
1219,4,6,46,56,1.25,0.07750157099371281,527,Hello friend. Allow me to Identify this Flying Object.
1219,2,10,44,56,1.25,0.06861335298462105,527,"Say, you think you could switch off the lights so Mae and I could get some rest?"
1219,4,6,46,56,1.25,0.07750157099371281,527,Are you from Monsanto?
1219,5,4,47,56,1.25,0.08158335710084598,527,Donald Trump is our leader. Please take me to yours.
1219,4,6,46,56,1.25,0.07750157099371281,527,"No, Mormon actually."
1219,4,6,46,56,1.25,0.07750157099371281,527,"Well, things don't usually get going until after 10, but you're certainly welcome to come in... even dressed like that."
1219,3,8,45,56,1.25,0.07319250547113999,527,"Welcome aboard, but I need you to first go through security."
1219,2,10,44,56,1.25,0.06861335298462105,527,Excuse me but what's the password to your wifi?
1219,2,10,44,56,1.25,0.06861335298462105,527,"Take me to your leader? No, let's not do that."
1219,4,6,46,56,1.25,0.07750157099371281,527,Please tell me you're here to run for President
1219,3,8,45,56,1.25,0.07319250547113999,527,This is the first time I have tried Uber .
1219,0,14,42,56,1.25,0.05838742081211422,527,Welcome. In first class we have fish or a vegan tamale.
1219,3,8,45,56,1.25,0.07319250547113999,527,Welcome aboard Earthling. Do you know how to fix a toilet?
1219,2,10,44,56,1.25,0.06861335298462105,527,This will be my last visit if Trump wins.
1219,1,12,43,56,1.25,0.06370589892970319,527,"Greetings earthman, we're from France."
1219,3,8,45,56,1.25,0.07319250547113999,527,I'm running on the independent ticket and together we can make Earth great again.
1219,2,10,44,56,1.25,0.06861335298462105,527,Looks like you're gonna need a bigger wall
1219,2,10,44,56,1.25,0.06861335298462105,527,Take me too your Leader just doesn't have the same impact as it did back in the fifties !
1219,4,6,46,56,1.25,0.07750157099371281,527,Trump won.
1219,0,14,42,56,1.25,0.05838742081211422,527,Is it okay to park here?
1219,5,4,47,56,1.25,0.08158335710084598,527,Excuse the shape of the place.
1219,3,8,45,56,1.25,0.07319250547113999,527,"It's about your daughter, we have to talk..."
1219,1,12,43,56,1.25,0.06370589892970319,527,Come in. I would love to show you my portfolio of crop circles.
1219,4,6,46,56,1.25,0.07750157099371281,527,Do you have a daughter?
1219,2,10,44,56,1.25,0.06861335298462105,527,Welcome to the Republican Party!
1219,3,8,45,56,1.25,0.07319250547113999,527,Welcome to Aliens For Trump.
1219,4,6,46,56,1.25,0.07750157099371281,527,Please tell your leaders to stop demonizing us as illegal aliens.
1219,4,6,46,56,1.25,0.07750157099371281,527,Congratulations! You've just won the Publishers Clearing House $10 Million prize!
1219,5,4,47,56,1.25,0.08158335710084598,527,"I'm sorry, but we really can't allow you people elect Donald Trump"
1219,4,6,46,56,1.25,0.07750157099371281,527,Uranus?
1219,2,10,44,56,1.25,0.06861335298462105,527,Your tomatoes are out of this world!
1219,5,4,47,56,1.25,0.08158335710084598,527,We're here for some locally sourced produce.
1219,2,10,44,56,1.25,0.06861335298462105,527,I never meant to alienate you!
1219,4,6,46,56,1.25,0.07750157099371281,527,"""Upstate MWM, curious, DDF,"" right? I loved your ad."
1219,3,7,42,52,1.25,0.07706434991063846,527,I hope you vote for me in November.
1219,3,8,45,56,1.25,0.07319250547113999,527,Ephraim suddenly regrets the Amish prohibition on cel phones.
1219,3,8,45,56,1.25,0.07319250547113999,527,I'm R2-D2. Are you E-I-E-I-O?
1219,3,8,45,56,1.25,0.07319250547113999,527,Please tell me you're here to fix the plumbing.
1219,3,8,45,56,1.25,0.07319250547113999,527,I'm here to make Earth great again!
1219,2,10,44,56,1.25,0.06861335298462105,527,"Welcome! You've been selected for a free medical exam, prepaid by Medicare."
1219,2,10,44,56,1.25,0.06861335298462105,527,We just want your wife's cornbread and fried chicken recipes.
1219,4,6,46,56,1.25,0.07750157099371281,527,You must be from Monsanto.
1219,2,10,44,56,1.25,0.06861335298462105,527,"Yeah, I sell dilithium crystals. I just need a place to stay tonight. Say, is that your daughter I saw in the window?"
1219,1,12,43,56,1.25,0.06370589892970319,527,Hello. I'm your driver. Thank you for using Uber.
1219,2,10,44,56,1.25,0.06861335298462105,527,Do you have any Grey Poupon?
1219,3,8,45,56,1.25,0.07319250547113999,527,"Nope, this is Area 49. You need to go back that way 'til ya see the big oak tree and hang a left."
1219,2,10,44,56,1.25,0.06861335298462105,527,Uber
1219,3,8,45,56,1.25,0.07319250547113999,527,This farm to table movement really has taken off.
1219,3,8,45,56,1.25,0.07319250547113999,527,"Hi, ever hear the one about the farmer's daughter and the space aliens?"
1219,3,8,45,56,1.25,0.07319250547113999,527,"Howdy, Bob. Ready to make some crop circles?"
1219,3,8,45,56,1.25,0.07319250547113999,527,You betcha we'll help with the barn raising!
1219,4,6,46,56,1.25,0.07750157099371281,527,We want to hear from Iowa first.
1219,3,8,45,56,1.25,0.07319250547113999,527,My opponent in this election eats people.
1219,5,4,47,56,1.25,0.08158335710084598,527,"Yes, I am a farmer, and I have a daughter. Why do you ask?"
1284,3,7,43,53,1.2452830188679245,0.07574334277585738,527,"Yes sir, I'll be your Uber-ET driver this evening."
1284,4,5,44,53,1.2452830188679245,0.08039118969013777,527,"There are no illegal aliens here, I assure you."
1284,1,11,41,53,1.2452830188679245,0.06546506828066133,527,"Welcome aboard, Crop Circling 101 starts in ten minutes."
1284,5,3,45,53,1.2452830188679245,0.08478462587480352,527,"Hello, would you like to take a moment to talk about Glyxkliop Christ, our Lord and Savior?"
1284,3,7,43,53,1.2452830188679245,0.07574334277585738,527,"Hello sir, I'll be doing your crop circle today."
1284,1,11,41,53,1.2452830188679245,0.06546506828066133,527,Have I got a crop circle for you!
1284,1,11,41,53,1.2452830188679245,0.06546506828066133,527,We're off! The crop circles went quicker than expected.
1284,3,7,43,53,1.2452830188679245,0.07574334277585738,527,"Come in, come in. I was just saying to the missus that we should get out and eat the ... meet the neighbours."
1284,3,7,43,53,1.2452830188679245,0.07574334277585738,527,We've come down to witness the Trump campaign for ourselves
1284,2,9,42,53,1.2452830188679245,0.07079099215243659,527,Is this your first experience with Uber pool?
1284,4,5,44,53,1.2452830188679245,0.08039118969013777,527,You really don't want me to take you to our leader.
1284,2,9,42,53,1.2452830188679245,0.07079099215243659,527,It looks just like the photos on Airbnb!
1284,4,5,44,53,1.2452830188679245,0.08039118969013777,527,Let me shed some light on why your crops are gone.
1284,2,9,42,53,1.2452830188679245,0.07079099215243659,527,I come in peace and do you grow organic?
1284,1,11,41,53,1.2452830188679245,0.06546506828066133,527,Do you folks have a bathroom that we can use?
1284,1,11,41,53,1.2452830188679245,0.06546506828066133,527,"Sorry I'm late, it took me light years to get here!"
1284,3,7,43,53,1.2452830188679245,0.07574334277585738,527,"Thank you for inviting me, and ee-ii-ee-ii-oh to you too"
1284,4,5,44,53,1.2452830188679245,0.08039118969013777,527,"""Yes, we welcome 'Trump refugees'""."
1284,2,9,42,53,1.2452830188679245,0.07079099215243659,527,"Absolutely, welcome aboard! We're getting a lot more volunteers now that Trump clinched the nomination."
1303,2,8,39,49,1.2448979591836735,0.074520075851043,527,Hop in. We know where Dorothy is .
1304,4,5,45,54,1.2407407407407407,0.07901907873711286,527,Do you have a reservation?
1304,1,11,42,54,1.2407407407407407,0.06440169831426679,527,"""We desperately need someone to explain the existentialist symbolism in ""Green Acres""."
1304,3,7,44,54,1.2407407407407407,0.07446611836866017,527,"That's correct, Farmer Smith, I am your Uber driver."
1304,2,9,43,54,1.2407407407407407,0.06961602376844407,527,Thanks for letting my son do doughnuts in your yard.
1304,2,9,43,54,1.2407407407407407,0.06961602376844407,527,"Yes, yes 100% ethanol."
1304,3,7,44,54,1.2407407407407407,0.07446611836866017,527,Are you from the tow company?
1304,2,9,43,54,1.2407407407407407,0.06961602376844407,527,Could you take Donald Trump instead.
1304,3,7,44,54,1.2407407407407407,0.07446611836866017,527,Good news! We're making the solar system great again and need you to pay for a wall.
1304,2,9,43,54,1.2407407407407407,0.06961602376844407,527,Your frequent flyer miles aren't suffcient for this trip.
1304,3,7,44,54,1.2407407407407407,0.07446611836866017,527,"I'm John, your interplanetary realtor."
1304,2,9,43,54,1.2407407407407407,0.06961602376844407,527,Don't let anyone tell you this is just a fly-over state.
1304,3,7,44,54,1.2407407407407407,0.07446611836866017,527,I believe you're seeking a president?
1304,2,9,43,54,1.2407407407407407,0.06961602376844407,527,I'm in but I need to be home before breakfast and NO funny stuff.
1304,2,9,43,54,1.2407407407407407,0.06961602376844407,527,"What? Uh.... Yes, I did just purchase the Johnson place."
1304,2,9,43,54,1.2407407407407407,0.06961602376844407,527,"Farmer, where is your daughter?"
1304,3,7,44,54,1.2407407407407407,0.07446611836866017,527,You're a life-saver. My GPS is acting up again.
1304,1,11,42,54,1.2407407407407407,0.06440169831426679,527,"It's a deal, then---seven quarts of milk every Friday"
1304,4,5,45,54,1.2407407407407407,0.07901907873711286,527,This is the first time we've tried a Farm to Spaceship meal.
1304,3,7,44,54,1.2407407407407407,0.07446611836866017,527,We sent out rescue ships as soon as Trump won the election
1304,2,9,43,54,1.2407407407407407,0.06961602376844407,527,Welcome aboard. Your immigration application has been approved.
1304,1,11,42,54,1.2407407407407407,0.06440169831426679,527,Darth Vader?? Doesn't sound familiar. What does he look like?
1304,3,7,44,54,1.2407407407407407,0.07446611836866017,527,"Reason for leaving earth? ""Trump."" Welcome aboard."
1304,1,11,42,54,1.2407407407407407,0.06440169831426679,527,Do you have any 2%? It's milkshake night.
1304,2,9,43,54,1.2407407407407407,0.06961602376844407,527,"Yes, the farmer and the alien can be friends!"
1304,2,9,43,54,1.2407407407407407,0.06961602376844407,527,Thanks for seeing me on short notice Mr. McDonald--I think this remix is a game changer
1304,4,5,45,54,1.2407407407407407,0.07901907873711286,527,"Hello, I'm running as a Third Party candidate and I'd like your vote."
1304,2,9,43,54,1.2407407407407407,0.06961602376844407,527,We need someone to show us how to grow kale.
1304,3,7,44,54,1.2407407407407407,0.07446611836866017,527,Jes dropped by to say howdie.
1304,3,7,44,54,1.2407407407407407,0.07446611836866017,527,I wanted to visit again before all this 'tightening the borders' nonsense.
1304,2,9,43,54,1.2407407407407407,0.06961602376844407,527,I understand you want your orifices probed?
1304,1,11,42,54,1.2407407407407407,0.06440169831426679,527,We've heard about your daughter.
1304,3,7,44,54,1.2407407407407407,0.07446611836866017,527,We have hipsters too and they all want 'farm-to-table'
1304,3,7,44,54,1.2407407407407407,0.07446611836866017,527,"Hey, you don't look like your FarmersOnly.com picture!"
1304,3,7,44,54,1.2407407407407407,0.07446611836866017,527,This is gonna be one heck of a Rumspringa!
1304,3,7,44,54,1.2407407407407407,0.07446611836866017,527,"Sorry, we don't have wi-fi out here on the farm."
1304,3,7,44,54,1.2407407407407407,0.07446611836866017,527,"Funny, we too are serving mankind!"
1304,5,3,46,54,1.2407407407407407,0.08332362704556721,527,"There's no presidential election up there, right?"
1304,3,7,44,54,1.2407407407407407,0.07446611836866017,527,Thanks for participating in our crop ration program. You have the potential to be a fine hybrid.
1304,3,7,44,54,1.2407407407407407,0.07446611836866017,527,"Thanks, we'll be quick. Just long enough to run into Denver for a few items."
1304,3,7,44,54,1.2407407407407407,0.07446611836866017,527,I loved you in The Day the Earth Stood Still.
1304,4,5,45,54,1.2407407407407407,0.07901907873711286,527,"Hi, I'm your new Monsanto rep."
1304,2,9,43,54,1.2407407407407407,0.06961602376844407,527,Welcome aboard. You're lucky we still have space. We've been awfully popular since Trump locked up the nomination.
1304,3,7,44,54,1.2407407407407407,0.07446611836866017,527,"Sure, if Trump becomes president, you can take him."
1304,3,7,44,54,1.2407407407407407,0.07446611836866017,527,Trump. Hillary. Brexit. I feel your pain. Welcome aboard.
1304,2,9,43,54,1.2407407407407407,0.06961602376844407,527,Take me to Old MacDonald.
1304,2,9,43,54,1.2407407407407407,0.06961602376844407,527,Wife says we're out of sugar.
1304,0,13,41,54,1.2407407407407407,0.05872620136016884,527,You guys have to land in a city sometime. No one believes me when I tell them.
1304,2,9,43,54,1.2407407407407407,0.06961602376844407,527,We sincerely apologize for the sequel.
1304,4,5,45,54,1.2407407407407407,0.07901907873711286,527,"Don't worry, anal probes are now covered under Obamacare."
1304,4,5,45,54,1.2407407407407407,0.07901907873711286,527,These are closer encounters than I had expected.
1304,2,9,43,54,1.2407407407407407,0.06961602376844407,527,Unisex restrooms only?
1355,2,8,40,50,1.24,0.07317856271351829,527,"I""ll have the crop circles completed by the end of the month."
1356,4,5,46,55,1.2363636363636363,0.07769246271931074,527,"I know, Dad, I know what you're gonna say, but it's too late. I've seen Paree."
1356,1,11,43,55,1.2363636363636363,0.06337126117720451,527,I'm so sorry...we didn't realize those cows belonged to you...
1356,3,7,45,55,1.2363636363636363,0.07323058165814891,527,"""I'd invite you in, but the place is a shambles, since the big bang."
1356,3,7,45,55,1.2363636363636363,0.07323058165814891,527,You'll have her back in 5-7 business days.
1356,3,7,45,55,1.2363636363636363,0.07323058165814891,527,"I promise you, if this Donald Trump is elected president, we will come back for you"
1356,3,7,45,55,1.2363636363636363,0.07323058165814891,527,Welcome to Voyage to the End of the Universe. First I'll need to see a picture ID and proof of health care coverage.
1356,2,9,44,55,1.2363636363636363,0.06847859093607389,527,"Come right in. All we want is to serve man, honest."
1356,4,5,46,55,1.2363636363636363,0.07769246271931074,527,Can you spare a few eggs and a cup of milk?
1356,4,5,46,55,1.2363636363636363,0.07769246271931074,527,I unnerstan' y'all do free prostate exams.
1356,3,7,45,55,1.2363636363636363,0.07323058165814891,527,"No, we are just getting started. Did you bring the guacamole?"
1356,3,7,45,55,1.2363636363636363,0.07323058165814891,527,You must be the guys from the crop circle company.
1356,2,9,44,55,1.2363636363636363,0.06847859093607389,527,I'm here to congratulate you on being the one millionth customer of Sonic Burger.
1356,2,9,44,55,1.2363636363636363,0.06847859093607389,527,Would you like to meet my spaced-out daughter?
1356,3,7,45,55,1.2363636363636363,0.07323058165814891,527,"Thanks for coming by. Now, maybe you can tell us what those big circles in the fields mean."
1356,4,5,46,55,1.2363636363636363,0.07769246271931074,527,Hello Sir. Do you have a moment to talk about our Lord Gundesplatt729
1356,3,7,45,55,1.2363636363636363,0.07323058165814891,527,"Remember Earl, what happens in the Andromeda galaxy, stays in the Andromeda galaxy."
1356,1,11,43,55,1.2363636363636363,0.06337126117720451,527,Welcome back. You're now eligible for our frequent probing rewards program.
1356,2,9,44,55,1.2363636363636363,0.06847859093607389,527,"Ok, I'll take you to Cleveland."
1356,3,7,45,55,1.2363636363636363,0.07323058165814891,527,The Missus was wondering if we could borrow a cup of sugar.
1356,2,9,44,55,1.2363636363636363,0.06847859093607389,527,I see you've checked your baggage.
1356,3,7,45,55,1.2363636363636363,0.07323058165814891,527,Do you know Ziggy Stardust?
1356,2,9,44,55,1.2363636363636363,0.06847859093607389,527,"Step right in for your very thorough, free physical examination."
1356,3,7,45,55,1.2363636363636363,0.07323058165814891,527,"If Trump wins, you and the missis can come stay with us."
1356,1,11,43,55,1.2363636363636363,0.06337126117720451,527,"Thank you for coming aboard. We're showing ""Aliens"" on our flight tonight."
1356,4,5,46,55,1.2363636363636363,0.07769246271931074,527,Welcome to America ...... you're going to need to prove you're here legally.
1356,1,11,43,55,1.2363636363636363,0.06337126117720451,527,"Actually, I am a third party candidate."
1356,1,11,43,55,1.2363636363636363,0.06337126117720451,527,I only wish all of our hostile takeovers were this easy.
1356,5,3,47,55,1.2363636363636363,0.08191165629379107,527,The messages we intercepted about your ability to capture moonshine in a bottle aroused our curiosity. We thank you for the samples and will take them to our leaders so their decision making can be as enlightened and clear headed as on earth.
1356,3,7,45,55,1.2363636363636363,0.07323058165814891,527,"Take me to your leader, unless you chose Trump."
1356,2,9,44,55,1.2363636363636363,0.06847859093607389,527,I come in peace—and to replenish my planet's stores of high-fructose corn syrup.
1356,4,5,46,55,1.2363636363636363,0.07769246271931074,527,Welcome aboard! Window or aisle seat?
1356,3,7,45,55,1.2363636363636363,0.07323058165814891,527,"Hello, I'm your new Monsanto rep."
1356,3,7,45,55,1.2363636363636363,0.07323058165814891,527,We heard you need seasonal help.
1356,1,11,43,55,1.2363636363636363,0.06337126117720451,527,"We would be happy to spray your crops, but our fees are astronomical."
1356,1,11,43,55,1.2363636363636363,0.06337126117720451,527,Welcome to Uber Air
1356,3,7,45,55,1.2363636363636363,0.07323058165814891,527,Come in. Come on. Pretty soon you won't be in Kansas anymore.
1356,3,7,45,55,1.2363636363636363,0.07323058165814891,527,William Shatner?
1356,2,9,44,55,1.2363636363636363,0.06847859093607389,527,"Canada was full, eh?"
1356,2,9,44,55,1.2363636363636363,0.06847859093607389,527,"Hope you don't mind, I had to circle the fields before landing."
1356,4,5,46,55,1.2363636363636363,0.07769246271931074,527,Welcome...we've opened our borders
1356,4,5,46,55,1.2363636363636363,0.07769246271931074,527,Welcome to Airbnb. We've been expecting you.
1356,2,9,44,55,1.2363636363636363,0.06847859093607389,527,So there IS life on farms.
1356,2,9,44,55,1.2363636363636363,0.06847859093607389,527,We knew that if we built this you would come.
1356,2,9,44,55,1.2363636363636363,0.06847859093607389,527,"Hi, Eric Stratton, Rush Chairman, Damn glad to meet you."
1356,1,11,43,55,1.2363636363636363,0.06337126117720451,527,Thanks for the offer ... but we're going to keep looking
1356,4,5,46,55,1.2363636363636363,0.07769246271931074,527,"It's nice, I'm just used to more space."
1356,3,7,45,55,1.2363636363636363,0.07323058165814891,527,"Yeah, I'm the crop circle guy."
1356,3,7,45,55,1.2363636363636363,0.07323058165814891,527,We heard that you were outstanding in your field!
1356,4,5,46,55,1.2363636363636363,0.07769246271931074,527,We have heard about your presidential election. Help is here!
1356,6,1,48,55,1.2363636363636363,0.08592392047732014,527,Your dog refused to let us do it but recommended you.
1356,2,9,44,55,1.2363636363636363,0.06847859093607389,527,I'm gonna build a wall around Mexico... and Guatemala... and Ecuador... and Honduras...and Canada. I'm gonna make American small farms so profitable your head will spin!
1356,3,7,45,55,1.2363636363636363,0.07323058165814891,527,Greetings. Can you grow weed?
1356,1,11,43,55,1.2363636363636363,0.06337126117720451,527,Sorry we're late! We honestly never thought that dude would get the nomination.
1356,3,7,45,55,1.2363636363636363,0.07323058165814891,527,I've come a long way for your corn on the cob. I heard it's the best
1356,4,5,46,55,1.2363636363636363,0.07769246271931074,527,I spotted your Mona Lisa crop art and felt compelled to meet you.
1356,2,9,44,55,1.2363636363636363,0.06847859093607389,527,Nice to make your acquaintance. My relatives in Roswell have told me all about you.
1356,3,7,45,55,1.2363636363636363,0.07323058165814891,527,You have package delivered from Amazon
1356,4,5,46,55,1.2363636363636363,0.07769246271931074,527,Just play along. They think I'm one of them.
1356,3,7,45,55,1.2363636363636363,0.07323058165814891,527,"Greetings, Earthling. Have you good Wi-Fi here?"
1356,4,5,46,55,1.2363636363636363,0.07769246271931074,527,I come in peace; can you work a microwave oven?
1356,3,7,45,55,1.2363636363636363,0.07323058165814891,527,Can you fix the tractor beam?
1356,3,7,45,55,1.2363636363636363,0.07323058165814891,527,Looks like things haven't changed much since our last visit to Roswell.
1356,4,5,46,55,1.2363636363636363,0.07769246271931074,527,"Welcome aboard. Make yourself comfortable, I have a few more stops to make."
1356,3,7,45,55,1.2363636363636363,0.07323058165814891,527,You'll be the first illegal alien on our planet.
1356,3,7,45,55,1.2363636363636363,0.07323058165814891,527,"Thank you for coming. We thought instead of talking on the phone, we'd do our probing on board."
1356,3,7,45,55,1.2363636363636363,0.07323058165814891,527,Are you guys from a 'right to work' planet or do I get union scale?
1356,2,9,44,55,1.2363636363636363,0.06847859093607389,527,Sorry about the crop circle thing.
1356,2,9,44,55,1.2363636363636363,0.06847859093607389,527,It's a deal. Two of my sons for consistent wifi.
1356,3,7,45,55,1.2363636363636363,0.07323058165814891,527,"Welcome, we've been looking forward to having you over for lunch."
1356,1,11,43,55,1.2363636363636363,0.06337126117720451,527,Yea so from now on just write off each cow as charitable contribution deductions on your income tax...
1356,4,5,46,55,1.2363636363636363,0.07769246271931074,527,Please take me away. There is no one to vote for here.
1356,1,11,43,55,1.2363636363636363,0.06337126117720451,527,You're going to have to gate check the hat.
1356,2,9,44,55,1.2363636363636363,0.06847859093607389,527,"Sorry again about the crop circles. Teenagers, you know?"
1356,3,7,45,55,1.2363636363636363,0.07323058165814891,527,I hope I can count on your vote in the 2020 election.
1356,2,9,44,55,1.2363636363636363,0.06847859093607389,527,"Welcome aboard, high-protein meal--I mean, respected human."
1356,2,9,44,55,1.2363636363636363,0.06847859093607389,527,I am from Sirius. And don't call me Shirley.
1356,3,7,45,55,1.2363636363636363,0.07323058165814891,527,Monsanto thanks you for your business!
1356,1,11,43,55,1.2363636363636363,0.06337126117720451,527,"We're hardly more advanced, this is our first farm to table."
1356,2,9,44,55,1.2363636363636363,0.06847859093607389,527,I remember your father.
1356,4,5,46,55,1.2363636363636363,0.07769246271931074,527,I'm your Uber.
1356,4,5,46,55,1.2363636363636363,0.07769246271931074,527,"...Ten! Hey Gort, we have a minyan!"
1356,4,5,46,55,1.2363636363636363,0.07769246271931074,527,"... I'll be covering for your proctologist until he's back from Quayzon 5, I mean, the medical conference."
1356,3,7,45,55,1.2363636363636363,0.07323058165814891,527,It was in the FinePrint. They sold us your mortgage.
1356,3,7,45,55,1.2363636363636363,0.07323058165814891,527,"First of all, you should know that we support ethanol."
1356,1,11,43,55,1.2363636363636363,0.06337126117720451,527,Quick - Where's the nearest unisex rest room?
1441,0,12,39,51,1.2352941176470589,0.05998846486579745,527,"Where I come from, we kiss now."
1441,3,6,42,51,1.2352941176470589,0.07714633558002353,527,"Do what you want, just get me away from Hillary and Trump..."
1441,1,10,40,51,1.2352941176470589,0.06620369810248677,527,Your Almanac is the only thing we can't figure out down here.
1441,2,8,41,51,1.2352941176470589,0.07188354031303278,527,Greetings from Enterprise Space Ship Rental. We pick you up.
1441,3,6,42,51,1.2352941176470589,0.07714633558002353,527,I'm only doing this because Earth is a swing state.
1441,1,10,40,51,1.2352941176470589,0.06620369810248677,527,Welcome. We have WiFi and espresso.
1441,1,10,40,51,1.2352941176470589,0.06620369810248677,527,I just wanted to ask if your lights went out too?
1441,2,8,41,51,1.2352941176470589,0.07188354031303278,527,We're from the future. Please stop growing GMOs.
1441,3,6,42,51,1.2352941176470589,0.07714633558002353,527,We have come for the shoo-fly pie.
1450,3,5,39,47,1.2340425531914894,0.0816842024739688,527,My name is Marvin and I'm here to pick up your daughter.
1451,3,7,46,56,1.2321428571428572,0.0720347653647201,527,There's been a change in plan. We're leaving you here until we figure out what the hell is going on.
1451,1,11,44,56,1.2321428571428572,0.062372318559189226,527,What's your sign?
1451,3,7,46,56,1.2321428571428572,0.0720347653647201,527,"You aren't writing a cookbook, are you?"
1451,1,11,44,56,1.2321428571428572,0.062372318559189226,527,"And to answer your question 'Klaatu barata nikto': Yes, it does itch inside this suit."
1451,0,13,43,56,1.2321428571428572,0.05692939024000109,527,Welcome. That will be $25 extra for each bag.
1451,2,9,45,56,1.2321428571428572,0.06737697508644648,527,"We heard it's the craziest year yet, so we came."
1451,1,11,44,56,1.2321428571428572,0.062372318559189226,527,"Say, do you know the Skinner family over in Windy Hill? I think I abducted them last year."
1451,4,5,47,56,1.2321428571428572,0.07640914912823549,527,"Hello, I'm Org and I am here to talk to you about reverse mortgages."
1451,3,7,46,56,1.2321428571428572,0.0720347653647201,527,Strawberries aren't ripe for another week? But I went a parsec out of my way!
1451,3,7,46,56,1.2321428571428572,0.0720347653647201,527,We bring you good news. The probes are covered by Obamacare!
1451,4,5,47,56,1.2321428571428572,0.07640914912823549,527,Hello. I'd like to add you to my professional network.
1451,2,9,45,56,1.2321428571428572,0.06737697508644648,527,"We come in peace, and I hope you know something about warp drive."
1463,4,4,44,52,1.2307692307692308,0.08060566646085904,527,Welcome to America where YOU can be President too.
1463,5,2,45,52,1.2307692307692308,0.08515527745577839,527,Help me. They're going to close the Canadian border.
1463,2,8,42,52,1.2307692307692308,0.07063269667552394,527,You’re not the first. This has been happening ever since they announced the presumptive republican nominee.
1463,2,8,42,52,1.2307692307692308,0.07063269667552394,527,Wow! I didn't think you farmers really existed.
1463,4,4,44,52,1.2307692307692308,0.08060566646085904,527,"Around these here parts, I am the leader."
1463,1,10,41,52,1.2307692307692308,0.06507557165853581,527,"We come in peas. It's bean a long trip, so lettuce rest or we squash you."
1463,3,6,43,52,1.2307692307692308,0.0757834127802906,527,Friends of Dorothy are always welcome aboard!
1463,4,4,44,52,1.2307692307692308,0.08060566646085904,527,"Mr. MacDonald, E-I-E-I-O."
1463,1,10,41,52,1.2307692307692308,0.06507557165853581,527,"No, trust me, you don't want to meet our leader."
1463,3,6,43,52,1.2307692307692308,0.0757834127802906,527,Jprpt! Uyn rcdolz! Bnh vadftg?
1463,3,6,43,52,1.2307692307692308,0.0757834127802906,527,Do you promise to respect our 2nd amendment?
1463,2,8,42,52,1.2307692307692308,0.07063269667552394,527,""" Jeez you're ugly""."
1463,2,8,42,52,1.2307692307692308,0.07063269667552394,527,"Trust me, genetically-modified crops are totally safe."
1463,1,10,41,52,1.2307692307692308,0.06507557165853581,527,"Thank you earth man, you and your cows will be spared."
1463,2,8,42,52,1.2307692307692308,0.07063269667552394,527,"Finally, we two out dated archetypes meet."
1463,2,8,42,52,1.2307692307692308,0.07063269667552394,527,"So, can I count on you in November?"
1463,1,10,41,52,1.2307692307692308,0.06507557165853581,527,Amazon hired us instead of the drone.
1463,1,10,41,52,1.2307692307692308,0.06507557165853581,527,Welcome to the new Farmers' Market!
1463,2,8,42,52,1.2307692307692308,0.07063269667552394,527,We heard your corn was gluten-free.
1463,2,8,42,52,1.2307692307692308,0.07063269667552394,527,I'm the leader of the Libertarians and I'd like your vote this November
1463,2,8,42,52,1.2307692307692308,0.07063269667552394,527,I hope you haven't left the oven on.
1463,4,4,44,52,1.2307692307692308,0.08060566646085904,527,"Are you one of the ""illegal aliens"" that Trump's been talking about?"
1463,1,10,41,52,1.2307692307692308,0.06507557165853581,527,"C'mon, let's get you lubed up."""
1463,2,8,42,52,1.2307692307692308,0.07063269667552394,527,Let's make this quick; I'm illegally parked.
1463,2,8,42,52,1.2307692307692308,0.07063269667552394,527,I saw your farmhand posting for $10 an hour plus mileage.
1463,3,6,43,52,1.2307692307692308,0.0757834127802906,527,"Don't worry, we use Astro Glide now."
1463,1,10,41,52,1.2307692307692308,0.06507557165853581,527,"Consider this a transplantation, not an abduction."
1463,3,6,43,52,1.2307692307692308,0.0757834127802906,527,We can offer you fewer taxes and more space.
1463,1,10,41,52,1.2307692307692308,0.06507557165853581,527,Shaking hands is having sex in my world but don't worry i'm wearing gloves!
1463,3,6,43,52,1.2307692307692308,0.0757834127802906,527,Our tractor beam isn't working.
1463,4,4,44,52,1.2307692307692308,0.08060566646085904,527,Take me to your rutabaga.
1463,1,10,41,52,1.2307692307692308,0.06507557165853581,527,"Greetings, Earthling - could I use your restroom?"
1463,2,8,42,52,1.2307692307692308,0.07063269667552394,527,Thanks for the sugar neighbor!
1463,2,8,42,52,1.2307692307692308,0.07063269667552394,527,Congratulations. You've been selected to have your crop fields decorated with interesting designs.
1463,5,2,45,52,1.2307692307692308,0.08515527745577839,527,Who's supposed to be talking here?
1463,3,6,43,52,1.2307692307692308,0.0757834127802906,527,"Don't be surprised, Uber is running low on drivers."
1463,3,6,43,52,1.2307692307692308,0.0757834127802906,527,"Well shoot, mister, given the alternatives you've got my vote"
1463,2,8,42,52,1.2307692307692308,0.07063269667552394,527,Congratulations. You have been chosen for crop circles.
1463,2,8,42,52,1.2307692307692308,0.07063269667552394,527,Come on in - just leave your shoes at the door.
1463,1,10,41,52,1.2307692307692308,0.06507557165853581,527,Can I borrow your charger? My cell phone's dead.
1463,1,10,41,52,1.2307692307692308,0.06507557165853581,527,"NANU, NANU! Welcome to the round thing in the sky!"
1463,3,6,43,52,1.2307692307692308,0.0757834127802906,527,I come from planet E-I-E-I-O.
1463,2,8,42,52,1.2307692307692308,0.07063269667552394,527,We no longer want you to take us to your leader.
1463,2,8,42,52,1.2307692307692308,0.07063269667552394,527,Sorry to drop in like this but I wanted to get here before Trump puts up the big fence.
1463,3,6,43,52,1.2307692307692308,0.0757834127802906,527,"No, really! WE are going to serve FOOD to YOU!"
1463,2,8,42,52,1.2307692307692308,0.07063269667552394,527,We've heard you're hiring migrant workers?
1463,1,10,41,52,1.2307692307692308,0.06507557165853581,527,Look everyone...a farmer. They still exist.
1510,2,9,46,57,1.2280701754385965,0.06630955666828549,527,We saw the light on
1510,2,9,46,57,1.2280701754385965,0.06630955666828549,527,"I normally ask to see your leader, but I understand he's fixing his hair..."
1510,3,7,47,57,1.2280701754385965,0.07087682076380587,527,We have some great deals on crop circles
1510,1,11,45,57,1.2280701754385965,0.06140350877192983,527,"I would've been here sooner, but that's the TSA for you."
1514,2,8,43,53,1.2264150943396226,0.06942386498172073,527,Thanks for letting me stop by your farm. I love local produce grown in my own galaxy.
1514,1,10,42,53,1.2264150943396226,0.06398424512382328,527,Do you have a copy of ' To Serve Man' ?
1514,1,10,42,53,1.2264150943396226,0.06398424512382328,527,"Howdy pardner, to you too. Are you ""corn""?"
1514,1,10,42,53,1.2264150943396226,0.06398424512382328,527,"On Mars, it's the men who ask directions."
1514,3,6,44,53,1.2264150943396226,0.07446719031852134,527,We too are Amish.
1514,2,8,43,53,1.2264150943396226,0.06942386498172073,527,"Actually, I'm from Mexico."
1514,3,6,44,53,1.2264150943396226,0.07446719031852134,527,Whew! For a minute there I thought I'd bought the farm.
1514,3,6,44,53,1.2264150943396226,0.07446719031852134,527,Let's make America great again!
1514,2,8,43,53,1.2264150943396226,0.06942386498172073,527,"My name is Gort, and I'll be your prober this evening."
1514,4,4,45,53,1.2264150943396226,0.07918997309552243,527,"Sorry, only one anal probe to a customer."
1514,2,8,43,53,1.2264150943396226,0.06942386498172073,527,"As a third part candidate, I'm hoping that I can count on your vote"
1514,5,2,46,53,1.2264150943396226,0.08364652559314256,527,Take me to your leader's SuperPAC executive director.
1514,2,8,43,53,1.2264150943396226,0.06942386498172073,527,Did you hear the one about the farmer's daughter and the alien?
1514,2,8,43,53,1.2264150943396226,0.06942386498172073,527,We've come in peace to learn how to make crop circles.
1514,2,8,43,53,1.2264150943396226,0.06942386498172073,527,You look better in person than on Spacebook.
1514,2,8,43,53,1.2264150943396226,0.06942386498172073,527,"After the election we thought you might need a new home, so we came to say hello."
1514,0,12,41,53,1.2264150943396226,0.058037007324041226,527,"Since this is your first test drive, I'll be riding with you."
1514,3,6,44,53,1.2264150943396226,0.07446719031852134,527,The crop circles are wonderful but can you creàte a happy anniversary design for my wife?
1514,4,4,45,53,1.2264150943396226,0.07918997309552243,527,"On behalf of Mansanto, I want to thank you for not choosing organic."
1514,2,8,43,53,1.2264150943396226,0.06942386498172073,527,"It's a deal. You can design my crops, but you take Trump back with you."
1514,2,8,43,53,1.2264150943396226,0.06942386498172073,527,You are from Kansas?
1514,3,6,44,53,1.2264150943396226,0.07446719031852134,527,That's your economic anxiety talking.
1514,0,12,41,53,1.2264150943396226,0.058037007324041226,527,Long distance relationships never work.
1514,2,8,43,53,1.2264150943396226,0.06942386498172073,527,"Mr. Spielberg, I presume?"
1514,3,6,44,53,1.2264150943396226,0.07446719031852134,527,"Thanks again, those crop circles really do make it easier to land!"
1514,1,10,42,53,1.2264150943396226,0.06398424512382328,527,I'm sorry to bother you but all the galactic stores are closed at this hour and my wife is going to kill me if I don't come back with eggs and milk.
1514,3,6,44,53,1.2264150943396226,0.07446719031852134,527,"Alright already...Klaatu Barada yadda yadda yadda."""
1514,3,6,44,53,1.2264150943396226,0.07446719031852134,527,Take me to your cow.
1514,1,10,42,53,1.2264150943396226,0.06398424512382328,527,They said your tomatoes are out of this world!
1514,1,10,42,53,1.2264150943396226,0.06398424512382328,527,Take us to your presumptive candidate.
1514,3,6,44,53,1.2264150943396226,0.07446719031852134,527,We heard you're the expert on genetically modified organisms.
1514,2,8,43,53,1.2264150943396226,0.06942386498172073,527,Congratulations! You got yourself a saucer!
1514,3,6,44,53,1.2264150943396226,0.07446719031852134,527,Those crop circles are amazing! How you do it?
1514,2,8,43,53,1.2264150943396226,0.06942386498172073,527,"Greetings, neighbor, you may have seen our ship hovering above you for the last 50 years"
1514,3,6,44,53,1.2264150943396226,0.07446719031852134,527,"Ever since Brexit, we've had to start trading with people from all over."
1514,2,8,43,53,1.2264150943396226,0.06942386498172073,527,Now I know how wrong it was to label this a “fly-over” planet.
1514,3,6,44,53,1.2264150943396226,0.07446719031852134,527,"Look, here's the thing. Donald Trump needs your vote."
1514,3,6,44,53,1.2264150943396226,0.07446719031852134,527,Our sensors detected an unprecedented clamoring for a third-party candidate. So here I am!
1514,3,6,44,53,1.2264150943396226,0.07446719031852134,527,"Oh, the farmer and the spaceman should be friends."
1514,4,4,45,53,1.2264150943396226,0.07918997309552243,527,I hope you're an organic farmer because we're trying to eat healthier.
1514,1,10,42,53,1.2264150943396226,0.06398424512382328,527,"Yes, we are from Vega, but we eat meat."
1514,3,6,44,53,1.2264150943396226,0.07446719031852134,527,Thanks again for checking out those polyps.
1514,4,4,45,53,1.2264150943396226,0.07918997309552243,527,"We've come to build the wall, our bid was lower than the Mexicans."
1514,1,10,42,53,1.2264150943396226,0.06398424512382328,527,You don't look anything like your profile picture on Farmers.com.
1514,0,12,41,53,1.2264150943396226,0.058037007324041226,527,Dorothy's been waiting.
1514,3,6,44,53,1.2264150943396226,0.07446719031852134,527,We need your advice about parsnips.
1514,3,6,44,53,1.2264150943396226,0.07446719031852134,527,Have you got any seeds that haven't been genetically modified?
1514,2,8,43,53,1.2264150943396226,0.06942386498172073,527,"Together we can ""serve mankind""...."
1514,2,8,43,53,1.2264150943396226,0.06942386498172073,527,The cows told us to give you special treatment
1514,0,12,41,53,1.2264150943396226,0.058037007324041226,527,"Yes, Joe, it's me. I'm back and this time, I'm speaking English."
1514,0,12,41,53,1.2264150943396226,0.058037007324041226,527,"Well, you're not old, Mr. McDonald, but you'll do."
1514,4,4,45,53,1.2264150943396226,0.07918997309552243,527,"Truth be told, the probes are just goofy fun. We use an MRI for the science stuff."
1514,4,4,45,53,1.2264150943396226,0.07918997309552243,527,Oops I think your overalls are on backwards !
1514,2,8,43,53,1.2264150943396226,0.06942386498172073,527,Did you really think you could build a wall to keep us out?
1514,2,8,43,53,1.2264150943396226,0.06942386498172073,527,"Dr. Livingstone, I presume."
1514,2,8,43,53,1.2264150943396226,0.06942386498172073,527,We're looking for support for an interplanetary immigration reform bill
1514,3,6,44,53,1.2264150943396226,0.07446719031852134,527,Deal. 1 planet for a handful of magic beans.
1514,5,2,46,53,1.2264150943396226,0.08364652559314256,527,"This won't take long, we just need you to explain that chicken crossing the road joke."
1514,2,8,43,53,1.2264150943396226,0.06942386498172073,527,So you'll come and pick me up after the election?
1514,2,8,43,53,1.2264150943396226,0.06942386498172073,527,You can spend the night but your gonna have to sleep with my ectoplasm.
1514,3,6,44,53,1.2264150943396226,0.07446719031852134,527,Thanks again for letting us crash at your place.
1514,3,6,44,53,1.2264150943396226,0.07446719031852134,527,"Before we get going, understand that I am not a salaried employee but an independent contractor and thus can accept tips."
1514,1,10,42,53,1.2264150943396226,0.06398424512382328,527,We're out of fuel. Do you have any cow manure?
1514,2,8,43,53,1.2264150943396226,0.06942386498172073,527,"The Farmer in the Dell, I presume?"
1514,3,6,44,53,1.2264150943396226,0.07446719031852134,527,"Under Obamacare, your colonoscopy is now free."
1514,2,8,43,53,1.2264150943396226,0.06942386498172073,527,Great news. I've been authorized to move you to the first-class probe section.
1514,3,6,44,53,1.2264150943396226,0.07446719031852134,527,"I know they said they built a wall, but trust me, they didn't build it high enough."
1514,3,6,44,53,1.2264150943396226,0.07446719031852134,527,We came as soon as we saw your presidential nominees. How many of you are coming?
1514,3,6,44,53,1.2264150943396226,0.07446719031852134,527,"Thanks for stopping by Trump supporter, but we don't need further evidence of lack of intelligent life forms on earth."
1514,3,6,44,53,1.2264150943396226,0.07446719031852134,527,"Hi, I'm Zendar, and Donald Trump tells me I can count on your support in my run for the House seat in the 3rd Congressional District...."
1514,3,6,44,53,1.2264150943396226,0.07446719031852134,527,I had to land to tell you your crop circles are out of this world!
1514,2,8,43,53,1.2264150943396226,0.06942386498172073,527,I don't want to be in Kansas anymore.
1514,3,6,44,53,1.2264150943396226,0.07446719031852134,527,"Sure stranger, you're welcome to spend the night. But, I have to tell you, I don't have any daughters."
1514,4,4,45,53,1.2264150943396226,0.07918997309552243,527,Thank you for agreeing to launch our first farm to table restaurant
1588,3,6,45,54,1.2222222222222223,0.0731953469605706,527,"You all come back now, you hear?"
1588,3,6,45,54,1.2222222222222223,0.0731953469605706,527,"Don't call us, we'll call you."
1588,3,6,45,54,1.2222222222222223,0.0731953469605706,527,How long have you been on Match.com?
1588,2,8,44,54,1.2222222222222223,0.06825501298155012,527,"No, I don't have a daughter."
1588,1,10,43,54,1.2222222222222223,0.06292801266165045,527,What are you getting for ethanol these days?
1588,3,6,45,54,1.2222222222222223,0.0731953469605706,527,Sorry about the crop circles.
1588,1,10,43,54,1.2222222222222223,0.06292801266165045,527,"You wouldn't happen to have a 3/4 open-ended box wrench, would you?"
1588,2,8,44,54,1.2222222222222223,0.06825501298155012,527,How did you get past the Trump Wall?
1588,4,4,46,54,1.2222222222222223,0.0778226884413861,527,Hay!
1588,2,8,44,54,1.2222222222222223,0.06825501298155012,527,01100001010000101110000011100000
1588,2,8,44,54,1.2222222222222223,0.06825501298155012,527,Come on in. I just put on a fresh pot of coffee.
1588,2,8,44,54,1.2222222222222223,0.06825501298155012,527,Don't be alarmed. I'm a proctologist.
1588,4,4,46,54,1.2222222222222223,0.0778226884413861,527,Now they'll believe me that there really is a family farm.
1588,1,10,43,54,1.2222222222222223,0.06292801266165045,527,Wife got the munchies for farm fresh earthling. What do you recommend?
1588,1,10,43,54,1.2222222222222223,0.06292801266165045,527,"Yep. A right at County 12, another right a 249, then straight on 'til you get to the Pleiades, and it's on your left. You can't miss it."
1588,1,10,43,54,1.2222222222222223,0.06292801266165045,527,"On behalf of all of all of us at Amazon, thank you for signing up for same light year delivery."
1588,5,2,47,54,1.2222222222222223,0.08218991942940318,527,Ted's reoccurring nightmare involved meeting his soon-to-be son in law's family from New York
1605,2,7,41,50,1.22,0.07165677830848258,527,It's no worse than a colonoscopy - except it isn't covered by insurance.
1605,3,5,42,50,1.22,0.07714285714285714,527,"Would you like the chicken, or the pasta salad?"
1605,2,7,41,50,1.22,0.07165677830848258,527,Come on in! Sorry about the mess; my wife is redecorating.
1605,3,5,42,50,1.22,0.07714285714285714,527,We're only buying organic now...
1605,1,9,40,50,1.22,0.06571428571428571,527,I think my gluten-free crop circles will be a big hit this year.
1605,3,5,42,50,1.22,0.07714285714285714,527,"Greetings, and before you ask, no, you can't come back if he loses in November."
1605,3,5,42,50,1.22,0.07714285714285714,527,Just know that saying 'Take me to your leader' can cause a fight around these parts.
1605,2,7,41,50,1.22,0.07165677830848258,527,"This *is* Zexas, right?"
1605,3,5,42,50,1.22,0.07714285714285714,527,There's no place like home.
1605,3,5,42,50,1.22,0.07714285714285714,527,"I'm sorry, but I don't have a daughter"
1605,1,9,40,50,1.22,0.06571428571428571,527,"Okay, we'll come back and pick you up if Trump wins."
1605,2,7,41,50,1.22,0.07165677830848258,527,You look taller in your profile picture.
1605,3,5,42,50,1.22,0.07714285714285714,527,Just tell me it's not campaign season on your planet.
1618,3,6,46,55,1.2181818181818183,0.0719657096184116,527,Tell me of your Eric Clapton.
1618,3,6,46,55,1.2181818181818183,0.0719657096184116,527,Your wife was right. Your GMO tomatoes really did take off.
1618,3,6,46,55,1.2181818181818183,0.0719657096184116,527,UFO is the new GMO
1621,1,9,41,51,1.2156862745098038,0.0645571671888405,527,You're a bit outlandish for us. We're more landish here. But welcome.
1621,2,7,42,51,1.2156862745098038,0.07037003311735827,527,Welcome to our annual solstice dinner!
1621,1,9,41,51,1.2156862745098038,0.0645571671888405,527,We heard Trump was running for King of the Universe.
1621,1,9,41,51,1.2156862745098038,0.0645571671888405,527,I'm from the ethanol lobby. What kind of fuel do you guys burn?
1621,1,9,41,51,1.2156862745098038,0.0645571671888405,527,What's up with that huge wall we just flew over?
1621,4,3,44,51,1.2156862745098038,0.08075004032146667,527,"Come on in, we're going to make America great again!"
1621,3,5,43,51,1.2156862745098038,0.07573807025814888,527,Our planet greatly prefers food that is not locally grown.
1621,2,7,42,51,1.2156862745098038,0.07037003311735827,527,Are you my Uber?
1621,4,3,44,51,1.2156862745098038,0.08075004032146667,527,"Are you, by any chance, the guy who's killing my cows?"
1621,2,7,42,51,1.2156862745098038,0.07037003311735827,527,Did you really think wind power was the new green?
1621,2,7,42,51,1.2156862745098038,0.07037003311735827,527,Congratulations! You've won a one-way trip to Mars.
1621,1,9,41,51,1.2156862745098038,0.0645571671888405,527,We'd like to arrange a meeting with the leader of your cows.
1621,1,9,41,51,1.2156862745098038,0.0645571671888405,527,"This is Area 51, isn't it?"
1621,1,9,41,51,1.2156862745098038,0.0645571671888405,527,Hi Im from the Welcome Wagon .
1621,4,3,44,51,1.2156862745098038,0.08075004032146667,527,Please take me with you! I can't face a Clinton or Trump future!
1621,2,7,42,51,1.2156862745098038,0.07037003311735827,527,"So, you're certified organic, non GMO and gluten-free, right?"
1621,1,9,41,51,1.2156862745098038,0.0645571671888405,527,You must be scheduled for the 2 AM probing.
1621,3,5,43,51,1.2156862745098038,0.07573807025814888,527,We mean you no harm. All we want is you kale.
1621,3,5,43,51,1.2156862745098038,0.07573807025814888,527,We're here about the crop circles.
1621,2,7,42,51,1.2156862745098038,0.07037003311735827,527,The key to success is a firm handshake.
1621,2,7,42,51,1.2156862745098038,0.07037003311735827,527,Only an alien would agree to be Trump's vice president.
1621,2,7,42,51,1.2156862745098038,0.07037003311735827,527,Come on in. Your new GMOs are ready.
1621,4,3,44,51,1.2156862745098038,0.08075004032146667,527,"It's me, Papa-- home from rumspringa"
1621,0,11,40,51,1.2156862745098038,0.058166262643887544,527,Is this your first time flying?
1621,2,7,42,51,1.2156862745098038,0.07037003311735827,527,"Uh, sorry. I don't know who my leader is."
1621,1,9,41,51,1.2156862745098038,0.0645571671888405,527,We need your help....our corn flakes keep coming out circular.
1621,0,11,40,51,1.2156862745098038,0.058166262643887544,527,"We saw your message in the manure. Clever use of ""crap"" circles!"
1621,4,3,44,51,1.2156862745098038,0.08075004032146667,527,"Yes, of course, we can drop you off in Paris this time."
1621,0,11,40,51,1.2156862745098038,0.058166262643887544,527,"You built it, so we came."
1621,2,7,42,51,1.2156862745098038,0.07037003311735827,527,"Am I the new crop duster? Uh, sure."
1621,2,7,42,51,1.2156862745098038,0.07037003311735827,527,"I'm sorry to bother you, but do you have room for one more?"
1621,2,7,42,51,1.2156862745098038,0.07037003311735827,527,"Thank goodness you got here in time! Her contractions are about four minutes apart, but she's more dilated between one set of legs than any of the others!"
1621,1,9,41,51,1.2156862745098038,0.0645571671888405,527,"It's been a pleasure discussing crop circle designs, Mr. Johnson."
1621,2,7,42,51,1.2156862745098038,0.07037003311735827,527,"I beg you, do NOT take me to your leader!"
1621,0,11,40,51,1.2156862745098038,0.058166262643887544,527,Hope you don't mind but I made a map in your cornfield so the others could find me.
1621,2,7,42,51,1.2156862745098038,0.07037003311735827,527,"Evening, sir! Name's Blork, of Xynth, Zeeb, and Glarb, and I'd like to take a moment to talk with you today about your universal health care!"
1621,3,5,43,51,1.2156862745098038,0.07573807025814888,527,"For the hundredth time, ""How To Serve Man"" is not a cookbook!"
1621,2,7,42,51,1.2156862745098038,0.07037003311735827,527,"yes, all meals in Star Class are gluten free"
1621,2,7,42,51,1.2156862745098038,0.07037003311735827,527,I'll take all the GMO corn you have
1621,3,5,43,51,1.2156862745098038,0.07573807025814888,527,"I hate to ask, but I'm gonna need gas money."
1621,1,9,41,51,1.2156862745098038,0.0645571671888405,527,I seek one of your species - Auntie Em.
1621,3,5,43,51,1.2156862745098038,0.07573807025814888,527,Welcome to the newly funded genetically modified organism project.
1621,2,7,42,51,1.2156862745098038,0.07037003311735827,527,The Johnsons? They live next door.
1664,2,7,43,52,1.2115384615384615,0.06912804512336526,527,We heard your prayer to take Mr Trump off your planet.
1664,1,9,42,52,1.2115384615384615,0.0634392529086423,527,I was wondering if you had that Rolling Stones album on CD.
1664,1,9,42,52,1.2115384615384615,0.0634392529086423,527,We heard your heirloom tomatoes were out of this world.
1664,3,5,44,52,1.2115384615384615,0.07438302518417335,527,What's Uber?
1664,5,1,46,52,1.2115384615384615,0.08391144177936673,527,"I would welcome you aboard , but your daughter called shotgun"
1664,3,5,44,52,1.2115384615384615,0.07438302518417335,527,Six million space miles. What's in your wallet?
1664,2,7,43,52,1.2115384615384615,0.06912804512336526,527,Welcome to Planetary Uber. Where are you headed today? Speak up man. And stop looking at me like that.
1664,3,5,44,52,1.2115384615384615,0.07438302518417335,527,"Before we go, can I count on you for a high rating?"
1664,3,5,44,52,1.2115384615384615,0.07438302518417335,527,Uber8 goes to all of the universe's fringe locations except Austin.
1664,3,5,44,52,1.2115384615384615,0.07438302518417335,527,You messed up my last seed order - once more and I go organic.
1664,3,5,44,52,1.2115384615384615,0.07438302518417335,527,Nobody knows Earth better than me!
1664,2,7,43,52,1.2115384615384615,0.06912804512336526,527,"You did say, ""Take me to your weeder""?"
1664,1,9,42,52,1.2115384615384615,0.0634392529086423,527,Bill's acid trip just took on a whole new meaning.
1664,2,7,43,52,1.2115384615384615,0.06912804512336526,527,I always love visiting Pennsylvania Dutch country.
1664,1,9,42,52,1.2115384615384615,0.0634392529086423,527,"There ain't no Dorothy or Toto here. This is Iowa, not Kansas."
1664,2,7,43,52,1.2115384615384615,0.06912804512336526,527,"Come on in, Ma's just making coffee!"
1664,2,7,43,52,1.2115384615384615,0.06912804512336526,527,Thank you for riding with Uber this evening
1664,1,9,42,52,1.2115384615384615,0.0634392529086423,527,Sorry about those crop circles in your alfalfa. Kids these days!
1664,2,7,43,52,1.2115384615384615,0.06912804512336526,527,Welcome. You just bought the farm.
1664,1,9,42,52,1.2115384615384615,0.0634392529086423,527,"Got it. All that probing. Not cool. Hey, we're learning as we abduct, right?"
1664,2,7,43,52,1.2115384615384615,0.06912804512336526,527,All our seats are Even More Space.
1664,1,9,42,52,1.2115384615384615,0.0634392529086423,527,"After I meet your leaders, can you direct me to the earthlings with the best taste?"
1664,2,7,43,52,1.2115384615384615,0.06912804512336526,527,Thank you for using our app LyftOff: Please rate and comment.
1664,2,7,43,52,1.2115384615384615,0.06912804512336526,527,Come inside for a delicious farmer-to-table meal.
1664,1,9,42,52,1.2115384615384615,0.0634392529086423,527,Welcome aboard! We're dying to know how you make those crop circles!
1664,1,9,42,52,1.2115384615384615,0.0634392529086423,527,I'm a firm supporter of ethanol
1664,2,7,43,52,1.2115384615384615,0.06912804512336526,527,How much do I owe you for the crop circle?
1664,3,5,44,52,1.2115384615384615,0.07438302518417335,527,"Welcome aboard, we're very excited about our new farm to table menu."
1664,4,3,45,52,1.2115384615384615,0.07929049280033962,527,Your green thumb is all that's needed for admittance.
1664,2,7,43,52,1.2115384615384615,0.06912804512336526,527,"Look, I know I asked you to take me to your leader. But that Trump guy scares the bejeezus out of me, so if it's all the same to you, goodbye and good luck."
1664,2,7,43,52,1.2115384615384615,0.06912804512336526,527,You mean this whole thing runs on just corn cobs?
1664,1,9,42,52,1.2115384615384615,0.0634392529086423,527,I'm from the government and I'm here to help you.
1664,2,7,43,52,1.2115384615384615,0.06912804512336526,527,"No, I just look Republican."
1664,2,7,43,52,1.2115384615384615,0.06912804512336526,527,We came as soon as we heard the election results.
1664,1,9,42,52,1.2115384615384615,0.0634392529086423,527,Congratulations! You're not in Kansas any more.
1664,1,9,42,52,1.2115384615384615,0.0634392529086423,527,You from New York?
1664,2,7,43,52,1.2115384615384615,0.06912804512336526,527,I hope you brought some lube. We're fresh out.
1664,4,3,45,52,1.2115384615384615,0.07929049280033962,527,We invited you to teach us Organic
1664,3,5,44,52,1.2115384615384615,0.07438302518417335,527,Howdy Neighhhhhh.......WHOA!
1664,4,3,45,52,1.2115384615384615,0.07929049280033962,527,I guess I better go with you now before it gets any hotter here...
1664,2,7,43,52,1.2115384615384615,0.06912804512336526,527,"Hey, did you ever hear the one about the alien and the farmer?"
1664,3,5,44,52,1.2115384615384615,0.07438302518417335,527,"You've never seen ""To Serve Man,"" have you?"
1664,1,9,42,52,1.2115384615384615,0.0634392529086423,527,Your crops are out of this world!
1664,3,5,44,52,1.2115384615384615,0.07438302518417335,527,Howdy! We're looking for farmhands. Are you here legally?
1664,1,9,42,52,1.2115384615384615,0.0634392529086423,527,We tried GMO! Thank God you're Organic.
1664,4,3,45,52,1.2115384615384615,0.07929049280033962,527,Welcome. No need to worry about Trump anymore
1664,3,5,44,52,1.2115384615384615,0.07438302518417335,527,I'm you from the future. Keep growing those GMOs!
1664,3,5,44,52,1.2115384615384615,0.07438302518417335,527,"Hello friend, this is your lucky day!"
1664,3,5,44,52,1.2115384615384615,0.07438302518417335,527,Meep! Meep! EE-I-EE-O!
1664,2,7,43,52,1.2115384615384615,0.06912804512336526,527,"I'm really sorry that you traveled so far, but we already leased our place for the next Century to a nice couple from Kepler-186f"
1664,3,5,44,52,1.2115384615384615,0.07438302518417335,527,Friendships are easy when you both like circles.
1664,4,3,45,52,1.2115384615384615,0.07929049280033962,527,Let's get you suited up mister.
1664,3,5,44,52,1.2115384615384615,0.07438302518417335,527,I understand you have 3 daughters.
1664,3,5,44,52,1.2115384615384615,0.07438302518417335,527,"Hi, I'm Mork, Rush Chairman. Damn glad to meet you."
1664,0,11,41,52,1.2115384615384615,0.05718733248399806,527,You got any ethanol?
1664,1,9,42,52,1.2115384615384615,0.0634392529086423,527,"Sure, come on in--we heard Canada's full."
1664,3,5,44,52,1.2115384615384615,0.07438302518417335,527,Great! You got in before the wall goes up.
1664,2,7,43,52,1.2115384615384615,0.06912804512336526,527,What the heck? There's a drought anyway.
1664,2,7,43,52,1.2115384615384615,0.06912804512336526,527,You will grow food for us. Like Matt Damon.
1664,0,11,41,52,1.2115384615384615,0.05718733248399806,527,Trump was elected. How much room do you have on your planet?
1664,3,5,44,52,1.2115384615384615,0.07438302518417335,527,So we'll leave him here and you contact us in November and let us know if he's won.
1664,2,7,43,52,1.2115384615384615,0.06912804512336526,527,I come in search of organic kale. Have any?
1664,1,9,42,52,1.2115384615384615,0.0634392529086423,527,Matt Damon says 'hi'.
1664,5,1,46,52,1.2115384615384615,0.08391144177936673,527,"Its good to see you again, Clem. I got you message about wanting to leave the planet before the Trump/Hillary thing get even weirder."
1664,2,7,43,52,1.2115384615384615,0.06912804512336526,527,What happened to your atmosphere. Didn't you listen to our ambassador cows and pigs that we sent down?
1664,4,3,45,52,1.2115384615384615,0.07929049280033962,527,"You're just the right, relatable candidate we've been looking for!"
1664,1,9,42,52,1.2115384615384615,0.0634392529086423,527,"Hey, welcome. Thanks to folks like you, this ship is completely powered by ethanol."
1664,4,3,45,52,1.2115384615384615,0.07929049280033962,527,Take me to Bernie Sanders--assuming that's the best you can do these days.
1664,2,7,43,52,1.2115384615384615,0.06912804512336526,527,You shouldn't be concerned... I've been an Uber driver for several millennia!
1664,2,7,43,52,1.2115384615384615,0.06912804512336526,527,'the crop circles thing....we felt we owed you an explanation'
1664,1,9,42,52,1.2115384615384615,0.0634392529086423,527,Have you heard the one about the traveling salesman and the Martian's daughter?
1735,3,4,41,48,1.2083333333333333,0.07854129630064868,527,Welcome to the REAL Comic-Con.
1736,2,7,44,53,1.2075471698113207,0.06792855979005262,527,How about I take you to MY Leader? mmm.
1736,1,9,43,53,1.2075471698113207,0.06235863877776731,527,I used to fly for UFOR but now I'm flying for Lift.
1736,2,7,44,53,1.2075471698113207,0.06792855979005262,527,Howdy neighbor! Glad you could make tonight's neighborhood meeting - we're discussing the strange neighbors that just moved in down the street.
1736,2,7,44,53,1.2075471698113207,0.06792855979005262,527,Uber here for a Dorothy.
1736,3,5,45,53,1.2075471698113207,0.07307515747561165,527,"Hey there, someone call an Uber?"
1736,2,7,44,53,1.2075471698113207,0.06792855979005262,527,"That was for, uh, research...yeah, research/"
1736,3,5,45,53,1.2075471698113207,0.07307515747561165,527,Welcome. I'm guessing you're here about the refurbished hay baler we posted on Craigslist?
1736,2,7,44,53,1.2075471698113207,0.06792855979005262,527,"It was nice meeting you, but your planet is too anti-immigrant."
1736,1,9,43,53,1.2075471698113207,0.06235863877776731,527,This thing got a tiller attachment?
1736,2,7,44,53,1.2075471698113207,0.06792855979005262,527,Wow Glorp! You've really gone native.
1736,2,7,44,53,1.2075471698113207,0.06792855979005262,527,So tell me the one about your daughter.
1736,3,5,45,53,1.2075471698113207,0.07307515747561165,527,You can't volunteer to be abducted after November.
1736,3,5,45,53,1.2075471698113207,0.07307515747561165,527,We're trying to save as many as we can from that Donald Trump.
1736,1,9,43,53,1.2075471698113207,0.06235863877776731,527,"Even if you didn't fully understand the consequences, we thank you for voting for Brexit."
1736,2,7,44,53,1.2075471698113207,0.06792855979005262,527,"Well, I think my holier than thou attitude is justified."
1751,1,8,40,49,1.2040816326530612,0.06507185874050676,527,Did you call an Uber?
1751,3,4,42,49,1.2040816326530612,0.07703912689051784,527,"Is this Idaho, Ohio, or Iowa?"
1751,1,8,40,49,1.2040816326530612,0.06507185874050676,527,So you'd like to apply for the crop circle position?
1751,2,6,41,49,1.2040816326530612,0.07130699079332185,527,"Yep! This is Kansas, but Dorothy doesn't live here anymore."
1751,3,4,42,49,1.2040816326530612,0.07703912689051784,527,Thank you. You have successfully unsubscribed from this list.
1751,3,4,42,49,1.2040816326530612,0.07703912689051784,527,"Thank you for being part of our ""farm to table"" menu!"
1751,2,6,41,49,1.2040816326530612,0.07130699079332185,527,So a traveling seed salesman lands on a hick planet. . .
1751,1,8,40,49,1.2040816326530612,0.06507185874050676,527,Please tell me I left my phone charger here
1751,1,8,40,49,1.2040816326530612,0.06507185874050676,527,Did you really think a 30 foot wall would be high enough?
1751,2,6,41,49,1.2040816326530612,0.07130699079332185,527,"No, we're not from Monsanto!"
1751,2,6,41,49,1.2040816326530612,0.07130699079332185,527,It's a pleasure to meet a fellow Republican.
1751,2,6,41,49,1.2040816326530612,0.07130699079332185,527,I've been sent to compensate you for the crop circles.
1751,2,6,41,49,1.2040816326530612,0.07130699079332185,527,Donald Trump sent us to raise the fear level.
1751,1,8,40,49,1.2040816326530612,0.06507185874050676,527,Looks like the wall didn't work after all.
1751,2,6,41,49,1.2040816326530612,0.07130699079332185,527,"This is an attempt to collect a debt, any information provided will be used for that purpose."
1751,2,6,41,49,1.2040816326530612,0.07130699079332185,527,I understand you're handy with a wrench.
1751,1,8,40,49,1.2040816326530612,0.06507185874050676,527,I promise--there's no Donald Trump or Hillary Clinton where we're going.
1751,4,2,43,49,1.2040816326530612,0.08237334039668254,527,Thanks for the potatoes!
1751,2,6,41,49,1.2040816326530612,0.07130699079332185,527,Got any more of them Reece's Pieces?'
1751,2,6,41,49,1.2040816326530612,0.07130699079332185,527,Welcome to Kansas! Is Dorothy with you?
1751,1,8,40,49,1.2040816326530612,0.06507185874050676,527,"""Hi, Bob Sample here, intergalactic sales! Farm equipment, seed, and fertilizer!'"
1751,0,10,39,49,1.2040816326530612,0.058172215566282534,527,"Oh, the spaceman and the farmer should be friends, Oh, the spaceman and the farmer should be friends..."
1773,4,3,47,54,1.2037037037037037,0.07652310699849257,527,"Welcome aboard your new manure spreader, Farmer Brown. She's a doozy."
1773,2,7,45,54,1.2037037037037037,0.06676946806414794,527,Welcome back! I'm one of your sons from your last stay.
1775,1,8,41,50,1.2,0.06388765649999399,527,"You are off by miles, Spielberg lives in LA."
1775,3,4,43,50,1.2,0.07559289460184544,527,"Well, you've got to trust me. I know more about business and the economy than anyone else in the universe."
1775,3,4,43,50,1.2,0.07559289460184544,527,I just want to see my options in case she loses.
1775,3,4,43,50,1.2,0.07559289460184544,527,"The ""Farmer to Table"" trend has really caught on back home!"
1775,3,4,43,50,1.2,0.07559289460184544,527,Global Entry sure beats TSA Pre.
1775,2,6,42,50,1.2,0.06998542122237651,527,Y'all from outer space or what?
1775,3,4,43,50,1.2,0.07559289460184544,527,Welcome home!
1775,2,6,42,50,1.2,0.06998542122237651,527,"I'm sorry to hear you didn't win an Oscar this year, Mr. Damon."
1775,2,6,42,50,1.2,0.06998542122237651,527,I've always wanted to probe the man behind the cattle.
1775,0,10,40,50,1.2,0.05714285714285714,527,My friends have told me your hospitality is great and that you have a pretty daughter.
1775,2,6,42,50,1.2,0.06998542122237651,527,Welcome Mr. Green Jeans! Is the Captain and Bunny Rabbit with you?
1775,2,6,42,50,1.2,0.06998542122237651,527,"...Crop Circle? Where I'm from, we call it Earth-A-Sketch... come on in."
1775,1,8,41,50,1.2,0.06388765649999399,527,Be careful among the English.
1775,1,8,41,50,1.2,0.06388765649999399,527,"-Hello neighbor, we are new in the neighborhood and I can't wait to introduce you to my family.."
1775,2,6,42,50,1.2,0.06998542122237651,527,"Wait, who's your leader?"
1775,3,4,43,50,1.2,0.07559289460184544,527,"Hi, there. I'm here to show you the latest Monsanto agricultural products."
1775,3,4,43,50,1.2,0.07559289460184544,527,Uber for Zeb?
1775,2,6,42,50,1.2,0.06998542122237651,527,Welcome to Space B&B!
1775,3,4,43,50,1.2,0.07559289460184544,527,We're here to support the Never Trump movement.
1775,3,4,43,50,1.2,0.07559289460184544,527,I think you'll agree this year's batch of crop circles is the best we've seen yet.
1775,3,4,43,50,1.2,0.07559289460184544,527,I swear I'll come back for you... if Trump doesn't win
1775,2,6,42,50,1.2,0.06998542122237651,527,Greetings-take me to your presumptive nominees!
1775,0,10,40,50,1.2,0.05714285714285714,527,Welcome aboard Noah. The animals are secured and we will be off in a flash.
1775,3,4,43,50,1.2,0.07559289460184544,527,DONALD TRUMP just became President!!!!! PLEASE take me to your planet!!!!
1775,1,8,41,50,1.2,0.06388765649999399,527,Table for one?
1775,2,6,42,50,1.2,0.06998542122237651,527,I don't know what happened. I was just in Britain and then found myself here.
1775,2,6,42,50,1.2,0.06998542122237651,527,I will make America great again!
1775,1,8,41,50,1.2,0.06388765649999399,527,It's OK. You're not Mexican.
1775,1,8,41,50,1.2,0.06388765649999399,527,Take us to your leader because we hear he's a doozy.
1775,2,6,42,50,1.2,0.06998542122237651,527,Thanks. I was planning to go to Canada but I hear they are full already.
1775,1,8,41,50,1.2,0.06388765649999399,527,"Hi, I'm Scotty. Sorry you had to take the stairs; we are having trouble with out beam."
1775,1,8,41,50,1.2,0.06388765649999399,527,I hope you don't mind the circles we made in your crops. It's an art project.
1775,2,6,42,50,1.2,0.06998542122237651,527,"Cool, but we ordered double pepperoni."
1775,1,8,41,50,1.2,0.06388765649999399,527,I am sorry this may seem a little Alien to you.
1775,0,10,40,50,1.2,0.05714285714285714,527,Did you hear about redistricting?
1775,1,8,41,50,1.2,0.06388765649999399,527,Get me out of this suit. I need to find a john .
1775,3,4,43,50,1.2,0.07559289460184544,527,"It's okay, Mr. Trump is mistaken -- I'm NOT illegal."
1775,3,4,43,50,1.2,0.07559289460184544,527,Gort? Klaatu barada nikto?! Do all aliens look alike to you?
1775,1,8,41,50,1.2,0.06388765649999399,527,"Goodbye, and thanks for all the zucchini."
1775,1,8,41,50,1.2,0.06388765649999399,527,Welcome and congratulations. You've been upgraded to first-class.
1775,2,6,42,50,1.2,0.06998542122237651,527,Are you my Uber driver? I really only just need a ride down to the Mercury dealership in town...
1775,2,6,42,50,1.2,0.06998542122237651,527,"I am looking for a farm-to-table, sustainable resource, with 23 pairs of chromosomes."
1775,3,4,43,50,1.2,0.07559289460184544,527,"Hello, and welcome aboard. I'm the Donald."
1775,1,8,41,50,1.2,0.06388765649999399,527,Sorry about your silo. We're used to the easier navigating around Roswell.
1775,3,4,43,50,1.2,0.07559289460184544,527,Thank god you arrived. I would never had made it to November 8th!
1775,2,6,42,50,1.2,0.06998542122237651,527,Tough finding parking spaces. We appreciate it.
1775,1,8,41,50,1.2,0.06388765649999399,527,"Hey Jack, of course you can borrow some sugar."
1775,3,4,43,50,1.2,0.07559289460184544,527,We're the only group in the galaxy that supports small American farms.
1775,1,8,41,50,1.2,0.06388765649999399,527,Don't you dare to take me to your leader.
1775,0,10,40,50,1.2,0.05714285714285714,527,We have been admiring your crop circles for years.
1775,3,4,43,50,1.2,0.07559289460184544,527,"I don't care if the election is between Clinton and Trump, you still can't go with us."
1775,1,8,41,50,1.2,0.06388765649999399,527,I understand you are here to serve mankind....but what do you mean by farm-to-table?
1775,2,6,42,50,1.2,0.06998542122237651,527,"Welcome to Uber ET, sir. As a reminder, we are currently operating at 200% surge pricing."
1775,1,8,41,50,1.2,0.06388765649999399,527,I represent the new conglomerate that bought the farm next door. We'd like to familiarize you with the expanding markets we serve.
1775,2,6,42,50,1.2,0.06998542122237651,527,Come on in! You like breathing chlorine don't you?
1775,1,8,41,50,1.2,0.06388765649999399,527,"""Greeting. I'm here to announce our diversity program""."
1775,0,10,40,50,1.2,0.05714285714285714,527,Now can we stop it with the circles?
1775,2,6,42,50,1.2,0.06998542122237651,527,Grass fed with no antibiotics! When I have to abduct cattle your farm is always my first choice.
1775,4,2,44,50,1.2,0.08081220356417686,527,Welcome back Clem. The doctor will see you now.
1775,2,6,42,50,1.2,0.06998542122237651,527,Hi! We saw your windmill and just had to stop.
1775,2,6,42,50,1.2,0.06998542122237651,527,"""I'm with Gallup Intergalactic and would like to ask you a few probing questions.?"
1775,4,2,44,50,1.2,0.08081220356417686,527,"So that's it, then. Jimmy takes a nap around 4. Spaghetti is Jane's favorite. Any questions, you have my number. I'll expect final payment on the 15th. Good luck!"
1775,3,4,43,50,1.2,0.07559289460184544,527,I promise you won't feel a thing
1838,1,8,42,51,1.196078431372549,0.06274509803921571,527,"Sorry about the crop circles, but we really wanted to discuss farm-to-table."
1838,2,6,43,51,1.196078431372549,0.06871143320758917,527,We installed the ladder just for you.
1838,2,6,43,51,1.196078431372549,0.06871143320758917,527,"Yes, hello. I'm your Uber X-Files driver."
1838,1,8,42,51,1.196078431372549,0.06274509803921571,527,Amazon?
1838,4,2,45,51,1.196078431372549,0.07930881731826153,527,"Before I take the job, you should know that I'm an undocumented alien."
1838,2,6,43,51,1.196078431372549,0.06871143320758917,527,"You are in luck, Earthling. There is one seat left."
1838,2,6,43,51,1.196078431372549,0.06871143320758917,527,"I'd take you to our leader, but President Trump doesn't let in illegal aliens."
1838,1,8,42,51,1.196078431372549,0.06274509803921571,527,Can you help us learn how to grow subsidies?
1838,3,4,44,51,1.196078431372549,0.07419956050362551,527,It's time for Mr. Trump to come home.
1838,3,4,44,51,1.196078431372549,0.07419956050362551,527,Greetings. We want to learn about your GMO's.
1838,1,8,42,51,1.196078431372549,0.06274509803921571,527,"Just one small step and one giant leap to come aboard, sir."
1838,2,6,43,51,1.196078431372549,0.06871143320758917,527,"So, can XR7 count on your vote?"
1838,2,6,43,51,1.196078431372549,0.06871143320758917,527,"Come in, we have free wifi."
1838,2,6,43,51,1.196078431372549,0.06871143320758917,527,"I'm mostly an old timer, but I'll have a look-see at your new fangled seeds!"
1838,3,4,44,51,1.196078431372549,0.07419956050362551,527,I send intergalactic greetings to all the humble denizens of flyover country.
1838,2,6,43,51,1.196078431372549,0.06871143320758917,527,We got a message from your leader asking us to pay for a wall.
1838,0,10,41,51,1.196078431372549,0.05614831789520141,527,Take me to your farm subsidies.
1838,1,8,42,51,1.196078431372549,0.06274509803921571,527,You were expecting Matt Damon?
1838,1,8,42,51,1.196078431372549,0.06274509803921571,527,Welcome aboard. I'm your new county Extension Agent.
1838,2,6,43,51,1.196078431372549,0.06871143320758917,527,We've been watching. We're here to vote.
1838,1,8,42,51,1.196078431372549,0.06274509803921571,527,And thanks so much for the Welcome Wagon basket!
1838,1,8,42,51,1.196078431372549,0.06274509803921571,527,I'm sorry -- you can't ride without a helmet. It's the law.
1838,4,2,45,51,1.196078431372549,0.07930881731826153,527,"For you, I've prepared a Polenta. But please don't talk about politics."
1838,1,8,42,51,1.196078431372549,0.06274509803921571,527,Yes I wish to leave before the election!
1838,2,6,43,51,1.196078431372549,0.06871143320758917,527,That's great. I gotta pee.
1838,2,6,43,51,1.196078431372549,0.06871143320758917,527,Come on in. We're watching The Martian.
1838,2,6,43,51,1.196078431372549,0.06871143320758917,527,"Welcome to Shabbas, Jim. First-timer?"
1838,0,10,41,51,1.196078431372549,0.05614831789520141,527,For the last time - you can't come with us!
1838,0,10,41,51,1.196078431372549,0.05614831789520141,527,We ran out of ethanol on our planet.
1838,4,2,45,51,1.196078431372549,0.07930881731826153,527,For fortified dairy that tastes out of this world
1838,1,8,42,51,1.196078431372549,0.06274509803921571,527,Congratulations! From over 10 centillion entries you have won the Publisher's Clearinghouse Sweepstakes.
1838,1,8,42,51,1.196078431372549,0.06274509803921571,527,We like to buy from local farms.
1838,2,6,43,51,1.196078431372549,0.06871143320758917,527,Wait until Donald hears about this. He'll be building another wall!
1838,2,6,43,51,1.196078431372549,0.06871143320758917,527,"I'm from the government, I'm here to help"
1838,1,8,42,51,1.196078431372549,0.06274509803921571,527,Mmm... Dinner!
1838,2,6,43,51,1.196078431372549,0.06871143320758917,527,"Now Uncle Henry, you didn't really think Dorothy got to us by traveling on a tornado, did you?"
1838,0,10,41,51,1.196078431372549,0.05614831789520141,527,Ready for an out-of-this-world dating experience?
1838,2,6,43,51,1.196078431372549,0.06871143320758917,527,Just in time for lunch!
1838,2,6,43,51,1.196078431372549,0.06871143320758917,527,"Hi, I'd like to add you to my professional network on LinkedIn."
1838,2,6,43,51,1.196078431372549,0.06871143320758917,527,We are your Uber ride to Roswell.
1838,1,8,42,51,1.196078431372549,0.06274509803921571,527,You squashed my squash.
1838,1,8,42,51,1.196078431372549,0.06274509803921571,527,"No worries, sir. We have no idea what Donald Trump is."
1838,2,6,43,51,1.196078431372549,0.06871143320758917,527,Ain't seen you around these parts.
1838,1,8,42,51,1.196078431372549,0.06274509803921571,527,I'm from another rural part of the universe.
1838,3,4,44,51,1.196078431372549,0.07419956050362551,527,"Well Jed they were right,your Blue Marble Moonshine is the best in the galaxy."
1838,1,8,42,51,1.196078431372549,0.06274509803921571,527,I'm very fond of your almanac -- so inaccurate.
1838,3,4,44,51,1.196078431372549,0.07419956050362551,527,Can I count on your vote?
1838,1,8,42,51,1.196078431372549,0.06274509803921571,527,"Hello, Mr. McDonald. I'm your new Monsanto representative. Welcome aboard."
1838,0,10,41,51,1.196078431372549,0.05614831789520141,527,Congratulations! Your crop circles won first prize.
1838,3,4,44,51,1.196078431372549,0.07419956050362551,527,"Glad to meet you, Homer. Let me tell you about my Odyssey."
1838,0,10,41,51,1.196078431372549,0.05614831789520141,527,"If you are seated next to an emergency exit, please read carefully the special instructions card located by your seat. If you do not wish to perform the functions described in the event of an emergency, please ask a flight attendant to reseat you."
1838,2,6,43,51,1.196078431372549,0.06871143320758917,527,Word in space is you hire aliens without green cards.
1838,3,4,44,51,1.196078431372549,0.07419956050362551,527,"Alien? So the rumors are true, gringo. You guys really haven't evolved much since the wall."
1838,3,4,44,51,1.196078431372549,0.07419956050362551,527,Welcome to Trump Campaign Headquarters. The greatest headquarters in the universe.
1838,1,8,42,51,1.196078431372549,0.06274509803921571,527,You're not in Kansas anymore.
1838,3,4,44,51,1.196078431372549,0.07419956050362551,527,Mr. Trump sent us to take you to his rally.
1838,2,6,43,51,1.196078431372549,0.06871143320758917,527,It's so nice to finally meet another crop circle creator.
1838,1,8,42,51,1.196078431372549,0.06274509803921571,527,We weren't expecting you until after the election.
1838,1,8,42,51,1.196078431372549,0.06274509803921571,527,"No,No,No....Let me take you to MY leader."
1838,1,8,42,51,1.196078431372549,0.06274509803921571,527,Is this the Kent residence?
1838,1,8,42,51,1.196078431372549,0.06274509803921571,527,"Thank you for coming, Sir. Now we have a Minion for our Sabbath Services. Please leave your Hat on."
1838,1,8,42,51,1.196078431372549,0.06274509803921571,527,Take me to the being who self-identifies as your leader.
1838,2,6,43,51,1.196078431372549,0.06871143320758917,527,"Hi, is corn in season?"
1838,3,4,44,51,1.196078431372549,0.07419956050362551,527,"Well, if you came in peace why did you land on my wife?"
1838,2,6,43,51,1.196078431372549,0.06871143320758917,527,"Welcome aboard. You will be our first experiment today, shouldn't take too long."
1838,2,6,43,51,1.196078431372549,0.06871143320758917,527,You're not bringing any GMO on board... are you?
1838,3,4,44,51,1.196078431372549,0.07419956050362551,527,"Don't be afraid, I just had to see your green thumb."
1838,2,6,43,51,1.196078431372549,0.06871143320758917,527,"Actually, we DID come for the harvest!"
1838,2,6,43,51,1.196078431372549,0.06871143320758917,527,We just wondered: Who are you wearing?
1838,1,8,42,51,1.196078431372549,0.06274509803921571,527,Am I too late to stop Brexit?
1838,3,4,44,51,1.196078431372549,0.07419956050362551,527,I can't wait for you to see these crop circle sketches.
1838,1,8,42,51,1.196078431372549,0.06274509803921571,527,Have you got a few minutes? We're doing a quick survey of red states.
1838,2,6,43,51,1.196078431372549,0.06871143320758917,527,"Hi, I'm running for congressman in your district. Let's talk about illegal aliens."
1838,3,4,44,51,1.196078431372549,0.07419956050362551,527,Your GMO crop was a big hit. We'll be back for more.
1838,0,10,41,51,1.196078431372549,0.05614831789520141,527,I don't know why our planets make us go on these play dates either.
1838,2,6,43,51,1.196078431372549,0.06871143320758917,527,Thank you for your vote and I'll see you in Cleveland.
1838,2,6,43,51,1.196078431372549,0.06871143320758917,527,"Are you another ""leave"" voter?"
1838,2,6,43,51,1.196078431372549,0.06871143320758917,527,"Sorry about your drought, but there's water on Mars."
1838,0,10,41,51,1.196078431372549,0.05614831789520141,527,"Yes, please come in! There's always room for one more for dinner."
1838,3,4,44,51,1.196078431372549,0.07419956050362551,527,Welcome to my dell.
1838,2,6,43,51,1.196078431372549,0.06871143320758917,527,I'm running as a third party candidate.
1838,2,6,43,51,1.196078431372549,0.06871143320758917,527,Welcome to your Airbnb reservation.
1838,2,6,43,51,1.196078431372549,0.06871143320758917,527,"Great to meet you, any suggestions for where I can get a good deal on Hamilton tickets?"
1838,2,6,43,51,1.196078431372549,0.06871143320758917,527,How about an exciting career in black hole exploration?
1838,3,4,44,51,1.196078431372549,0.07419956050362551,527,We're your new neighbors. Would you like to come in?
1838,1,8,42,51,1.196078431372549,0.06274509803921571,527,"It's ok if I pay you back next week, right?"
1838,0,10,41,51,1.196078431372549,0.05614831789520141,527,"If I get my wife, would you take her to your leader?"
1838,3,4,44,51,1.196078431372549,0.07419956050362551,527,"Goodbye, and thank you for showing us how to grow potatoes from our poop!"
1838,2,6,43,51,1.196078431372549,0.06871143320758917,527,"Finally, a human!"
1838,1,8,42,51,1.196078431372549,0.06274509803921571,527,"Welcome aboard! We're here to ""serve"" mankind!"
1838,2,6,43,51,1.196078431372549,0.06871143320758917,527,"Thanks, farmer. Your produce is out of this world."
1838,2,6,43,51,1.196078431372549,0.06871143320758917,527,"And for a limited time, we'll throw in a second set of encyclopedias absolutely free!"
1838,3,4,44,51,1.196078431372549,0.07419956050362551,527,Congratulations! You've won this year's crop circle contest.
1838,2,6,43,51,1.196078431372549,0.06871143320758917,527,Greetings Earthling..have you heard of the good works and writings of our overlord Xylog 6?
1838,2,6,43,51,1.196078431372549,0.06871143320758917,527,"""With the truck broke down, you Uber drivers are life savers""."
1838,1,8,42,51,1.196078431372549,0.06274509803921571,527,I've been looking for intelligent life everywhere!
1838,2,6,43,51,1.196078431372549,0.06871143320758917,527,Jeff Goldblum?
1838,1,8,42,51,1.196078431372549,0.06274509803921571,527,We've heard a lot about your farm-to-table movement.
1838,3,4,44,51,1.196078431372549,0.07419956050362551,527,"No, you won't be needing your ruby slippers."
1838,1,8,42,51,1.196078431372549,0.06274509803921571,527,I have some fantastic seeds for you.
1838,3,4,44,51,1.196078431372549,0.07419956050362551,527,"Come on, let's go ""crop circling""."
1838,4,2,45,51,1.196078431372549,0.07930881731826153,527,"Hi, neighbor."
1838,4,2,45,51,1.196078431372549,0.07930881731826153,527,"Don't worry, we'll provide the proper outfit fo you."
1838,4,2,45,51,1.196078431372549,0.07930881731826153,527,"Don't worry, Hank, the lurch isn't all that bad."
1838,0,10,41,51,1.196078431372549,0.05614831789520141,527,... A couple of things we'd like to see you work into rotation.
1943,2,6,44,52,1.1923076923076923,0.06748253524388616,527,Thanks for giving us Trump
1943,3,4,45,52,1.1923076923076923,0.07285629949368606,527,"Congratulations, you're the millionth customer!"
1943,1,8,43,52,1.1923076923076923,0.06164206964379924,527,The Intergalactic Party is your only viable option in November.
1943,2,6,44,52,1.1923076923076923,0.06748253524388616,527,"Hi, My name is Rob and I ""Feel the Bern"""
1947,2,5,40,47,1.1914893617021276,0.07222061144970149,527,Sorry about the mess. We circled a lot as we landed.
1947,2,5,40,47,1.1914893617021276,0.07222061144970149,527,I heard you became legal today. Congratulations!
1947,2,5,40,47,1.1914893617021276,0.07222061144970149,527,Exiting?
1950,2,5,41,48,1.1875,0.0708124708534365,527,Welcome to our Annuity Seminar.
1950,3,3,42,48,1.1875,0.07681751656402223,527,I'm afraid we need him back to make Gork great again.
1950,1,7,40,48,1.1875,0.06424858913372151,527,"Welcome to your alien abduction, Earthling. You may have a hazy memory upon return, but rest assured we will have some spectacular views of Uranus!"
1950,1,7,40,48,1.1875,0.06424858913372151,527,take me to your cornfield
1950,3,3,42,48,1.1875,0.07681751656402223,527,"I don't mind the lovely crop patterns, but could you do a little dusting while you're at it?"
1950,1,7,40,48,1.1875,0.06424858913372151,527,Yes. I am the last farmer on Earth.
1950,3,3,42,48,1.1875,0.07681751656402223,527,"Wait, just how bad do we look to the rest of the galaxy?"
1950,1,7,40,48,1.1875,0.06424858913372151,527,"Honestly, we're looking for something more long-term."
1950,1,7,40,48,1.1875,0.06424858913372151,527,"I'm afraid the ""Hamilton"" tour is sold out, sir."
1950,2,5,41,48,1.1875,0.0708124708534365,527,Good-bye! And don't forget to have that prostate checked again.
1950,0,9,39,48,1.1875,0.05693291124629693,527,"Hey there, I know we haven't formally met, but can we borrow a cup of sugar?"
1950,2,5,41,48,1.1875,0.0708124708534365,527,...and thanks for the delicious fried okra and grits.
1950,4,1,43,48,1.1875,0.08238601625129634,527,People will write songs about how that townhouse development in the dell never happened.
1950,2,5,41,48,1.1875,0.0708124708534365,527,Come quick! The boll weevils are in the cotton again.
1950,2,5,41,48,1.1875,0.0708124708534365,527,"Thank God for ""Farmersonly.com """
1950,1,7,40,48,1.1875,0.06424858913372151,527,We've admired your crop circles and wanted to meet you in person.
1950,2,5,41,48,1.1875,0.0708124708534365,527,"Thanks for coming, we are still having problems with the hydroponic tomatoes"
1950,1,7,40,48,1.1875,0.06424858913372151,527,"We would have walked, but there was a wall."
1950,1,7,40,48,1.1875,0.06424858913372151,527,At last! We need your advice on crop rotation.
1950,1,7,40,48,1.1875,0.06424858913372151,527,I'm Zorg and I'll be your anal prober this evening.
1950,1,7,40,48,1.1875,0.06424858913372151,527,"Pardon me sir, our tractor beam is toast. Might you have any grey poupon?"
1950,1,7,40,48,1.1875,0.06424858913372151,527,"Congratulations, you're our one-millionth test subject."
1950,1,7,40,48,1.1875,0.06424858913372151,527,How did you get over the wall?
1950,2,5,41,48,1.1875,0.0708124708534365,527,"Congratulations Mr. Johnson! You'll be receiving a complimentary subscription to The New Yorker as a ""thank you"" for completing your 100th probing."
1974,1,8,45,54,1.1851851851851851,0.05954682150320808,527,"Before you ask, I ain't got none of them metric wrenches."
1974,2,6,46,54,1.1851851851851851,0.06515087083609597,527,E.T. phoned home.
1976,0,9,40,49,1.183673469387755,0.05589005688828228,527,Are your cows organic?
1976,1,7,41,49,1.183673469387755,0.06303997616615865,527,I understand. I'd want to leave Earth with Trump running too.
1976,2,5,42,49,1.183673469387755,0.069457747811776,527,Thank you for agreeing to move the saucer so that our driveway is not blocked.
1976,1,7,41,49,1.183673469387755,0.06303997616615865,527,I watched your news on the way over - don't take me to your leader.
1976,0,9,40,49,1.183673469387755,0.05589005688828228,527,"Nice to meet you too, but no, I don't have a daughter."
1976,2,5,42,49,1.183673469387755,0.069457747811776,527,"Look, it's been a great evening but I really have to go."
1976,3,3,43,49,1.183673469387755,0.07533072989915002,527,We come for your Metamucil.
1976,1,7,41,49,1.183673469387755,0.06303997616615865,527,So do we have your affirmative consent?
1976,4,1,44,49,1.183673469387755,0.08077783732678857,527,"...And your next humiliating procedure won't be until Election Day...HA! But seriously, do remember to vote for the presidential candidate of your choice."
1976,1,7,41,49,1.183673469387755,0.06303997616615865,527,"Astounding, we both greet each other with a handshake."
1976,1,7,41,49,1.183673469387755,0.06303997616615865,527,"Sorry we couldn't squeeze you in sooner, Bob, but my secretary overscheduled me for anal probings today."
1976,1,7,41,49,1.183673469387755,0.06303997616615865,527,"I would take you to my leader, but she's plowing the back forty."
1976,3,3,43,49,1.183673469387755,0.07533072989915002,527,"November 9, 2016: ""Are you sure this is the fastest way to Canada?"""
1976,1,7,41,49,1.183673469387755,0.06303997616615865,527,You're just the demographic we're looking for.
1976,2,5,42,49,1.183673469387755,0.069457747811776,527,We serve farm-to-table.
1976,2,5,42,49,1.183673469387755,0.069457747811776,527,"The Airbnb listing said there was ample parking, is it ok if we leave this here?"
1976,2,5,42,49,1.183673469387755,0.069457747811776,527,"Hi, I think we found a location you've been looking for. It screams isolation."
1976,2,5,42,49,1.183673469387755,0.069457747811776,527,"Greetings, I'm from the planet Monsanto."
1976,1,7,41,49,1.183673469387755,0.06303997616615865,527,2020 Iowa Caucus - first candidate's meet and greet
1976,0,9,40,49,1.183673469387755,0.05589005688828228,527,"Yeah, I was going to park it in the street. But, I didn't want to get towed."
1976,1,7,41,49,1.183673469387755,0.06303997616615865,527,"We always take great pride in eating fresh, locally sourced, and sustainable humans."
1976,2,5,42,49,1.183673469387755,0.069457747811776,527,"If my wife calls, I'm not here."
1976,2,5,42,49,1.183673469387755,0.069457747811776,527,I can let this baby go for zero down and 350 a month!
1976,2,5,42,49,1.183673469387755,0.069457747811776,527,Farmer wants a wife?
1976,2,5,42,49,1.183673469387755,0.069457747811776,527,We are going to have an out of this world Hee Haw time.
1976,1,7,41,49,1.183673469387755,0.06303997616615865,527,Sj%kiw@# and the kids have never really seen a farm before and I was wondering if it would be possible...
1976,1,7,41,49,1.183673469387755,0.06303997616615865,527,"Actually, I *am* your new seed supply, Mr. Grundy. There was a slip-up in the gene-splicing."
1976,0,9,40,49,1.183673469387755,0.05589005688828228,527,"Well, you tell Mr. Trump that we're not paying for this huge shield generator."
1976,2,5,42,49,1.183673469387755,0.069457747811776,527,Our wifi is out. Thanks for coming to fix it!
1976,1,7,41,49,1.183673469387755,0.06303997616615865,527,Take me to your ethanol.
1976,0,9,40,49,1.183673469387755,0.05589005688828228,527,Would you like to pay a little more to upgrade to first class?
1976,2,5,42,49,1.183673469387755,0.069457747811776,527,"""Well, good luck, and again, sorry about all the 'probing'"
1976,2,5,42,49,1.183673469387755,0.069457747811776,527,It's good knowing someone who knows what America is about.
1976,1,7,41,49,1.183673469387755,0.06303997616615865,527,"Yes, we are here to serve you, but you would have tasted better with the corn and beans we requested."
1976,3,3,43,49,1.183673469387755,0.07533072989915002,527,I know. Every farmer needs his dell.
1976,2,5,42,49,1.183673469387755,0.069457747811776,527,Thanks for mowing the circles. Much appreciated.
1976,2,5,42,49,1.183673469387755,0.069457747811776,527,"Farmer Brown?"" ""Elvis?"
1976,0,9,40,49,1.183673469387755,0.05589005688828228,527,Our policy is $50 for each checked bag.
1976,0,9,40,49,1.183673469387755,0.05589005688828228,527,Can you get a message to Dorothy that there's no place like home?
1976,2,5,42,49,1.183673469387755,0.069457747811776,527,"It's a deal: you take Trump, and we'll take all of your kind."
1976,0,9,40,49,1.183673469387755,0.05589005688828228,527,Come with me and you won't be in Kansas anymore.
1976,2,5,42,49,1.183673469387755,0.069457747811776,527,Farm raised
1976,2,5,42,49,1.183673469387755,0.069457747811776,527,"If anyone from my condo association sees you in the elevator, say I abducted you for an anal probe. They have this strict policy against Airbnb."
1976,1,7,41,49,1.183673469387755,0.06303997616615865,527,"January 20, 2017...Take me to your leade...wait...on second thought, you'll do just fine."
1976,3,3,43,49,1.183673469387755,0.07533072989915002,527,"Welcome aboard, homosapian! Thank you, anywhere is better than here as of November 8th, 2016!"
1976,3,3,43,49,1.183673469387755,0.07533072989915002,527,words gotten around that you grow the best damn corn in the galaxy
1976,1,7,41,49,1.183673469387755,0.06303997616615865,527,"The hell with subsidies, we're making you an offer that is out of this world!"
1976,1,7,41,49,1.183673469387755,0.06303997616615865,527,Welcome! You must be a friend of Elliott's?
1976,1,7,41,49,1.183673469387755,0.06303997616615865,527,Welcome to Uber-Uber!
1976,1,7,41,49,1.183673469387755,0.06303997616615865,527,We're looking for something organic
1976,3,3,43,49,1.183673469387755,0.07533072989915002,527,"You're the first, but if Hillary wins, you won't be the last."
1976,2,5,42,49,1.183673469387755,0.069457747811776,527,"Let's get this straight: I rent you my property for the weekend, this ain't gonna be a repeat of Woodstock. Got it?"
1976,3,3,43,49,1.183673469387755,0.07533072989915002,527,"That's correct we offer a 401K, 6 weeks vacation, health insurance and free annual probing."
1976,1,7,41,49,1.183673469387755,0.06303997616615865,527,Just not in my back yard... Deal?
1976,2,5,42,49,1.183673469387755,0.069457747811776,527,"I have to erase your memory now, but you'll always have my five-star review on Airbnb."
1976,2,5,42,49,1.183673469387755,0.069457747811776,527,Congratulations! Your name has been selected at random for our one millionth abduction!
1976,0,9,40,49,1.183673469387755,0.05589005688828228,527,Are you SURE you want me to take you to our leader?
1976,2,5,42,49,1.183673469387755,0.069457747811776,527,? You don't have to be lonely At FarmersOnly.Com. ?
1976,0,9,40,49,1.183673469387755,0.05589005688828228,527,Don't worry. A lot of folks confuse us with the USDA.
1976,2,5,42,49,1.183673469387755,0.069457747811776,527,You look just like your farmersonly.com profile picture.
1976,1,7,41,49,1.183673469387755,0.06303997616615865,527,Wanted: Down to earth men for out of this world experience.
1976,2,5,42,49,1.183673469387755,0.069457747811776,527,"Would you please return Scully and Mulder, the network has dreamed up more episodes to continue their TV series."
1976,1,7,41,49,1.183673469387755,0.06303997616615865,527,We support a path to citizenship for undocumented aliens.
1976,1,7,41,49,1.183673469387755,0.06303997616615865,527,"I hear you folks can build me an inexpensive, high quality shed."
1976,2,5,42,49,1.183673469387755,0.069457747811776,527,I'm here as a guest worker.
1976,2,5,42,49,1.183673469387755,0.069457747811776,527,Let me explain how subsidies work
1976,1,7,41,49,1.183673469387755,0.06303997616615865,527,So this is what happened to the children of the corn.
1976,2,5,42,49,1.183673469387755,0.069457747811776,527,I knew I'd see you after the election.
1976,1,7,41,49,1.183673469387755,0.06303997616615865,527,Can I interest you in some corn futures?
1976,1,7,41,49,1.183673469387755,0.06303997616615865,527,"Vote for me, I'll make the universe great again!"
1976,1,7,41,49,1.183673469387755,0.06303997616615865,527,...thank you for all you taught us about humanity. I'll leave you with the words of your people: 'ee-ii-ee-ii-oh'.
1976,1,7,41,49,1.183673469387755,0.06303997616615865,527,"Hello sir, can you give me directions to Roswell?"
1976,2,5,42,49,1.183673469387755,0.069457747811776,527,"You have been randomly selected as ""Farmer Of The Month"". Congratulations and welcome to Team Monsanto!"
1976,2,5,42,49,1.183673469387755,0.069457747811776,527,"Bill, welcome aboard we haven't probed you since '03"
1976,2,5,42,49,1.183673469387755,0.069457747811776,527,"Come right in, the urologist will be ready shortly."
1976,1,7,41,49,1.183673469387755,0.06303997616615865,527,We come in search of free-range chickens.
1976,1,7,41,49,1.183673469387755,0.06303997616615865,527,"Don't let the helmet fool you, I'm just a regular guy."
1976,2,5,42,49,1.183673469387755,0.069457747811776,527,Klaatu barada nikto... have you considered term life insurance?
1976,1,7,41,49,1.183673469387755,0.06303997616615865,527,You're a little early for the GOP convention.
1976,2,5,42,49,1.183673469387755,0.069457747811776,527,"Yes, Bob! Your wife's meatloaf was the best I've ever had. Now if you'll excuse me, she's just about to explain the part with the breadcrumbs."
1976,1,7,41,49,1.183673469387755,0.06303997616615865,527,We are going to rewrite the BOOK on Reality TV!
1976,2,5,42,49,1.183673469387755,0.069457747811776,527,"He built a wall, Earthling - but forgot to build a ceiling!"
1976,2,5,42,49,1.183673469387755,0.069457747811776,527,"Supper's at six, and she won't take ""No"" for an answer."
1976,0,9,40,49,1.183673469387755,0.05589005688828228,527,"""A million frequent flyer miles, sir, but you could get a billion if you upgrade to First Class. That's a billion with a ""b""""."
2060,1,6,37,44,1.1818181818181819,0.06720584069874137,527,I know what you must be thinking.
2061,1,7,42,50,1.18,0.061875450936307745,527,"Welcome aboard, Mr. McCoy. I can guarantee that no Hatfields will bother you where we're going."
2061,0,9,41,50,1.18,0.054883922035138685,527,It was literally out-of-this-world Airbnb experience.
2061,1,7,42,50,1.18,0.061875450936307745,527,You're Uber SpaceX has arrived.
2061,1,7,42,50,1.18,0.061875450936307745,527,"""It's not exactly rocket science, but it pays well""."
2061,2,5,43,50,1.18,0.06815348823929464,527,"Welcome! I'm Beebak, and I will be your host for this abduction. Now, did you select 'probe' or 'no probe'?"
2061,2,5,43,50,1.18,0.06815348823929464,527,"I'd take you, but we don't have any leaders."
2061,3,3,44,50,1.18,0.07390009803644321,527,You'll take a left at Albuquerque...
2061,1,7,42,50,1.18,0.061875450936307745,527,"""So where's the corn?"
2061,1,7,42,50,1.18,0.061875450936307745,527,This baby runs on horse manure!
2061,1,7,42,50,1.18,0.061875450936307745,527,"We're here from the future. We came back to 1930 to buy ""all natural""....."
2061,1,7,42,50,1.18,0.061875450936307745,527,How about you take me to YOUR leader?
2061,1,7,42,50,1.18,0.061875450936307745,527,""" Step inside friend and let me show you what interstellar condo living is all about."
2061,2,5,43,50,1.18,0.06815348823929464,527,Come with me if you want to live.
2061,2,5,43,50,1.18,0.06815348823929464,527,"Bud Wilkins, they told me you moved to Arizona?"
2061,2,5,43,50,1.18,0.06815348823929464,527,"No really, you should leave now and come back AFTER the November election."
2061,1,7,42,50,1.18,0.061875450936307745,527,I was wondering if I could borrow a cup of sugar?
2061,2,5,43,50,1.18,0.06815348823929464,527,"Welcome to AA, we've been waiting for you."
2061,2,5,43,50,1.18,0.06815348823929464,527,I've found you the perfect match on Venus.
2061,3,3,44,50,1.18,0.07390009803644321,527,EEEIIEEEIIOOOO
2061,3,3,44,50,1.18,0.07390009803644321,527,"Can you grow potatoes? Matt Damon left some behind-- we can't get enough! Red Bliss, Yukon Gold, those little fingerlings-- yummyummyummy-- boiled, mashed, fried, baked! Can you grow us some?"
2061,1,7,42,50,1.18,0.061875450936307745,527,Going Up
2061,3,3,44,50,1.18,0.07390009803644321,527,"We come in search of ""local food."""
2061,2,5,43,50,1.18,0.06815348823929464,527,Did you bring your seeds?
2061,2,5,43,50,1.18,0.06815348823929464,527,No papers? That won't be a problem for an experienced picker like you.
2061,0,9,41,50,1.18,0.054883922035138685,527,I hope we can count on your vote in November.
2061,2,5,43,50,1.18,0.06815348823929464,527,Folks 'round here don't take kindly to strangers.
2061,1,7,42,50,1.18,0.061875450936307745,527,We were all so saddened to hear about Bowie and Prince.
2061,1,7,42,50,1.18,0.061875450936307745,527,...and it gets 40 light years per plutonium rod!
2061,1,7,42,50,1.18,0.061875450936307745,527,Welcome. We'd like your views on harvesting.
2061,1,7,42,50,1.18,0.061875450936307745,527,Welcome. You folks from 'round here?
2061,0,9,41,50,1.18,0.054883922035138685,527,Heard you're the man to see about arugula.
2061,1,7,42,50,1.18,0.061875450936307745,527,"Ah! Finally, a planet with inhabitants who have opposable thumbs!"
2061,3,3,44,50,1.18,0.07390009803644321,527,"Good evening, sir. I'll be your driver tonight. Is this your first time using Rides on Demand?"
2061,2,5,43,50,1.18,0.06815348823929464,527,You built it!
2061,2,5,43,50,1.18,0.06815348823929464,527,"Hi, we're from Monsanto. You work for us now."
2061,2,5,43,50,1.18,0.06815348823929464,527,We'll come back another time...
2061,1,7,42,50,1.18,0.061875450936307745,527,Thanks again. We can't wait to try kale!
2061,1,7,42,50,1.18,0.061875450936307745,527,A Visit from Monsanto.
2061,1,7,42,50,1.18,0.061875450936307745,527,Congratulations! You’ve won the Crop Circle Sweepstakes.
2061,1,7,42,50,1.18,0.061875450936307745,527,You're being audited - the probing will begin shortly.
2061,3,3,44,50,1.18,0.07390009803644321,527,We have long been intrigued by your flyover planet.
2061,2,5,43,50,1.18,0.06815348823929464,527,Would you mind cutting back on the crop circles?
2061,3,3,44,50,1.18,0.07390009803644321,527,So you take a left at the farmhouse and that will take you straight to the interstate
2061,0,9,41,50,1.18,0.054883922035138685,527,Welcome aboard and our sympathies about the election.
2061,2,5,43,50,1.18,0.06815348823929464,527,We've come for your crop subsidy.
2061,1,7,42,50,1.18,0.061875450936307745,527,Me? I work at Area 51.
2061,1,7,42,50,1.18,0.061875450936307745,527,I'll take two dozen ears of corn and a bushel of tomatoes.
2061,2,5,43,50,1.18,0.06815348823929464,527,Can we borrow your Almanac?
2061,1,7,42,50,1.18,0.061875450936307745,527,What is Twilight Zone?
2061,1,7,42,50,1.18,0.061875450936307745,527,You've really aged since your Facebook photo.
2061,2,5,43,50,1.18,0.06815348823929464,527,Hey there. We're on the run from an oppressive intergalactic regime. Mind if we crash here for a stint? Or do you inexplicably hate us as much as the last farmer?
2061,2,5,43,50,1.18,0.06815348823929464,527,I 'm looking for a place to park this ship and retire. What a beautiful spot you have here.
2061,2,5,43,50,1.18,0.06815348823929464,527,We loved your performance in Interstellar!
2061,2,5,43,50,1.18,0.06815348823929464,527,Relax! We agreed to host the support group for people with Windows 10 issues.
2061,2,5,43,50,1.18,0.06815348823929464,527,"Congratulations! You have won the Intergalactic Sweepstakes grand prize, which is a ticket to leave Earth before it is reduced to cinders should Trump get elected."
2061,2,5,43,50,1.18,0.06815348823929464,527,What would you pay for a crop circle???
2061,1,7,42,50,1.18,0.061875450936307745,527,Democratic or Republican
2061,1,7,42,50,1.18,0.061875450936307745,527,"Trust me, it's an upgrade."
2061,0,9,41,50,1.18,0.054883922035138685,527,Could you fill her up please?
2061,2,5,43,50,1.18,0.06815348823929464,527,It's going to be an honor serving you—as hors d'oeuvres.
2061,3,3,44,50,1.18,0.07390009803644321,527,"If you really want to Brexit, you'll get into the saucer, Earthling."
2061,1,7,42,50,1.18,0.061875450936307745,527,Thanks for contacting farmersonly.com.
2061,2,5,43,50,1.18,0.06815348823929464,527,"That's a deal, 12k bushels of corn for a time warp machine"
2061,3,3,44,50,1.18,0.07390009803644321,527,And you're cosplaying as a... farmer?
2061,2,5,43,50,1.18,0.06815348823929464,527,"So East till i see the coast, than North till the giant lady . Thanks again your a life saver."
2061,2,5,43,50,1.18,0.06815348823929464,527,"Come on inside, man. I know, this is totally bitchin' isn't it?"
2061,2,5,43,50,1.18,0.06815348823929464,527,Are you Mr. Trump? We wanted to take him back home.
2061,2,5,43,50,1.18,0.06815348823929464,527,Take me to your presumptive nominees.
2061,3,3,44,50,1.18,0.07390009803644321,527,We can remove the implant now.
2061,1,7,42,50,1.18,0.061875450936307745,527,Welcome to the Crop Circle Seminar. Did you bring your protractor?
2061,1,7,42,50,1.18,0.061875450936307745,527,Is this where I vote?
2061,2,5,43,50,1.18,0.06815348823929464,527,Welcome. We have chosen you to address our conference on Amazing Earth Stories to describe the reasoning behind the practice of planting things in a mixture of dirt and animal excrement and then eating the result.
2061,2,5,43,50,1.18,0.06815348823929464,527,OK. We'll be back in November.
2061,3,3,44,50,1.18,0.07390009803644321,527,Welcome aboard! Are you another one of Trumps refugees.
2061,4,1,45,50,1.18,0.07923099785064026,527,"Likewise, nice to make your acquaintance. But no, this is 51 Amish Way, not Area 51."
2061,2,5,43,50,1.18,0.06815348823929464,527,Nice work on the crop circles.
2061,0,9,41,50,1.18,0.054883922035138685,527,We heard you're looking for migrant workers.
2061,1,7,42,50,1.18,0.061875450936307745,527,"Yes, we have Wi-Fi!"
2061,2,5,43,50,1.18,0.06815348823929464,527,Welcome to our panel of crop circle judges.
2061,1,7,42,50,1.18,0.061875450936307745,527,So you're our lucky volunteer.
2061,1,7,42,50,1.18,0.061875450936307745,527,"Welcome and yes, the wifi is free."
2061,1,7,42,50,1.18,0.061875450936307745,527,It's ok. Trust me I'm legal.
2061,1,7,42,50,1.18,0.061875450936307745,527,"It's not our first choice but, the housing market on Mars has gone thru the roof."
2061,1,7,42,50,1.18,0.061875450936307745,527,You were great. Really. That one about the chicken that crossed the universe was hilarious. Thanks for coming. We'll call you.
2061,2,5,43,50,1.18,0.06815348823929464,527,"I just felt that I had to personally drop by to tell you how much I admire your rugged, rural primitivism."
2061,1,7,42,50,1.18,0.061875450936307745,527,"Sorry, I'm late. Have you been waiting long?"
2061,1,7,42,50,1.18,0.061875450936307745,527,I'm sorry I turned your crop into popcorn.
2061,1,7,42,50,1.18,0.061875450936307745,527,"We come in peace... Sooo, sorry about the crops"
2061,3,3,44,50,1.18,0.07390009803644321,527,"Hi, I'm from the Intergalactic Government, and I'm here to help you."
2061,1,7,42,50,1.18,0.061875450936307745,527,Greetings. I just wanted y'all to know that I'm on the: National Do-Not-Abduct Registry.
2061,1,7,42,50,1.18,0.061875450936307745,527,I'm from the planet Monsanto.
2061,2,5,43,50,1.18,0.06815348823929464,527,"Come in, we have WiFi."
2061,2,5,43,50,1.18,0.06815348823929464,527,Deal. You don't tell anyone we're illegal aliens; we don't tell anyone you grow GMO corn.
2061,2,5,43,50,1.18,0.06815348823929464,527,"Welcome, you can use our telephone to call E.T."
2061,2,5,43,50,1.18,0.06815348823929464,527,I'm your radiology tech.
2061,2,5,43,50,1.18,0.06815348823929464,527,I’m here to save Earth - taking Donald Trump (DT) back home.
2061,1,7,42,50,1.18,0.061875450936307745,527,"""Hello, we heard you accepted our websites terms and conditions..."
2061,1,7,42,50,1.18,0.061875450936307745,527,Take me to any leader who isn't Donald Trump.
2061,0,9,41,50,1.18,0.054883922035138685,527,"Well, Frank, you'll definitely have my support this fall."
2061,1,7,42,50,1.18,0.061875450936307745,527,"Great to see you, Bob. Thanks for not holding a grudge about that whole crop circle thing."
2061,3,3,44,50,1.18,0.07390009803644321,527,Don't worry--after the election illegal aliens won't want to be here.
2061,0,9,41,50,1.18,0.054883922035138685,527,We fly non-stop to Area 51.
2061,1,7,42,50,1.18,0.061875450936307745,527,Love the crop circles...curious how you did that?
2061,3,3,44,50,1.18,0.07390009803644321,527,I got candy
2061,2,5,43,50,1.18,0.06815348823929464,527,I have to make some crop circles for my fraternity -- would you mind?
2061,0,9,41,50,1.18,0.054883922035138685,527,Hey! We need someone who knows how to use a wrench.
2061,0,9,41,50,1.18,0.054883922035138685,527,Don't worry. I'm totally legal.
2061,1,7,42,50,1.18,0.061875450936307745,527,I'm from planet Cookie...Got Milk?
2061,2,5,43,50,1.18,0.06815348823929464,527,We received your message about the upcoming election.
2061,2,5,43,50,1.18,0.06815348823929464,527,"Welcome, friend, but please remember: You never get a second chance to make a first impression."
2061,1,7,42,50,1.18,0.061875450936307745,527,We can use all the undocumented immigrants you can spare.
2061,1,7,42,50,1.18,0.061875450936307745,527,"Come in, come in you are just in time to be dinner"
2061,2,5,43,50,1.18,0.06815348823929464,527,Greetings ! Take me to your seeder.
2061,1,7,42,50,1.18,0.061875450936307745,527,"Thank you for explaining the whole cornhole thing. Boy, are our faces red!"
2061,2,5,43,50,1.18,0.06815348823929464,527,Come on baby we're going home.
2061,3,3,44,50,1.18,0.07390009803644321,527,Can't be worse than Trump.
2061,4,1,45,50,1.18,0.07923099785064026,527,Are you the guy the crop circles said has half-price plutonium?
2061,1,7,42,50,1.18,0.061875450936307745,527,"With our Galactically Modified seeds your new crop could feed on 10,000 people ... I meant ""feed 10,000 people""."
2061,3,3,44,50,1.18,0.07390009803644321,527,Greetings 2020 Iowa voter. You're welcome.
2061,0,9,41,50,1.18,0.054883922035138685,527,"Now Ben, I just have one word for you... Just one word. Are you listening? Satellites."
2061,1,7,42,50,1.18,0.061875450936307745,527,You've got to help us understand Donald Trump's brain.
2061,1,7,42,50,1.18,0.061875450936307745,527,"The trip was fantastic, but I couldn't use my mileage."
2061,1,7,42,50,1.18,0.061875450936307745,527,Deal. I'll deliver this district for Trump; you'll deliver the farm bill in the Senate.
2061,2,5,43,50,1.18,0.06815348823929464,527,We come in search of fresh eggs.
2061,1,7,42,50,1.18,0.061875450936307745,527,We prefer using the backdoor.
2061,0,9,41,50,1.18,0.054883922035138685,527,Thanks for coming. Our ethanol tank is down to fumes.
2061,2,5,43,50,1.18,0.06815348823929464,527,Or...... you could wait for our Uber flight from Venus.
2061,1,7,42,50,1.18,0.061875450936307745,527,I noticed your daughter's crop circle
2061,3,3,44,50,1.18,0.07390009803644321,527,"So, you're from Monsanto?"
2061,2,5,43,50,1.18,0.06815348823929464,527,Did you happen to see a crop circle around here?
2061,3,3,44,50,1.18,0.07390009803644321,527,Come teach us how to make those creepy crop circles.
2061,1,7,42,50,1.18,0.061875450936307745,527,We paid online at Farm Vacations for a three night stay. The rest of the invasion fleet arrives tomorrow.
2061,1,7,42,50,1.18,0.061875450936307745,527,"I know. I know. We DID try the middle of Times Square, but parking was such a pain in the ass."
2061,2,5,43,50,1.18,0.06815348823929464,527,Take me to your milkmaid.
2061,3,3,44,50,1.18,0.07390009803644321,527,"I guess you're welcomed, just as long as you're a legal alien."
2061,0,9,41,50,1.18,0.054883922035138685,527,Why did you come so early? The Farmers' Market starts tomorrow at 9 am.
2061,2,5,43,50,1.18,0.06815348823929464,527,Keep me until 2020 this time.
2061,1,7,42,50,1.18,0.061875450936307745,527,"Come on in and browse. I've got seeds, tractors, tractor beams - you name it!"
2061,2,5,43,50,1.18,0.06815348823929464,527,You don't have to be lonely anymore.
2061,2,5,43,50,1.18,0.06815348823929464,527,"So, I'm guessin' you ain't from around these parts?"
2061,3,3,44,50,1.18,0.07390009803644321,527,"Don't worry, It's only for 4 years."
2061,4,1,45,50,1.18,0.07923099785064026,527,Hello...I'm from Monsanto and I'm here to help you.
2061,3,3,44,50,1.18,0.07390009803644321,527,We're here to save the Earth. Can you give us directions to the Trump headquarters?
2061,3,3,44,50,1.18,0.07390009803644321,527,He thought a wall would stop us huh?
2061,1,7,42,50,1.18,0.061875450936307745,527,"Sorry to call you out like this, I know you have to get up with the chickens."
2061,2,5,43,50,1.18,0.06815348823929464,527,Finally! Someone who never heard of Donald Trump!
2207,0,8,37,45,1.1777777777777778,0.05763774795025092,527,We are just here for your charging station.
2207,2,4,39,45,1.1777777777777778,0.07309112127323451,527,You folks ever think about selling?
2207,0,8,37,45,1.1777777777777778,0.05763774795025092,527,Welcome! We're so looking forward to finally discussing quantum mechanics and plasma physics with someone from a civilization with an understanding of such things!
2207,2,4,39,45,1.1777777777777778,0.07309112127323451,527,"Welcome, earthling, our borders are always open."
2211,2,5,44,51,1.1764705882352942,0.06689694944796853,527,Harvest time for farmers
2211,2,5,44,51,1.1764705882352942,0.06689694944796853,527,"Rumspringa is over, come back home."
2211,3,3,45,51,1.1764705882352942,0.07252251768198795,527,I can assure you the colonoscopy equipment is state of the art
2211,3,3,45,51,1.1764705882352942,0.07252251768198795,527,I'm here to make America great again.
2211,2,5,44,51,1.1764705882352942,0.06689694944796853,527,The crop pattern invoice is in the mail!
2211,1,7,43,51,1.1764705882352942,0.06075267994050848,527,"I've beamed up a lot of cows,but none can compare to yours."
2211,2,5,44,51,1.1764705882352942,0.06689694944796853,527,So you think these Amish folks down the road will have spare parts?
2211,2,5,44,51,1.1764705882352942,0.06689694944796853,527,It just so happens we run on chicken poop.
2211,2,5,44,51,1.1764705882352942,0.06689694944796853,527,Elsie's gone into labor.
2211,1,7,43,51,1.1764705882352942,0.06075267994050848,527,I hope you'll forgive me for not being entirely truthful on my FarmersOnly.com description.
2211,2,5,44,51,1.1764705882352942,0.06689694944796853,527,"Thank God you've come. This rig runs on corn ethanol, and we're on empty!"
2222,1,6,39,46,1.173913043478261,0.06448868249648403,527,"Before you say anything, I'm not current on Game of Thrones."
2222,0,8,38,46,1.173913043478261,0.056503155622080956,527,And remember -- make hay while the sun shines.
2222,1,6,39,46,1.173913043478261,0.06448868249648403,527,Are you sure that my wife can't find me here?
2222,1,6,39,46,1.173913043478261,0.06448868249648403,527,Guess we need to build a sky fence now to keep the illegal extra-terrestrials out as well!
2222,1,6,39,46,1.173913043478261,0.06448868249648403,527,Hi! I'm your new crop duster.
2222,1,6,39,46,1.173913043478261,0.06448868249648403,527,Congratulations! You may already have won the Interplanetary Clearing House Sweepstakes!
2222,1,6,39,46,1.173913043478261,0.06448868249648403,527,We heard you folks need a new place to live after November.
2222,2,4,40,46,1.173913043478261,0.07158892194335345,527,Welcome! I'm glad you understand my crop circle message. Can I offer you a drink?
2222,2,4,40,46,1.173913043478261,0.07158892194335345,527,I need a place to stay...have those three salesman left yet?;
2222,1,6,39,46,1.173913043478261,0.06448868249648403,527,Greetings! We come in peace from Monsanto.
2222,2,4,40,46,1.173913043478261,0.07158892194335345,527,We come as locavore.
2222,0,8,38,46,1.173913043478261,0.056503155622080956,527,Did you bring the pizza?
2222,1,6,39,46,1.173913043478261,0.06448868249648403,527,Can I get you some coffee or a soda?
2222,2,4,40,46,1.173913043478261,0.07158892194335345,527,I won't eat you—I'm a Vegan.
2222,0,8,38,46,1.173913043478261,0.056503155622080956,527,"On behalf of interplanetary Vegans, welcome!"
2222,1,6,39,46,1.173913043478261,0.06448868249648403,527,"Conquer? No, we only want to know what ""corny"" means."
2222,2,4,40,46,1.173913043478261,0.07158892194335345,527,The wife came along. Tonight's probes will just be in the ear and nose.
2222,2,4,40,46,1.173913043478261,0.07158892194335345,527,Can you smell a storm with that thing on?
2222,1,6,39,46,1.173913043478261,0.06448868249648403,527,Come in. I'm from the government. I'm here to help you.
2222,2,4,40,46,1.173913043478261,0.07158892194335345,527,"Listen, this has been great, but the suit is getting really hot."
2242,0,8,39,47,1.1702127659574468,0.055411578656325414,527,I hope you don't mind if I ask you to take your boots off in our mudroom.
2242,1,6,40,47,1.1702127659574468,0.0632100658866106,527,"If you're certified organic, welcome aboard!"
2242,1,6,40,47,1.1702127659574468,0.0632100658866106,527,"Welcome to the neighborhood! For a small fee I can provide you with organic non GMO veggies, right from the earth!"
2242,1,6,40,47,1.1702127659574468,0.0632100658866106,527,Election isn't until November. Get me out of here now!
2242,2,4,41,47,1.1702127659574468,0.07014685887189226,527,No worries... the probing is optional!
2242,0,8,39,47,1.1702127659574468,0.055411578656325414,527,Can I interest you in crop circle insurance?
2242,3,2,42,47,1.1702127659574468,0.07645685835683208,527,We are from the future. Global warming doesn't destroy civilization. Baseball's new slide rule does.
2242,2,4,41,47,1.1702127659574468,0.07014685887189226,527,"Please come in, they'll never believe me."
2242,0,8,39,47,1.1702127659574468,0.055411578656325414,527,Greetings. Do you know where we might find a Shaker table?
2242,2,4,41,47,1.1702127659574468,0.07014685887189226,527,Rest assured Middle American! I am not one of the aliens Mr. Trump would have you worry about.
2242,2,4,41,47,1.1702127659574468,0.07014685887189226,527,We heard you grew the best organic kale in the universe
2242,1,6,40,47,1.1702127659574468,0.0632100658866106,527,We've heard good things about potatoes.
2242,1,6,40,47,1.1702127659574468,0.0632100658866106,527,"Yes, of course, we are afraid of your elections too."
2242,1,6,40,47,1.1702127659574468,0.0632100658866106,527,We saw your crop circle messages.
2242,3,2,42,47,1.1702127659574468,0.07645685835683208,527,Its time you embrace technology.
2242,0,8,39,47,1.1702127659574468,0.055411578656325414,527,All our abductees are 100% organic farmer.
2242,2,4,41,47,1.1702127659574468,0.07014685887189226,527,I'm sorry I can't take you with me as I'm all full of Republicans.
2242,2,4,41,47,1.1702127659574468,0.07014685887189226,527,"Thanks, my former GMO supplier turned into a turnip."
2242,2,4,41,47,1.1702127659574468,0.07014685887189226,527,We’re hoping you can settle an argument about crop rotation.
2242,2,4,41,47,1.1702127659574468,0.07014685887189226,527,"Don't worry, we're happy to help. Since Trump won the nomination we've literally rescued millions who couldn't stand to stay here any longer."
2242,1,6,40,47,1.1702127659574468,0.0632100658866106,527,Take me to your loudest businessman.
2242,3,2,42,47,1.1702127659574468,0.07645685835683208,527,"Hi, I'll be your Uber Galaxy driver"
2242,2,4,41,47,1.1702127659574468,0.07014685887189226,527,Wazzuuuuup
2242,2,4,41,47,1.1702127659574468,0.07014685887189226,527,I'll keep an eye out for Dorothy.
2242,2,4,41,47,1.1702127659574468,0.07014685887189226,527,"So good to see you again, Cousin Roswell"
2242,1,6,40,47,1.1702127659574468,0.0632100658866106,527,You've won the trip of your life!
2242,3,2,42,47,1.1702127659574468,0.07645685835683208,527,We're here to rescue you from the Nightly News
2242,2,4,41,47,1.1702127659574468,0.07014685887189226,527,"I'm from Future Farmers, crop-dusting division."
2242,2,4,41,47,1.1702127659574468,0.07014685887189226,527,Welcome to the Enterprise. We boldly go where no man has gone before and we pick you up.
2242,1,6,40,47,1.1702127659574468,0.0632100658866106,527,Boy are we glad to see you ! We've been craving sweet corn ever since our last trip here.
2242,1,6,40,47,1.1702127659574468,0.0632100658866106,527,Got any ethanol?
2242,3,2,42,47,1.1702127659574468,0.07645685835683208,527,Thank you for swiping right.
2242,1,6,40,47,1.1702127659574468,0.0632100658866106,527,Nice designs. Very post-modern.
2242,0,8,39,47,1.1702127659574468,0.055411578656325414,527,Congratulations farmer! You're the next bachelor.
2242,2,4,41,47,1.1702127659574468,0.07014685887189226,527,Come on in! We were just about to make more crop circles!
2242,2,4,41,47,1.1702127659574468,0.07014685887189226,527,"Sorry, we already took two of your kind..."
2242,2,4,41,47,1.1702127659574468,0.07014685887189226,527,Welcome. Thanks for answering my ad. Regarding your qualifications...just how long have you fellows been offering crop dusting services?
2242,2,4,41,47,1.1702127659574468,0.07014685887189226,527,"UFO good, GMO bad!"
2242,0,8,39,47,1.1702127659574468,0.055411578656325414,527,Is this your first time using Uber Space?
2242,0,8,39,47,1.1702127659574468,0.055411578656325414,527,"Sorry, no shoes. Is that strange?"
2242,1,6,40,47,1.1702127659574468,0.0632100658866106,527,How's everything been in Roswell?
2242,2,4,41,47,1.1702127659574468,0.07014685887189226,527,"Congratulations! They said, ""If you build it they will come."" And we did!"
2242,2,4,41,47,1.1702127659574468,0.07014685887189226,527,Thanks. We couldn't find a parking space in space.
2242,2,4,41,47,1.1702127659574468,0.07014685887189226,527,I'll show you mine if you show me yours first.
2242,1,6,40,47,1.1702127659574468,0.0632100658866106,527,Howdy friend. We have warm nuts and a hot towel waiting for you.
2242,1,6,40,47,1.1702127659574468,0.0632100658866106,527,My name is Zook. My grandmother was Amish.
2242,2,4,41,47,1.1702127659574468,0.07014685887189226,527,"Got it, a Celtic trinity knot in the north field and a tree life symbol in the south field."
2242,1,6,40,47,1.1702127659574468,0.0632100658866106,527,"Don't ask, don't tell, O.K.?"
2242,2,4,41,47,1.1702127659574468,0.07014685887189226,527,"Welcome. You grow genetically modified crops? Great, the others are inside."
2242,2,4,41,47,1.1702127659574468,0.07014685887189226,527,I'm not sure what you mean by 'Monsanto'.
2242,1,6,40,47,1.1702127659574468,0.0632100658866106,527,"Made it over the Wall, did you?"
2242,1,6,40,47,1.1702127659574468,0.0632100658866106,527,I'm counting on your vote.
2242,1,6,40,47,1.1702127659574468,0.0632100658866106,527,"Okay, ten thousand bushels of non-GMO organic corn ... if you can deliver."
2242,2,4,41,47,1.1702127659574468,0.07014685887189226,527,Dorothy sent me to fetch you.
2242,2,4,41,47,1.1702127659574468,0.07014685887189226,527,I love your book 'To Serve Man'.
2242,1,6,40,47,1.1702127659574468,0.0632100658866106,527,We like to support local farmers. And by local I mean within the same galaxy.
2242,1,6,40,47,1.1702127659574468,0.0632100658866106,527,Thank God you showed up. Donald Trump just won and Canada was full.
2242,0,8,39,47,1.1702127659574468,0.055411578656325414,527,"Hi, I'm your new GMO seed distributor"
2242,1,6,40,47,1.1702127659574468,0.0632100658866106,527,It's been fun! Give me a ring anytime if you need more crop circles!
2242,2,4,41,47,1.1702127659574468,0.07014685887189226,527,Welcome to Uber x 5000
2242,2,4,41,47,1.1702127659574468,0.07014685887189226,527,Helluva wall!
2242,2,4,41,47,1.1702127659574468,0.07014685887189226,527,I'm locally sourced from a nearby farm
2242,0,8,39,47,1.1702127659574468,0.055411578656325414,527,"You brought the organic kale seeds, right?"
2242,1,6,40,47,1.1702127659574468,0.0632100658866106,527,"Sorry about the crops, but it'll be nice to finally get some recognition for my work!"
2242,2,4,41,47,1.1702127659574468,0.07014685887189226,527,"Our economy out there is not doing great right now, so I thought, why not make a fews extra buck with Uber, you know"
2242,1,6,40,47,1.1702127659574468,0.0632100658866106,527,Illegal is an alien term.
2242,1,6,40,47,1.1702127659574468,0.0632100658866106,527,"We're not locovores, I hope that's OK..."
2242,1,6,40,47,1.1702127659574468,0.0632100658866106,527,Where's the pizza?
2242,0,8,39,47,1.1702127659574468,0.055411578656325414,527,Step right this way to find your missing cattle.
2242,1,6,40,47,1.1702127659574468,0.0632100658866106,527,"Welcome, we have great gun control."
2242,3,2,42,47,1.1702127659574468,0.07645685835683208,527,welcome to starbucks!
2242,1,6,40,47,1.1702127659574468,0.0632100658866106,527,Come in. I'd love to probe you about the neighborhood.
2242,0,8,39,47,1.1702127659574468,0.055411578656325414,527,Organic life form?
2242,1,6,40,47,1.1702127659574468,0.0632100658866106,527,I never thought that my search for a date through farmers.com would reach so far!
2242,1,6,40,47,1.1702127659574468,0.0632100658866106,527,Our cable is shot. Can I just watch the second half with you?
2242,1,6,40,47,1.1702127659574468,0.0632100658866106,527,"I think you picked the right night, it's Country Music Karaoke night."
2242,2,4,41,47,1.1702127659574468,0.07014685887189226,527,Trust me. People will come.
2242,1,6,40,47,1.1702127659574468,0.0632100658866106,527,""" Can you take me to your planet,Trump is going to be our president""."
2242,0,8,39,47,1.1702127659574468,0.055411578656325414,527,Are you the ones who have been doing the crop circles.
2242,1,6,40,47,1.1702127659574468,0.0632100658866106,527,Crop circles? So last decade. We're into textile art now.
2242,0,8,39,47,1.1702127659574468,0.055411578656325414,527,"Yessir, it was a long trip. But we heard that your organic tomatoes are worth every light-year!"
2242,1,6,40,47,1.1702127659574468,0.0632100658866106,527,"Kansas, I presume!"
2242,1,6,40,47,1.1702127659574468,0.0632100658866106,527,"Your tomatos are out of this world, man!"
2242,1,6,40,47,1.1702127659574468,0.0632100658866106,527,"In case my candidate loses, what's the quickest way to become a citizen?"
2242,2,4,41,47,1.1702127659574468,0.07014685887189226,527,Thank you! I am the result of your genetically altered seeds!
2242,1,6,40,47,1.1702127659574468,0.0632100658866106,527,Welcome Mel. I knew your pod.
2242,2,4,41,47,1.1702127659574468,0.07014685887189226,527,You have awfully soft hands for a farmer
2242,1,6,40,47,1.1702127659574468,0.0632100658866106,527,"Abe Lincoln, I presume. This is 1834 A.D. by your calendar, isn’t it?"
2242,1,6,40,47,1.1702127659574468,0.0632100658866106,527,Welcome to Farmer's Only.com!
2242,2,4,41,47,1.1702127659574468,0.07014685887189226,527,"Thanks, again. Your artichokes were out of this world!"
2242,2,4,41,47,1.1702127659574468,0.07014685887189226,527,"Well, we just got a new leader - and Mister, I'd advise you to keep looking for intelligent life out there."
2242,2,4,41,47,1.1702127659574468,0.07014685887189226,527,Wanna pull some donuts in the fields?
2242,1,6,40,47,1.1702127659574468,0.0632100658866106,527,That GMO corn? Can't thank you enough.
2242,1,6,40,47,1.1702127659574468,0.0632100658866106,527,Congratulations! Your field is perfect for my crop circles!
2242,2,4,41,47,1.1702127659574468,0.07014685887189226,527,Sure glad yer not from my bank.
2242,1,6,40,47,1.1702127659574468,0.0632100658866106,527,Fill 'er up with Ethanol.
2242,1,6,40,47,1.1702127659574468,0.0632100658866106,527,Your GMO Corn sent for us.
2242,2,4,41,47,1.1702127659574468,0.07014685887189226,527,"I know, I know--we heard the results of the election too."
2242,2,4,41,47,1.1702127659574468,0.07014685887189226,527,Are you the GMO rep?
2341,2,4,42,48,1.1666666666666667,0.06876141641725292,527,"Believe it or not, this is exactly what we’ve been expecting."
2341,1,6,41,48,1.1666666666666667,0.061980703166484186,527,"Yes, that's true what you heard. Free education, health care, food stamps....no you don't need a job."
2341,3,2,43,48,1.1666666666666667,0.074931016344381,527,"Greetings, organic, non-GMO, Earthling."
2341,2,4,42,48,1.1666666666666667,0.06876141641725292,527,Hi. Name's Jesus. Welcome aboard!
2341,1,6,41,48,1.1666666666666667,0.061980703166484186,527,Hi there! I'd like to take a few moments of your time to talk about our Overlord and Savior...
2341,1,6,41,48,1.1666666666666667,0.061980703166484186,527,I've got the perfect market for your genetically modified produce.
2341,2,4,42,48,1.1666666666666667,0.06876141641725292,527,Do you know how to use the NEW Waze APP ?
2341,1,6,41,48,1.1666666666666667,0.061980703166484186,527,Take me to your... now don't get upset... leader.
2341,1,6,41,48,1.1666666666666667,0.061980703166484186,527,"You will teach us to grow marijuana, so that we too can imagine scenes like this."
2341,2,4,42,48,1.1666666666666667,0.06876141641725292,527,"Welcome, Mr. Greenjeans, the Captain awaits!"
2341,2,4,42,48,1.1666666666666667,0.06876141641725292,527,"Alien, huh? You should know, I support Trump."
2341,1,6,41,48,1.1666666666666667,0.061980703166484186,527,We shall return at the end of your election cycle.
2341,0,8,40,48,1.1666666666666667,0.05436067275445353,527,Please tell me about your cell phone plan.
2341,0,8,40,48,1.1666666666666667,0.05436067275445353,527,Hi there. I've been drafted as the alternative Republican candidate.
2341,2,4,42,48,1.1666666666666667,0.06876141641725292,527,Vote for Kodos.
2341,2,4,42,48,1.1666666666666667,0.06876141641725292,527,Take me to your new leader. Ours is particularly tough on immigration.
2341,1,6,41,48,1.1666666666666667,0.061980703166484186,527,We love the uneducated
2341,0,8,40,48,1.1666666666666667,0.05436067275445353,527,"For flyover country, we've taken Uber to the next level."
2341,2,4,42,48,1.1666666666666667,0.06876141641725292,527,"Congratulations Sir, You've won a trip to the Big Bang."
2341,0,8,40,48,1.1666666666666667,0.05436067275445353,527,You're not going to be in Kansas anymore.
2341,1,6,41,48,1.1666666666666667,0.061980703166484186,527,"Come with me, we welcome aliens on our planet."
2341,3,2,43,48,1.1666666666666667,0.074931016344381,527,"Yes, hello Mr. President, welcome aboard."
2341,1,6,41,48,1.1666666666666667,0.061980703166484186,527,We'd like to talk to you about a big art project.
2341,0,8,40,48,1.1666666666666667,0.05436067275445353,527,Let's say 10% of any income generated by the new circles and call it a deal.
2341,2,4,42,48,1.1666666666666667,0.06876141641725292,527,I hope I can count on your support at the caucus.
2341,0,8,40,48,1.1666666666666667,0.05436067275445353,527,"Really sorry for the crop circle, junior took the keys and you know kids..."
2341,2,4,42,48,1.1666666666666667,0.06876141641725292,527,Congratulations! You're a candidate for our farm-to-table franchise!
2341,2,4,42,48,1.1666666666666667,0.06876141641725292,527,Our robots love your franken-corn.
2341,1,6,41,48,1.1666666666666667,0.061980703166484186,527,"If it weren't for your crop circle, we would have gotten off at the next planet."
2341,1,6,41,48,1.1666666666666667,0.061980703166484186,527,"When I saw the ""Raw Milk"" sign, I had to stop."
2341,1,6,41,48,1.1666666666666667,0.061980703166484186,527,"Good, so, this really is Kansas?"
2341,2,4,42,48,1.1666666666666667,0.06876141641725292,527,It has come to the attention of the Galactic Community that you subconsciously wish to leave Kansas.
2341,0,8,40,48,1.1666666666666667,0.05436067275445353,527,Where would you like the crop circle this time?
2341,2,4,42,48,1.1666666666666667,0.06876141641725292,527,Where's Shoeless Joe?
2341,1,6,41,48,1.1666666666666667,0.061980703166484186,527,"When I heard ""If you build it, they will come,"" this is not what I envisioned."
2341,3,2,43,48,1.1666666666666667,0.074931016344381,527,Would you mind boots off? The wife insisted on white carpet and its just been cleaned.
2341,1,6,41,48,1.1666666666666667,0.061980703166484186,527,"That was, without question, my most unique Grindr experience ever."
2341,1,6,41,48,1.1666666666666667,0.061980703166484186,527,Thanks. The corn was out of this world.
2341,2,4,42,48,1.1666666666666667,0.06876141641725292,527,Welcome aboard. Your wish has come true. There IS a planet without political turmoil.
2341,2,4,42,48,1.1666666666666667,0.06876141641725292,527,You've been chosen to receive a year of Bon Appétit with no obligation!
2341,0,8,40,48,1.1666666666666667,0.05436067275445353,527,Just plant the root crops when there's a new moon!
2341,2,4,42,48,1.1666666666666667,0.06876141641725292,527,"Actually, I only want to leave if Trump wins."
2341,1,6,41,48,1.1666666666666667,0.061980703166484186,527,So glad to see that life exists on earth.
2341,1,6,41,48,1.1666666666666667,0.061980703166484186,527,Welcome to the hoedown.
2341,2,4,42,48,1.1666666666666667,0.06876141641725292,527,Thank goodness you're here! The corn is as high as an eleuwyd's eye!
2341,2,4,42,48,1.1666666666666667,0.06876141641725292,527,"Son, I tasted the cabbage a la Bretonne; the wife loved it. I think we have a deal."
2341,1,6,41,48,1.1666666666666667,0.061980703166484186,527,Your Match.com profile said you wanted to escape Trump.
2341,3,2,43,48,1.1666666666666667,0.074931016344381,527,"Just a heads-up, Frank. Za!klisx lost the bake-off today, so she's feeling a little glum."
2341,0,8,40,48,1.1666666666666667,0.05436067275445353,527,"Cletus, it's time for your annual colonoscopy."
2341,1,6,41,48,1.1666666666666667,0.061980703166484186,527,Quick! Inside! The National Weather Service has just issued a tornado warning!
2341,1,6,41,48,1.1666666666666667,0.061980703166484186,527,We were anxious to visit before you folks build the wall.
2341,2,4,42,48,1.1666666666666667,0.06876141641725292,527,Hey dude long time no see!
2341,2,4,42,48,1.1666666666666667,0.06876141641725292,527,"Would you like a crop circle? Beats a probe, right?"
2341,1,6,41,48,1.1666666666666667,0.061980703166484186,527,Welcome! We're the ampere waves of brain.
2341,0,8,40,48,1.1666666666666667,0.05436067275445353,527,Congratulations on deciding to go green.
2341,3,2,43,48,1.1666666666666667,0.074931016344381,527,C'mon in ..We can't wait to talk about Trump.
2341,1,6,41,48,1.1666666666666667,0.061980703166484186,527,"Which galaxy would you like to try, Rube?"
2341,0,8,40,48,1.1666666666666667,0.05436067275445353,527,Our sources on Venus tell us that you're outstanding in your field.
2341,1,6,41,48,1.1666666666666667,0.061980703166484186,527,"Well, well, it's a fellow frontiersman."
2341,1,6,41,48,1.1666666666666667,0.061980703166484186,527,I'm here to replant those crop circles we made on your farm
2341,2,4,42,48,1.1666666666666667,0.06876141641725292,527,"Don't worry, Earthling, I'm okay, but the alien behind me is nuts!"
2341,1,6,41,48,1.1666666666666667,0.061980703166484186,527,Hi. I'm your future self. Technically we're not supposed to meet. Or touch. But I just had to come back to warn you. Do not take Marjorie Mae to the hoedown tonight. Instead take farmhand Luke. You'll be back to thank yourself in a thousand years.
2341,1,6,41,48,1.1666666666666667,0.061980703166484186,527,"I see we landed in a red state, feels like home."
2341,2,4,42,48,1.1666666666666667,0.06876141641725292,527,...and that's why I believe I'm the presidential candidate your country needs.
2341,2,4,42,48,1.1666666666666667,0.06876141641725292,527,Tell me about this wall.
2341,1,6,41,48,1.1666666666666667,0.061980703166484186,527,"Yes, your cow will jump over the moon."
2341,1,6,41,48,1.1666666666666667,0.061980703166484186,527,Just think of me as a genetically modified human.
2341,2,4,42,48,1.1666666666666667,0.06876141641725292,527,"""I believe you are a better example of the human race then its political leaders""."
2341,1,6,41,48,1.1666666666666667,0.061980703166484186,527,Abductions are for old-schoolers.
2341,1,6,41,48,1.1666666666666667,0.061980703166484186,527,"Welcome aboard, Dad. I told them you'd be glad to see me."
2341,0,8,40,48,1.1666666666666667,0.05436067275445353,527,Relax! I have a 5-star Uber rating.
2341,1,6,41,48,1.1666666666666667,0.061980703166484186,527,"Yes, we know, Trump won...."
2341,1,6,41,48,1.1666666666666667,0.061980703166484186,527,Think about it - there are no mortgages in space!
2341,2,4,42,48,1.1666666666666667,0.06876141641725292,527,"Hello, I belive your ordered some GMO seeds?"
2341,2,4,42,48,1.1666666666666667,0.06876141641725292,527,We hear your pies are out of this world.
2341,0,8,40,48,1.1666666666666667,0.05436067275445353,527,"Relax, we are totally noninvasive now."
2341,1,6,41,48,1.1666666666666667,0.061980703166484186,527,"""...welcome aboard friend you'll never hear the Trump name again where we're going...."
2341,1,6,41,48,1.1666666666666667,0.061980703166484186,527,so YOUR the Fellas who bought out Monsanto?
2341,2,4,42,48,1.1666666666666667,0.06876141641725292,527,"On the bright side, you may get a sports team named after you."
2341,0,8,40,48,1.1666666666666667,0.05436067275445353,527,Sorry we couldn't drop you off closer to the house
2341,0,8,40,48,1.1666666666666667,0.05436067275445353,527,010010 1101100010 101 00101010 0010 0100010111000 010110 0 010010 0101 010 hello.
2341,2,4,42,48,1.1666666666666667,0.06876141641725292,527,We've spotted unidentified farming objects on your property.
2341,3,2,43,48,1.1666666666666667,0.074931016344381,527,"No, it's still Iowa."
2341,0,8,40,48,1.1666666666666667,0.05436067275445353,527,"And after one light-year of travel, you'll be eligible for a seat upgrade."
2341,2,4,42,48,1.1666666666666667,0.06876141641725292,527,"And remember, a vote for me is a vote against the lunacy of our two-party system."
2341,1,6,41,48,1.1666666666666667,0.061980703166484186,527,"Hi Jack Daniels, I'm Jim Beam-me-up."
2341,2,4,42,48,1.1666666666666667,0.06876141641725292,527,Have you ever considered selling Amway?
2341,0,8,40,48,1.1666666666666667,0.05436067275445353,527,"We couldn't bear watching this campaign season any longer, so decided to just begin rescue missions..."
2341,1,6,41,48,1.1666666666666667,0.061980703166484186,527,"Yeah, I know, but the Uber gigs are really helping right now."
2341,2,4,42,48,1.1666666666666667,0.06876141641725292,527,"Moo moo to you too, stranger."
2341,0,8,40,48,1.1666666666666667,0.05436067275445353,527,$1500 for the bull and I can pick up for free.
2341,0,8,40,48,1.1666666666666667,0.05436067275445353,527,"Howdy neighbor, can I borrow a few head of cattle?"
2341,2,4,42,48,1.1666666666666667,0.06876141641725292,527,"Yes, yes we want to hear all about Mr. Trump, welcome!"
2341,1,6,41,48,1.1666666666666667,0.061980703166484186,527,We've been admiring your crop circles.
2341,1,6,41,48,1.1666666666666667,0.061980703166484186,527,Our planet has been disqualified from the Olympics for doping. It must be your so called 'organic' cow's milk.
2341,0,8,40,48,1.1666666666666667,0.05436067275445353,527,You'll be farther away than Canada when you-know-what happens in November.
2341,0,8,40,48,1.1666666666666667,0.05436067275445353,527,You betcha'! We use genetically modified organisms in our fields too.
2341,3,2,43,48,1.1666666666666667,0.074931016344381,527,This is just a social call so come on board and relax. We only do anal probes on business trips.
2341,2,4,42,48,1.1666666666666667,0.06876141641725292,527,I'm surprised you still have steps on this thing.
2341,1,6,41,48,1.1666666666666667,0.061980703166484186,527,So how's the farm subsidy on your planet?
2341,2,4,42,48,1.1666666666666667,0.06876141641725292,527,Congratulations! You are the winner of the Publisher's Clearinghouse $1 million contest! If you'll just step inside...
2341,2,4,42,48,1.1666666666666667,0.06876141641725292,527,You're doing the right thing. He will be elected!
2341,0,8,40,48,1.1666666666666667,0.05436067275445353,527,We'd like to pick your brain for a little help with our crop circles
2341,1,6,41,48,1.1666666666666667,0.061980703166484186,527,Congratulations on pioneering our new farmer-to-table initiative.
2341,0,8,40,48,1.1666666666666667,0.05436067275445353,527,"Great to see you too. Hey, did you happen to go by the duty-free shop?"
2341,1,6,41,48,1.1666666666666667,0.061980703166484186,527,"Stairway to heaven? No, but come in, I want to show you something that will knock your socks off."
2341,2,4,42,48,1.1666666666666667,0.06876141641725292,527,"Unforeseen consequence of Trump presidency: On second thought, DON'T take me to your leader."
2341,3,2,43,48,1.1666666666666667,0.074931016344381,527,"Picked, farm fresh!"
2341,1,6,41,48,1.1666666666666667,0.061980703166484186,527,I've got tickets to Hamilton and I'm running late. Could you point me towards New York.
2341,2,4,42,48,1.1666666666666667,0.06876141641725292,527,You got here just in time. We're about to build a wall.
2341,1,6,41,48,1.1666666666666667,0.061980703166484186,527,"Don't worry, I have a Green Card."
2341,0,8,40,48,1.1666666666666667,0.05436067275445353,527,"Greetings, Mr. President!"
2341,1,6,41,48,1.1666666666666667,0.061980703166484186,527,You're just not martian material...
2341,1,6,41,48,1.1666666666666667,0.061980703166484186,527,His tweets went intergalactic!
2341,1,6,41,48,1.1666666666666667,0.061980703166484186,527,I'm Blursk. Did you request an Uber?
2341,0,8,40,48,1.1666666666666667,0.05436067275445353,527,"Well shoot, come on in, the missus done cooked up a mess of viddles and we ain't had no proper company since halfway across the galaxy."
2341,1,6,41,48,1.1666666666666667,0.061980703166484186,527,Sorry to trouble you....could you help me out with a gallon of ethanol?
2341,1,6,41,48,1.1666666666666667,0.061980703166484186,527,"Welcome aboard, but we don't take off till Inauguration Day."
2341,1,6,41,48,1.1666666666666667,0.061980703166484186,527,"Is Thursday night still chicken and dumplings at your house, earthling?"
2341,1,6,41,48,1.1666666666666667,0.061980703166484186,527,"To us, this is an alien world. That makes you the alien. Not us."
2341,1,6,41,48,1.1666666666666667,0.061980703166484186,527,"It's an honor to meet you, sir. I'd ask for your autograph, but I see you've already taken that liberty on my cornfield."
2341,2,4,42,48,1.1666666666666667,0.06876141641725292,527,Thanks for the circle! Haven't seen a coyote since.
2341,1,6,41,48,1.1666666666666667,0.061980703166484186,527,Why circles?
2341,3,2,43,48,1.1666666666666667,0.074931016344381,527,Our planet intends to go locavore and we need your expertise.
2341,1,6,41,48,1.1666666666666667,0.061980703166484186,527,Do not worry. This is a non-GMO UFO.
2341,1,6,41,48,1.1666666666666667,0.061980703166484186,527,"Are you my Billy, captured by aliens twenty years ago?"
2341,2,4,42,48,1.1666666666666667,0.06876141641725292,527,Remember when I was just a GMO seedling?
2341,0,8,40,48,1.1666666666666667,0.05436067275445353,527,Parsnips? I told him parsecs!
2341,1,6,41,48,1.1666666666666667,0.061980703166484186,527,"Thanks for the offer, but we're gonna pass on this planet."
2341,2,4,42,48,1.1666666666666667,0.06876141641725292,527,"Welcome, this is a Trump-free zone!"
2341,1,6,41,48,1.1666666666666667,0.061980703166484186,527,Are you the guy that's been leaving designs in my yard?
2341,1,6,41,48,1.1666666666666667,0.061980703166484186,527,Hey I found your barn cat! She's a keeper.
2341,2,4,42,48,1.1666666666666667,0.06876141641725292,527,Don't be afraid--I'm a Bernie delegate.
2341,1,6,41,48,1.1666666666666667,0.061980703166484186,527,My name is Org and I'm running to represent you in the Galactic Senate.
2341,1,6,41,48,1.1666666666666667,0.061980703166484186,527,The Farmer's Almanac didn't tell you....?
2341,3,2,43,48,1.1666666666666667,0.074931016344381,527,"We realize we have implanted the perception of free will in your species, and therefore thank you for choosing to fly with us."
2341,2,4,42,48,1.1666666666666667,0.06876141641725292,527,"Good evening. My name is Z*>T!*GH and I am running for Congress- can I count on your vote? And, oh, sorry about the cornfield."
2341,1,6,41,48,1.1666666666666667,0.061980703166484186,527,"Welcome. Rare, medium, or well-done?"
2341,0,8,40,48,1.1666666666666667,0.05436067275445353,527,Are you coming just for dinner or will you be spending the night?
2341,1,6,41,48,1.1666666666666667,0.061980703166484186,527,Hello! Help us out with some tips on crop rotation.
2341,1,6,41,48,1.1666666666666667,0.061980703166484186,527,"Mr. Android, will you promise to take our leader?"
2341,2,4,42,48,1.1666666666666667,0.06876141641725292,527,"I thought I ordered a tractor, not a spaceship - oh jeez."
2483,1,6,42,49,1.163265306122449,0.060797833101086655,527,I never met someone wasn't from Iowa.
2483,1,6,42,49,1.163265306122449,0.060797833101086655,527,Welcome to Planet Trump!
2483,2,4,43,49,1.163265306122449,0.06742934558367009,527,"Mr. Trump, it's very nice of you to invite me to your home!"
2483,2,4,43,49,1.163265306122449,0.06742934558367009,527,Who's going to pay for this wall?
2483,2,4,43,49,1.163265306122449,0.06742934558367009,527,I'm graffiti artist; Your crop fields are my canvas.
2483,0,8,41,49,1.163265306122449,0.05334825558285075,527,Welcome. Your wife and the pitchfork are already on board.
2483,2,4,43,49,1.163265306122449,0.06742934558367009,527,"Welcome aboard, you're our souvenir for the road trip."
2483,1,6,42,49,1.163265306122449,0.060797833101086655,527,Howdy; I'm from Future Farmers of America; you really need to modernize your spread!
2483,2,4,43,49,1.163265306122449,0.06742934558367009,527,"Yes, you have my word, we have three-party system."
2483,1,6,42,49,1.163265306122449,0.060797833101086655,527,"Howdy, neighbor! Have you seen a fella who has been creating those dang circles in my crops?"
2483,2,4,43,49,1.163265306122449,0.06742934558367009,527,you hate us because of our freedom?
2483,1,6,42,49,1.163265306122449,0.060797833101086655,527,Well---klaatu barada nikto to you too!
2483,1,6,42,49,1.163265306122449,0.060797833101086655,527,Thanks again for letting us make those circles for the kids.
2483,3,2,44,49,1.163265306122449,0.07346466349134413,527,Can we talk about fracking?
2483,2,4,43,49,1.163265306122449,0.06742934558367009,527,Did we make it in time for the conventions?
2483,2,4,43,49,1.163265306122449,0.06742934558367009,527,Hi. We're looking for some new farm-to-table partners.
2483,2,4,43,49,1.163265306122449,0.06742934558367009,527,"Bob, nice to see you again."
2483,1,6,42,49,1.163265306122449,0.060797833101086655,527,"Thanks for coming at such short notice. My wife can barley contain herself, so it would be great if you could give her a prune."
2483,1,6,42,49,1.163265306122449,0.060797833101086655,527,"Ok, four hens, two head of cattle, and a metric ton of ethanol."
2502,1,5,37,43,1.1627906976744187,0.06597285053646283,527,This way to Canada?
2503,1,6,43,50,1.16,0.05965889433663171,527,Greetings Earthling. I just stopped by to let you know I'm vegan.
2504,0,7,37,44,1.1590909090909092,0.055778005112363215,527,"Thanks for choosing Uber: Cosmos. My name is T'b B'falg, and I will be your pilot this evening."
2505,1,5,39,45,1.1555555555555554,0.06321005190772531,527,"Don't be silly... Our tome, 'How to Serve Humans' is not a cookbook!"
2505,0,7,38,45,1.1555555555555554,0.05463890236888291,527,We just can't get enough of your kale
2505,2,3,40,45,1.1555555555555554,0.07075034750641399,527,Hi Stan! Good to see you after all these lightyears.
2505,2,3,40,45,1.1555555555555554,0.07075034750641399,527,We realize that small family farms are vital to our success.
2505,0,7,38,45,1.1555555555555554,0.05463890236888291,527,You may be entitled to compensation.
2505,1,5,39,45,1.1555555555555554,0.06321005190772531,527,You must be Dorothy's uncle!
2505,1,5,39,45,1.1555555555555554,0.06321005190772531,527,"""We've come for the lima beans""."
2505,0,7,38,45,1.1555555555555554,0.05463890236888291,527,Congratulations! You've been chosen to teach us how to plant corn. I will have you back before the weekend.
2505,1,5,39,45,1.1555555555555554,0.06321005190772531,527,You may want to leave before Trump finds out you are here illegally.
2505,1,5,39,45,1.1555555555555554,0.06321005190772531,527,Didn't know they made 'em like you anymore.
2505,1,5,39,45,1.1555555555555554,0.06321005190772531,527,"Actually, the congressperson told me I have you to thank."
2505,2,3,40,45,1.1555555555555554,0.07075034750641399,527,"Thanks to free trade, we can offer a full line of genetically modified seeds at competitive prices."
2505,0,7,38,45,1.1555555555555554,0.05463890236888291,527,Fill her up and tell me how to get to Roswell.
2505,1,5,39,45,1.1555555555555554,0.06321005190772531,527,"Thanks pal, it's an amazing maize maze!"
2505,1,5,39,45,1.1555555555555554,0.06321005190772531,527,Please bring me back in 2020 when there are better candidates for president.
2505,2,3,40,45,1.1555555555555554,0.07075034750641399,527,"Sorry we had to put you on the waiting list, our planet was nearing overpopulation since Trump took office."
2505,2,3,40,45,1.1555555555555554,0.07075034750641399,527,I'm the third party candidate for President and I'd appreciate your vote in November!
2505,2,3,40,45,1.1555555555555554,0.07075034750641399,527,Hello! Are you the farmer that said he grew the best wheat in the Universe?
2505,2,3,40,45,1.1555555555555554,0.07075034750641399,527,You never heard of sushi? That's why we came.
2505,1,5,39,45,1.1555555555555554,0.06321005190772531,527,"Oh yes, preserving corn subsidies will be my first priority!"
2505,1,5,39,45,1.1555555555555554,0.06321005190772531,527,May I interest you in a free 'crop beautification' demonstration?
2505,1,5,39,45,1.1555555555555554,0.06321005190772531,527,You won't need that gear. We got good clean air out here.
2505,1,5,39,45,1.1555555555555554,0.06321005190772531,527,We come in friendship provided you promise NOT to take me to your leader!
2505,3,1,41,45,1.1555555555555554,0.07756102553718168,527,I'm with the Publishers Clearing House Prize Patrol.
2505,0,7,38,45,1.1555555555555554,0.05463890236888291,527,Greetings! And congratulations! That magnificent field has won you the crop circle of the year!
2505,1,5,39,45,1.1555555555555554,0.06321005190772531,527,Come aboard! We have heard great things about farm to table!
2505,1,5,39,45,1.1555555555555554,0.06321005190772531,527,A job like this calls for a sense of perspective.
2505,2,3,40,45,1.1555555555555554,0.07075034750641399,527,Just stopped by for a quick snack.
2505,0,7,38,45,1.1555555555555554,0.05463890236888291,527,"Greetings, now how do you get such big tomatoes?"
2505,0,7,38,45,1.1555555555555554,0.05463890236888291,527,I just love it when you don't shave.
2505,2,3,40,45,1.1555555555555554,0.07075034750641399,527,We need you. It's harvest time on Mars.
2505,1,5,39,45,1.1555555555555554,0.06321005190772531,527,"I'm pleased to tell you the new probes are in... Now, remember Steve. What happens in Alpha Centauri, STAYS, in Alpha Centauri."
2505,1,5,39,45,1.1555555555555554,0.06321005190772531,527,We appreciate your continued support of our agrochemical work...
2538,2,3,41,46,1.1521739130434783,0.06927778784183837,527,Don't be afraid. This is a rescue mission for you to be our new Family Farm Leader .
2538,2,3,41,46,1.1521739130434783,0.06927778784183837,527,Are you visiting or staying?
2538,2,3,41,46,1.1521739130434783,0.06927778784183837,527,"Welcome Aboard!"" ""The ETA to your destination, as stated, will be in light years."
2538,1,5,40,46,1.1521739130434783,0.061913070618242964,527,"From Roswell, I presume."
2538,0,7,39,46,1.1521739130434783,0.05354479188959757,527,Your online dating profile didn't mention that you liked to clasp hands on a first date.
2538,2,3,41,46,1.1521739130434783,0.06927778784183837,527,"""Our GPS is down and we need directions th Grover's Mill""!"
2538,0,7,39,46,1.1521739130434783,0.05354479188959757,527,Could you do crop triangles this time? Circles make me dizzy.
2538,0,7,39,46,1.1521739130434783,0.05354479188959757,527,'Greetings! We have observed that you are the one truly intelligent being on this planet.'
2538,1,5,40,46,1.1521739130434783,0.061913070618242964,527,"Mr. Kent? We have come for your boy, Clark."
2538,1,5,40,46,1.1521739130434783,0.061913070618242964,527,We were here long ago. Just been waiting for those cannabis laws to change.
2538,1,5,40,46,1.1521739130434783,0.061913070618242964,527,Are you available for crop spraying?
2538,0,7,39,46,1.1521739130434783,0.05354479188959757,527,Got GMO?
2538,0,7,39,46,1.1521739130434783,0.05354479188959757,527,"Farmer John, the Red Planet is going Green."
2538,2,3,41,46,1.1521739130434783,0.06927778784183837,527,Your crop circles look great! See ya next time!
2538,1,5,40,46,1.1521739130434783,0.061913070618242964,527,"Comes with a 100,000 light year warranty"
2538,0,7,39,46,1.1521739130434783,0.05354479188959757,527,Is your crop gluten-free?
2538,1,5,40,46,1.1521739130434783,0.061913070618242964,527,""" Who is 'Farm Bill' ""?"
2538,2,3,41,46,1.1521739130434783,0.06927778784183837,527,"Dad, I've come back for the summer harvest."
2538,2,3,41,46,1.1521739130434783,0.06927778784183837,527,"Thanks again for picking up my crop circle shift, Farmer Brown."
2538,2,3,41,46,1.1521739130434783,0.06927778784183837,527,Words out. We hear you need a leader.
2538,1,5,40,46,1.1521739130434783,0.061913070618242964,527,Did you come in over the wall or really go through immigraton?
2538,2,3,41,46,1.1521739130434783,0.06927778784183837,527,"Pleased to meet you, take my card MARTIAN WORKERS LLC, in case Mexico builds that wall."
2538,1,5,40,46,1.1521739130434783,0.061913070618242964,527,...and remember to 'Like' us on Facebook for 25%-off your next abduction.
2538,2,3,41,46,1.1521739130434783,0.06927778784183837,527,The field is yours for any geometrical pattern you see fit
2538,2,3,41,46,1.1521739130434783,0.06927778784183837,527,"No hard feelings, but Green Acres is the place to be."
2538,2,3,41,46,1.1521739130434783,0.06927778784183837,527,"I just demolished the Wall, so you won't have to work in the field by yourself any more."
2538,2,3,41,46,1.1521739130434783,0.06927778784183837,527,Welcome aboard Space Mountain. One revolution or two?
2538,1,5,40,46,1.1521739130434783,0.061913070618242964,527,I'm a bit lost. Which way is Mars?
2538,1,5,40,46,1.1521739130434783,0.061913070618242964,527,"So you was fixin' to git to Rigel? Shoot, I knows where that be, in Orion's Foot. Lemme give y'all some directions."
2538,1,5,40,46,1.1521739130434783,0.061913070618242964,527,"""This is the new John Deere?"
2538,1,5,40,46,1.1521739130434783,0.061913070618242964,527,Greetings! Can I use your bathroom?!
2538,1,5,40,46,1.1521739130434783,0.061913070618242964,527,Could I trouble you for some sugar?
2538,2,3,41,46,1.1521739130434783,0.06927778784183837,527,"So, how much moonshine do you want this time?"
2538,1,5,40,46,1.1521739130434783,0.061913070618242964,527,"Greetings, let's talk crop circles and what they can do for your farm."
2538,2,3,41,46,1.1521739130434783,0.06927778784183837,527,"So it's settled: we'll split your insurance payments for ""mysteriously destroyed crops""."
2538,2,3,41,46,1.1521739130434783,0.06927778784183837,527,What do you mean you only mow in circles?
2538,1,5,40,46,1.1521739130434783,0.061913070618242964,527,"Greetings earthling, take me to your seeder."
2538,0,7,39,46,1.1521739130434783,0.05354479188959757,527,"I don't usually answer Craigslist personals, but I was curious what you meant by ""probing""?"
2538,1,5,40,46,1.1521739130434783,0.061913070618242964,527,We need your help with our new farm-to-table restaurant.
2538,1,5,40,46,1.1521739130434783,0.061913070618242964,527,Of course you're welcome to come with us. But are you sure Donald Trump will win the election?
2538,1,5,40,46,1.1521739130434783,0.061913070618242964,527,"Sorry, but I don't know of a Rod Serling around these parts."
2538,1,5,40,46,1.1521739130434783,0.061913070618242964,527,We believe in eating foods sourced only in our local galactic cluster.
2538,1,5,40,46,1.1521739130434783,0.061913070618242964,527,Greetings from the Planet Monsanto. We're here to improve your crop yield.
2538,2,3,41,46,1.1521739130434783,0.06927778784183837,527,¡Hola! Mi casa es su casa.
2538,0,7,39,46,1.1521739130434783,0.05354479188959757,527,How do you feel about genetic crop modification?
2538,1,5,40,46,1.1521739130434783,0.061913070618242964,527,"Thanks, Jim. Same time next eon?"
2538,3,1,42,46,1.1521739130434783,0.07593151824596947,527,"After you ran away to Woodstock, I never thought I would see you again son."
2538,1,5,40,46,1.1521739130434783,0.061913070618242964,527,But I must warn you -- the farming subsidies on our planet are quite low.
2538,0,7,39,46,1.1521739130434783,0.05354479188959757,527,Howdy! Chris Smith here - your new Monsanto sales rep.
2538,1,5,40,46,1.1521739130434783,0.061913070618242964,527,Thanks for the kale. It's not in season on our planet.
2538,1,5,40,46,1.1521739130434783,0.061913070618242964,527,We're here on behalf of the Trump campaign to see if we can count on your support in November.
2538,1,5,40,46,1.1521739130434783,0.061913070618242964,527,Welcome Earthling! My tomatoes look like crap.
2538,3,1,42,46,1.1521739130434783,0.07593151824596947,527,Greetings! I'm your new sales rep from Monsanto.
2538,1,5,40,46,1.1521739130434783,0.061913070618242964,527,"Hi, I'm Zork and I'm running for Galactic OverLord. I hope I can count on your vote."
2538,1,5,40,46,1.1521739130434783,0.061913070618242964,527,Howdy Neighbor! Come on in and stay for dinner.
2538,1,5,40,46,1.1521739130434783,0.061913070618242964,527,"Hello there. Our spaceship technology is sponsored by Dell. Welcome aboard to the Dell, farmer."
2538,1,5,40,46,1.1521739130434783,0.061913070618242964,527,You're on your way to a better place where there is no agribusiness.
2538,2,3,41,46,1.1521739130434783,0.06927778784183837,527,"So, just the THREE crop circles this time?"
2538,2,3,41,46,1.1521739130434783,0.06927778784183837,527,Welcome aboard. I love the poorly educated.
2538,2,3,41,46,1.1521739130434783,0.06927778784183837,527,I've always heard about southern grits.
2538,1,5,40,46,1.1521739130434783,0.061913070618242964,527,"Sorry, our planet is at capacity with American ""abductees"" since Trump won."
2538,1,5,40,46,1.1521739130434783,0.061913070618242964,527,We have to stop meeting like this!
2538,2,3,41,46,1.1521739130434783,0.06927778784183837,527,Where can I get this 'double-down'?
2538,0,7,39,46,1.1521739130434783,0.05354479188959757,527,Hi. We're here from the government and we're here to help you.
2538,1,5,40,46,1.1521739130434783,0.061913070618242964,527,We need to learn how to grow corn.
2538,0,7,39,46,1.1521739130434783,0.05354479188959757,527,Have you come to help me find water?
2538,2,3,41,46,1.1521739130434783,0.06927778784183837,527,Everyone on our planet is looking forward to your renowned expertise!
2538,0,7,39,46,1.1521739130434783,0.05354479188959757,527,"With your fresh produce and my unrivaled distribution system, we can do farm-to-table in places you never even heard of."
2538,0,7,39,46,1.1521739130434783,0.05354479188959757,527,Don't worry about the manure smell---it's potpourri on our planet.
2538,2,3,41,46,1.1521739130434783,0.06927778784183837,527,Great to see you again.
2538,1,5,40,46,1.1521739130434783,0.061913070618242964,527,Congratulations! You are the Publisher Clearinghouse winner!
2538,1,5,40,46,1.1521739130434783,0.061913070618242964,527,Are you planning to vote for Trump? We'd like to study you.
2538,1,5,40,46,1.1521739130434783,0.061913070618242964,527,Greetings neighbor. We'll trade you the secrets of the universe for a bushel of fresh sweet corn and two sticks of butter.
2538,1,5,40,46,1.1521739130434783,0.061913070618242964,527,We have some wonderful deals on tractors.
2538,1,5,40,46,1.1521739130434783,0.061913070618242964,527,We're searching for a new leader who is unconventional yet harmless in appearance.
2538,0,7,39,46,1.1521739130434783,0.05354479188959757,527,"Yes, that's right, ""To Serve Man."""
2538,1,5,40,46,1.1521739130434783,0.061913070618242964,527,Thank you for helping us make America 'great' again.
2538,1,5,40,46,1.1521739130434783,0.061913070618242964,527,"Now Tom, I expect your support at the 2020 Iowa Republican caucuses."
2538,1,5,40,46,1.1521739130434783,0.061913070618242964,527,"Greetings, perhaps you've seen my crop circles in your lower forty."
2538,1,5,40,46,1.1521739130434783,0.061913070618242964,527,"Welcome, neighbor. You are going to love this dinner, my wife's meatloaf is out of this world!"
2538,2,3,41,46,1.1521739130434783,0.06927778784183837,527,"If you could just remove your shoes, we'll take care of the rest."
2538,2,3,41,46,1.1521739130434783,0.06927778784183837,527,"You are not alone. Since the Trump campaign started gaining momentum, our phone has been ringing off the hook"
2538,1,5,40,46,1.1521739130434783,0.061913070618242964,527,"We gave up on wind power 75,000 of... uh...your years ago. But have some new ideas you might be interested in!"
2538,0,7,39,46,1.1521739130434783,0.05354479188959757,527,"Thanks, but we aren't in the market for a fixer upper."
2538,1,5,40,46,1.1521739130434783,0.061913070618242964,527,So sorry for your lost planet.
2538,2,3,41,46,1.1521739130434783,0.06927778784183837,527,"Have you heard the good news of our Savior, Lord Gronk from Planet Gorlock?"
2538,0,7,39,46,1.1521739130434783,0.05354479188959757,527,Do you agree to 2.5 times surge pricing?
2538,1,5,40,46,1.1521739130434783,0.061913070618242964,527,Now forget this never happened.
2538,1,5,40,46,1.1521739130434783,0.061913070618242964,527,"hi, I am Ali, your uber driver today..."
2538,0,7,39,46,1.1521739130434783,0.05354479188959757,527,"Oh, good. Maybe you can explain to us that program called ""Dancing with the Stars."""
2538,2,3,41,46,1.1521739130434783,0.06927778784183837,527,Could I borrow 200 grams of C12H22O11?
2538,2,3,41,46,1.1521739130434783,0.06927778784183837,527,At least my species has the decency to shake your hand and buy you a drink before we get to the probing...
2538,0,7,39,46,1.1521739130434783,0.05354479188959757,527,Soon you won't be in Kansas anymore.
2538,1,5,40,46,1.1521739130434783,0.061913070618242964,527,I come from the planet Monsanto and I mean you no harm.
2538,2,3,41,46,1.1521739130434783,0.06927778784183837,527,Thank you for not abducting the cows again.
2538,2,3,41,46,1.1521739130434783,0.06927778784183837,527,Take me with you.
2538,1,5,40,46,1.1521739130434783,0.061913070618242964,527,"Welcome aboard, you are my first Uber customer from Kansas!"
2538,1,5,40,46,1.1521739130434783,0.061913070618242964,527,It's just for one term
2538,0,7,39,46,1.1521739130434783,0.05354479188959757,527,Glxpr is my name; crop circles is my game.
2538,0,7,39,46,1.1521739130434783,0.05354479188959757,527,Welcome to your all expense paid vacation to Proxima Centauri IV.
2538,1,5,40,46,1.1521739130434783,0.061913070618242964,527,"Hello, I am your sales representative from Monsanto."
2538,1,5,40,46,1.1521739130434783,0.061913070618242964,527,Hope that giant wall didn't give you any trouble coming in.
2538,1,5,40,46,1.1521739130434783,0.061913070618242964,527,Welcome back to Roswell! We need you more than ever during this election year!
2538,1,5,40,46,1.1521739130434783,0.061913070618242964,527,Big fan of your work. Your crop circles are so inspiring.
2538,0,7,39,46,1.1521739130434783,0.05354479188959757,527,I'm here to spruce up your crop circles.
2538,0,7,39,46,1.1521739130434783,0.05354479188959757,527,Word of your pumpkin-face-carving has greatly excited our cosmetologists.
2538,1,5,40,46,1.1521739130434783,0.061913070618242964,527,"Me Tonto, You Lone Rancher"
2538,2,3,41,46,1.1521739130434783,0.06927778784183837,527,Take me to your Donald.
2538,1,5,40,46,1.1521739130434783,0.061913070618242964,527,Hello. I'd like to offer you the first crop circle franchise in your area.
2538,2,3,41,46,1.1521739130434783,0.06927778784183837,527,No GMO? Welcome in.
2538,2,3,41,46,1.1521739130434783,0.06927778784183837,527,"Welcome, but be warned, someone just crop dusted."
2649,1,5,41,47,1.148936170212766,0.06066790909183939,527,"You'll always be my son, Xarghxx, but I understand your wish to know your birth parents. Follow your hearts, er, heart."
2649,2,3,42,47,1.148936170212766,0.06786504677504616,527,"Mr. Livingstone, I assume?"
2649,2,3,42,47,1.148936170212766,0.06786504677504616,527,"Finally, are you here to buy our fracking rights?"
2649,2,3,42,47,1.148936170212766,0.06786504677504616,527,We can't wait any more lightyears for the Whole Foods to open
2649,1,5,41,47,1.148936170212766,0.06066790909183939,527,Need a third party candidate?
2649,0,7,40,47,1.148936170212766,0.05249310253140096,527,Boy! It sure is nice to find a place that is welcoming to aliens.
2649,1,5,41,47,1.148936170212766,0.06066790909183939,527,We're finally here. You built the landing field and we have come.
2649,2,3,42,47,1.148936170212766,0.06786504677504616,527,"I'm from the inter-galactic government, and I'm here to help you."
2649,0,7,40,47,1.148936170212766,0.05249310253140096,527,Welcome! You're just in time for dinner.
2649,1,5,41,47,1.148936170212766,0.06066790909183939,527,And I hope I can depend on your support for my third-party candidacy.
2649,1,5,41,47,1.148936170212766,0.06066790909183939,527,Hey Look! It's my future self!
2649,1,5,41,47,1.148936170212766,0.06066790909183939,527,Let's talk dairy cows.
2649,2,3,42,47,1.148936170212766,0.06786504677504616,527,"Marvin?"" ""Really..."
2649,1,5,41,47,1.148936170212766,0.06066790909183939,527,"Let me begin by saying, ""Be Careful!"" Its election year"
2649,2,3,42,47,1.148936170212766,0.06786504677504616,527,We love the potatoes in your farm share
2649,1,5,41,47,1.148936170212766,0.06066790909183939,527,Do you have a phone I can use?
2649,2,3,42,47,1.148936170212766,0.06786504677504616,527,Yes sir we have your goat. Sorry for the confusion.
2649,1,5,41,47,1.148936170212766,0.06066790909183939,527,I don't think it matters that your Amish....
2649,1,5,41,47,1.148936170212766,0.06066790909183939,527,"It's a pleasure to finally meet you, I'm a big fan of your work."
2649,2,3,42,47,1.148936170212766,0.06786504677504616,527,"Welcome Earthling, Your Search Has Ended EI EIO."
2649,2,3,42,47,1.148936170212766,0.06786504677504616,527,I'm not much for these time share thingamagigges
2649,1,5,41,47,1.148936170212766,0.06066790909183939,527,Don't be afraid. I just need you to help me with Farmville.
2649,1,5,41,47,1.148936170212766,0.06066790909183939,527,"Welcome to the first intergalactic reality show -- ""How to Serve Man!"""
2649,2,3,42,47,1.148936170212766,0.06786504677504616,527,"There's no ""probing"" -- we just need help finding our crop circles."
2649,0,7,40,47,1.148936170212766,0.05249310253140096,527,I just want to say one word to you. Ethanol.
2649,2,3,42,47,1.148936170212766,0.06786504677504616,527,Thanks for giving us a hand.
2649,2,3,42,47,1.148936170212766,0.06786504677504616,527,We've traveled thousands of light years to watch you milk a cow. We hear you're the best!
2649,1,5,41,47,1.148936170212766,0.06066790909183939,527,"Thank you for the welcome, but can we just get some coffee on this planet?"
2649,2,3,42,47,1.148936170212766,0.06786504677504616,527,We seek your help in fixing our planet's broken political system.
2649,3,1,43,47,1.148936170212766,0.07436890448287321,527,"""when you go back,take my wife."
2649,2,3,42,47,1.148936170212766,0.06786504677504616,527,are you really from Farmersonly.com?
2649,1,5,41,47,1.148936170212766,0.06066790909183939,527,"Welcome aboaard and might I say ""Nice bibs""."
2649,3,1,43,47,1.148936170212766,0.07436890448287321,527,I forgot to bring the six pack.
2649,2,3,42,47,1.148936170212766,0.06786504677504616,527,Greetings. I'm here to see your leader about a bill I received for a giant dome.
2649,1,5,41,47,1.148936170212766,0.06066790909183939,527,"Sorry, but we don't need anymore help on the farm."
2649,1,5,41,47,1.148936170212766,0.06066790909183939,527,Klaatu barada restroom?
2649,3,1,43,47,1.148936170212766,0.07436890448287321,527,"That's right. That's right. United Farmers Organization, transplanting, grafting and cross-breeding section. Please clone...I mean, come in."
2649,1,5,41,47,1.148936170212766,0.06066790909183939,527,"Sorry again about the crop circles, but we’ve been traveling all day and needed a place to rest for the night."
2649,1,5,41,47,1.148936170212766,0.06066790909183939,527,We set our GPS for the planet Iowa
2649,2,3,42,47,1.148936170212766,0.06786504677504616,527,Welcome back. The stairway to heaven has been cleared.
2649,2,3,42,47,1.148936170212766,0.06786504677504616,527,And y'all promise there will none of them dang foreigners there...right?
2649,3,1,43,47,1.148936170212766,0.07436890448287321,527,"Iowa, right ? Howdy then - I’m Zeezar, and I am running for President"
2649,3,1,43,47,1.148936170212766,0.07436890448287321,527,The supply of Ego that fuels our civilization is running out and word has reached us of something on your planet called Trump.
2649,1,5,41,47,1.148936170212766,0.06066790909183939,527,We spell genetically modified 'E-I-E-I-O!'
2649,1,5,41,47,1.148936170212766,0.06066790909183939,527,FOR GIVE ME IS IT A MISH OR AMISH
2649,2,3,42,47,1.148936170212766,0.06786504677504616,527,"Likewise. Um, do you have one of those little wooden enclosures with the hole underneath?"
2649,2,3,42,47,1.148936170212766,0.06786504677504616,527,Any problems crossing the border?
2649,2,3,42,47,1.148936170212766,0.06786504677504616,527,You're safe with us. Our planet doesn't even allow seed patents.
2649,2,3,42,47,1.148936170212766,0.06786504677504616,527,Sure beats the USPS.
2649,1,5,41,47,1.148936170212766,0.06066790909183939,527,Those crop circles were the other guy
2649,2,3,42,47,1.148936170212766,0.06786504677504616,527,Greetings. I am from the planet Gluten and proud of it.
2649,0,7,40,47,1.148936170212766,0.05249310253140096,527,The farm to galaxy movement is taking off and we need you to be a part of it.
2649,2,3,42,47,1.148936170212766,0.06786504677504616,527,"Why, yes, sir! I can explain crop circles."
2649,1,5,41,47,1.148936170212766,0.06066790909183939,527,Come on in; we just baked a casserole that is out of this world.
2649,1,5,41,47,1.148936170212766,0.06066790909183939,527,St. Peter has the day off.
2649,1,5,41,47,1.148936170212766,0.06066790909183939,527,We've come to present you with the award for The Best Crop Formations in a Rural Setting 2016
2649,0,7,40,47,1.148936170212766,0.05249310253140096,527,"So, we have a deal! I can use your crop field for my art work."
2649,2,3,42,47,1.148936170212766,0.06786504677504616,527,"Thanks for choosing Theranos to administer your 50th birthday probe; technically I'm a subcontractor, but I'm very experienced."
2649,1,5,41,47,1.148936170212766,0.06066790909183939,527,"Sorry for the damage, but we're barely leading in the crop circles contest."
2649,1,5,41,47,1.148936170212766,0.06066790909183939,527,As soon as you get everyone eating the non-GMO stuff we'll be back to start marinating.
2649,2,3,42,47,1.148936170212766,0.06786504677504616,527,"Ironically, I'm a factory farmer too and we think you look delicious."
2649,1,5,41,47,1.148936170212766,0.06066790909183939,527,Is this Farmers Only dot com?
2649,1,5,41,47,1.148936170212766,0.06066790909183939,527,I've just got to ask... What do those Damn crop circles mean!
2649,2,3,42,47,1.148936170212766,0.06786504677504616,527,Gort? I'm sorry but Gort can't come out to play.
2649,2,3,42,47,1.148936170212766,0.06786504677504616,527,We've been worried about Dorothy after that Oz thing.
2649,2,3,42,47,1.148936170212766,0.06786504677504616,527,"""Xinad triestan golub dsfned (or, Don't let this smile fool you - you're screwed)."
2649,1,5,41,47,1.148936170212766,0.06066790909183939,527,Guess who's going to be dinner!
2649,1,5,41,47,1.148936170212766,0.06066790909183939,527,Is it free?
2649,1,5,41,47,1.148936170212766,0.06066790909183939,527,I'm very sorry but the Farmers Market closed at 6:00
2649,0,7,40,47,1.148936170212766,0.05249310253140096,527,Ancestry.com has us related 4000 generations back.
2649,1,5,41,47,1.148936170212766,0.06066790909183939,527,"Please , I cant live here with President Trump ."
2649,2,3,42,47,1.148936170212766,0.06786504677504616,527,You say a War of the Worlds is better than the next election?
2649,2,3,42,47,1.148936170212766,0.06786504677504616,527,"Oz? No, sir. You' re in Kansas. Go back straight up and turn right into that big funnel cloud. Gotta run."
2649,1,5,41,47,1.148936170212766,0.06066790909183939,527,Farm to table activist? You're just what we're looking for.
2649,2,3,42,47,1.148936170212766,0.06786504677504616,527,Circles are SO over... how about some nice non-Euclidean tessellations?
2649,1,5,41,47,1.148936170212766,0.06066790909183939,527,Hi there! I always wanted to meet a farmer.
2649,1,5,41,47,1.148936170212766,0.06066790909183939,527,We want you to help us go green.
2649,0,7,40,47,1.148936170212766,0.05249310253140096,527,This baby's perfect for you. She takes space-time warps in stride and only has 5 trillion miles on her !
2649,1,5,41,47,1.148936170212766,0.06066790909183939,527,"Your leader is this Trump fellow? Never mind, don't take me to him."
2649,1,5,41,47,1.148936170212766,0.06066790909183939,527,"Hope you don't mind me dropping in, but we need to learn about sustainable farming."
2649,1,5,41,47,1.148936170212766,0.06066790909183939,527,You're welcome. But you might want to ask again after the November elections.
2649,1,5,41,47,1.148936170212766,0.06066790909183939,527,Please no video or sound recordings. Why do you think we always show up in the middle of nowhere?
2649,2,3,42,47,1.148936170212766,0.06786504677504616,527,Welcome! I hope you like your steak still mooing.
2649,2,3,42,47,1.148936170212766,0.06786504677504616,527,Thank you for understanding why I couldn't drive this new taxi up your driveway.
2649,0,7,40,47,1.148936170212766,0.05249310253140096,527,My English not good. What is E I E I O ?
2649,0,7,40,47,1.148936170212766,0.05249310253140096,527,"Hey, neighbor, I think your windmill is on my side of the property line."
2649,1,5,41,47,1.148936170212766,0.06066790909183939,527,You're my ride?
2649,1,5,41,47,1.148936170212766,0.06066790909183939,527,You have the best landing fields in town.
2649,2,3,42,47,1.148936170212766,0.06786504677504616,527,"Nice to you meet you, we don't get many visitors from New York."
2649,1,5,41,47,1.148936170212766,0.06066790909183939,527,Welcome aboard! We're here to serve man.
2649,0,7,40,47,1.148936170212766,0.05249310253140096,527,Thanks again and sorry for the circle. You'd think an advanced civilization would have found a more efficient fuel than corn by now.
2649,2,3,42,47,1.148936170212766,0.06786504677504616,527,"Congratulations, You are our one-millionth passenger."
2649,2,3,42,47,1.148936170212766,0.06786504677504616,527,My only options here are Trump and Hillary. Let's go!
2649,2,3,42,47,1.148936170212766,0.06786504677504616,527,"I don't think I need a photo, they'll believe me."
2649,0,7,40,47,1.148936170212766,0.05249310253140096,527,Come on - it's time to build a wall around Earth.
2649,1,5,41,47,1.148936170212766,0.06066790909183939,527,Have you given any thought as to who you might support in the 2096 Iowa Caucuses?
2649,1,5,41,47,1.148936170212766,0.06066790909183939,527,"Hello, I must be going"
2649,1,5,41,47,1.148936170212766,0.06066790909183939,527,My wife wants to know if you have been sent by Steven King and if so will you speak to her book club on Tuesday afternoon at 1:00?
2649,0,7,40,47,1.148936170212766,0.05249310253140096,527,Come right in...this'll just take a light year or two!
2649,0,7,40,47,1.148936170212766,0.05249310253140096,527,"You must have misunderstood me the first time. I'm here to ""Take you FROM your leader."""
2649,1,5,41,47,1.148936170212766,0.06066790909183939,527,"We heard your country is in a difficult election year, we're here to help."
2649,0,7,40,47,1.148936170212766,0.05249310253140096,527,We flew over the wall.
2649,1,5,41,47,1.148936170212766,0.06066790909183939,527,Sure you can spend the night. But I just have one rule.
2649,0,7,40,47,1.148936170212766,0.05249310253140096,527,"Don't worry, it runs on ethanol."
2649,2,3,42,47,1.148936170212766,0.06786504677504616,527,"Yes, I've heard of globiaization..."""
2649,1,5,41,47,1.148936170212766,0.06066790909183939,527,"Earthling, we have much in common: no buttons."
2649,1,5,41,47,1.148936170212766,0.06066790909183939,527,Is it true you don't do daylight savings time up there?
2649,1,5,41,47,1.148936170212766,0.06066790909183939,527,We've come to help Bernie Sanders.
2649,2,3,42,47,1.148936170212766,0.06786504677504616,527,Have I got a tractor beam for you.
2649,1,5,41,47,1.148936170212766,0.06066790909183939,527,"""We’re delighted you saw our ad for 'crop circles' on Nextdoor.com."
2649,0,7,40,47,1.148936170212766,0.05249310253140096,527,"Howdy, I'm your new Monsanto representative."
2649,1,5,41,47,1.148936170212766,0.06066790909183939,527,"...now don't feel too bad, folks visiting from New York and California weren't able to live without technology for a whole weekend either!"
2649,1,5,41,47,1.148936170212766,0.06066790909183939,527,Yes...Uber has thoroughly vetted both me and my vehicle.
2649,1,5,41,47,1.148936170212766,0.06066790909183939,527,Take me to your bully.
2649,1,5,41,47,1.148936170212766,0.06066790909183939,527,This wasn't mentioned in the almanac.
2649,1,5,41,47,1.148936170212766,0.06066790909183939,527,Is this the highway to heaven?
2649,2,3,42,47,1.148936170212766,0.06786504677504616,527,"The kids are so excited about meeting you, mister Mcdonald!"
2649,0,7,40,47,1.148936170212766,0.05249310253140096,527,Can you teach me to make crop circles?
2649,1,5,41,47,1.148936170212766,0.06066790909183939,527,Howdy Pardner!
2649,2,3,42,47,1.148936170212766,0.06786504677504616,527,Welcome to the Machine
2649,2,3,42,47,1.148936170212766,0.06786504677504616,527,what took you so long?
2649,0,7,40,47,1.148936170212766,0.05249310253140096,527,We heard you run the best Farmer's Market on Earth.
2649,1,5,41,47,1.148936170212766,0.06066790909183939,527,It's pretty near showtime.
2649,1,5,41,47,1.148936170212766,0.06066790909183939,527,Nice to meet you. Does this Spaceship have wifi?
2649,2,3,42,47,1.148936170212766,0.06786504677504616,527,"Hi, I'm your new neighbor. Can I borrow a cup of sugar?"
2649,3,1,43,47,1.148936170212766,0.07436890448287321,527,"Welcome to Kansas, as long as you're not one of those illegal aliens."
2649,0,7,40,47,1.148936170212766,0.05249310253140096,527,"Fear not humanoid, you will be safe from Trump on Martian land."
2649,0,7,40,47,1.148936170212766,0.05249310253140096,527,No one will ever again call you a redneck!
2649,1,5,41,47,1.148936170212766,0.06066790909183939,527,"Greetings, we saw your signs."
2649,1,5,41,47,1.148936170212766,0.06066790909183939,527,I was thinking we might change things up and go with crop ovals this year.
2649,2,3,42,47,1.148936170212766,0.06786504677504616,527,It's ok. We wont use those long needles on you like we did last time. I promise.
2649,0,7,40,47,1.148936170212766,0.05249310253140096,527,"Greetings, Earthling! Are you male, female, or non-binary?"
2649,2,3,42,47,1.148936170212766,0.06786504677504616,527,I hope you take Trump refugees.
2649,1,5,41,47,1.148936170212766,0.06066790909183939,527,Don't be alarmed. I'm organic.
2649,2,3,42,47,1.148936170212766,0.06786504677504616,527,"Hi. It's Me. Thought I was never coming, did you?"""
2649,1,5,41,47,1.148936170212766,0.06066790909183939,527,"You from a red state or a blue state, friend?"
2649,0,7,40,47,1.148936170212766,0.05249310253140096,527,"If the effects last more than 4 million years, see your doctor."
2649,0,7,40,47,1.148936170212766,0.05249310253140096,527,Take us to your Farm Aid. We want to meet Willie Nelson.
2649,2,3,42,47,1.148936170212766,0.06786504677504616,527,Come in and try some roasted tperoxit gizzards.
2649,2,3,42,47,1.148936170212766,0.06786504677504616,527,Don't worry we don't have politicians on our planet.
2649,0,7,40,47,1.148936170212766,0.05249310253140096,527,It was a dare.
2649,1,5,41,47,1.148936170212766,0.06066790909183939,527,"Hey guys, our crop circle designer is here."
2649,0,7,40,47,1.148936170212766,0.05249310253140096,527,"You don't know it yet, but thank you for letting us use your corn field for our latest ad."
2649,1,5,41,47,1.148936170212766,0.06066790909183939,527,Greetings stranger. Why yes yes I've heard of ancestry dot com.
2649,1,5,41,47,1.148936170212766,0.06066790909183939,527,"Hi, we're here to make an enigmatic circle in your wheat field."
2649,1,5,41,47,1.148936170212766,0.06066790909183939,527,E.T. said we could trust you.
2649,2,3,42,47,1.148936170212766,0.06786504677504616,527,We're interested in opening a farm-to-zilxort restaurant
2649,2,3,42,47,1.148936170212766,0.06786504677504616,527,I'm from Monsanto.
2649,0,7,40,47,1.148936170212766,0.05249310253140096,527,Best darn arugula in the galaxy!
2649,1,5,41,47,1.148936170212766,0.06066790909183939,527,Don't worry... only half of us are genetically modified.
2649,2,3,42,47,1.148936170212766,0.06786504677504616,527,Good news! We left Obama's birth certificate on Pluto and built a wall around it.
2649,1,5,41,47,1.148936170212766,0.06066790909183939,527,"TAKE ME TO YOU LEA -- oh, never mind."
2649,1,5,41,47,1.148936170212766,0.06066790909183939,527,I've been waiting so long for this moment that it feels like light years.
2649,1,5,41,47,1.148936170212766,0.06066790909183939,527,Have I got a cookbook for YOU!!
2649,1,5,41,47,1.148936170212766,0.06066790909183939,527,Your turn to pick where we put a crop circle.
2649,3,1,43,47,1.148936170212766,0.07436890448287321,527,We're from the government and we're here to help.
2649,1,5,41,47,1.148936170212766,0.06066790909183939,527,Hi -- We heard all about your marvelous corn.
2649,1,5,41,47,1.148936170212766,0.06066790909183939,527,"Is your farm insured against space aliens? If not, do I have a deal for you..."
2649,3,1,43,47,1.148936170212766,0.07436890448287321,527,"Tell the Donald, we can't wait any longer."
2649,2,3,42,47,1.148936170212766,0.06786504677504616,527,Thanks so much for deciding to use the GMO seed! We're finding that we get much better mileage and the engines run cleaner with your corn.
2649,1,5,41,47,1.148936170212766,0.06066790909183939,527,"We're new to the neighborhood, where is the nearest Walmart?"
2649,1,5,41,47,1.148936170212766,0.06066790909183939,527,"With the illegals gone, we heard you needed farm hands"
2649,3,1,43,47,1.148936170212766,0.07436890448287321,527,Ted is having second thoughts about his chose of “Spacebnb” for lodging.
2649,1,5,41,47,1.148936170212766,0.06066790909183939,527,"It's been light-years, I'm your distant cousin Sid."
2649,1,5,41,47,1.148936170212766,0.06066790909183939,527,Pleasetake me to your planet. Its an election year here.
2649,1,5,41,47,1.148936170212766,0.06066790909183939,527,Happy Halloween
2649,1,5,41,47,1.148936170212766,0.06066790909183939,527,Thanks but your planet is a little too polluted for us to invade.
2649,1,5,41,47,1.148936170212766,0.06066790909183939,527,"We saw that you just moved in a couple hundred millennia ago and wanted to say, 'Hello.'"
2649,0,7,40,47,1.148936170212766,0.05249310253140096,527,Fly me to the moon and let me play among the stars.......
2649,1,5,41,47,1.148936170212766,0.06066790909183939,527,"Don't be sad, Pholutel. We warned you how they felt about unregistered aliens."
2649,1,5,41,47,1.148936170212766,0.06066790909183939,527,"You ain't seen nothin' yet, Mr. Organic Farmer!"
2649,1,5,41,47,1.148936170212766,0.06066790909183939,527,"Howdy, I rather thought his wall couldn't keep you out."
2649,1,5,41,47,1.148936170212766,0.06066790909183939,527,"On your survey, I'm looking for ""Excellent."""
2649,0,7,40,47,1.148936170212766,0.05249310253140096,527,Interesting. I guess you could say we're universavores.
2649,1,5,41,47,1.148936170212766,0.06066790909183939,527,Got time for a drink?
2649,2,3,42,47,1.148936170212766,0.06786504677504616,527,President? Sure you have my vote!
2649,1,5,41,47,1.148936170212766,0.06066790909183939,527,"You come to take us to California, mister?"
2826,3,0,38,41,1.146341463414634,0.08235094154211772,527,Are you bringing your daughter Mr. Farmer?
2827,1,5,42,48,1.1458333333333333,0.059471544937141164,527,Do you have anything without gluten?
2827,1,5,42,48,1.1458333333333333,0.059471544937141164,527,I'm all done mowing your crops.
2827,1,5,42,48,1.1458333333333333,0.059471544937141164,527,"Yes, it will be organic."
2827,1,5,42,48,1.1458333333333333,0.059471544937141164,527,"Just wanted to personally apologize for the crop circles, sir. Such amateur work. Interns, you know."
2827,1,5,42,48,1.1458333333333333,0.059471544937141164,527,We can offer you plenty of leg room.
2827,0,7,41,48,1.1458333333333333,0.05148145136372289,527,"Good to see you again, where do you want the GMO's?"
2827,1,5,42,48,1.1458333333333333,0.059471544937141164,527,Welcome! Your place at the center of the table is ready.
2827,2,3,43,48,1.1458333333333333,0.06650856696625959,527,"No worries, our special procedures are completely covered by Obamacare."
2827,3,1,44,48,1.1458333333333333,0.07286915878889004,527,"Just go with it, Jethro. We're remaking The Wizard of Oz."
2827,2,3,43,48,1.1458333333333333,0.06650856696625959,527,No...it's Iowa.
2827,0,7,41,48,1.1458333333333333,0.05148145136372289,527,So Canada's not taking in any more refugees post-election?
2827,2,3,43,48,1.1458333333333333,0.06650856696625959,527,"Hold on... Before we go, let me grab my cow."
2827,2,3,43,48,1.1458333333333333,0.06650856696625959,527,"......did he send you here to help with the fences? If not, could you give me a lift in to town?"
2827,2,3,43,48,1.1458333333333333,0.06650856696625959,527,You must be The Farmer in the Dell.We have a wife for you.
2827,1,5,42,48,1.1458333333333333,0.059471544937141164,527,"Have no fear. I'm just here to make T479 (or ""earth"" as you call it) great again."
2827,1,5,42,48,1.1458333333333333,0.059471544937141164,527,"Greetings! I'm the ""Never Trump"" candidate you've been waiting for."
2827,1,5,42,48,1.1458333333333333,0.059471544937141164,527,"We appreciate your interest, but we're waiting for someone named Trump who promised to build our new Cloud tower."
2827,1,5,42,48,1.1458333333333333,0.059471544937141164,527,"I'm Caleb, here to fix your tractor beam."
2827,0,7,41,48,1.1458333333333333,0.05148145136372289,527,"Welcome and congratulations, you lucky fellow! You're our one billionth visitor!"
2827,1,5,42,48,1.1458333333333333,0.059471544937141164,527,I heard you're looking for more acreage.
2827,0,7,41,48,1.1458333333333333,0.05148145136372289,527,"You need not worry sir, she's right inside!"
2827,0,7,41,48,1.1458333333333333,0.05148145136372289,527,We welcomed all Trump refugees.
2827,1,5,42,48,1.1458333333333333,0.059471544937141164,527,"""Take you to OUR leader""? ""Are you sure you have the right planet""?"
2827,2,3,43,48,1.1458333333333333,0.06650856696625959,527,We can compesate you for the crop circles in your wheat field.
2827,1,5,42,48,1.1458333333333333,0.059471544937141164,527,"Hey, nobody would be picking you up out here if it weren't for Uber."
2827,2,3,43,48,1.1458333333333333,0.06650856696625959,527,"Rest assured this is a peanut -free flight, now come aboard!"
2827,2,3,43,48,1.1458333333333333,0.06650856696625959,527,Yes Auntie Em is this way.
2827,1,5,42,48,1.1458333333333333,0.059471544937141164,527,Remember that drawing in your hayfield a few years ago? We're back!
2827,2,3,43,48,1.1458333333333333,0.06650856696625959,527,"Howdy partner, it's been a dang long trip."
2827,1,5,42,48,1.1458333333333333,0.059471544937141164,527,It's a pleasure to finally meet the biggest winner of our 'Crop Circle Caption ' contests.
2827,0,7,41,48,1.1458333333333333,0.05148145136372289,527,I've gotta go. There's a recall on the brakes. Sorry about the circles man.
2827,2,3,43,48,1.1458333333333333,0.06650856696625959,527,Howdy neighbor! Name's Chet over from Astro Crop Duster.
2827,1,5,42,48,1.1458333333333333,0.059471544937141164,527,Of course genetically modified corn is safe!
2827,0,7,41,48,1.1458333333333333,0.05148145136372289,527,I was just on my way to ask you if I could borrow a cup of sugar?
2827,2,3,43,48,1.1458333333333333,0.06650856696625959,527,Are you accepting refugees from Trump-torn America?
2827,1,5,42,48,1.1458333333333333,0.059471544937141164,527,"Good news! We're here to help with your harvest. And the really good news, we're not subject to federal or state minimum wage."
2827,2,3,43,48,1.1458333333333333,0.06650856696625959,527,Have a feeling you're not in Kansas any more?
2827,1,5,42,48,1.1458333333333333,0.059471544937141164,527,"Hi, there! I'm your new seed company rep."
2827,1,5,42,48,1.1458333333333333,0.059471544937141164,527,You found a needle in my haystack?
2827,0,7,41,48,1.1458333333333333,0.05148145136372289,527,We like to know where our food comes from.
2827,1,5,42,48,1.1458333333333333,0.059471544937141164,527,"Gort barada nikto. Nanu nanu. Eep opp ork ah-ah . . . heh heh, just kidding, rube"
2827,2,3,43,48,1.1458333333333333,0.06650856696625959,527,Afternoon stranger. Are you from the FBI or the CIA?
2827,1,5,42,48,1.1458333333333333,0.059471544937141164,527,"Pleased to meet you, but could you turn down your lights? Your flying saucer is waking up my cows."
2827,1,5,42,48,1.1458333333333333,0.059471544937141164,527,"Oh, no, please! Mr. Alien was my father."
2827,1,5,42,48,1.1458333333333333,0.059471544937141164,527,... just dropping off the new prescription for Mr. Trump.
2827,1,5,42,48,1.1458333333333333,0.059471544937141164,527,"Welcome, we look forward to putting some weight on you."
2827,1,5,42,48,1.1458333333333333,0.059471544937141164,527,"I have the book you ordered, sir. Come on in. It's called 'To Serve Man.'"
2827,2,3,43,48,1.1458333333333333,0.06650856696625959,527,Welcome to a haven from the upcoming election.
2827,2,3,43,48,1.1458333333333333,0.06650856696625959,527,"Greetings, Earthling Agrarian. The government of my planet sent me to help you!"
2827,2,3,43,48,1.1458333333333333,0.06650856696625959,527,My name is Krzyxx and I'll be your server
2827,1,5,42,48,1.1458333333333333,0.059471544937141164,527,Congratulations! You're the one hundredth alien to land in my cornfield!
2827,1,5,42,48,1.1458333333333333,0.059471544937141164,527,You called?
2827,1,5,42,48,1.1458333333333333,0.059471544937141164,527,"Don't worry, I've had my shots."
2880,1,5,43,49,1.1428571428571428,0.05832118435198043,527,"I tried at the next place over, but they were out."
2880,0,7,42,49,1.1428571428571428,0.050507627227610534,527,Don't worry. We're seasonal workers and we will NEVER claim permanent immigration status.
2880,1,4,37,42,1.1428571428571428,0.0644049739048166,527,"Hi, I suppose you're here about those unsightly crop circles..."
2880,1,5,43,49,1.1428571428571428,0.05832118435198043,527,I heard you were part of the farm-to-flying saucers movement. Can you help a guy out?
2880,2,3,44,49,1.1428571428571428,0.06520506636966264,527,Welcome..We Amish always welcome others to join our community..
2880,1,5,43,49,1.1428571428571428,0.05832118435198043,527,Rest assured this ride is way better than Space Mountain.
2880,1,5,43,49,1.1428571428571428,0.05832118435198043,527,"No, I'm with the Federation Government, not the Federal Government."
2880,1,5,43,49,1.1428571428571428,0.05832118435198043,527,Let me show you the coolest feature...it transforms into a tractor!
2888,2,2,39,43,1.1395348837209303,0.07122869869716944,527,Step right in sweet thing!
2888,2,2,39,43,1.1395348837209303,0.07122869869716944,527,Hi Farmer Brown we need you to help us develop a new species.
2888,0,6,37,43,1.1395348837209303,0.05346670079545209,527,Are you Plan C in case of overcrowding in Canada?
2888,1,4,38,43,1.1395348837209303,0.06297704189640278,527,Greetings! We are eager to serve you.
2888,0,6,37,43,1.1395348837209303,0.05346670079545209,527,Congratulations on your first Uber rideshare!
2893,0,6,38,44,1.1363636363636365,0.05233358898302985,527,"Here's your first CSA box but, hey, I'm a little worried about your carbon footprint."
2893,0,6,38,44,1.1363636363636365,0.05233358898302985,527,Thanks for letting us park here.
2893,1,4,39,44,1.1363636363636365,0.06161077006722115,527,Greetings! We heard you might be able to fill our tank with ethanol?
2893,1,4,39,44,1.1363636363636365,0.06161077006722115,527,We are here to repossess you.
2893,2,2,40,44,1.1363636363636365,0.06966325746551968,527,The wall didn't even slow me down.
2893,1,4,39,44,1.1363636363636365,0.06161077006722115,527,"Mars? About 10,000 miles up, left at the 3rd star, straight ahead."
2893,1,4,39,44,1.1363636363636365,0.06161077006722115,527,Dinner tonight is farm-to-table and completely GMO.
2893,0,6,38,44,1.1363636363636365,0.05233358898302985,527,Take me to your Party leader. I'd like to teach him a thing or two about aliens.
2893,1,4,39,44,1.1363636363636365,0.06161077006722115,527,"Sorry John, no can do. All our abductions are guaranteed non-GMO, certified organic and hormone free."
2893,1,4,39,44,1.1363636363636365,0.06161077006722115,527,Many thanks. I don't think I could have made it another parsec without fresh eggs.
2893,1,4,39,44,1.1363636363636365,0.06161077006722115,527,"Yes, we are here to probe you. Which presidential candidate are you supporting?"
2893,2,2,40,44,1.1363636363636365,0.06966325746551968,527,"Welcome to the Interstellar Love Boat where true ""galaxial"" bliss awaits you!"
2893,1,4,39,44,1.1363636363636365,0.06161077006722115,527,You're just in time to be supper.
2893,1,4,39,44,1.1363636363636365,0.06161077006722115,527,"Earthling, what do you mean by ""third-party candidate""?"
2893,1,4,39,44,1.1363636363636365,0.06161077006722115,527,Greetings earthling farmhand. The job will entail terraforming your atmosphere to 99% nitrogen.
2893,1,4,39,44,1.1363636363636365,0.06161077006722115,527,"The Wall is powerless against us, too!"
2893,0,6,38,44,1.1363636363636365,0.05233358898302985,527,Great! Maybe you can teach Matt Damon how to grow more than just potatoes?
2893,2,2,40,44,1.1363636363636365,0.06966325746551968,527,"You can trust me, this won't hurt a bit. Plus, you won't remember a thing."
2893,2,2,40,44,1.1363636363636365,0.06966325746551968,527,"Congratulations, you have won a free trip to an unknown galaxy far far away."
2893,1,4,39,44,1.1363636363636365,0.06161077006722115,527,Yes I'm the one who made the crop circles.
2893,1,4,39,44,1.1363636363636365,0.06161077006722115,527,"Nice yo meet you too, but you just ruined my crop circle."
2893,1,4,39,44,1.1363636363636365,0.06161077006722115,527,"Hey there, you're parked in my spot!"
2893,0,6,38,44,1.1363636363636365,0.05233358898302985,527,We are just going to be circling around your crops for a while
2893,1,4,39,44,1.1363636363636365,0.06161077006722115,527,Greetings! I've heard so much about Planet Trump. The best planet in the universe!
2893,1,4,39,44,1.1363636363636365,0.06161077006722115,527,We're here to see your crop circles.
2893,2,2,40,44,1.1363636363636365,0.06966325746551968,527,Independence day? I voted to REMAIN in Europe
2893,0,6,38,44,1.1363636363636365,0.05233358898302985,527,Sure! Just coffee...
2893,1,4,39,44,1.1363636363636365,0.06161077006722115,527,Trump's right! There's too much outsourcing.
2893,0,6,38,44,1.1363636363636365,0.05233358898302985,527,Is it too late to pick up some sweet jersey corn?
2893,2,2,40,44,1.1363636363636365,0.06966325746551968,527,"Excuse me sir, do you have a moment to talk about the environment?"
2893,1,4,39,44,1.1363636363636365,0.06161077006722115,527,I am yor Farmers Only .com rep
2893,1,4,39,44,1.1363636363636365,0.06161077006722115,527,We are glad you booked your space travel through UFO Uber!
2893,1,4,39,44,1.1363636363636365,0.06161077006722115,527,I don't think I'm in Kansas anymore.
2893,0,6,38,44,1.1363636363636365,0.05233358898302985,527,"Remember the equations I taught you, Jim. Your species' survival depends on it."
2893,2,2,40,44,1.1363636363636365,0.06966325746551968,527,C'mon in. UFO does stand for Unbelievable Farming Options.
2893,1,4,39,44,1.1363636363636365,0.06161077006722115,527,So glad to meet a real person. I get tired of all those actors.
2893,1,4,39,44,1.1363636363636365,0.06161077006722115,527,"I'm sorry, this is a no-parking zone."
2930,1,4,40,45,1.1333333333333333,0.06030226891555274,527,Don't worry. I can assure you that Donald Trump is not even on our radar.
2930,1,4,40,45,1.1333333333333333,0.06030226891555274,527,It is true -- you came after we built it!!
2930,0,6,39,45,1.1333333333333333,0.05124707431905384,527,Just dropped by to let you know it's all GMO.
2930,2,2,41,45,1.1333333333333333,0.06816498108607269,527,"No, I am not an actor from ""Lost in Space,"" but we are ready for you to visit us - permanently!"
2930,3,0,42,45,1.1333333333333333,0.07521014330903551,527,I've been authorized to offer free planetwide eternal energy in exchange for Kate Upton.
2930,2,2,41,45,1.1333333333333333,0.06816498108607269,527,"Why no, Mr. Crosby. Actually, I'm a Presbyterian."
2930,2,2,41,45,1.1333333333333333,0.06816498108607269,527,"Greetings, we would have been here sooner but, for a moment there, we mistook Donald Trump's hair for your crop circle."
2930,1,4,40,45,1.1333333333333333,0.06030226891555274,527,"Nick, We received your distress signal about Trump. Looks like it is time he comes home before he ruins another planet."" ""We appreciate your help on this Za-Zahalaatta Bali."
2930,1,4,40,45,1.1333333333333333,0.06030226891555274,527,"Welcome alien, we think you'll buy this Stairway to Heaven."
2930,1,4,40,45,1.1333333333333333,0.06030226891555274,527,How ya gonna keep ‘em down on the farm…?
2930,0,6,39,45,1.1333333333333333,0.05124707431905384,527,Don't worry. I'll be back after the elections.
2930,1,4,40,45,1.1333333333333333,0.06030226891555274,527,And did I already mention the miles you can get on this thing?
2930,1,4,40,45,1.1333333333333333,0.06030226891555274,527,Greetings! We are desperately trying to locate a lost android. Have you seen a DONALD 2016?
2930,1,4,40,45,1.1333333333333333,0.06030226891555274,527,We are here as your friends. Can you teach us to grow corn and tobacco?
2930,1,4,40,45,1.1333333333333333,0.06030226891555274,527,Welcome! The parties in back... where are the 'hoes'?
2930,2,2,41,45,1.1333333333333333,0.06816498108607269,527,"It's a deal - 500,000 pounds of GMO veggies for 500,000 Euros."
2930,1,4,40,45,1.1333333333333333,0.06030226891555274,527,A15? That's on your right. Window seat. Thanks for checking your bag.
2930,1,4,40,45,1.1333333333333333,0.06030226891555274,527,"I wanted to give you my card: ""We buy ugly houses."""
2930,0,6,39,45,1.1333333333333333,0.05124707431905384,527,Thanks for the ride.
2930,1,4,40,45,1.1333333333333333,0.06030226891555274,527,Bring me back after the election or drop me off in Canada. Whatever works.
2930,2,2,41,45,1.1333333333333333,0.06816498108607269,527,Greetings! We were exepcting you For dinner.
2930,0,6,39,45,1.1333333333333333,0.05124707431905384,527,The only thing I'm here to probe is your country's fascination for a candidate who wants to keep out aliens.
2930,2,2,41,45,1.1333333333333333,0.06816498108607269,527,"Hello, welcome to the neighborhood. Ah, no worries, I am not that guy. My name is McDonald. I only scare people when I make crop circles with my tractor."
2930,1,4,40,45,1.1333333333333333,0.06030226891555274,527,"I'm from the planet Uber, want a lift?"
2930,1,4,40,45,1.1333333333333333,0.06030226891555274,527,Howdy neighbor! I just bought the McDonald farm.
2930,1,4,40,45,1.1333333333333333,0.06030226891555274,527,"See, I warmed up my hands so the probe will be less unpleasant for you."
2930,1,4,40,45,1.1333333333333333,0.06030226891555274,527,"We're trying a farmer-to-table thing tonight. Kidding! Get in here, ya big lug."
2930,0,6,39,45,1.1333333333333333,0.05124707431905384,527,"Well, I suppose this was inevitable after NAFTA and the TPP."
2930,0,6,39,45,1.1333333333333333,0.05124707431905384,527,Probed . . eh . . pleased to meet you.
2930,1,4,40,45,1.1333333333333333,0.06030226891555274,527,Welcome aboard. Our planet loves immigrants.
2930,0,6,39,45,1.1333333333333333,0.05124707431905384,527,We wish to learn more this government subsidy you exist on.
2930,2,2,41,45,1.1333333333333333,0.06816498108607269,527,Don't worry. This trip is going to be out of this world.
2930,2,2,41,45,1.1333333333333333,0.06816498108607269,527,Sorry. I thought it said CASUAL not COSMO attire.
2930,1,4,40,45,1.1333333333333333,0.06030226891555274,527,It's been fun. Don't call us. We'll call you.
2930,1,4,40,45,1.1333333333333333,0.06030226891555274,527,"Your field has been selected to receive a free picture from Crop Circles, International."
2930,1,4,40,45,1.1333333333333333,0.06030226891555274,527,We've heard much about your Shoofly pie.
2930,1,4,40,45,1.1333333333333333,0.06030226891555274,527,"'Ya furgot the missus."""
2930,2,2,41,45,1.1333333333333333,0.06816498108607269,527,"Hi, We're from the planet common sense. We're here to save you from American politics!"
2930,1,4,40,45,1.1333333333333333,0.06030226891555274,527,"Thanks for all the crops circles, sorry for the delay"
2930,1,4,40,45,1.1333333333333333,0.06030226891555274,527,Ever heard of farm-to-spaceship?
2930,1,4,40,45,1.1333333333333333,0.06030226891555274,527,Finally a non-Mexican non-Muslim willing to visit the United States of Trump.
2930,0,6,39,45,1.1333333333333333,0.05124707431905384,527,"We had a soft landing thanks to your haystacks,."
2930,1,4,40,45,1.1333333333333333,0.06030226891555274,527,We have come to your planet to serve man. Have you ever considered purchasing a retirement annuity?
2930,1,4,40,45,1.1333333333333333,0.06030226891555274,527,So glad you came - I don't want to be in Kansas anymore.
2930,1,4,40,45,1.1333333333333333,0.06030226891555274,527,"Congratulations, you're our final contestant!"
2930,1,4,40,45,1.1333333333333333,0.06030226891555274,527,"""Welcome to the Cornrow Art Institute!'"
2930,1,4,40,45,1.1333333333333333,0.06030226891555274,527,"Hello, I’m from the government, and I’m here to help."
2930,1,4,40,45,1.1333333333333333,0.06030226891555274,527,"Glad ya back, Luke. Since ya been gone Emylou's had twins, Grandma's gout's been actin' up and the mule's gone lame."
2930,1,4,40,45,1.1333333333333333,0.06030226891555274,527,"Sorry to bother, but I could not find organic food anywhere else!"
2930,1,4,40,45,1.1333333333333333,0.06030226891555274,527,"Hey, Cousin Jethro! This Virtual Reality Technology keeps getting better and better and more real. You gotta to try these goggles."
2930,0,6,39,45,1.1333333333333333,0.05124707431905384,527,We heard you have openings for produce pickers.
2930,1,4,40,45,1.1333333333333333,0.06030226891555274,527,"No, I'm not here about the fracking"
2930,1,4,40,45,1.1333333333333333,0.06030226891555274,527,"We were looking for the one called Trump, but you seem comparable."
2930,0,6,39,45,1.1333333333333333,0.05124707431905384,527,I hope you know hydroponics.
2930,2,2,41,45,1.1333333333333333,0.06816498108607269,527,So this is what the clerk meant when he said the new fertilizer would make my garden out of this world.
2930,0,6,39,45,1.1333333333333333,0.05124707431905384,527,Congratulations. You've just won an all expense paid trip.
2930,1,4,40,45,1.1333333333333333,0.06030226891555274,527,[Insert joke about probing Uranus and send me my prize.]
2930,1,4,40,45,1.1333333333333333,0.06030226891555274,527,"So, how far do you want to get away from Trump?"
2930,1,4,40,45,1.1333333333333333,0.06030226891555274,527,Ready for exotic locations and strange wildlife? We’re going to Staten Island!
2930,1,4,40,45,1.1333333333333333,0.06030226891555274,527,My leader wants to pay you for those circles in your wheat.
2930,1,4,40,45,1.1333333333333333,0.06030226891555274,527,I'm E.T.'s uncle. He had to stay behind to take his final exams.
2930,1,4,40,45,1.1333333333333333,0.06030226891555274,527,Do you know how to grow potatoes?
2930,0,6,39,45,1.1333333333333333,0.05124707431905384,527,"Hey, nice meeting you ahead of the apocalypse!"
2930,1,4,40,45,1.1333333333333333,0.06030226891555274,527,"Take me to your lea--oh, God, why even bother with that crap in America these days, am I right?"
2930,1,4,40,45,1.1333333333333333,0.06030226891555274,527,"A lot of you are moving to Canada, but we’re glad to have you."
2930,1,4,40,45,1.1333333333333333,0.06030226891555274,527,"Nice to meet the backbone of America, my name is Zohn and I'm running for president."
2930,1,4,40,45,1.1333333333333333,0.06030226891555274,527,"Of course I'm pleased to meet you, it's just that I made certain assumptions when I heard, 'If you build it, he will come.'"
2930,1,4,40,45,1.1333333333333333,0.06030226891555274,527,Where's your daughter ?
2930,1,4,40,45,1.1333333333333333,0.06030226891555274,527,Help us get the news out! We don't do rectal probes.
2930,0,6,39,45,1.1333333333333333,0.05124707431905384,527,"Human abduction is easier than many people may think, they're so curious and intelligent they just walk in."
2930,1,4,40,45,1.1333333333333333,0.06030226891555274,527,We haven't had enough rain either. It must be this global and beyond warming thing.
2930,2,2,41,45,1.1333333333333333,0.06816498108607269,527,"Welcome,mr trump will see you now"
2930,0,6,39,45,1.1333333333333333,0.05124707431905384,527,Welcome! Your Buggy Got an Upgrade!
2930,2,2,41,45,1.1333333333333333,0.06816498108607269,527,We may have to stop meeting like this. I'm starting to get calls from an Agent K.
2930,1,4,40,45,1.1333333333333333,0.06030226891555274,527,"Glad you made it over the wall. I'm a non-resident alien too."""
2930,1,4,40,45,1.1333333333333333,0.06030226891555274,527,"At last, the real creator of the crop circles was revealed."
2930,1,4,40,45,1.1333333333333333,0.06030226891555274,527,Welcome. Can you keep a secret?
2930,1,4,40,45,1.1333333333333333,0.06030226891555274,527,"Welcome to the Convention, Sir! Super-delegates to the left..."""
2930,2,2,41,45,1.1333333333333333,0.06816498108607269,527,"So, if I show up at the Republican convention, do you I'd be detained for being an illegal alien?"
2930,0,6,39,45,1.1333333333333333,0.05124707431905384,527,"Don't worry, I'm not genetically modified."
2930,1,4,40,45,1.1333333333333333,0.06030226891555274,527,The farm subsidies are out of this world.
2930,0,6,39,45,1.1333333333333333,0.05124707431905384,527,You're cornfed? Excellent! Non-GMO?
2930,1,4,40,45,1.1333333333333333,0.06030226891555274,527,We're back for more apple butter.
2930,0,6,39,45,1.1333333333333333,0.05124707431905384,527,"Goodbye Gork, sorry your race voted for ALIENEXIT but I guess you had to before Trump puts up the dome."
2930,1,4,40,45,1.1333333333333333,0.06030226891555274,527,"Greetings, Earthling! Take me to your Cleveland!"
2930,1,4,40,45,1.1333333333333333,0.06030226891555274,527,Manure for Mars wants you on our team.
2930,0,6,39,45,1.1333333333333333,0.05124707431905384,527,We have some notes on your crop circles.
3017,1,4,41,46,1.1304347826086956,0.059047967499893814,527,Good news Earth Farmer! None of us are gluten-intolerant!
3017,1,4,41,46,1.1304347826086956,0.059047967499893814,527,"That costume looks so real!"" ""I know. It's all makeup including the ship."
3017,0,6,40,46,1.1304347826086956,0.05020437123388051,527,"Give me your tired, your poor, your huddled masses yearning to beam free."
3017,1,4,41,46,1.1304347826086956,0.059047967499893814,527,I am from the Government and am here to help
3017,0,6,40,46,1.1304347826086956,0.05020437123388051,527,Is this heaven?
3017,1,4,41,46,1.1304347826086956,0.059047967499893814,527,Trump Escape Shuttle?
3017,1,4,41,46,1.1304347826086956,0.059047967499893814,527,Greetings serfling
3017,2,2,42,46,1.1304347826086956,0.06672964888823965,527,Really? You've been expecting us?
3017,0,6,40,46,1.1304347826086956,0.05020437123388051,527,"Love your corn mazes, man."
3017,0,6,40,46,1.1304347826086956,0.05020437123388051,527,Welcome aboard sir. Cocktail to steady your nerves ?
3017,0,6,40,46,1.1304347826086956,0.05020437123388051,527,"Broke down, huh? Well, okay. But, you'll have to share the bed with my beautiful daughter ..."
3017,1,4,41,46,1.1304347826086956,0.059047967499893814,527,"Sorry, we have to leave before Monsanto takes control of us, too!"
3017,2,2,42,46,1.1304347826086956,0.06672964888823965,527,Welcome! We buy GMO
3017,0,6,40,46,1.1304347826086956,0.05020437123388051,527,Can you tell me where the nearest Starbucks is?
3017,1,4,41,46,1.1304347826086956,0.059047967499893814,527,Whazzup!
3017,2,2,42,46,1.1304347826086956,0.06672964888823965,527,Is that a gingbrzek you're wearing? Or are you just glad to see me?
3017,0,6,40,46,1.1304347826086956,0.05020437123388051,527,"I've been following your crop designs and came to say I'm a big fan of your work. Say, do you have a restroom nearby I could use?"
3017,0,6,40,46,1.1304347826086956,0.05020437123388051,527,Oh. How disappointing. I expected a little girl with a dog.
3017,2,2,42,46,1.1304347826086956,0.06672964888823965,527,We understand your need to be away from the pesticides.
3017,2,2,42,46,1.1304347826086956,0.06672964888823965,527,Thank God you're here! It's hoedown sing along night and we have forgotten what comes after E-I-E-I-.....!
3017,0,6,40,46,1.1304347826086956,0.05020437123388051,527,Wait until you see this spot from up above. It's our finest work yet.
3017,1,4,41,46,1.1304347826086956,0.059047967499893814,527,"I'm sorry, but we only accept our kind."
3017,1,4,41,46,1.1304347826086956,0.059047967499893814,527,"Hi, my name is Marty McFly III. What's yours?"
3017,1,4,41,46,1.1304347826086956,0.059047967499893814,527,You mean the leader of our farm bureau?
3017,0,6,40,46,1.1304347826086956,0.05020437123388051,527,So good to meet a true crop circle aficionado
3017,1,4,41,46,1.1304347826086956,0.059047967499893814,527,Just remember if your cought without a green card you don't work here!
3017,1,4,41,46,1.1304347826086956,0.059047967499893814,527,That's one giant leap for a man destined to explain an unexplained aerial phenomenon.
3017,1,4,41,46,1.1304347826086956,0.059047967499893814,527,"I assure you, our Farm to Table venture will prove to be quite profitable. See you next week."
3017,2,2,42,46,1.1304347826086956,0.06672964888823965,527,We agree to provide farm to space delivery.
3017,0,6,40,46,1.1304347826086956,0.05020437123388051,527,Ugh! So I guess that orange guy won.
3017,1,4,41,46,1.1304347826086956,0.059047967499893814,527,Thanks for agreeing to meet with us privately. We're hoping to avoid export duties.
3017,1,4,41,46,1.1304347826086956,0.059047967499893814,527,I came a long way to see what your price of sweet corn is.
3017,2,2,42,46,1.1304347826086956,0.06672964888823965,527,I am holier-than-thou.
3017,0,6,40,46,1.1304347826086956,0.05020437123388051,527,"This may sound weird, but I really enjoy your Instagram feed"
3017,0,6,40,46,1.1304347826086956,0.05020437123388051,527,I have light-years to go before I sleep.
3017,0,6,40,46,1.1304347826086956,0.05020437123388051,527,Now it's your turn to make crop circles on our planet!
3017,0,6,40,46,1.1304347826086956,0.05020437123388051,527,"Hi I'm Hank, your Uber driver. Where are we off to today?"
3017,0,6,40,46,1.1304347826086956,0.05020437123388051,527,We've been hearing good things about sorghum.
3017,0,6,40,46,1.1304347826086956,0.05020437123388051,527,"Elliott, it's so good to see you again!"
3017,1,4,41,46,1.1304347826086956,0.059047967499893814,527,"Is this heaven? No, it's Iowa."
3017,1,4,41,46,1.1304347826086956,0.059047967499893814,527,Trump was just elected.
3017,1,4,41,46,1.1304347826086956,0.059047967499893814,527,I am so glad to be in Iowa. Let me tell you about my plans if I am elected President of the Galaxy.
3017,0,6,40,46,1.1304347826086956,0.05020437123388051,527,Congratulations on being the millionth Earthling we've visited! We brought you some moonshine!
3017,1,4,41,46,1.1304347826086956,0.059047967499893814,527,Why don't you come on in and I'll show you my cookbook.
3017,0,6,40,46,1.1304347826086956,0.05020437123388051,527,Thanks for agreeing to be interviewed for Crop Circular
3017,1,4,41,46,1.1304347826086956,0.059047967499893814,527,"We have heard of Donald Trump, welcome."
3017,1,4,41,46,1.1304347826086956,0.059047967499893814,527,"Costner? Sure, I know 'Ol Kev. What's that whack job up to now?"
3017,3,0,43,46,1.1304347826086956,0.07361405854608867,527,I'm here to pick up my CSA share.
3017,1,4,41,46,1.1304347826086956,0.059047967499893814,527,"Sorry, we came here to escape our own Trump."
3017,0,6,40,46,1.1304347826086956,0.05020437123388051,527,Can I count on your vote in the pan-galactic election?
3017,1,4,41,46,1.1304347826086956,0.059047967499893814,527,"After intense mutilation, your cow and I are happily married."
3017,1,4,41,46,1.1304347826086956,0.059047967499893814,527,Fear not earthling- the anal probe stories are just anti-alien bias
3017,1,4,41,46,1.1304347826086956,0.059047967499893814,527,Don't worry. We only use technology for interstellar travel.
3017,0,6,40,46,1.1304347826086956,0.05020437123388051,527,Hey! So you're their leader! Great to meet you!
3017,0,6,40,46,1.1304347826086956,0.05020437123388051,527,"""That's a nice firm handshake you have there""."
3017,0,6,40,46,1.1304347826086956,0.05020437123388051,527,I can't believe I am the first to sign up for your farm to outerspace dining experience!
3017,1,4,41,46,1.1304347826086956,0.059047967499893814,527,Welcome aboard genuine Hillbilly.
3017,1,4,41,46,1.1304347826086956,0.059047967499893814,527,We can definitely use you in crop circles.
3017,1,4,41,46,1.1304347826086956,0.059047967499893814,527,Glad we can count on your vote. It's about time we elect a political far-outsider who can make the galaxy great again.
3017,0,6,40,46,1.1304347826086956,0.05020437123388051,527,And you can rest easy knowing that our interviews are now 100% probe-free.
3017,1,4,41,46,1.1304347826086956,0.059047967499893814,527,We want to talk to you about farm-to-Mars.
3017,1,4,41,46,1.1304347826086956,0.059047967499893814,527,"For sake of our galaxy, we need to talk to you about your vote"
3017,0,6,40,46,1.1304347826086956,0.05020437123388051,527,Ready for Hillary?
3017,1,4,41,46,1.1304347826086956,0.059047967499893814,527,"Thanks for your help. Don't tell anybody about this. Trust me, it's a waste of your time."
3017,2,2,42,46,1.1304347826086956,0.06672964888823965,527,Don't look so surprised. We've had millions of requests since Donald Trump was elected President.
3017,2,2,42,46,1.1304347826086956,0.06672964888823965,527,"Yup, I'm the President of the World!"
3017,0,6,40,46,1.1304347826086956,0.05020437123388051,527,"Welcome aboard, trusting caffeine-free Amish delicacy."
3017,2,2,42,46,1.1304347826086956,0.06672964888823965,527,"It was the biggest, brightest silo Farmer Brown had ever seen."
3017,2,2,42,46,1.1304347826086956,0.06672964888823965,527,Vote Hilary.
3017,1,4,41,46,1.1304347826086956,0.059047967499893814,527,Omg it's an illegal alien
3017,2,2,42,46,1.1304347826086956,0.06672964888823965,527,"You will like our planet better, we have no Donald Trump."
3017,2,2,42,46,1.1304347826086956,0.06672964888823965,527,We had no idea your world was advanced enough to have CSAs!
3017,2,2,42,46,1.1304347826086956,0.06672964888823965,527,I appreciate you showing up to help me pick my crops.
3017,1,4,41,46,1.1304347826086956,0.059047967499893814,527,"Oh good, you're just in time for tomorrow's farmer's market. We have produce that is out of this world."
3017,0,6,40,46,1.1304347826086956,0.05020437123388051,527,"Our galaxy was built on you, the family farmer. Vote Qwarqx in November!"
3017,0,6,40,46,1.1304347826086956,0.05020437123388051,527,This really is the field of DREAM.
3017,1,4,41,46,1.1304347826086956,0.059047967499893814,527,Whadda you mean I'm being deported??
3017,0,6,40,46,1.1304347826086956,0.05020437123388051,527,"Build it and they will come? Well, I'm here"
3017,0,6,40,46,1.1304347826086956,0.05020437123388051,527,You're the first to arrive. Did you bring the barbecue?
3017,1,4,41,46,1.1304347826086956,0.059047967499893814,527,"Nice to meet you, Jim! So sorry about the crop circle."
3017,1,4,41,46,1.1304347826086956,0.059047967499893814,527,"""Greetings, I've been recruited to ask that you vote for me instead of someone called 'Donald'."
3017,1,4,41,46,1.1304347826086956,0.059047967499893814,527,You make corn oil? Take me to your liter.
3017,1,4,41,46,1.1304347826086956,0.059047967499893814,527,See you next week!
3017,0,6,40,46,1.1304347826086956,0.05020437123388051,527,Thanks; the parking rates here are so much more reasonable than in town.
3017,0,6,40,46,1.1304347826086956,0.05020437123388051,527,"Pleased to meet you, I wonder if you can help us? - we've run out of Zucchini."
3017,0,6,40,46,1.1304347826086956,0.05020437123388051,527,This farm fresh to table thing might not work for you.
3017,0,6,40,46,1.1304347826086956,0.05020437123388051,527,Congratulations on winning Publisher's Clearing House.
3017,0,6,40,46,1.1304347826086956,0.05020437123388051,527,"Say, do you have any extra eggs?"
3017,0,6,40,46,1.1304347826086956,0.05020437123388051,527,You are running circles around the other guys we hired.
3017,2,2,42,46,1.1304347826086956,0.06672964888823965,527,"I know this cliché, but we need your help."
3017,0,6,40,46,1.1304347826086956,0.05020437123388051,527,I'm sorry but you've been shunned
3017,0,6,40,46,1.1304347826086956,0.05020437123388051,527,Greetings from the creator of your crop circle!
3017,0,6,40,46,1.1304347826086956,0.05020437123388051,527,"Greetings, I'm Xrtykl, with Crop Circles ""R"" Us."
3017,1,4,41,46,1.1304347826086956,0.059047967499893814,527,And what about the corn--is it knee high?
3017,2,2,42,46,1.1304347826086956,0.06672964888823965,527,"Did I just prove Buddhism wrong, or is this a side effect of my Zoloft?"
3017,1,4,41,46,1.1304347826086956,0.059047967499893814,527,Congratulations! You've been accepted into our farm-to-UFO program!
3017,0,6,40,46,1.1304347826086956,0.05020437123388051,527,Can I interest you in corn futures?
3017,1,4,41,46,1.1304347826086956,0.059047967499893814,527,"Punctual as ever, and dinner is ready."
3017,0,6,40,46,1.1304347826086956,0.05020437123388051,527,"I'm sorry, but I don't hire unregistered aliens."
3017,1,4,41,46,1.1304347826086956,0.059047967499893814,527,You barely made it! The Trump inauguration starts in twenty minutes.
3017,2,2,42,46,1.1304347826086956,0.06672964888823965,527,Quickly! It's only four months until the election!
3017,1,4,41,46,1.1304347826086956,0.059047967499893814,527,We've got plenty of scientists but no farmers!
3017,1,4,41,46,1.1304347826086956,0.059047967499893814,527,"""Welcome, Rural Earthling. We are from Southern Mars, so please come aboard and set a spell."" [underline ""Southern""]"
3017,0,6,40,46,1.1304347826086956,0.05020437123388051,527,"No, the Dorothy thing wasn't us."
3017,1,4,41,46,1.1304347826086956,0.059047967499893814,527,I am happy to meet you. I am so sorry we missed the Hootenanny. But please come on in and meet the wife and kids.
3017,3,0,43,46,1.1304347826086956,0.07361405854608867,527,"Have you heard of the candidate Bing Yu? I guess you could say we're ""pro"" him."
3017,1,4,41,46,1.1304347826086956,0.059047967499893814,527,"We're slow to caucus, but light years ahead in tax reform."
3017,1,4,41,46,1.1304347826086956,0.059047967499893814,527,We've got to hurry if you're going to make it as a third party candidate in all 50 states.
3017,2,2,42,46,1.1304347826086956,0.06672964888823965,527,"Greetings, we come in peace seeking life-giving GMOs."
3017,1,4,41,46,1.1304347826086956,0.059047967499893814,527,"""Klaatu barada nikto"", means hello AND goodbye."
3017,1,4,41,46,1.1304347826086956,0.059047967499893814,527,"We're serving humans, and you look well done."
3017,2,2,42,46,1.1304347826086956,0.06672964888823965,527,Is there any possibility of a President Trump where you live?
3017,0,6,40,46,1.1304347826086956,0.05020437123388051,527,So glad you're here for dinner! You saved me a trip to the market!
3017,1,4,41,46,1.1304347826086956,0.059047967499893814,527,"Welcome neighbor, is this one of those IKEA houses?"
3017,1,4,41,46,1.1304347826086956,0.059047967499893814,527,"Promise, no Trump, no Brexit?"
3017,0,6,40,46,1.1304347826086956,0.05020437123388051,527,"Congratulations! You're our 1,000th passenger."
3017,2,2,42,46,1.1304347826086956,0.06672964888823965,527,I'm here from the government and have come to help you.
3017,1,4,41,46,1.1304347826086956,0.059047967499893814,527,"Zeekil Fenker, candidate for Leader of the Galaxy. Damned glad to meet ya."
3017,0,6,40,46,1.1304347826086956,0.05020437123388051,527,Welcome back! I can't wait to show you how well your crop has grown in our planet.
3017,0,6,40,46,1.1304347826086956,0.05020437123388051,527,Farm work? Sure! Crop circles is my specialty.
3017,0,6,40,46,1.1304347826086956,0.05020437123388051,527,I'm sorry.I don'thave that tool.
3017,0,6,40,46,1.1304347826086956,0.05020437123388051,527,"Welcome, we are from planet Kansas."
3017,0,6,40,46,1.1304347826086956,0.05020437123388051,527,FarmersOnly sent me with a special delivery.
3017,0,6,40,46,1.1304347826086956,0.05020437123388051,527,"Clem, hi, thanks for stopping by. Come on in. Listen, don't mention the flux capacitor to LuAnn, it's still kind of a touchy subject."
3017,1,4,41,46,1.1304347826086956,0.059047967499893814,527,"Hi! My name is Zron, and I want to let you know why I support of Hillary Clinton"
3017,1,4,41,46,1.1304347826086956,0.059047967499893814,527,"Frankenstein, D.V.M! Thank goodness you're here! We've been reassembling the cows all wrong!"
3017,1,4,41,46,1.1304347826086956,0.059047967499893814,527,"I'm running for President, since there doesn't seem to be anyone on Earth who is qualified."
3017,1,4,41,46,1.1304347826086956,0.059047967499893814,527,We understand you have been curious about those mysterious crop circles
3017,1,4,41,46,1.1304347826086956,0.059047967499893814,527,Can we pass by NASA so I can Moon them?
3017,1,4,41,46,1.1304347826086956,0.059047967499893814,527,"Please remove your shoes before entering the spaceship, you cannot imagine how hard it is to keep those floors clean."
3017,1,4,41,46,1.1304347826086956,0.059047967499893814,527,if you come they will build it
3017,1,4,41,46,1.1304347826086956,0.059047967499893814,527,May I say how pleasant it is to finally meet you father.
3017,0,6,40,46,1.1304347826086956,0.05020437123388051,527,"We were all out of crop dusters, so you've been given an upgrade."
3017,0,6,40,46,1.1304347826086956,0.05020437123388051,527,Invade? Hack no. I came all this way to attend Trump University!
3017,2,2,42,46,1.1304347826086956,0.06672964888823965,527,"We'd like to talk to you about our new ""farm to planet Gronika tables"" idea."
3017,1,4,41,46,1.1304347826086956,0.059047967499893814,527,"Congratulations. You build it, and we came."
3017,0,6,40,46,1.1304347826086956,0.05020437123388051,527,Welcome spokesman for the beings you call corn.
3017,1,4,41,46,1.1304347826086956,0.059047967499893814,527,Fields Of Dreams 2
3017,1,4,41,46,1.1304347826086956,0.059047967499893814,527,This 'presumptive' election has this town ready to leave for Mars.
3017,0,6,40,46,1.1304347826086956,0.05020437123388051,527,We made a quick stop to buy a dozen eggs. The crew is making a birthday cake for the Captain.
3017,0,6,40,46,1.1304347826086956,0.05020437123388051,527,"Let me tell ya Hank, your sweet corn is out of this world."
3017,2,2,42,46,1.1304347826086956,0.06672964888823965,527,Can I go with you? Trump nominated himself to be his running mate.
3017,1,4,41,46,1.1304347826086956,0.059047967499893814,527,"Congratulations! You're our 143,999th abductee."
3017,0,6,40,46,1.1304347826086956,0.05020437123388051,527,We're 100 percent organic
3017,1,4,41,46,1.1304347826086956,0.059047967499893814,527,"Are you the one who is to come, or should we expect someone else?"
3017,0,6,40,46,1.1304347826086956,0.05020437123388051,527,"Hi John, nice to finally meet you in person. Where would you like me to park?"
3017,0,6,40,46,1.1304347826086956,0.05020437123388051,527,I want to congratulate you on your superb crop circles.
3017,1,4,41,46,1.1304347826086956,0.059047967499893814,527,Have you taken your enema yet?
3017,0,6,40,46,1.1304347826086956,0.05020437123388051,527,Greetings! I have come for your GMO soybeans.
3017,1,4,41,46,1.1304347826086956,0.059047967499893814,527,See you next year Sam. By the way I mixed a little something special in with the sheep.
3017,1,4,41,46,1.1304347826086956,0.059047967499893814,527,We want to open a WholeMars.
3168,0,6,41,47,1.127659574468085,0.04920290896196927,527,Thank you for having me over for dinner.
3168,2,2,43,47,1.127659574468085,0.06535338561028699,527,"Welcome, friend. We're hoping you can show us how to play polly wolly doodle all the day."
3168,1,4,42,47,1.127659574468085,0.057844581686821384,527,We want you for your federal farm subsidy.
3168,0,6,41,47,1.127659574468085,0.04920290896196927,527,"As your House Speaker Ryan said, “There’s much more that unites us than divides us.”"
3168,0,6,41,47,1.127659574468085,0.04920290896196927,527,We're thinking of going organic.
3168,0,6,41,47,1.127659574468085,0.04920290896196927,527,We've come to meet the Father of the Droid.
3168,1,4,42,47,1.127659574468085,0.057844581686821384,527,The last thing I remember is shopping at Costco.
3168,1,4,42,47,1.127659574468085,0.057844581686821384,527,"Sorry, pardner, but the location of Area 51 is highly classified."
3168,3,0,44,47,1.127659574468085,0.0720842173497804,527,Hi I'm apart of the Jehovah's Witness and let me tell you about something that is out of this world
3168,1,4,42,47,1.127659574468085,0.057844581686821384,527,"Take me to Donald Trump, I gotta see it to believe it..."
3168,1,4,42,47,1.127659574468085,0.057844581686821384,527,Welcome to Kansas!
3168,0,6,41,47,1.127659574468085,0.04920290896196927,527,Any chance this thing runs on ethanol?
3168,1,4,42,47,1.127659574468085,0.057844581686821384,527,Mr. Monsanto I presume?
3168,1,4,42,47,1.127659574468085,0.057844581686821384,527,Thank you for agreeing to abduct me from Planet Trump
3168,0,6,41,47,1.127659574468085,0.04920290896196927,527,Can we watch Game of Thrones at your house?
3168,2,2,43,47,1.127659574468085,0.06535338561028699,527,!#^+@?(Universal Translator) Greetings . Can you help with the repair our tractor beam?
3168,1,4,42,47,1.127659574468085,0.057844581686821384,527,"Welcome! Don't wory, we left our probes at home. We just have a penchance for banjo-picking."
3168,2,2,43,47,1.127659574468085,0.06535338561028699,527,"""Take me away from here the political situation is total chaos""."
3168,1,4,42,47,1.127659574468085,0.057844581686821384,527,Greetings earthling...Thanks for meeting with me regarding those crop circles.
3187,2,2,44,48,1.125,0.06403262687852607,527,"ET, EE I EE I O."
3187,2,2,44,48,1.125,0.06403262687852607,527,"Come on Bill, we have your cows in possession."
3187,1,4,43,48,1.125,0.056689086094851654,527,"Sorry about the crop circles, I'm new at this Uber thing."
3187,1,4,43,48,1.125,0.056689086094851654,527,"""Mr. McDonald, I hope you can get our saucer to go 'bzzt bzzt' again, instead of 'clank clank' !"
3191,1,3,37,41,1.1219512195121952,0.06242187264424257,527,"This will hurt, but you won't remember a thing."
3191,0,5,36,41,1.1219512195121952,0.051739520574625435,527,We'll keep your CV on file in case we need to test any more humans.
3191,0,5,36,41,1.1219512195121952,0.051739520574625435,527,"We're not here to takeover over earth, just to take part in your presidential election."
3194,0,6,44,50,1.12,0.046423076597919784,527,Thank you! I'd love to make some circles in the wheat fields.
3195,2,1,39,42,1.119047619047619,0.06986282354917808,527,"~Hey, Brother....Does you Hi-Test contain Methylcyclopentadienyl manganese tricarbonyl?~"
3195,0,5,37,42,1.119047619047619,0.05057601944205112,527,And you won't have to sell the farm to own this baby!
3195,0,5,37,42,1.119047619047619,0.05057601944205112,527,Congratulations! Yo've won the Farmer of the Universe Award.
3195,1,3,38,42,1.119047619047619,0.060986670088086975,527,we're here to ask you to be the Republican Presidential Candidate
3195,0,5,37,42,1.119047619047619,0.05057601944205112,527,We're thrilled that you've chose to join Canada.
3195,2,1,39,42,1.119047619047619,0.06986282354917808,527,We heard your party's leader wants some alien construction.
3195,0,5,37,42,1.119047619047619,0.05057601944205112,527,"Like I said on the phone, we're running a special on crop circles this month only."
3195,0,5,37,42,1.119047619047619,0.05057601944205112,527,"Ah, back in Kansas. Toto will be ecstatic!"
3195,0,5,37,42,1.119047619047619,0.05057601944205112,527,Excellent. Welcome aboard. Let the guys weekend begin!
3195,1,3,38,42,1.119047619047619,0.060986670088086975,527,Welcome aboard Flying Saucer Airlines. Your boarding pass please.
3195,1,3,38,42,1.119047619047619,0.060986670088086975,527,We want to talk to you about those overalls.
3195,1,3,38,42,1.119047619047619,0.060986670088086975,527,"Land sakes, Hank. I still think it woulda been a hell of a lot easier if you just let us help you get the fish bowl off your head."
3195,0,5,37,42,1.119047619047619,0.05057601944205112,527,My wife's a hoarder
3195,0,5,37,42,1.119047619047619,0.05057601944205112,527,And that's why Herald stutters now.
3195,1,3,38,42,1.119047619047619,0.060986670088086975,527,Sorry about the drought. I guess we'll go back to where we came from.
3195,1,3,38,42,1.119047619047619,0.060986670088086975,527,you look exactly like my cousin from Alpha Centari....!
3195,1,3,38,42,1.119047619047619,0.060986670088086975,527,"I'll give you a 9.5 on the landing, however you must understand there is a landing tax to pay for the new alien wall.."
3195,2,1,39,42,1.119047619047619,0.06986282354917808,527,"Yes, we promise to bring you back only AFTER November 8 --- and only if you still want to come back!"
3195,0,5,37,42,1.119047619047619,0.05057601944205112,527,Welcome aboard. We wish to know how you get your government farm subsidies!
3195,2,1,39,42,1.119047619047619,0.06986282354917808,527,Wow. Those are clammy hands.
3195,0,5,37,42,1.119047619047619,0.05057601944205112,527,I like to join your CSA.
3195,0,5,37,42,1.119047619047619,0.05057601944205112,527,Welcome to Earf
3195,1,3,38,42,1.119047619047619,0.060986670088086975,527,'We sought you out specifically after hearing that your produce is super natural.'
3195,2,1,39,42,1.119047619047619,0.06986282354917808,527,We're part of the whole spaceship-to-farm movement.
3195,1,3,38,42,1.119047619047619,0.060986670088086975,527,"Que paso bro. Klaatu barada nikto, and all that."
3195,0,5,37,42,1.119047619047619,0.05057601944205112,527,Welcome! We look forward to your subsidy!
3195,1,3,38,42,1.119047619047619,0.060986670088086975,527,"Come with me, my daughter is waiting for you."
3195,2,1,39,42,1.119047619047619,0.06986282354917808,527,"I've got two words for you, farmer earthling: More eggs!"
3195,0,5,37,42,1.119047619047619,0.05057601944205112,527,"Relax, friend; I haven't used the joy buzzer in over 800 years."
3224,1,3,39,43,1.1162790697674418,0.059615808787130756,527,"Welcome, we're interested in meeting the alien that feeds this planet."
3224,0,5,38,43,1.1162790697674418,0.04946336973228635,527,Let's make the galaxy Great Again !!
3224,1,3,39,43,1.1162790697674418,0.059615808787130756,527,"So, like, you are Canadian?"
3224,0,5,38,43,1.1162790697674418,0.04946336973228635,527,We heard you'll be needing farm labor
3224,0,5,38,43,1.1162790697674418,0.04946336973228635,527,Donald J Trump.
3224,0,5,38,43,1.1162790697674418,0.04946336973228635,527,"So glad we changed it to ""Take us to your follower."""
3224,0,5,38,43,1.1162790697674418,0.04946336973228635,527,Welcome to Kansas. I just can't believe your name is Toto.
3224,1,3,39,43,1.1162790697674418,0.059615808787130756,527,Are you sure you have room....and what about my horse?
3224,0,5,38,43,1.1162790697674418,0.04946336973228635,527,We couldn't help but notice; the Pants! Where did you get them?
3224,1,3,39,43,1.1162790697674418,0.059615808787130756,527,"Yep, you're dying."
3224,1,3,39,43,1.1162790697674418,0.059615808787130756,527,You haven't seen a little guy named ALF have you?
3224,0,5,38,43,1.1162790697674418,0.04946336973228635,527,I was sorta expecting the Jolly Green Giant!
3224,0,5,38,43,1.1162790697674418,0.04946336973228635,527,How about this...I'll give you 500 pounds of corn for one of those cool Alien suits. Does one size fit all?
3224,0,5,38,43,1.1162790697674418,0.04946336973228635,527,"Don't worry, we're GMO-free."
3224,2,1,40,43,1.1162790697674418,0.06827491757164275,527,"Why, yes, I am an expert in thermals and a-kneeling."
3224,1,3,39,43,1.1162790697674418,0.059615808787130756,527,Can you help us? We need to find Grover's Mill.
3224,1,3,39,43,1.1162790697674418,0.059615808787130756,527,always be prepared for the unexpected
3224,1,3,39,43,1.1162790697674418,0.059615808787130756,527,"""Thanks. Happy to be back. Come on in - We're ready. Texas Holdem? And can the Missus whip up some of those buttermilk biscuits again?"
3224,0,5,38,43,1.1162790697674418,0.04946336973228635,527,The Grey Aliens told us your people make an amazing apple butter!
3224,1,3,39,43,1.1162790697674418,0.059615808787130756,527,"Yum, main course at Farm to Table!"
3224,0,5,38,43,1.1162790697674418,0.04946336973228635,527,"It has been an honour, sir, making circles in your field."
3224,1,3,39,43,1.1162790697674418,0.059615808787130756,527,I'm sorry we have a ban on all Earthlings until we can figure out what's going on.
3224,1,3,39,43,1.1162790697674418,0.059615808787130756,527,We hope you can share the secret of cereal crop rotation.
3224,0,5,38,43,1.1162790697674418,0.04946336973228635,527,"Greetings, earthling. I'm running for Master of the Universe and I'm going to need your vote."
3224,0,5,38,43,1.1162790697674418,0.04946336973228635,527,Thanks for plowing my crops!
3224,1,3,39,43,1.1162790697674418,0.059615808787130756,527,Thanks for the directions — I must have taken the wrong turn for Roswell.
3224,2,1,40,43,1.1162790697674418,0.06827491757164275,527,"Glad you could make it, Jim-now we've got enough for a game if Canasta.....Popet"
3224,1,3,39,43,1.1162790697674418,0.059615808787130756,527,Welcome to the heartland. Are you from the East or West coast?
3224,1,3,39,43,1.1162790697674418,0.059615808787130756,527,So you're the leader? Nice to finally meet.
3224,1,3,39,43,1.1162790697674418,0.059615808787130756,527,"Yah, sure, you're right about that, Sven, 'this is crazy' and 'no one will ever believe' you."
3224,1,3,39,43,1.1162790697674418,0.059615808787130756,527,Do you have a change of clothes for dinner?
3224,0,5,38,43,1.1162790697674418,0.04946336973228635,527,"Don't worry, everyone will believe you. Before we take off we'll flush our tank."
3224,1,3,39,43,1.1162790697674418,0.059615808787130756,527,"howdy fella , you must be here bout that asbestos stuff"
3224,1,3,39,43,1.1162790697674418,0.059615808787130756,527,"Don't worry. We'll add you to the wait list and contact you if there's any cancellations to our citizenship list, or if our wall comes down."
3224,0,5,38,43,1.1162790697674418,0.04946336973228635,527,Welcome! We have received your inquiry on Ancestry.com
3224,0,5,38,43,1.1162790697674418,0.04946336973228635,527,"I'm your date, thanks farmers only.com"
3224,0,5,38,43,1.1162790697674418,0.04946336973228635,527,"Don't worry. Now that Cleveland has their title, we will focus on the Cubbies."
3224,2,1,40,43,1.1162790697674418,0.06827491757164275,527,We want to make America great again
3224,1,3,39,43,1.1162790697674418,0.059615808787130756,527,Good evening Earthling – I've come here to serve as your much improved scarecrow.
3224,0,5,38,43,1.1162790697674418,0.04946336973228635,527,Thanks for buying Local!
3224,0,5,38,43,1.1162790697674418,0.04946336973228635,527,We'll be in touch.
3224,1,3,39,43,1.1162790697674418,0.059615808787130756,527,We have some great things to try out on your anus.
3224,1,3,39,43,1.1162790697674418,0.059615808787130756,527,We come in peace. And to subsidize your corn production.
3224,2,1,40,43,1.1162790697674418,0.06827491757164275,527,Wow! Uber drivers have really stepped up their game...
3224,1,3,39,43,1.1162790697674418,0.059615808787130756,527,"""Say pal, you a friend of you a foe?"" (var. ""Say pal, you a friend or UFO?"")"
3224,2,1,40,43,1.1162790697674418,0.06827491757164275,527,"Greetings, friend, we're from the USexit campaign."
3224,1,3,39,43,1.1162790697674418,0.059615808787130756,527,"HI! My name's Lennie, and have I got a deal for you!"
3224,1,3,39,43,1.1162790697674418,0.059615808787130756,527,"Come in, come in, Ptatoe Head I presume."
3224,0,5,38,43,1.1162790697674418,0.04946336973228635,527,No carry-ons with you guys too?
3224,0,5,38,43,1.1162790697674418,0.04946336973228635,527,"Hello, Are you GMO friendly?"
3224,2,1,40,43,1.1162790697674418,0.06827491757164275,527,Klaatu barada nikto
3224,0,5,38,43,1.1162790697674418,0.04946336973228635,527,Welcome aboard...we look forward to serving you!
3224,2,1,40,43,1.1162790697674418,0.06827491757164275,527,Hodor.
3224,1,3,39,43,1.1162790697674418,0.059615808787130756,527,"Hi, were hear from the ""Make America Afraid Again"", Illegal Alien Chapter!"
3224,1,3,39,43,1.1162790697674418,0.059615808787130756,527,Haven't we met someplace before?
3224,1,3,39,43,1.1162790697674418,0.059615808787130756,527,Yes it is somewhere over the rainbow!
3224,1,3,39,43,1.1162790697674418,0.059615808787130756,527,"My friend, can your heart stand the shocking facts about the grave robbers from outer space?"""
3224,1,3,39,43,1.1162790697674418,0.059615808787130756,527,"Don't worry, we don't do the probes anymore."
3224,2,1,40,43,1.1162790697674418,0.06827491757164275,527,"You are welcome to come aboard, but you must leave your horse and buggy."
3224,1,3,39,43,1.1162790697674418,0.059615808787130756,527,Wait'll you see how tall the corn is that we planted!
3224,0,5,38,43,1.1162790697674418,0.04946336973228635,527,"I am sorry to ask you to leave, but I told you to leave my daughter alone."
3224,0,5,38,43,1.1162790697674418,0.04946336973228635,527,Are you GMO free?
3224,0,5,38,43,1.1162790697674418,0.04946336973228635,527,"Howdy, come on in and have a piece of pie and sit awhile"
3224,0,5,38,43,1.1162790697674418,0.04946336973228635,527,"Hi, I'm Blxft, the new county agent. I hear you have an invasive pest problem."
3224,1,3,39,43,1.1162790697674418,0.059615808787130756,527,Can you take me to the illegal alien sanctuary?
3224,1,3,39,43,1.1162790697674418,0.059615808787130756,527,You look even better in person. My daughter will be thrilled to meet one of your kind.
3224,0,5,38,43,1.1162790697674418,0.04946336973228635,527,"Take me to your leader. Oh, you won't know that until January?"
3224,0,5,38,43,1.1162790697674418,0.04946336973228635,527,"An alien's and a human's idea of ""the good old days"" tragically aligns."
3224,1,3,39,43,1.1162790697674418,0.059615808787130756,527,"""Mr. Peters, excuse us for intruding. But, is that freshly-squeezed lemonade on your front porch?"
3224,0,5,38,43,1.1162790697674418,0.04946336973228635,527,"Welcome, we've come to find out how you made your wind mill"
3224,0,5,38,43,1.1162790697674418,0.04946336973228635,527,"We,ve got to stop meeting this way."
3224,1,3,39,43,1.1162790697674418,0.059615808787130756,527,I'm guessing you're from Venus? I'm from Saturn
3224,1,3,39,43,1.1162790697674418,0.059615808787130756,527,I thought aliens didn't need spacesuits.
3224,1,3,39,43,1.1162790697674418,0.059615808787130756,527,Greetings! Take me to your Kardashian.
3224,2,1,40,43,1.1162790697674418,0.06827491757164275,527,I'd like to tell you about Bernie Sanders!
3224,1,3,39,43,1.1162790697674418,0.059615808787130756,527,"I'm your new laborer. There's no wall that can keep me out."""
3224,1,3,39,43,1.1162790697674418,0.059615808787130756,527,"Yes, you should leave before Donald Trump threatens to build a wall around the universe."
3224,2,1,40,43,1.1162790697674418,0.06827491757164275,527,"You have your wall, we have our asteroid belt- we'll see who keeps out who. or You forget this stupid wall thing to keep out aliens and we'll consider dismantling our asteroid belt."
3224,0,5,38,43,1.1162790697674418,0.04946336973228635,527,My first trip and I'm already a frequent flier?
3224,0,5,38,43,1.1162790697674418,0.04946336973228635,527,"Yes, I heard you were inquiring about crop circles."
3224,1,3,39,43,1.1162790697674418,0.059615808787130756,527,"Welcome farmer, I'm from New York City."
3224,1,3,39,43,1.1162790697674418,0.059615808787130756,527,"Don't be afraid, you've won the referendum. England doesn't have to be part of earth anymore. Huzzah!"
3224,0,5,38,43,1.1162790697674418,0.04946336973228635,527,Does this mean that I don't have to pretend to like corn anymore?
3224,1,3,39,43,1.1162790697674418,0.059615808787130756,527,"Vote for me, and I promise not to destroy your planet."
3224,2,1,40,43,1.1162790697674418,0.06827491757164275,527,Welcome. I've been sent here to find a suitable presidential candidate.
3224,1,3,39,43,1.1162790697674418,0.059615808787130756,527,"Dude, like, I'm looking for Area 51, Dude. Can ya give me directions Chief?"
3224,0,5,38,43,1.1162790697674418,0.04946336973228635,527,I'm just a guy from New York in an Audi. You must not get out much.
3224,1,3,39,43,1.1162790697674418,0.059615808787130756,527,Are you going up or down?
3224,0,5,38,43,1.1162790697674418,0.04946336973228635,527,I'm just here to ask for your daughter's hand.
3224,1,3,39,43,1.1162790697674418,0.059615808787130756,527,"Come on in, you look spaced out."
3224,1,3,39,43,1.1162790697674418,0.059615808787130756,527,I was wondering if you could park in the laneway?
3224,1,3,39,43,1.1162790697674418,0.059615808787130756,527,"Mr. Monsanto, it's a pleasure to meet you"
3224,0,5,38,43,1.1162790697674418,0.04946336973228635,527,"Howdy, neighbor -- I'd like to buy 28 billion bushels of corn."
3224,1,3,39,43,1.1162790697674418,0.059615808787130756,527,"Well, your crop circles are ready for another season."
3224,0,5,38,43,1.1162790697674418,0.04946336973228635,527,Welcome aboard! We want you to lead our heirloom tomato program.
3224,1,3,39,43,1.1162790697674418,0.059615808787130756,527,We have your genetically modified seed in the rear.
3224,1,3,39,43,1.1162790697674418,0.059615808787130756,527,I know your in an election year. I have come to save you !
3224,1,3,39,43,1.1162790697674418,0.059615808787130756,527,"If you're serious about a hostile takeover, you're going to need a firmer handshake."
3224,1,3,39,43,1.1162790697674418,0.059615808787130756,527,Summer movie release weekends are a little too action packed for me.
3224,0,5,38,43,1.1162790697674418,0.04946336973228635,527,I apologize if this UFO leaves crop circles on your GMOs.
3224,0,5,38,43,1.1162790697674418,0.04946336973228635,527,Greetings Earth Man... we'd like to Seed You
3224,0,5,38,43,1.1162790697674418,0.04946336973228635,527,No probe. We just want to ask if we can make a crop circle.
3224,1,3,39,43,1.1162790697674418,0.059615808787130756,527,Unsightly crop circle formations? Our technicians are UFO-trained.
3327,0,5,39,44,1.1136363636363635,0.048398332783092544,527,I thought voting for Trump was a good idea at the time
3327,0,5,39,44,1.1136363636363635,0.048398332783092544,527,Y'all Democrats or Republicans?
3327,1,3,40,44,1.1136363636363635,0.05830506897872825,527,Hate to cut this short but I got a close encounter with Dreyfus at Devils Tower in ten minutes.
3327,0,5,39,44,1.1136363636363635,0.048398332783092544,527,"No, that's some other guy. I don't care about your atomic weapons."
3327,1,3,40,44,1.1136363636363635,0.05830506897872825,527,So you're the tin man and I'm the scarecrow?
3327,1,3,40,44,1.1136363636363635,0.05830506897872825,527,"Welcome to Bleep Blorp. I think you'll appreciate our farm to table concept, and the trout tonight is out of this world."
3327,1,3,40,44,1.1136363636363635,0.05830506897872825,527,Do you have any fresh corn on the cob ?
3327,1,3,40,44,1.1136363636363635,0.05830506897872825,527,"Surprising, yes, but I'm from Texas too."
3327,0,5,39,44,1.1136363636363635,0.048398332783092544,527,I'm going to make you an offer for your planet you can't refuse.
3327,0,5,39,44,1.1136363636363635,0.048398332783092544,527,"Once the terrible Emperor Zorp was elected I knew I had to expatriate Mars, and move some place safe, like Earth."
3327,1,3,40,44,1.1136363636363635,0.05830506897872825,527,How'd y'all make it over the wall?
3327,1,3,40,44,1.1136363636363635,0.05830506897872825,527,"NOT TO STEP ON YOUR TOES BUT, WE;RE SELLING LETTUCE,APPLES;CORN AND PEACHES."
3327,0,5,39,44,1.1136363636363635,0.048398332783092544,527,Mr. Musk sent me to pick up some farm-fresh kale. Tell me Bezos didn't get here first.
3327,1,3,40,44,1.1136363636363635,0.05830506897872825,527,Howdy. I reckoned you might need something.
3327,0,5,39,44,1.1136363636363635,0.048398332783092544,527,"Congratulations, your crop spirals just got you a free buffet and round-trip to Houston!"
3327,1,3,40,44,1.1136363636363635,0.05830506897872825,527,You don't recognize us? We were the pigs that got into your GMO corncrib.
3327,1,3,40,44,1.1136363636363635,0.05830506897872825,527,It's nice to finally meet you.
3327,1,3,40,44,1.1136363636363635,0.05830506897872825,527,Welcome aboard the good ship lollipop!
3327,1,3,40,44,1.1136363636363635,0.05830506897872825,527,"Welcome aboard. You're not funny. Stop trying. Find something else to believe in. Or just stop thinking, period. Your flaws don't make you beautiful. They just make you flawed."
3327,2,1,41,44,1.1136363636363635,0.06675749786387705,527,Heard about the free trial painless hair-removal.
3327,0,5,39,44,1.1136363636363635,0.048398332783092544,527,Welcome. It's a harvester of a different kind.
3327,1,3,40,44,1.1136363636363635,0.05830506897872825,527,"Mr. Trump wants your vote."""
3327,1,3,40,44,1.1136363636363635,0.05830506897872825,527,"Yes, I'm your Uber cab."
3327,1,3,40,44,1.1136363636363635,0.05830506897872825,527,Take me to your GOP leader
3327,0,5,39,44,1.1136363636363635,0.048398332783092544,527,"Welcome to your complimentary stay at our resort community. Why don't you freshen up, we'll take a look at a few units and discuss financing."
3327,1,3,40,44,1.1136363636363635,0.05830506897872825,527,"Wait, you're not Elliot!"
3327,0,5,39,44,1.1136363636363635,0.048398332783092544,527,"Farm-to-table cookbook? Ha! No, we're here to try and seduce your daughter."
3327,0,5,39,44,1.1136363636363635,0.048398332783092544,527,Welcome aboard! We have sheep on our planet too.
3327,0,5,39,44,1.1136363636363635,0.048398332783092544,527,Come on in. How about a nice cup of Plutonium?
3327,0,5,39,44,1.1136363636363635,0.048398332783092544,527,Welcome. We've been Organic since 1972.
3327,0,5,39,44,1.1136363636363635,0.048398332783092544,527,Do you mind if we carve a few crop circles in your corn field?
3327,1,3,40,44,1.1136363636363635,0.05830506897872825,527,Welcome to Martian Idol Star Contest
3327,2,1,41,44,1.1136363636363635,0.06675749786387705,527,"If you really can churn butter, welcome aboard. We hate dry toast."
3327,1,3,40,44,1.1136363636363635,0.05830506897872825,527,"Thanks for answering our You Tube ad. If you pass the hydroponics test, you've got the job."
3327,0,5,39,44,1.1136363636363635,0.048398332783092544,527,Please come in. Matt Damon has been waiting to meet you.
3327,0,5,39,44,1.1136363636363635,0.048398332783092544,527,I think this is taking role play too far
3327,0,5,39,44,1.1136363636363635,0.048398332783092544,527,"Thanks for helping us bring ""Farm to Table"" to a whole new level!"
3327,1,3,40,44,1.1136363636363635,0.05830506897872825,527,Sorry we don't sell directly to the public
3327,1,3,40,44,1.1136363636363635,0.05830506897872825,527,Hi! We're Brexit too!
3327,0,5,39,44,1.1136363636363635,0.048398332783092544,527,"I think I've been watching too much Star Trek! Wake up, Vern. Wake UP!"
3327,1,3,40,44,1.1136363636363635,0.05830506897872825,527,"Now, about those cattle of yours..."
3327,1,3,40,44,1.1136363636363635,0.05830506897872825,527,x#!h*~^t
3327,1,3,40,44,1.1136363636363635,0.05830506897872825,527,Weary traveler seeking farmer with good personality. Must be open to intergalactic travel. No smokers.
3327,1,3,40,44,1.1136363636363635,0.05830506897872825,527,Thanks! Space regulations require 10% ethanol from corn.
3327,1,3,40,44,1.1136363636363635,0.05830506897872825,527,"Sure, come on board. We'd be happy to help you look for Dorothy and Toto."
3327,0,5,39,44,1.1136363636363635,0.048398332783092544,527,Now serving farm to UFO
3327,0,5,39,44,1.1136363636363635,0.048398332783092544,527,"Welcome! And if you believe this, I have a bridge I want to sell you in Brooklyn"
3327,0,5,39,44,1.1136363636363635,0.048398332783092544,527,I'd be more'n happy to help ya with yer crop circles.
3327,0,5,39,44,1.1136363636363635,0.048398332783092544,527,Cavity search-sure we can find a needle in your haystack.
3327,1,3,40,44,1.1136363636363635,0.05830506897872825,527,"Hi, planet M.Santo here to personally thank you for your business."
3327,2,1,41,44,1.1136363636363635,0.06675749786387705,527,"No, no, I said make a left! at Venus, not a right."
3327,0,5,39,44,1.1136363636363635,0.048398332783092544,527,"Sorry we're a bit late, wifi connectivity is a little shaky around Proxima Centauri. Pleasure to have you on board today. Thanks for tapping our app."
3327,1,3,40,44,1.1136363636363635,0.05830506897872825,527,I noticed you are growing High-amylose Class V corn. I hope you are getting a decent premium.
3327,1,3,40,44,1.1136363636363635,0.05830506897872825,527,What is the current price of corn on this planet?
3327,0,5,39,44,1.1136363636363635,0.048398332783092544,527,We have much to learn about this thing called stubble .
3327,2,1,41,44,1.1136363636363635,0.06675749786387705,527,"Well Clinton and Trump are your nominees, Mars can't possibly be worse."
3327,1,3,40,44,1.1136363636363635,0.05830506897872825,527,"We have neither oxygen nor real gravity and since you've sucked both out of the Promised Land, you'll love it on Mars, Mr. GOP."
3327,0,5,39,44,1.1136363636363635,0.048398332783092544,527,So we will finish your crop-dusting in a light second.
3327,0,5,39,44,1.1136363636363635,0.048398332783092544,527,"Oh, don't look so surprised neighbor. I only live in the next galaxy!"
3327,0,5,39,44,1.1136363636363635,0.048398332783092544,527,Question 12: Have you or any family members traveling with you been in close proximity of livestock?
3327,0,5,39,44,1.1136363636363635,0.048398332783092544,527,"Anywhere else it would be a media nightmare - television coverage, cell phone pictures, posting to the internet; not to mention nowhere to land."
3327,0,5,39,44,1.1136363636363635,0.048398332783092544,527,So you're the guy behind those pumpkins
3327,0,5,39,44,1.1136363636363635,0.048398332783092544,527,"My name is Mwrxthp, and I'm asking for your vote."
3327,0,5,39,44,1.1136363636363635,0.048398332783092544,527,Welcome aboard the Outer Space Alternative Living Program. No Second Amendment. No Walls. No Fox News.
3327,1,3,40,44,1.1136363636363635,0.05830506897872825,527,"No leader yet, but I can introduce you to the candidates."
3327,1,3,40,44,1.1136363636363635,0.05830506897872825,527,"Hi, my name is Zingon and I'm calling on you and your neighbors with an interesting article . ."
3327,0,5,39,44,1.1136363636363635,0.048398332783092544,527,Take me with you. Trump won the election.
3327,1,3,40,44,1.1136363636363635,0.05830506897872825,527,Let's get out of this world.
3327,0,5,39,44,1.1136363636363635,0.048398332783092544,527,The farmers market was yesterday.
3327,0,5,39,44,1.1136363636363635,0.048398332783092544,527,Sorry your wife can't make it for dinner
3327,0,5,39,44,1.1136363636363635,0.048398332783092544,527,Because nobody will believe you..........that's why
3327,0,5,39,44,1.1136363636363635,0.048398332783092544,527,"Sure, but 'round these parts you won't meet too many fans of genetically modified crops."
3327,1,3,40,44,1.1136363636363635,0.05830506897872825,527,"Trust me, don't tell anyone we were here."
3327,2,1,41,44,1.1136363636363635,0.06675749786387705,527,"Sorry, we're all out of fresh eggs."
3327,1,3,40,44,1.1136363636363635,0.05830506897872825,527,Hey man was in the neighborhood just wanted to drop by and apologize for doing that artwork in your cornfield. I. Hope we didn't ruin your crop.
3327,1,3,40,44,1.1136363636363635,0.05830506897872825,527,Been farmin' long?
3327,1,3,40,44,1.1136363636363635,0.05830506897872825,527,And you welcome losers?
3327,0,5,39,44,1.1136363636363635,0.048398332783092544,527,Organically? No; we're probe-biotic.
3327,0,5,39,44,1.1136363636363635,0.048398332783092544,527,I know; reality used to be a friend of mine too!
3327,0,5,39,44,1.1136363636363635,0.048398332783092544,527,Do you happen to have a bathroom and fabric scissors?
3327,1,3,40,44,1.1136363636363635,0.05830506897872825,527,"No, I did not see CLOSE ENCOUNTERS OF THE THIRD KIND, but..."
3327,1,3,40,44,1.1136363636363635,0.05830506897872825,527,E-I-E-I-O to you Old McDonald.
3327,0,5,39,44,1.1136363636363635,0.048398332783092544,527,"Come on in. We are going to slap you around a little bit, and then drop you off in Roswell, New Mexico."
3327,1,3,40,44,1.1136363636363635,0.05830506897872825,527,Hi! We're hoping you can help us adjust to a down to Earth lifestyle.
3327,0,5,39,44,1.1136363636363635,0.048398332783092544,527,Sorry to meet like this—my papers aren’t exactly in order.
3327,0,5,39,44,1.1136363636363635,0.048398332783092544,527,"Honey, do you have a tip for the deliver boy."
3327,1,3,40,44,1.1136363636363635,0.05830506897872825,527,howdy from Mars.
3327,0,5,39,44,1.1136363636363635,0.048398332783092544,527,"On plant Zuto, we are all about fresh veggies"
3327,1,3,40,44,1.1136363636363635,0.05830506897872825,527,"Sure-the land sounds good, but what about the subsidies?"
3327,0,5,39,44,1.1136363636363635,0.048398332783092544,527,"Crop circles? No, I saw your add on Craigslist."
3327,0,5,39,44,1.1136363636363635,0.048398332783092544,527,"I am Shrib, Independent Party, and I want to be your president."
3327,0,5,39,44,1.1136363636363635,0.048398332783092544,527,"Never thought you'd be leasing water rights from a Martian, did you?"
3327,1,3,40,44,1.1136363636363635,0.05830506897872825,527,Come on in. We found your cow.
3327,0,5,39,44,1.1136363636363635,0.048398332783092544,527,"I'm hoping you can settle an argument. Which did come first, the chicken or the egg?"
3327,1,3,40,44,1.1136363636363635,0.05830506897872825,527,Take you to my leader? Ummm....
3327,0,5,39,44,1.1136363636363635,0.048398332783092544,527,You can find me on LinkedIn...we'll let you know if anything opens up
3327,1,3,40,44,1.1136363636363635,0.05830506897872825,527,I'm surprised your big truck didn't have better safety features.
3327,1,3,40,44,1.1136363636363635,0.05830506897872825,527,"Kal-El, I presume?"
3327,0,5,39,44,1.1136363636363635,0.048398332783092544,527,Your leader cleared it. He calls it 'eminent domain.'
3327,0,5,39,44,1.1136363636363635,0.048398332783092544,527,"Farewell friend, and see you next time or until the cows come home."
3327,0,5,39,44,1.1136363636363635,0.048398332783092544,527,"Hello, you may own the land but I own the mineral rights."
3327,0,5,39,44,1.1136363636363635,0.048398332783092544,527,"Nice to meet you, I'm Marvin."
3327,0,5,39,44,1.1136363636363635,0.048398332783092544,527,"We are huge fans of your GMO corn and soy beans, but we need to explain about the wind farms."
3327,0,5,39,44,1.1136363636363635,0.048398332783092544,527,Welcome aboard! Good idea to book now and beat the November 8 rush.
3327,0,5,39,44,1.1136363636363635,0.048398332783092544,527,"Great, you can help me bring in my corn."
3327,1,3,40,44,1.1136363636363635,0.05830506897872825,527,We're here to pay for that wall.
3327,1,3,40,44,1.1136363636363635,0.05830506897872825,527,Hello--my--name--is--Dorothy
3327,0,5,39,44,1.1136363636363635,0.048398332783092544,527,Suggest you tell Ma you won't be back for supper.
3327,1,3,40,44,1.1136363636363635,0.05830506897872825,527,"Right this way, Mr. President."
3327,0,5,39,44,1.1136363636363635,0.048398332783092544,527,We saw your farm featured on Ancient Aliens and wanted to invite you to try our dinner rolls.
3327,0,5,39,44,1.1136363636363635,0.048398332783092544,527,"Our family, the Trumps, is looking for a lost relation."
3327,0,5,39,44,1.1136363636363635,0.048398332783092544,527,"Welcome aboard. With the upcoming Presidential election, demand for the express shuttle to Mars has been greater than ever."
3327,1,3,40,44,1.1136363636363635,0.05830506897872825,527,We could use your help for a little problem with whitefly.
3327,0,5,39,44,1.1136363636363635,0.048398332783092544,527,So you're not the one that's been making circles in my cornfield?
3327,1,3,40,44,1.1136363636363635,0.05830506897872825,527,"Welcome, but you almost missed the caucus."
3327,0,5,39,44,1.1136363636363635,0.048398332783092544,527,"Are you the one with the green thumbs, the one the oracles foretold?"
3327,1,3,40,44,1.1136363636363635,0.05830506897872825,527,"It's not what you do, it's who you know."
3327,1,3,40,44,1.1136363636363635,0.05830506897872825,527,"It's nice to finally meet you, I've heard so much about you!"
3327,1,3,40,44,1.1136363636363635,0.05830506897872825,527,Thanks. I'll fly left at the barn.
3327,1,3,40,44,1.1136363636363635,0.05830506897872825,527,"Thank you, all the other spots were taken."
3327,0,5,39,44,1.1136363636363635,0.048398332783092544,527,Do you have enough corn to export this year?
3327,0,5,39,44,1.1136363636363635,0.048398332783092544,527,We come in peace to offer an opportunity for a hardworking hairless simian like yourself. Have you ever heard of intergalactic reverse funnel financing?
3327,1,3,40,44,1.1136363636363635,0.05830506897872825,527,I came as soon as I heard about Donald Trump. That's crazy!
3327,2,1,41,44,1.1136363636363635,0.06675749786387705,527,I think we might be able to exchange seeds.
3327,1,3,40,44,1.1136363636363635,0.05830506897872825,527,How are you at driving in circles?
3327,0,5,39,44,1.1136363636363635,0.048398332783092544,527,"No, it's not my ego - - it's just that I think you're very sexy."
3327,1,3,40,44,1.1136363636363635,0.05830506897872825,527,Are you here for the test drive?
3327,1,3,40,44,1.1136363636363635,0.05830506897872825,527,Then we agreed: we exchange places
3327,0,5,39,44,1.1136363636363635,0.048398332783092544,527,Congratulations! Your farm has been chosen as the site of our next crop circle.
3327,1,3,40,44,1.1136363636363635,0.05830506897872825,527,Oh you're back! I've been guarding this space ship much too long for you.
3327,1,3,40,44,1.1136363636363635,0.05830506897872825,527,We like to harvest too.
3327,0,5,39,44,1.1136363636363635,0.048398332783092544,527,We grow beings just like you.
3327,0,5,39,44,1.1136363636363635,0.048398332783092544,527,I wanted to thank you in person — the crop circles are lovely. They add an artistic flair to an otherwise boring field of corn.
3327,1,3,40,44,1.1136363636363635,0.05830506897872825,527,Are you GMO'd? We only take those earthlings presently.
3327,2,1,41,44,1.1136363636363635,0.06675749786387705,527,"So yeah, sorry about those crops circles and thanks for not getting the authorities involved. I wouls blow earth up before dealing with an insurance company... and hey, tell the wife thanks for the lemonade."
3327,1,3,40,44,1.1136363636363635,0.05830506897872825,527,"Vop glarto! Pindo piegap, ieieee vappa-zoink!"""
3327,0,5,39,44,1.1136363636363635,0.048398332783092544,527,"Greetings, Earthling. We have Shoofly pie!"
3327,1,3,40,44,1.1136363636363635,0.05830506897872825,527,But you know I can't dress like that.
3327,1,3,40,44,1.1136363636363635,0.05830506897872825,527,"Ah, gee, thanks man. I'll try it. Click my heels and keep repeating ""There's no place like home."" Thanks!"
3327,0,5,39,44,1.1136363636363635,0.048398332783092544,527,"Just so you know, we're anti GMO."
3327,0,5,39,44,1.1136363636363635,0.048398332783092544,527,"Excuse me sir, do I get the immigrant treatment?"
3327,1,3,40,44,1.1136363636363635,0.05830506897872825,527,What kind of design do you want this week?
3327,1,3,40,44,1.1136363636363635,0.05830506897872825,527,It's an honor to meet someone that gets over 400 bushels of corn to the acre.
3327,1,3,40,44,1.1136363636363635,0.05830506897872825,527,Welcome to another corny oufit.
3327,1,3,40,44,1.1136363636363635,0.05830506897872825,527,We came to learn your seceret recipe for corn squeezins!
3327,1,3,40,44,1.1136363636363635,0.05830506897872825,527,"With Trump in the White House, and Canada officially closing the border, I was hoping that your planet has mild weather?"
3327,1,3,40,44,1.1136363636363635,0.05830506897872825,527,"Trust me, intergalactic agro will be good for all of us..."
3327,0,5,39,44,1.1136363636363635,0.048398332783092544,527,"Welcome to Trumpville. You can't come in, however."
3327,0,5,39,44,1.1136363636363635,0.048398332783092544,527,"It's all organic and non-irradiated, right?"
3327,1,3,40,44,1.1136363636363635,0.05830506897872825,527,Matt Damon needs your help!!!!
3327,0,5,39,44,1.1136363636363635,0.048398332783092544,527,"""Klaatu barada nikto"" to you too. How was the ride?"
3327,1,3,40,44,1.1136363636363635,0.05830506897872825,527,"Well, howdy there, Zortt. And, no, not to worry...that was just a movie."
3327,1,3,40,44,1.1136363636363635,0.05830506897872825,527,Y'mind movin' this contraption nearer t' house? You done run off ma Holsteins.
3327,1,3,40,44,1.1136363636363635,0.05830506897872825,527,"GMO? No, it's a UFO."
3327,1,3,40,44,1.1136363636363635,0.05830506897872825,527,That's one hell of a grain silo you got yourself here buddy.
3327,0,5,39,44,1.1136363636363635,0.048398332783092544,527,"Oh, I forgot. Do you validate parking?"
3327,0,5,39,44,1.1136363636363635,0.048398332783092544,527,Serving you will be our pleasure. Perchance did you bring Chianti?
3327,1,3,40,44,1.1136363636363635,0.05830506897872825,527,"What the hell do you mean, 'Klaatu barada nikto'?"
3327,1,3,40,44,1.1136363636363635,0.05830506897872825,527,Donald Trump? Goodbye!
3327,0,5,39,44,1.1136363636363635,0.048398332783092544,527,25 farm hands at $5 per hour? Deal.
3327,1,3,40,44,1.1136363636363635,0.05830506897872825,527,"Actually, inorganic only."
3327,0,5,39,44,1.1136363636363635,0.048398332783092544,527,"We received your message and we're very flattered but sorry, we just need some space."
3327,0,5,39,44,1.1136363636363635,0.048398332783092544,527,Come on in neighbor. The klatooine paddy frog soup's awaiten.
3327,1,3,40,44,1.1136363636363635,0.05830506897872825,527,We just stopped by to get some organic produce
3327,1,3,40,44,1.1136363636363635,0.05830506897872825,527,"So, what did you think of the crop circle?"
3327,0,5,39,44,1.1136363636363635,0.048398332783092544,527,Howdy! You fellas must be from Monsanto.
3327,1,3,40,44,1.1136363636363635,0.05830506897872825,527,So you're here to serve Man again?
3327,0,5,39,44,1.1136363636363635,0.048398332783092544,527,"Again, I'd like to apologize for that limerick I didn't know you were the miller"
3327,2,1,41,44,1.1136363636363635,0.06675749786387705,527,Hi. I'm Donald. I'm here to put up a wall
3327,1,3,40,44,1.1136363636363635,0.05830506897872825,527,"Howdy, neighbor. Come in and set a spell."
3327,1,3,40,44,1.1136363636363635,0.05830506897872825,527,I'm from the Megellanic group. We only buy local
3327,0,5,39,44,1.1136363636363635,0.048398332783092544,527,"Hi Pa, come on in. We're just examining Ma now."
3327,2,1,41,44,1.1136363636363635,0.06675749786387705,527,"UFO?"" But I've only just got here?"
3327,1,3,40,44,1.1136363636363635,0.05830506897872825,527,You ever picked cotton before?
3501,0,5,40,45,1.1111111111111112,0.047377936967913425,527,Fertilizer taste good.
3501,0,5,40,45,1.1111111111111112,0.047377936967913425,527,We want you to come to Mars to help with our farm program.
3501,1,3,41,45,1.1111111111111112,0.057050590894718936,527,Yes it was me who put the circles in your wheat field
3501,0,5,40,45,1.1111111111111112,0.047377936967913425,527,"Up here, we have 17 flavors of La Croix water."
3501,1,3,41,45,1.1111111111111112,0.057050590894718936,527,"No offense, Visitor from Space... but the whole crop circle thing is getting really old."
3501,0,5,40,45,1.1111111111111112,0.047377936967913425,527,"Yes, we are the caucus, but don't worry, we only come to you every four years."
3501,1,3,41,45,1.1111111111111112,0.057050590894718936,527,Grain Futures.
3501,0,5,40,45,1.1111111111111112,0.047377936967913425,527,"We don't need any chickens, pigs, or corn, but you got any more of that Colorado Special?"
3501,0,5,40,45,1.1111111111111112,0.047377936967913425,527,Don't worry about your cows -- they're safe with us.
3501,1,3,41,45,1.1111111111111112,0.057050590894718936,527,Congrats to our first contestant on Interstellar Jeopardy!
3501,2,1,42,45,1.1111111111111112,0.06530597929391763,527,We have the oxen & the plows... But we need you to teach us how to use them...
3501,0,5,40,45,1.1111111111111112,0.047377936967913425,527,"Partner,your handrail ain't up to code on this planet."
3501,2,1,42,45,1.1111111111111112,0.06530597929391763,527,Welcome to the farm to table movement.
3501,1,3,41,45,1.1111111111111112,0.057050590894718936,527,Welcome aboard. You'll like it on Mars; our election campaign season lasts only one week.
3501,0,5,40,45,1.1111111111111112,0.047377936967913425,527,Hey Fred! Long time no see. Hop in and we’ll go buzz some jackrabbits in Area 51.
3516,1,2,37,40,1.1,0.05991446895152781,527,HAVE I GOT A DEAL FOR YOU!
3517,0,4,37,41,1.0975609756097562,0.046915570882125224,527,Welcome Earthling... We want to show you how we made our planet great again.
3517,2,0,39,41,1.0975609756097562,0.06811824411594605,527,"Trust us, we have no incisions to farm you."
3517,0,4,37,41,1.0975609756097562,0.046915570882125224,527,Hide in here. No one cares about crop circles unless they think I did it.
3517,0,4,37,41,1.0975609756097562,0.046915570882125224,527,"Come on in, you're just in time for lunch!"
3517,1,2,38,41,1.0975609756097562,0.05848575028430145,527,Welcome neighbor. Wife's made a apple pie over ther if ya need a good feed.
3517,1,2,38,41,1.0975609756097562,0.05848575028430145,527,"Glurb freeble zurf pftht, Monsanto."
3517,1,2,38,41,1.0975609756097562,0.05848575028430145,527,We came for the tractor tour of your crop circles.
3517,0,4,37,41,1.0975609756097562,0.046915570882125224,527,Please come in and allow me to introduce you to this year's selection of Monsanto seeds.
3517,0,4,37,41,1.0975609756097562,0.046915570882125224,527,"Your corm makes excellent ethanol, so fill her up and for take-out, I'll need a dozen corn dogs."
3517,1,2,38,41,1.0975609756097562,0.05848575028430145,527,"''Welcome to farming's future, up and clean.''"
3517,0,4,37,41,1.0975609756097562,0.046915570882125224,527,You'll be back in a mere 500 years.
3517,0,4,37,41,1.0975609756097562,0.046915570882125224,527,The space guy wants locally-sourced vegetables for his colony.
3517,0,4,37,41,1.0975609756097562,0.046915570882125224,527,This land is your land
3517,1,2,38,41,1.0975609756097562,0.05848575028430145,527,Howdy! I don't think we've met before.
3517,0,4,37,41,1.0975609756097562,0.046915570882125224,527,We're here to get you out of Dodge.
3517,1,2,38,41,1.0975609756097562,0.05848575028430145,527,Thanks for not bein' like all them other ones that can't stand the sight of a crop without a circle in it!
3517,1,2,38,41,1.0975609756097562,0.05848575028430145,527,"You can sleep in my barn, but you have to stay away from the milking machine."
3517,0,4,37,41,1.0975609756097562,0.046915570882125224,527,"First things first, I will not be able to help you get 'Hamilton' tickets."
3517,1,2,38,41,1.0975609756097562,0.05848575028430145,527,We will give back your GPS on our return trip next week.
3517,0,4,37,41,1.0975609756097562,0.046915570882125224,527,Tell me all about your government's farm subsidies.
3517,1,2,38,41,1.0975609756097562,0.05848575028430145,527,"Alien: ""I'm ready. Take me off into your delusional sunset."""
3517,1,2,38,41,1.0975609756097562,0.05848575028430145,527,Great to meet you man. We're all a big fan of your crop circles. They're really out of this world.
3517,1,2,38,41,1.0975609756097562,0.05848575028430145,527,"""Doesn't matter, Trump or Clinton, betcha' a dollar you'll have to get some kind of vaccination against the entire human race""."
3517,1,2,38,41,1.0975609756097562,0.05848575028430145,527,Are you a good martian or a bad martian?
3517,2,0,39,41,1.0975609756097562,0.06811824411594605,527,"In fact it's not cliche since the old ""farmer's daughter"" joke never involved a spaceship."
3517,1,2,38,41,1.0975609756097562,0.05848575028430145,527,Take me to your farmhand.
3517,1,2,38,41,1.0975609756097562,0.05848575028430145,527,Yes! I sold hula-hoops. How did you know?
3517,1,2,38,41,1.0975609756097562,0.05848575028430145,527,"Welcome, we serve men!"
3517,0,4,37,41,1.0975609756097562,0.046915570882125224,527,My wife was wondering if you could spare a cup of sugar.
3517,1,2,38,41,1.0975609756097562,0.05848575028430145,527,3.141592653598793 . . .
3547,1,2,39,42,1.0952380952380953,0.057123496526633864,527,""" Nice to meet you, now get going before my wife comes out here and want to redecorate your ship! "" Bridgebody.squarespace.com"
3547,1,2,39,42,1.0952380952380953,0.057123496526633864,527,Welcome to the political free zone!
3547,0,4,38,42,1.0952380952380953,0.045843796413450766,527,ew its touching me
3547,0,4,38,42,1.0952380952380953,0.045843796413450766,527,In 3 easy steps we'll make your planet great again.
3547,1,2,39,42,1.0952380952380953,0.057123496526633864,527,"No probe, Lem. No problem."
3547,0,4,38,42,1.0952380952380953,0.045843796413450766,527,"Geez, from the Trump campaign are ye?"
3547,1,2,39,42,1.0952380952380953,0.057123496526633864,527,"Believe me, it's better on our planet."
3547,1,2,39,42,1.0952380952380953,0.057123496526633864,527,Certified organic? Totally.
3547,1,2,39,42,1.0952380952380953,0.057123496526633864,527,Hail Earth Buddy. We have come for your kale!
3547,1,2,39,42,1.0952380952380953,0.057123496526633864,527,"I understand your position, but I think you'll see some real potential in what we're doing with genetically modified organisms."
3547,0,4,38,42,1.0952380952380953,0.045843796413450766,527,"How'd you get over the wall, fella?"
3547,1,2,39,42,1.0952380952380953,0.057123496526633864,527,"Hello, again."
3547,0,4,38,42,1.0952380952380953,0.045843796413450766,527,Bowie?
3547,0,4,38,42,1.0952380952380953,0.045843796413450766,527,Our farm girls ARE out of this world.
3547,0,4,38,42,1.0952380952380953,0.045843796413450766,527,Welcome to the funny farm.
3547,1,2,39,42,1.0952380952380953,0.057123496526633864,527,I have the new crop circle catalog for this year but you'll have to sign the confidentiality form or be abducted.
3547,0,4,38,42,1.0952380952380953,0.045843796413450766,527,Can you give me a minute? I'm just feeding the kids.
3547,1,2,39,42,1.0952380952380953,0.057123496526633864,527,"Oh, the farmer and the martian should be friends..."
3547,1,2,39,42,1.0952380952380953,0.057123496526633864,527,"So good to see you, Mr Littlegreen"
3547,1,2,39,42,1.0952380952380953,0.057123496526633864,527,"What do you mean, ""Going green?"""
3547,0,4,38,42,1.0952380952380953,0.045843796413450766,527,Greetings earthling. Just wanted your permission to leave a couple of crop circles in your field.
3547,1,2,39,42,1.0952380952380953,0.057123496526633864,527,"Mom and dad are away, so we invited some Reptilians too."
3547,1,2,39,42,1.0952380952380953,0.057123496526633864,527,"Thanks for getting here so quickly. I can put up with the droughts, floods and tornadoes, but that Trump! Get me out of here!"
3547,1,2,39,42,1.0952380952380953,0.057123496526633864,527,We all hope you brought a FarmBox--we're out of turnips.
3547,1,2,39,42,1.0952380952380953,0.057123496526633864,527,Congratulations! The Zanadunians of Zanadunia have voted you the best dressed man in the galaxy.
3547,1,2,39,42,1.0952380952380953,0.057123496526633864,527,"That's right, I'm Mr. Trumps new campaign manager, can you point the way?"
3547,1,2,39,42,1.0952380952380953,0.057123496526633864,527,Your Miracle Heater will be delivered within 5 business days.
3547,0,4,38,42,1.0952380952380953,0.045843796413450766,527,Welcome home Brother Odysseus.
3547,1,2,39,42,1.0952380952380953,0.057123496526633864,527,"We come in peace..and even if we didn't, you want Trump or Hillary?"
3547,0,4,38,42,1.0952380952380953,0.045843796413450766,527,"...and on our planet we call this a ""handshake"". Now, show me again what you called a ""fist bump""."
3547,1,2,39,42,1.0952380952380953,0.057123496526633864,527,Welcome aboard ... we have been monitoring your presidential primaries!
3547,0,4,38,42,1.0952380952380953,0.045843796413450766,527,"It's about time. Now, get me my helmet."
3547,1,2,39,42,1.0952380952380953,0.057123496526633864,527,"We've come to learn more about this thing you call ""Instagram."""
3547,0,4,38,42,1.0952380952380953,0.045843796413450766,527,Trump campaign headquarters?
3547,1,2,39,42,1.0952380952380953,0.057123496526633864,527,Have I got a campaign for you!
3547,0,4,38,42,1.0952380952380953,0.045843796413450766,527,Amish-ed you sooooo much.
3547,0,4,38,42,1.0952380952380953,0.045843796413450766,527,"Welcome, but unfortunately, today we aren't accepting ""Take me to your leader"" requests."
3547,0,4,38,42,1.0952380952380953,0.045843796413450766,527,"And greetings to you as well, would you mind retrieving Beyonce, my kids just love her latest LP."
3547,1,2,39,42,1.0952380952380953,0.057123496526633864,527,I don't want to go to Uranus - my proctologist already probed me!
3547,1,2,39,42,1.0952380952380953,0.057123496526633864,527,Don't worry. It's not an election year on my planet.
3547,1,2,39,42,1.0952380952380953,0.057123496526633864,527,We're with the Trump campaign.
3547,0,4,38,42,1.0952380952380953,0.045843796413450766,527,Howdy stranger!
3547,0,4,38,42,1.0952380952380953,0.045843796413450766,527,Got any ethanol we could borrow?
3547,2,0,40,42,1.0952380952380953,0.06651717102567413,527,We come as manifestations of your primitive bipedal fantasies.
3547,1,2,39,42,1.0952380952380953,0.057123496526633864,527,Thanks for coming out tonight Carl. This meeting is really important.
3547,1,2,39,42,1.0952380952380953,0.057123496526633864,527,"I know we said the pesticide was harmless, Farmer Brown, but . . ."
3547,1,2,39,42,1.0952380952380953,0.057123496526633864,527,"Oh, no, no, no. Nothing like that. I'm here to bring you the good word...the Rapture starts in five minutes..."
3547,0,4,38,42,1.0952380952380953,0.045843796413450766,527,Got any extra blorf-glorkens lying around? The ship broke down.
3547,1,2,39,42,1.0952380952380953,0.057123496526633864,527,Welcome to the Biosphere 3 Project.
3547,2,0,40,42,1.0952380952380953,0.06651717102567413,527,Only 239 days until JOHN WICK: CHAPTER TWO.
3547,0,4,38,42,1.0952380952380953,0.045843796413450766,527,"""Corn crop looks that bad, uh?"
3547,1,2,39,42,1.0952380952380953,0.057123496526633864,527,Can you come back to Earth with me?
3547,0,4,38,42,1.0952380952380953,0.045843796413450766,527,I understand - those dating sites limited to farmers are too limiting. I'll broaden you're horizons.
3547,0,4,38,42,1.0952380952380953,0.045843796413450766,527,YOU are a contestant on 'Farming With The Stars'
3547,0,4,38,42,1.0952380952380953,0.045843796413450766,527,"HI! I represent a large farming co-op, and we can offer you a handsome profit on your farm."
3547,0,4,38,42,1.0952380952380953,0.045843796413450766,527,"Welcome to a world without rakes, hoes or plows!"
3547,0,4,38,42,1.0952380952380953,0.045843796413450766,527,"HOWDY NEIGHBOR, GLAD YOU DROPPOD BY."
3547,1,2,39,42,1.0952380952380953,0.057123496526633864,527,I'm *(^#!+@. Fly me.
3547,1,2,39,42,1.0952380952380953,0.057123496526633864,527,No. I'm sorry. All our crops are non-GMO.
3547,2,0,40,42,1.0952380952380953,0.06651717102567413,527,Just dropped by to thank you for all that genetically modified veggies you have produced.
3547,0,4,38,42,1.0952380952380953,0.045843796413450766,527,Glad we could agree about the crop circles.
3547,0,4,38,42,1.0952380952380953,0.045843796413450766,527,Welcome. My name is Jim Bob and I'm with the county agriculture extension program.
3547,0,4,38,42,1.0952380952380953,0.045843796413450766,527,Welcome. We just love the neighborhood.
3547,0,4,38,42,1.0952380952380953,0.045843796413450766,527,"Can I get a bushel of corn, two bales of hay and 5 pounds of wheat, please? Oh, and can you make that to go?"
3547,1,2,39,42,1.0952380952380953,0.057123496526633864,527,"You know the drill Noah, bring two of each kind to the ship before the Big Storm."
3547,0,4,38,42,1.0952380952380953,0.045843796413450766,527,"We will beat China by 20% per bushel and no anal probe ever, guaranteed!"
3547,0,4,38,42,1.0952380952380953,0.045843796413450766,527,We see you have corn - we need fuel to get home!
3547,1,2,39,42,1.0952380952380953,0.057123496526633864,527,"I am weary traveler who's vehicle seems to have broken down. May I sleep your barn tonight? I promise not to touch your daughter."" ""This sounds like some kind of joke."
3547,0,4,38,42,1.0952380952380953,0.045843796413450766,527,"Well, it's nice to meet you too. We get so few callers, you know."
3547,1,2,39,42,1.0952380952380953,0.057123496526633864,527,"Welcome to Xebo's Proctology, home of the galaxy's wackiest anesthesia."
3547,0,4,38,42,1.0952380952380953,0.045843796413450766,527,"I asked to be taken to your leader, not feeder."
3547,0,4,38,42,1.0952380952380953,0.045843796413450766,527,"My name is Artificial Intelligence, and you must be Real Stupid."
3547,0,4,38,42,1.0952380952380953,0.045843796413450766,527,"Howdy, we sell the best seed corn in the universe."
3547,1,2,39,42,1.0952380952380953,0.057123496526633864,527,It's BETTER than Kansas...
3547,1,2,39,42,1.0952380952380953,0.057123496526633864,527,Pleased to meet you. I'm Old Macdonald. E I E I O.
3547,0,4,38,42,1.0952380952380953,0.045843796413450766,527,Hello. I’m Bizoork here to help. One of your cows sent us a message that you are having trouble with a neighbor.
3547,1,2,39,42,1.0952380952380953,0.057123496526633864,527,Donald Trump is deporting me but I didn't think it would be to outer space
3547,1,2,39,42,1.0952380952380953,0.057123496526633864,527,Oui est la Paris?
3547,1,2,39,42,1.0952380952380953,0.057123496526633864,527,Now I understand why you checked both pick-up and delivery when you submitted your on-line order
3547,0,4,38,42,1.0952380952380953,0.045843796413450766,527,Can I interest you in some GMOs?
3547,0,4,38,42,1.0952380952380953,0.045843796413450766,527,Ball game's over?
3547,1,2,39,42,1.0952380952380953,0.057123496526633864,527,"Once again, my apologies for the misunderstanding over the fish bowl."
3547,0,4,38,42,1.0952380952380953,0.045843796413450766,527,We traveled halfway across the galaxy to witness your upcoming Presidential debates!
3547,1,2,39,42,1.0952380952380953,0.057123496526633864,527,"Howdy Pardner, I sure do appreciate you lettin' me borrow that rake"
3547,0,4,38,42,1.0952380952380953,0.045843796413450766,527,Welcome aboard Mr Lewandowski. Mission accomplished.
3547,0,4,38,42,1.0952380952380953,0.045843796413450766,527,A warm welcome to the inter-galactic ethanol price-fixing summit.
3547,0,4,38,42,1.0952380952380953,0.045843796413450766,527,We need to double-check that it's organic.
3547,1,2,39,42,1.0952380952380953,0.057123496526633864,527,Lucky us! You are our first organic farmer !
3547,2,0,40,42,1.0952380952380953,0.06651717102567413,527,Welcome back. Stairway to heaven has been clearest. Go for it!
3547,1,2,39,42,1.0952380952380953,0.057123496526633864,527,"Congratulations, I know you will be very happy with this used turbo 360 Saturn."
3547,0,4,38,42,1.0952380952380953,0.045843796413450766,527,No - we have no Ethanol for consumption here.
3547,2,0,40,42,1.0952380952380953,0.06651717102567413,527,"Come aboard, but don't tell the missus about this, okay?"
3547,1,2,39,42,1.0952380952380953,0.057123496526633864,527,"Thanks anyway, but I already gave at the space station."
3547,1,2,39,42,1.0952380952380953,0.057123496526633864,527,Welcome! There are no illegal aliens here.
3641,1,2,40,43,1.0930232558139534,0.055823181223160837,527,I've a new grain you might like
3641,1,2,40,43,1.0930232558139534,0.055823181223160837,527,The best you can do is stairs? Really?
3641,1,2,40,43,1.0930232558139534,0.055823181223160837,527,Republican health care plan...
3641,0,4,39,43,1.0930232558139534,0.04481972612369448,527,"""Pleased to meet you too . Now how about you run back home and fetch us some of that Earthling moonshine we've heard so much about ?"
3641,2,0,41,43,1.0930232558139534,0.06498959358193226,527,I am really feeling this grassroots campaign - it should get people talking.
3641,1,2,40,43,1.0930232558139534,0.055823181223160837,527,"Congratulations Mr. McDonald, you are now officially an Operating Thetan."
3641,1,2,40,43,1.0930232558139534,0.055823181223160837,527,"Hi-ho, the derry-o!"
3641,1,2,40,43,1.0930232558139534,0.055823181223160837,527,"Take me to your leader--unless, of course, that douchebag Donald Trump has somehow already assumed that office."
3641,0,4,39,43,1.0930232558139534,0.04481972612369448,527,Hey come on in and I want to know all about LeBron James.
3641,0,4,39,43,1.0930232558139534,0.04481972612369448,527,"No one will believe a word of it when you return, not since you started growing marijuana."
3641,0,4,39,43,1.0930232558139534,0.04481972612369448,527,Jimmy Johns?
3641,1,2,40,43,1.0930232558139534,0.055823181223160837,527,Your cheese is ready
3641,2,0,41,43,1.0930232558139534,0.06498959358193226,527,The progressive folks at Agri-Nuke would like the chance to boost your yield.
3641,0,4,39,43,1.0930232558139534,0.04481972612369448,527,"Cons: XJ-9 lacks oxygen and is hotter than your sun. Pros: We do not to post our political views on social media. Welcome aboard, you're going to love it."
3641,0,4,39,43,1.0930232558139534,0.04481972612369448,527,Hi. What would you take in exchange for a free range chicken and a quart of raw milk?
3641,0,4,39,43,1.0930232558139534,0.04481972612369448,527,Take me to your caucus.
3641,1,2,40,43,1.0930232558139534,0.055823181223160837,527,"We're very excited that you've planted our new Monsanto seeds and can't wait for your crop to be ready to invade, uh, harvest!"
3641,1,2,40,43,1.0930232558139534,0.055823181223160837,527,Peas? Carrots? What'll it be?
3641,0,4,39,43,1.0930232558139534,0.04481972612369448,527,We've come to buy more GMOs!
3641,0,4,39,43,1.0930232558139534,0.04481972612369448,527,I'm running for president of the universe.
3641,0,4,39,43,1.0930232558139534,0.04481972612369448,527,Show us how to grow dandelions and kudzu and we'll give you back your cows and chickens.
3641,0,4,39,43,1.0930232558139534,0.04481972612369448,527,Is that you Gort?
3641,1,2,40,43,1.0930232558139534,0.055823181223160837,527,"""Just think of us as a viable third-party choice."" Submitted by Paul & Joel Angiolillo, Watertown MA"
3641,0,4,39,43,1.0930232558139534,0.04481972612369448,527,"Thanks, but I need coveralls, not overalls."
3641,0,4,39,43,1.0930232558139534,0.04481972612369448,527,I used to say Heaven can Wait but now I'm sorry I did.
3641,1,2,40,43,1.0930232558139534,0.055823181223160837,527,"Well, thank you Farmers Only!"
3641,1,2,40,43,1.0930232558139534,0.055823181223160837,527,Anal probe?
3641,1,2,40,43,1.0930232558139534,0.055823181223160837,527,"Thanks, but we prefer Organic vegetables."
3641,1,2,40,43,1.0930232558139534,0.055823181223160837,527,"Captain, coming down your vectored thrusters looked super-critical."
3641,0,4,39,43,1.0930232558139534,0.04481972612369448,527,I'm trying to reduce my carbon footprint.
3641,0,4,39,43,1.0930232558139534,0.04481972612369448,527,"Alien?"" ""Doggone it, get Trump on the phone, now we gotta build a wall and a dome."
3641,1,2,40,43,1.0930232558139534,0.055823181223160837,527,"Further evidence to explain why Mars is a ""red"" planet."""
3641,1,2,40,43,1.0930232558139534,0.055823181223160837,527,"Yup, that's what I said- any other planet you like. Just needs to be within this galaxy."
3641,0,4,39,43,1.0930232558139534,0.04481972612369448,527,Do you always knock this time of night?
3641,0,4,39,43,1.0930232558139534,0.04481972612369448,527,Howdy earth alien! Will you help me brush up on my country?
3641,0,4,39,43,1.0930232558139534,0.04481972612369448,527,I hear your corn is out of this world.
3641,1,2,40,43,1.0930232558139534,0.055823181223160837,527,"Sorry about the crop circle, old chap, but we were in the neighborhood and were hoping you'd be up to being a fourth at bridge."
3641,1,2,40,43,1.0930232558139534,0.055823181223160837,527,"So I hear you need a new scarecrow. Well, one question: how much does the job pay?"
3641,1,2,40,43,1.0930232558139534,0.055823181223160837,527,"Please come in, mi casa es su casa. Hell, you Mexican?"
3641,0,4,39,43,1.0930232558139534,0.04481972612369448,527,Hello! We don't get many farmers.
3641,0,4,39,43,1.0930232558139534,0.04481972612369448,527,This will really raise the GMO controversy to a whole new level!
3641,0,4,39,43,1.0930232558139534,0.04481972612369448,527,Somewhere where I don't have to be Certified Organic.
3641,1,2,40,43,1.0930232558139534,0.055823181223160837,527,Sarah Palin wanted us to thank you personally for supporting Trump.
3641,0,4,39,43,1.0930232558139534,0.04481972612369448,527,"Welcome aboard the Interstellar Harvester, specializing in free-range white meat!"
3641,0,4,39,43,1.0930232558139534,0.04481972612369448,527,"We're switching to corn ethanol, thanks for your cooperation."
3641,1,2,40,43,1.0930232558139534,0.055823181223160837,527,Workers unite!
3641,0,4,39,43,1.0930232558139534,0.04481972612369448,527,Usually the summonses are *after* the election.
3641,0,4,39,43,1.0930232558139534,0.04481972612369448,527,Can I count on your vote this November?
3641,0,4,39,43,1.0930232558139534,0.04481972612369448,527,"Greetings, Earthling! Take me to your Trump."
3641,1,2,40,43,1.0930232558139534,0.055823181223160837,527,GMO friend or foe?
3641,0,4,39,43,1.0930232558139534,0.04481972612369448,527,We're calling it the Farm to Flying Saucer to Table movement.
3641,1,2,40,43,1.0930232558139534,0.055823181223160837,527,Welcome stranger. Can you help make America great again?
3641,0,4,39,43,1.0930232558139534,0.04481972612369448,527,"Goodbye son, sorry about feeding you that GMO corn."
3641,0,4,39,43,1.0930232558139534,0.04481972612369448,527,"Welcome aboard, You've been vetted for a new reality show called, 'Farmers in Space' ."
3641,1,2,40,43,1.0930232558139534,0.055823181223160837,527,"GMO, Gmosin"
3641,0,4,39,43,1.0930232558139534,0.04481972612369448,527,You lucky duck! Our new probe is out of this world. Come on in!
3641,0,4,39,43,1.0930232558139534,0.04481972612369448,527,"I'm positive, I didn't seed the icloud."
3641,1,2,40,43,1.0930232558139534,0.055823181223160837,527,Welcome to Trump-free Travel!
3641,1,2,40,43,1.0930232558139534,0.055823181223160837,527,I'm hoping to borrow a selfie stick.
3641,1,2,40,43,1.0930232558139534,0.055823181223160837,527,"Welcome! Sorry about the anal probe, but we're serious about keeping galactic travel safe."
3641,2,0,41,43,1.0930232558139534,0.06498959358193226,527,"Mr. President, it's been years."
3641,0,4,39,43,1.0930232558139534,0.04481972612369448,527,We received your signal. Take me to The Fonz.
3641,1,2,40,43,1.0930232558139534,0.055823181223160837,527,"Sorry, we're gluten free-- you'll have to leave your wheat sheaves behind."
3641,1,2,40,43,1.0930232558139534,0.055823181223160837,527,"Yes, Zebulon. Let's talk."
3641,0,4,39,43,1.0930232558139534,0.04481972612369448,527,'TRUST ME. IT WILL BE A BETTER LIFE'
3641,0,4,39,43,1.0930232558139534,0.04481972612369448,527,How would you like to be the first to participate in interplanetary crop rotation?
3641,1,2,40,43,1.0930232558139534,0.055823181223160837,527,Klaatu is asking for more melons.
3641,1,2,40,43,1.0930232558139534,0.055823181223160837,527,We forget – when did you say Election Day is?
3641,0,4,39,43,1.0930232558139534,0.04481972612369448,527,We are from the planet Shoo-Fly Pie and we'd like to ask you a few questions.
3641,1,2,40,43,1.0930232558139534,0.055823181223160837,527,Dick Cheney recruits patriots for his new neoconservative planet.
3641,0,4,39,43,1.0930232558139534,0.04481972612369448,527,One word: Plastics
3641,1,2,40,43,1.0930232558139534,0.055823181223160837,527,Take me to your leader. But only if we can get there before Inauguration Day.
3641,0,4,39,43,1.0930232558139534,0.04481972612369448,527,"Before you enter, I should inform you that my mission is concerned with the harvesting of edible substances."
3641,0,4,39,43,1.0930232558139534,0.04481972612369448,527,"A Triple, Venti, Soy, No Foam Latte?"
3641,1,2,40,43,1.0930232558139534,0.055823181223160837,527,Ship needs methane gas for fuel ? Washington has tons. Ask for Mitch.
3641,0,4,39,43,1.0930232558139534,0.04481972612369448,527,I got dizzy circling your crops.
3641,0,4,39,43,1.0930232558139534,0.04481972612369448,527,I tried to tell everyone that this day was gonna come.
3641,0,4,39,43,1.0930232558139534,0.04481972612369448,527,And I agree not to say anything about those subsidy claims.
3641,1,2,40,43,1.0930232558139534,0.055823181223160837,527,Take me to your litter.
3641,0,4,39,43,1.0930232558139534,0.04481972612369448,527,We wish to be simple. We wish to be free. Show us your ways.
3641,0,4,39,43,1.0930232558139534,0.04481972612369448,527,We have come to learn about your organic farming techniques!
3641,0,4,39,43,1.0930232558139534,0.04481972612369448,527,We are so happy you have gone organic
3641,0,4,39,43,1.0930232558139534,0.04481972612369448,527,There is life after Brexit.
3641,1,2,40,43,1.0930232558139534,0.055823181223160837,527,You can call me GMO.
3641,0,4,39,43,1.0930232558139534,0.04481972612369448,527,If you build it we will come.
3641,0,4,39,43,1.0930232558139534,0.04481972612369448,527,Did you bring the cookbook?
3641,1,2,40,43,1.0930232558139534,0.055823181223160837,527,Was it the Trump 2016 crop circle?
3641,0,4,39,43,1.0930232558139534,0.04481972612369448,527,Amazing. We keyed SCUM into our advanced GPS and it brings us to Texas for the close encounters of the fourth kind.
3641,0,4,39,43,1.0930232558139534,0.04481972612369448,527,Congratulations! You have been selected to participate in scientific survey.
3641,0,4,39,43,1.0930232558139534,0.04481972612369448,527,Peace! I'm here about your crop circles.
3641,1,2,40,43,1.0930232558139534,0.055823181223160837,527,"Before we get started, you should know we don't make crop circles in GMO fields."
3641,0,4,39,43,1.0930232558139534,0.04481972612369448,527,"Any fresh eggs for sale, buddy?"
3641,0,4,39,43,1.0930232558139534,0.04481972612369448,527,"Welcome to Galactic Uber, hayseed."
3641,0,4,39,43,1.0930232558139534,0.04481972612369448,527,Sorry about the bad reception on your TV. It’s probably all of this damn electromagnetic radiation.
3641,1,2,40,43,1.0930232558139534,0.055823181223160837,527,"Just dropping by to say ""hello."""
3641,0,4,39,43,1.0930232558139534,0.04481972612369448,527,Take me to your okra.
3641,0,4,39,43,1.0930232558139534,0.04481972612369448,527,"I know, Tinder, Bumble, I can't keep them straight either."
3641,1,2,40,43,1.0930232558139534,0.055823181223160837,527,"We’d love to examine your feeder, try out your weeder, and meet your breeder, but that’s really all that’s on our minds."
3641,1,2,40,43,1.0930232558139534,0.055823181223160837,527,"Congratulations, we are from the art appreciation society of planet Picasso. We love your corn-field design."
3641,1,2,40,43,1.0930232558139534,0.055823181223160837,527,They wanted to know if they can slot you in after Gingrich on day three
3641,1,2,40,43,1.0930232558139534,0.055823181223160837,527,"I assure you, this is an executive order from President Trump."
3641,0,4,39,43,1.0930232558139534,0.04481972612369448,527,Take me to your agribusiness leader.
3641,0,4,39,43,1.0930232558139534,0.04481972612369448,527,We would like your insight on the Kanye vs. Swift fued.
3641,0,4,39,43,1.0930232558139534,0.04481972612369448,527,You're just what we need for settling on Mars.
3641,0,4,39,43,1.0930232558139534,0.04481972612369448,527,Thank you for help. You wouldn't believe how hard it is to find a decent parking zone in the city.
3641,1,2,40,43,1.0930232558139534,0.055823181223160837,527,"The name's Trump, and I need honest folk like you to get on board."
3641,1,2,40,43,1.0930232558139534,0.055823181223160837,527,We need to talk about Monsanto.
3641,0,4,39,43,1.0930232558139534,0.04481972612369448,527,We have the cookbook; now we just need the right ingredients.
3641,0,4,39,43,1.0930232558139534,0.04481972612369448,527,Come quickly - the cows need milking!
3641,0,4,39,43,1.0930232558139534,0.04481972612369448,527,I heard you're looking for a president.
3641,0,4,39,43,1.0930232558139534,0.04481972612369448,527,I heard Dorthy was back. Is she home?
3641,0,4,39,43,1.0930232558139534,0.04481972612369448,527,Are you delivering those non-GMO seeds I ordered from Mars?
3641,1,2,40,43,1.0930232558139534,0.055823181223160837,527,"Welcome, and thank you for meeting with the leaders of Monsanto."
3641,0,4,39,43,1.0930232558139534,0.04481972612369448,527,Glad to know we can count on your vote in November.
3641,0,4,39,43,1.0930232558139534,0.04481972612369448,527,I cant thank you enough for getting me out of here...now that Trump is President.
3641,1,2,40,43,1.0930232558139534,0.055823181223160837,527,The flight to Mars is now boarding
3641,1,2,40,43,1.0930232558139534,0.055823181223160837,527,We're so glad you could come with us. Our entire crop of lettuce is dying from some terrible disease!
3641,0,4,39,43,1.0930232558139534,0.04481972612369448,527,thanks! I promise you that I'll return to Iowa often before 2020...
3641,0,4,39,43,1.0930232558139534,0.04481972612369448,527,"Welcome, we've heard people were disappointed with the presidential choices!"
3641,2,0,41,43,1.0930232558139534,0.06498959358193226,527,"Welcome, you are not a Trump supporter."
3641,0,4,39,43,1.0930232558139534,0.04481972612369448,527,Do you have something to do with Donald Trump?
3641,1,2,40,43,1.0930232558139534,0.055823181223160837,527,"FARMERS REMORSE: Alien excitedly, ""Did you remember the beer?"""
3641,1,2,40,43,1.0930232558139534,0.055823181223160837,527,See you next year Fred. We can't get enough of the corn and bluberries.
3641,0,4,39,43,1.0930232558139534,0.04481972612369448,527,I'm going to need to check your passport.
3641,0,4,39,43,1.0930232558139534,0.04481972612369448,527,Welcome survivor.
3641,0,4,39,43,1.0930232558139534,0.04481972612369448,527,Welcome! We have come four billion light years to learn how you make silage.
3641,1,2,40,43,1.0930232558139534,0.055823181223160837,527,Is the oxygen breathable Mr. Earthling?
3641,1,2,40,43,1.0930232558139534,0.055823181223160837,527,Welcome to shuttle service to Oz.
3641,0,4,39,43,1.0930232558139534,0.04481972612369448,527,I'm here for Shark Week.
3641,0,4,39,43,1.0930232558139534,0.04481972612369448,527,"Saucer here, to deliver your Sirius Dish, sir!"
3641,1,2,40,43,1.0930232558139534,0.055823181223160837,527,Congratulations. We've been watching for fifty years. You're the one sane human.
3641,1,2,40,43,1.0930232558139534,0.055823181223160837,527,We need someone who knows about farming.
3641,1,2,40,43,1.0930232558139534,0.055823181223160837,527,Thanks for coming on short notice. We need to have your tractor push us to help get our engine running again
3641,1,2,40,43,1.0930232558139534,0.055823181223160837,527,"Look, we've heard there's a chance we can still get Hamilton tickets before Lin Manuel Miranda's contract runs out. Can you help us or not?"
3641,1,2,40,43,1.0930232558139534,0.055823181223160837,527,Have you heard the one about the farmer and the alien? Wait 'til you see my bar scene!
3641,0,4,39,43,1.0930232558139534,0.04481972612369448,527,"Pleasure to probe you...er, I mean, meet you."
3641,0,4,39,43,1.0930232558139534,0.04481972612369448,527,"Welcome, finally someone to explain quantum mechanics."
3641,0,4,39,43,1.0930232558139534,0.04481972612369448,527,I'm from the government and I am here to help.
3641,0,4,39,43,1.0930232558139534,0.04481972612369448,527,I guess its true that aliens only land in corn fields...
3641,1,2,40,43,1.0930232558139534,0.055823181223160837,527,"How's fifty Jupiters per bushel? We're having a little food shortage in here"""
3641,0,4,39,43,1.0930232558139534,0.04481972612369448,527,Help us grow huge vegetables in outer space.
3641,0,4,39,43,1.0930232558139534,0.04481972612369448,527,"Father, it's me Johnny, come on in, you'll be safe here!"
3641,1,2,40,43,1.0930232558139534,0.055823181223160837,527,do you want to have golden corn? then come with me.
3641,0,4,39,43,1.0930232558139534,0.04481972612369448,527,We're from Farm Aid. Willie sent us.
3641,0,4,39,43,1.0930232558139534,0.04481972612369448,527,"How now, brown cow?"
3641,0,4,39,43,1.0930232558139534,0.04481972612369448,527,Welcome to planet Trump. It's gonna be TREMEMDOUS!
3641,1,2,40,43,1.0930232558139534,0.055823181223160837,527,"To be honest, I thought you said you came with *peats*"
3641,1,2,40,43,1.0930232558139534,0.055823181223160837,527,"Really, it'll be no harder that farming in Kentucky"
3641,1,2,40,43,1.0930232558139534,0.055823181223160837,527,Till death do us part seemed long enough to me.
3641,1,2,40,43,1.0930232558139534,0.055823181223160837,527,"Yes, Mr Trump, it's time to go home!"
3641,1,2,40,43,1.0930232558139534,0.055823181223160837,527,Would you like to take a spin...we still have some space left?
3792,0,4,40,44,1.0909090909090908,0.04384025656094653,527,"Howdy, is this Trump headquarters?"
3792,1,2,41,44,1.0909090909090908,0.054580679253385125,527,"Hello! Is your farm for sale, by any chance?"
3792,1,2,41,44,1.0909090909090908,0.054580679253385125,527,Jimmy Hoffa. I knew you would be back!
3792,0,4,40,44,1.0909090909090908,0.04384025656094653,527,Did you bring the Taco Bell!?
3792,0,4,40,44,1.0909090909090908,0.04384025656094653,527,"Just got our crew's referendum results-- ETexit won. Hasta la vista, baby!"
3792,1,2,41,44,1.0909090909090908,0.054580679253385125,527,Sorry it took so long to get back to you.
3792,0,4,40,44,1.0909090909090908,0.04384025656094653,527,Thank God you came! We ran out of organic micro-greens three planetary invasions ago.
3792,1,2,41,44,1.0909090909090908,0.054580679253385125,527,Trump said that wall would keep all of your kind out.
3792,1,2,41,44,1.0909090909090908,0.054580679253385125,527,"Remember, all the produce you deliver has to be non-GMO and gluten-free."
3792,1,2,41,44,1.0909090909090908,0.054580679253385125,527,"Appreciate yer 23 light year trip to get here, Xebon, but yer too dang early again. Corn’ll be perfect in about three more weeks – see ya then."
3792,1,2,41,44,1.0909090909090908,0.054580679253385125,527,"Congratulations, we read your crop circle, you're the winner of our 5 billion light year trip around the universe!"
3792,2,0,42,44,1.0909090909090908,0.06353056744742798,527,"I'm your great, great, great grandson returning from our gap-century trip to Jupiter."
3792,0,4,40,44,1.0909090909090908,0.04384025656094653,527,Your circles are now complete.
3792,1,2,41,44,1.0909090909090908,0.054580679253385125,527,Thank god you came. The presidential elections are in November and I need the get off this planet asap.
3792,1,2,41,44,1.0909090909090908,0.054580679253385125,527,Are you interested in discussing a new way of doing that farm-to-table thing?
3792,2,0,42,44,1.0909090909090908,0.06353056744742798,527,If you want me to take you to my leader we better get going.
3792,0,4,40,44,1.0909090909090908,0.04384025656094653,527,We're a little low on fuel.
3792,1,2,41,44,1.0909090909090908,0.054580679253385125,527,"Oh! Hey, bro! I wasn't expecting you to drop by."""
3792,0,4,40,44,1.0909090909090908,0.04384025656094653,527,"Get inside,...we want to take you to the world of better farm subsidies."
3792,0,4,40,44,1.0909090909090908,0.04384025656094653,527,"Take me anywhere, as long as there isn't a Democrat or Republican party."
3792,1,2,41,44,1.0909090909090908,0.054580679253385125,527,"You nearly had me going there, when you took me to see Donald Trump!"
3792,1,2,41,44,1.0909090909090908,0.054580679253385125,527,But why would you want to pay me to draw circles in my corn field?
3792,1,2,41,44,1.0909090909090908,0.054580679253385125,527,"""Klaatu barada, um, HOWDEE!?"
3792,0,4,40,44,1.0909090909090908,0.04384025656094653,527,"Welcome, Joe. So glad you can make it because we are in dire need of a real down-to-earth guy like you up there."
3792,0,4,40,44,1.0909090909090908,0.04384025656094653,527,"Welcome, Wizard of Oz."
3792,0,4,40,44,1.0909090909090908,0.04384025656094653,527,"Spoken with an alien accent, ""leader"" and ""weeder"" are often confused."
3792,1,2,41,44,1.0909090909090908,0.054580679253385125,527,Just think of me as far-out Kansas.
3792,2,0,42,44,1.0909090909090908,0.06353056744742798,527,"Wait, this isn't Maple Street..."
3792,0,4,40,44,1.0909090909090908,0.04384025656094653,527,"I know things look bad right now, but the election will be over in November."
3821,0,3,34,37,1.0810810810810811,0.045493265488117475,527,"Welcome to the Bliss. And yes, I am a real hallucination."
3822,1,1,36,38,1.0789473684210527,0.058204267603313695,527,"Thank you for your time, sir. Eminent domain is wonderful, wouldn't you agree?"
3823,1,1,37,39,1.0769230769230769,0.05672833888524614,527,Greetings! I would love your vote in the Iowa caucus to be President of the Milky Way.
3823,0,3,36,39,1.0769230769230769,0.04322703745761662,527,Do y'all eat fried chicken?
3823,1,1,37,39,1.0769230769230769,0.05672833888524614,527,Welcome to our spaceship sir. You'll be a strange creature.
3826,1,1,38,40,1.075,0.055325377864931344,527,You start on Monday.
3826,0,3,37,40,1.075,0.04217636961434866,527,"No, thank you. My daughter's greatest wish is to travel."
3826,1,1,38,40,1.075,0.055325377864931344,527,"Welcome back, Fnxxxrp. How was Brooklyn?"
3826,0,3,37,40,1.075,0.04217636961434866,527,Soooo...should I call you an Uber?
3826,0,3,37,40,1.075,0.04217636961434866,527,I thought President Trump built a wall.
3826,0,3,37,40,1.075,0.04217636961434866,527,You're doing a fine job with the crop dusting.
3826,0,3,37,40,1.075,0.04217636961434866,527,I need to speak with you about the government's agricultural subsidies program.
3826,0,3,37,40,1.075,0.04217636961434866,527,We come from the planet Trumpania. Your crops are gonna be yuge; really yuge!
3826,0,3,37,40,1.075,0.04217636961434866,527,3000 tons of GMO corn at $200 per ton? Done!
3826,0,3,37,40,1.075,0.04217636961434866,527,Is this your first time being probed???
3826,1,1,38,40,1.075,0.055325377864931344,527,Best crop dusting I've ever had.
3826,0,3,37,40,1.075,0.04217636961434866,527,"Take us to your...wait, no, any leader but Donald Trump"
3826,1,1,38,40,1.075,0.055325377864931344,527,Welcome sir. Guessing there weren't any lights to turn off on your way out.
3826,0,3,37,40,1.075,0.04217636961434866,527,"Whadya mean ""we're not in Kansas anymore""?"
3826,0,3,37,40,1.075,0.04217636961434866,527,He won't make America great - it's a good choice.
3826,0,3,37,40,1.075,0.04217636961434866,527,Take me to your your soybeans.
3826,1,1,38,40,1.075,0.055325377864931344,527,Can you spare any change?
3826,0,3,37,40,1.075,0.04217636961434866,527,Farm to table? Thank goodness. We were worried we'd missed your moment.
3826,0,3,37,40,1.075,0.04217636961434866,527,Welcome to our 'locally-sourced' program!
3826,0,3,37,40,1.075,0.04217636961434866,527,You don't look like the aliens Donald Trump talks about.
3826,0,3,37,40,1.075,0.04217636961434866,527,Come in so we can best serve you!
3847,0,3,38,41,1.0731707317073171,0.04117547077105886,527,the farmer and the alien should be friends
3847,1,1,39,41,1.0731707317073171,0.05399010639311867,527,It's my old hula hoop.
3847,0,3,38,41,1.0731707317073171,0.04117547077105886,527,"Don't you believe all that hokey crap about wizards, straw men and red shoes."
3847,1,1,39,41,1.0731707317073171,0.05399010639311867,527,You like nice and ripe.
3847,0,3,38,41,1.0731707317073171,0.04117547077105886,527,"Come aboard ,I promise, we don't have a presidential election this fall on our planet"
3847,0,3,38,41,1.0731707317073171,0.04117547077105886,527,"Welcome, earthling farmer, to COMEX IN SPACE! We've been expecting you!"
3847,0,3,38,41,1.0731707317073171,0.04117547077105886,527,I'm not an alien--I' a genetically modified astronaut.
3847,1,1,39,41,1.0731707317073171,0.05399010639311867,527,Finally nice to meet someone who isn't so swept up in all this political drama!
3847,0,3,38,41,1.0731707317073171,0.04117547077105886,527,"Ah, my alien beak detects beets, corn, baked bread and strewed dirt with a hint of musk; you'll be in our 'Stew' group, sir."
3847,0,3,38,41,1.0731707317073171,0.04117547077105886,527,"Hi, Mr. Brown. Wanna ride?"
3847,1,1,39,41,1.0731707317073171,0.05399010639311867,527,"Your a vegetarian, then the barbecue is Off. have your people contact my people to reschedule."
3847,0,3,38,41,1.0731707317073171,0.04117547077105886,527,"Howdy, just your friendly intergalactic aliens checking out the neighborhood."
3847,0,3,38,41,1.0731707317073171,0.04117547077105886,527,Welcome Alien crop picker.
3847,0,3,38,41,1.0731707317073171,0.04117547077105886,527,You are no longer in Kansas.
3847,1,1,39,41,1.0731707317073171,0.05399010639311867,527,"Welcome, you are one of the few; as we only show ourselves to farmers."
3847,0,3,38,41,1.0731707317073171,0.04117547077105886,527,I'm from the Intergalactic Government and I'm here to help!
3847,0,3,38,41,1.0731707317073171,0.04117547077105886,527,Reince. Trump barada nikto
3847,0,3,38,41,1.0731707317073171,0.04117547077105886,527,"No, the digital exam won't increase your crop yield."
3847,1,1,39,41,1.0731707317073171,0.05399010639311867,527,"So, imagine a cow that... Just follow me."
3847,1,1,39,41,1.0731707317073171,0.05399010639311867,527,"So, some things have changed since I majored in communications."
3847,1,1,39,41,1.0731707317073171,0.05399010639311867,527,"Nice to meet you, but what took you so long?"
3847,1,1,39,41,1.0731707317073171,0.05399010639311867,527,Welcome. We can start your harvesting.
3847,0,3,38,41,1.0731707317073171,0.04117547077105886,527,"Thanks, but I already have a GMO salesman."
3847,1,1,39,41,1.0731707317073171,0.05399010639311867,527,Come in past me...this is the point in history I wouldn't want you to experience again...
3847,0,3,38,41,1.0731707317073171,0.04117547077105886,527,Thanks for the livestock. We'll be back tomorrow with the payment.
3847,0,3,38,41,1.0731707317073171,0.04117547077105886,527,Welcome to Monsanto
3847,1,1,39,41,1.0731707317073171,0.05399010639311867,527,Deal. $8M. You get purple rain.
3847,0,3,38,41,1.0731707317073171,0.04117547077105886,527,Now we're doing alien introductions.
3847,0,3,38,41,1.0731707317073171,0.04117547077105886,527,...and under our administration farm subsidies will continue!
3847,0,3,38,41,1.0731707317073171,0.04117547077105886,527,"Hey, welcome. So glad you could make it up."
3847,0,3,38,41,1.0731707317073171,0.04117547077105886,527,Hi...I would like to talk to you about starting a Farmer's Market up your way...
3847,1,1,39,41,1.0731707317073171,0.05399010639311867,527,Welcome fellow Ethonolian!
3847,1,1,39,41,1.0731707317073171,0.05399010639311867,527,Christ Almighty that was a long trip!
3847,1,1,39,41,1.0731707317073171,0.05399010639311867,527,President Bob it was a pleasure meeting you.
3847,0,3,38,41,1.0731707317073171,0.04117547077105886,527,Don't worry I'm not an Islamic Extremest I just have a keen interest in farming.
3847,0,3,38,41,1.0731707317073171,0.04117547077105886,527,We didn't expect so many of you who were afraid of Mr. Trump being elected!
3847,0,3,38,41,1.0731707317073171,0.04117547077105886,527,I knew there was a reason that I planted Kale.
3847,0,3,38,41,1.0731707317073171,0.04117547077105886,527,Welcome aboard! Your rumspringa is going to be fantastic.
3847,0,3,38,41,1.0731707317073171,0.04117547077105886,527,Beyonce!
3847,1,1,39,41,1.0731707317073171,0.05399010639311867,527,Did you bring your fork? There's pie.
3847,1,1,39,41,1.0731707317073171,0.05399010639311867,527,Adele?
3847,0,3,38,41,1.0731707317073171,0.04117547077105886,527,Did you see my Missus anywhere?
3847,1,1,39,41,1.0731707317073171,0.05399010639311867,527,Just wait until you experience the jet lag...grrsplurb...gack!
3847,1,1,39,41,1.0731707317073171,0.05399010639311867,527,"Honey, I'm home!"
3847,1,1,39,41,1.0731707317073171,0.05399010639311867,527,"I understand that you are having troubles finding the right candidate for the nomination, sorry, we cant help with this one"
3847,0,3,38,41,1.0731707317073171,0.04117547077105886,527,"Hey Tom, welcome to the first Farm-to-Mars event!"
3847,1,1,39,41,1.0731707317073171,0.05399010639311867,527,Let's go for a spin earthly. Then I will help rotate your crops.
3847,0,3,38,41,1.0731707317073171,0.04117547077105886,527,Our Commander Potato Head needs Your expertise...
3847,1,1,39,41,1.0731707317073171,0.05399010639311867,527,"Listen—I'd love to work with you, but we'd have to break down the silos first."
3847,0,3,38,41,1.0731707317073171,0.04117547077105886,527,"Hi there, I am your presumptive Alien presidential nominee. When you called for outside help, I came as soon as I could."
3847,0,3,38,41,1.0731707317073171,0.04117547077105886,527,E---------------------------T-----------------------
3847,1,1,39,41,1.0731707317073171,0.05399010639311867,527,We heard you make great hat boxes. Can you also make great helmet boxes?
3847,0,3,38,41,1.0731707317073171,0.04117547077105886,527,Thank you for coming. Trump's poll numbers are up.
3847,1,1,39,41,1.0731707317073171,0.05399010639311867,527,Thank you for your hospitality and you're welcome to come visit us.
3847,0,3,38,41,1.0731707317073171,0.04117547077105886,527,"No, I haven't seen your daughter this evening."
3847,1,1,39,41,1.0731707317073171,0.05399010639311867,527,Welcome aboard. Where's the family?
3847,0,3,38,41,1.0731707317073171,0.04117547077105886,527,Hello Earthling. We need a Lyft!
3847,0,3,38,41,1.0731707317073171,0.04117547077105886,527,"Greetings, I am from the Intergalactic Federation of Governments and I am here to help."
3847,0,3,38,41,1.0731707317073171,0.04117547077105886,527,Welcome To Publishers Weekly.
3847,0,3,38,41,1.0731707317073171,0.04117547077105886,527,Hi! Space-age crop rings at your service. Ready for that free estimate?
3847,0,3,38,41,1.0731707317073171,0.04117547077105886,527,"Not to worry, I am not a GMO."
3847,1,1,39,41,1.0731707317073171,0.05399010639311867,527,"Yes, yes we do speak American."
3847,0,3,38,41,1.0731707317073171,0.04117547077105886,527,And we have great corn subsidies.
3847,0,3,38,41,1.0731707317073171,0.04117547077105886,527,But are you a GMO?
3847,0,3,38,41,1.0731707317073171,0.04117547077105886,527,Can I borrow your cattle prod?
3847,0,3,38,41,1.0731707317073171,0.04117547077105886,527,"Yes , the service is out of this world ..."
3847,0,3,38,41,1.0731707317073171,0.04117547077105886,527,"Well, there goes that Wall idea..."
3847,1,1,39,41,1.0731707317073171,0.05399010639311867,527,You will be safe with us. We dwell 614 light years left of the Trump galaxy. But you won't be in Kansas anymore.
3847,0,3,38,41,1.0731707317073171,0.04117547077105886,527,Greetings! Have I reached Eieio?
3847,0,3,38,41,1.0731707317073171,0.04117547077105886,527,"We love the pose. First you work those rows with hoes, and then you sows what grows."
3847,1,1,39,41,1.0731707317073171,0.05399010639311867,527,"I wonder why he is landing here, wait why is he taking the farmer away and what is he going to do to him?!"
3847,1,1,39,41,1.0731707317073171,0.05399010639311867,527,It's never too early to start a campaign ... may I count on your vote in the next Presidential caucus?
3847,0,3,38,41,1.0731707317073171,0.04117547077105886,527,Don't Worry It's Gluten Free
3847,0,3,38,41,1.0731707317073171,0.04117547077105886,527,Can I get fries with that?
3847,0,3,38,41,1.0731707317073171,0.04117547077105886,527,Welcome Mr. Monsanto. Your crop circle scam has worked wonders!
3847,0,3,38,41,1.0731707317073171,0.04117547077105886,527,"That's one small step for man, one giant leap for Martians."
3847,0,3,38,41,1.0731707317073171,0.04117547077105886,527,"Welcome to earth. Heads up. We are absolutely confused about whether to vote yes or no, on genetically modified foods."
3847,0,3,38,41,1.0731707317073171,0.04117547077105886,527,"Hi,Welcome to the Louisiana Hayride Martian style"
3847,0,3,38,41,1.0731707317073171,0.04117547077105886,527,I'm a big fan of your work. I loved the self-portrait you did last year in Stan's cornfield.
3847,0,3,38,41,1.0731707317073171,0.04117547077105886,527,We think you have a great future in crop circling.
3847,0,3,38,41,1.0731707317073171,0.04117547077105886,527,"Welcome to Trump Airlines, University, Resorts, AND Casinos."
3847,1,1,39,41,1.0731707317073171,0.05399010639311867,527,"Bernie, you said this was tobacco."
3847,1,1,39,41,1.0731707317073171,0.05399010639311867,527,"Well if Trump won we were moving to Canada, and since Hillary won..."
3847,0,3,38,41,1.0731707317073171,0.04117547077105886,527,"Given the choice, people may not even want to be abducted."
3847,1,1,39,41,1.0731707317073171,0.05399010639311867,527,Welcome aboard! Del Martian Foods needs farmers.
3847,0,3,38,41,1.0731707317073171,0.04117547077105886,527,"Sorry, but a teleporter wasn't included as a feature when I bought it."
3847,1,1,39,41,1.0731707317073171,0.05399010639311867,527,"Believe me, the hands match the halo."
3847,0,3,38,41,1.0731707317073171,0.04117547077105886,527,HELLO: I REPRESENT TRANSGENIC CROPS CORPORATION LTD.
3847,0,3,38,41,1.0731707317073171,0.04117547077105886,527,"No, Iowa...best corn this side of Jupiter."
3847,0,3,38,41,1.0731707317073171,0.04117547077105886,527,Welcome aboard. Your daughter's been waiting for you.
3847,0,3,38,41,1.0731707317073171,0.04117547077105886,527,catfished
3847,1,1,39,41,1.0731707317073171,0.05399010639311867,527,"My ag extension said you're the man to see about ethanol. Man, you are out there!"
3847,0,3,38,41,1.0731707317073171,0.04117547077105886,527,Your offer to continue living on Earth is rejected.
3847,1,1,39,41,1.0731707317073171,0.05399010639311867,527,"Greetings, and Welcome to our AstroPub! We recommend the grass-fed beef."
3941,1,1,40,42,1.0714285714285714,0.05271774316741633,527,So you're the president of the Future Farmers of America.
3941,0,3,39,42,1.0714285714285714,0.04022089331224806,527,Pleased to meet you. Having dinner at the moment. Back in an hour?
3941,0,3,39,42,1.0714285714285714,0.04022089331224806,527,We have a few cows and chickens out in the Milky Way
3941,0,3,39,42,1.0714285714285714,0.04022089331224806,527,But I can't take you to my leader - She is out tonight playing mah-jongg with her friends.
3941,0,3,39,42,1.0714285714285714,0.04022089331224806,527,"If you're looking for the county administrator, he left an hour ago for the DMV in Sioux city."
3941,1,1,40,42,1.0714285714285714,0.05271774316741633,527,"Howdy, I'm Jeb, do you have your green card?"
3941,1,1,40,42,1.0714285714285714,0.05271774316741633,527,"Hello, I'm an anti-Trump. Is this Iowa?"" ""Yes, but you're 6 months too late. But you can still make it to Cleveland in time."
3941,0,3,39,42,1.0714285714285714,0.04022089331224806,527,We have searched the galaxy for non-GMO zucchini!
3941,0,3,39,42,1.0714285714285714,0.04022089331224806,527,Are... you... Seymour... Butts?
3941,0,3,39,42,1.0714285714285714,0.04022089331224806,527,Yes we can make this an Amish home for you.
3941,0,3,39,42,1.0714285714285714,0.04022089331224806,527,Have we got GMOs for you!
3941,0,3,39,42,1.0714285714285714,0.04022089331224806,527,Last time you came for the Mrs. How is she by the way?
3941,1,1,40,42,1.0714285714285714,0.05271774316741633,527,"The old farmer with the pitchfork and his wife? You betcha! They live in that house yonder, right across the field."
3941,1,1,40,42,1.0714285714285714,0.05271774316741633,527,""" We can translate your almanac""."
3941,0,3,39,42,1.0714285714285714,0.04022089331224806,527,Nice spread. What's your water situation?
3941,1,1,40,42,1.0714285714285714,0.05271774316741633,527,We'd like to do farm-to-mothership-control-module. Interested?
3941,1,1,40,42,1.0714285714285714,0.05271774316741633,527,Ransom paid. Welcome back. Let's go home and leave this decadence behind.
3941,1,1,40,42,1.0714285714285714,0.05271774316741633,527,Welcome to our planet...Are you interested in running for President?
3941,1,1,40,42,1.0714285714285714,0.05271774316741633,527,Your patents on GMO corn don't apply on our planet; load 'em up!!
3941,1,1,40,42,1.0714285714285714,0.05271774316741633,527,See ya. I can't bring myself to vote for either one of them.
3941,0,3,39,42,1.0714285714285714,0.04022089331224806,527,We're here to help you with your snoring Gus.
3941,1,1,40,42,1.0714285714285714,0.05271774316741633,527,Thanks! My kids insisted that I bring them back a disco ball when I left for planet Earth.
3941,0,3,39,42,1.0714285714285714,0.04022089331224806,527,"Pearson's Feedlot. I'll be about 20 minutes. Then, a stop at the computer place. So leave the meter running and bill my Visa card."
3941,1,1,40,42,1.0714285714285714,0.05271774316741633,527,"Fist bump? Brother, it's still the disco era back home."
3941,0,3,39,42,1.0714285714285714,0.04022089331224806,527,Take me to your presidential debate.
3941,1,1,40,42,1.0714285714285714,0.05271774316741633,527,We like your work uniform.
3941,0,3,39,42,1.0714285714285714,0.04022089331224806,527,Thanks for coming. We were hoping to find a man of probity like yourself.
3941,1,1,40,42,1.0714285714285714,0.05271774316741633,527,"Hello earthling, we have come for your daughters."
3941,0,3,39,42,1.0714285714285714,0.04022089331224806,527,"Thank you for visiting. As a matter of fact, I have been meaning to increase my life insurance."
3941,0,3,39,42,1.0714285714285714,0.04022089331224806,527,Welcome on board The Brexit.
3941,0,3,39,42,1.0714285714285714,0.04022089331224806,527,"Hi , I'm campaigning as an independent , because the federation has decided we simply must have better than Clinton or Trump ."
3941,1,1,40,42,1.0714285714285714,0.05271774316741633,527,Welcome to our little oratory. We are glad that you are here with us. God bless you.
3941,1,1,40,42,1.0714285714285714,0.05271774316741633,527,Thanks for stopping by.
3941,1,1,40,42,1.0714285714285714,0.05271774316741633,527,"Hi, Jeb, I'm Bill. Pleased to meet you. I'm stuck here for a layover. Can I use your WIFI password to watch ""Game of Thrones?"
3941,1,1,40,42,1.0714285714285714,0.05271774316741633,527,This is better than Canada.
3941,1,1,40,42,1.0714285714285714,0.05271774316741633,527,We're going to start with earthlings from the 17th Century.
3941,0,3,39,42,1.0714285714285714,0.04022089331224806,527,Dinner's on. Do you have any food allergies?
3941,1,1,40,42,1.0714285714285714,0.05271774316741633,527,"Yep, we're here for the corn and wheat."
3941,1,1,40,42,1.0714285714285714,0.05271774316741633,527,"Hi Herb !! Welcome to our ""fly in fly out"" restaurant!!!!!!"
3941,1,1,40,42,1.0714285714285714,0.05271774316741633,527,Trump? Good luck...
3941,1,1,40,42,1.0714285714285714,0.05271774316741633,527,Greetings. I'm an interplanetary free-range farmer.
3941,0,3,39,42,1.0714285714285714,0.04022089331224806,527,Relax! We offer direct flights to Hicksville!
3941,0,3,39,42,1.0714285714285714,0.04022089331224806,527,Now let me have your cows.
3941,1,1,40,42,1.0714285714285714,0.05271774316741633,527,"I think ""anchor baby"" is a real buzz-kill, don't you?"
3941,0,3,39,42,1.0714285714285714,0.04022089331224806,527,I'm here for eighteen months to party with earthlings -- then I decide whether to return
3941,0,3,39,42,1.0714285714285714,0.04022089331224806,527,We accept all illegal aliens where I come from.
3941,0,3,39,42,1.0714285714285714,0.04022089331224806,527,I'm taking requests before I head out to the field.
3941,1,1,40,42,1.0714285714285714,0.05271774316741633,527,"Hey Chuck, Zawlex - we spoke via crop? Nice to finally meet you."
3941,0,3,39,42,1.0714285714285714,0.04022089331224806,527,Sorry but I don't speak French.
3941,1,1,40,42,1.0714285714285714,0.05271774316741633,527,Take you to my leader.
3941,0,3,39,42,1.0714285714285714,0.04022089331224806,527,"Hey, Honey, I told you this was a good place to stop for a quick bite. Take out is here!"
3941,0,3,39,42,1.0714285714285714,0.04022089331224806,527,"Well, yes, my crops ARE genetically engineered..."
3941,0,3,39,42,1.0714285714285714,0.04022089331224806,527,It's all yours! I'll need a ride back
3941,0,3,39,42,1.0714285714285714,0.04022089331224806,527,"Listen, that ""corn"" you sold me last week was really great. Do you have any more?"
3941,0,3,39,42,1.0714285714285714,0.04022089331224806,527,Hello Friend ! Can I interest you in some intergalactic farm insurance ?
3941,0,3,39,42,1.0714285714285714,0.04022089331224806,527,Welcome. Let's take a spin around your farm first before we blast it.
3941,1,1,40,42,1.0714285714285714,0.05271774316741633,527,Greetings! We're about to show you an aerial view of your field.
3941,0,3,39,42,1.0714285714285714,0.04022089331224806,527,Come inside and have a drink
3941,0,3,39,42,1.0714285714285714,0.04022089331224806,527,At last! Someone who knows the farmer's handshake!
3941,0,3,39,42,1.0714285714285714,0.04022089331224806,527,"Nice mission, Klaatu. Where's Gort?"
3941,1,1,40,42,1.0714285714285714,0.05271774316741633,527,Welcome to Iowa. Bernie has long predicted a Super Delegate Surprise.
3941,1,1,40,42,1.0714285714285714,0.05271774316741633,527,so its true
3941,1,1,40,42,1.0714285714285714,0.05271774316741633,527,Thats man...Did you...Did you want to come in for a smoke?
3941,1,1,40,42,1.0714285714285714,0.05271774316741633,527,Sorry about the crop circles. We needed the corn to make E85.
3941,1,1,40,42,1.0714285714285714,0.05271774316741633,527,Howdy partner. Somebody obviously screwed up. We were headed for the bright lights of New York City and here we are in a lonely Iowa cornfield.
3941,0,3,39,42,1.0714285714285714,0.04022089331224806,527,"We're sorry to go; it's a great neighborhood, but Zork just doesn't feel safe with all these illegal immigrants moving in."
3941,1,1,40,42,1.0714285714285714,0.05271774316741633,527,There was a mix up at the tire store
3941,1,1,40,42,1.0714285714285714,0.05271774316741633,527,You would not believe how hard it is to find non-GMO tomatoes out there...
3941,1,1,40,42,1.0714285714285714,0.05271774316741633,527,Thanks again for taking the blame on those crop circles!
3941,0,3,39,42,1.0714285714285714,0.04022089331224806,527,"Hello at last, farmer John! We Venusians are huge fans of your crop circles . they're an inspiation to us all!"
3941,0,3,39,42,1.0714285714285714,0.04022089331224806,527,Did you make your own reservations online or have your travel agent planet?
3941,0,3,39,42,1.0714285714285714,0.04022089331224806,527,May I interest you in a Crop Circle Insurance policy?
3941,0,3,39,42,1.0714285714285714,0.04022089331224806,527,Your dead and brown crop circles have convinced me there's global warming
3941,1,1,40,42,1.0714285714285714,0.05271774316741633,527,We'll have you back by sunset. No sweat.
3941,1,1,40,42,1.0714285714285714,0.05271774316741633,527,Take me to your unsuccessful Democrat candidate.
3941,1,1,40,42,1.0714285714285714,0.05271774316741633,527,Good evening Sir. Welcome to THE VEGAN.
3941,1,1,40,42,1.0714285714285714,0.05271774316741633,527,"I'm running for President, and I'd like your vote."
3941,0,3,39,42,1.0714285714285714,0.04022089331224806,527,"Are you what they call ""an african-american""?"
3941,0,3,39,42,1.0714285714285714,0.04022089331224806,527,So good to see you. Can you score me some ethanol? We're out of fuel--and really thirsty...
3941,0,3,39,42,1.0714285714285714,0.04022089331224806,527,"Magnetic levitation and wind power. That's the future, friend."
3941,0,3,39,42,1.0714285714285714,0.04022089331224806,527,I'm sorry we only accept intergalactic credit cards.
3941,1,1,40,42,1.0714285714285714,0.05271774316741633,527,My name is Donald J. Trump and I want your vote!
3941,0,3,39,42,1.0714285714285714,0.04022089331224806,527,We've traveled 3 light years to study how Earthlings avoid chaffing.
3941,1,1,40,42,1.0714285714285714,0.05271774316741633,527,It's just not as much fun since Monsanto trademarked the circle.
3941,0,3,39,42,1.0714285714285714,0.04022089331224806,527,"Welcome, earthling, our televised Probe-a-thon has set a new record in intergallactic ratings!"""
3941,0,3,39,42,1.0714285714285714,0.04022089331224806,527,"I come in peas, and, uh, sorry about the corn, too."
3941,0,3,39,42,1.0714285714285714,0.04022089331224806,527,No one is ever going to believe me.
3941,0,3,39,42,1.0714285714285714,0.04022089331224806,527,I wanted to visit before Emperor Trump builds a dome.
3941,0,3,39,42,1.0714285714285714,0.04022089331224806,527,Congratulations! You've made it to Global Services!
3941,1,1,40,42,1.0714285714285714,0.05271774316741633,527,I thought you could use a hand crop dusting.
3941,1,1,40,42,1.0714285714285714,0.05271774316741633,527,Hello Pumpkin Head
3941,0,3,39,42,1.0714285714285714,0.04022089331224806,527,"Intergalactic domination or not, you're still paying for the crop circle damage."
3941,0,3,39,42,1.0714285714285714,0.04022089331224806,527,Welcome to alie-nation after brexit!
3941,1,1,40,42,1.0714285714285714,0.05271774316741633,527,Do you have any suggestions on what to draw tonight?
3941,1,1,40,42,1.0714285714285714,0.05271774316741633,527,Glad you could drop by I have a couple of your steaks on the Barbie
3941,1,1,40,42,1.0714285714285714,0.05271774316741633,527,"Welcome, you come highly recommended by Anne."
3941,0,3,39,42,1.0714285714285714,0.04022089331224806,527,"But, you are on my lawn."
3941,1,1,40,42,1.0714285714285714,0.05271774316741633,527,"Don't worry, this isn't one of your hallucinations!"
3941,1,1,40,42,1.0714285714285714,0.05271774316741633,527,"We're here to capture your ""farm to table"" technology."
3941,0,3,39,42,1.0714285714285714,0.04022089331224806,527,"I'm here to call on your daughter, sir."
3941,0,3,39,42,1.0714285714285714,0.04022089331224806,527,You the first of of the guest workers?
3941,1,1,40,42,1.0714285714285714,0.05271774316741633,527,"Welcome friend! No need for all the gear. We're a non GMO, pesticide free operation here!"
3941,0,3,39,42,1.0714285714285714,0.04022089331224806,527,What's for dinner?
3941,0,3,39,42,1.0714285714285714,0.04022089331224806,527,"Welcome, you're the untutored organic farmer we've been looking for."
3941,1,1,40,42,1.0714285714285714,0.05271774316741633,527,"I didn't realize this is what your online dating profile meant by ""looking for interracial"
3941,1,1,40,42,1.0714285714285714,0.05271774316741633,527,"Yes, we have a healthcare package."
3941,0,3,39,42,1.0714285714285714,0.04022089331224806,527,Thanks again for stopping by to meet the new neighbors.We really appreciate it.
3941,0,3,39,42,1.0714285714285714,0.04022089331224806,527,Welcome to the gene farm!
3941,0,3,39,42,1.0714285714285714,0.04022089331224806,527,My planet loves this Frosted Flake you sell me
3941,0,3,39,42,1.0714285714285714,0.04022089331224806,527,Is this the new Buick?!?
3941,1,1,40,42,1.0714285714285714,0.05271774316741633,527,"Don't worry, this ship isn't powered by electricity..."
3941,0,3,39,42,1.0714285714285714,0.04022089331224806,527,"Nice to meet you, too. We were so afraid we might not make it here before you guys built The Wall to keep folks like us out."
3941,0,3,39,42,1.0714285714285714,0.04022089331224806,527,You can still farm--at our multi-galactic food corporation!
3941,0,3,39,42,1.0714285714285714,0.04022089331224806,527,Please don't build a wall.
3941,1,1,40,42,1.0714285714285714,0.05271774316741633,527,It's universally known you have the best poppy crop.
3941,0,3,39,42,1.0714285714285714,0.04022089331224806,527,Welcome aboard.. We can really use your expertise on crop rotation!
3941,1,1,40,42,1.0714285714285714,0.05271774316741633,527,"Hello!, I'm Smiztete Quiviste from the Crop Circle Compliance Agency."
3941,0,3,39,42,1.0714285714285714,0.04022089331224806,527,Don't thank me: thank Monsanto.
3941,0,3,39,42,1.0714285714285714,0.04022089331224806,527,"Welcome, Salt of the Earth! Our rations have been too bland for light-years."
3941,1,1,40,42,1.0714285714285714,0.05271774316741633,527,Maker Mars great again!
3941,1,1,40,42,1.0714285714285714,0.05271774316741633,527,Probing our non-probing?
3941,0,3,39,42,1.0714285714285714,0.04022089331224806,527,"Is like to come, but Mars is a little too cool for corn..."
3941,0,3,39,42,1.0714285714285714,0.04022089331224806,527,"Again, I'm not Matt Damon."
3941,1,1,40,42,1.0714285714285714,0.05271774316741633,527,Watu Wangu.
3941,0,3,39,42,1.0714285714285714,0.04022089331224806,527,Am I too late for the Great American Dust Bowl?
3941,1,1,40,42,1.0714285714285714,0.05271774316741633,527,I'll show you corn as high as an elephant's eye!
3941,0,3,39,42,1.0714285714285714,0.04022089331224806,527,"So sorry, our light beam is in the shop."
3941,1,1,40,42,1.0714285714285714,0.05271774316741633,527,I'd like to apply for your organic farm worker exchange for lodging.
3941,0,3,39,42,1.0714285714285714,0.04022089331224806,527,I'll be back in nine months in time for your daughter's and my child's birth.
3941,1,1,40,42,1.0714285714285714,0.05271774316741633,527,Thrilled to have you aboard!
3941,0,3,39,42,1.0714285714285714,0.04022089331224806,527,"There ya go Tommy, easy does it."
3941,0,3,39,42,1.0714285714285714,0.04022089331224806,527,"Yes, we UFO's are a United Farmers Organization"
3941,0,3,39,42,1.0714285714285714,0.04022089331224806,527,Have you seen Bessie?
3941,1,1,40,42,1.0714285714285714,0.05271774316741633,527,My family asked me to come down to thank you for supporting GMOs.
3941,1,1,40,42,1.0714285714285714,0.05271774316741633,527,"Hey ho, a merrio, you must be the farmer in the dale"
3941,0,3,39,42,1.0714285714285714,0.04022089331224806,527,Take me to your ethanol subsidizer!
3941,0,3,39,42,1.0714285714285714,0.04022089331224806,527,"""Hello sir, we received a distress signal from one of our people, he goes by the name of D.T"
3941,0,3,39,42,1.0714285714285714,0.04022089331224806,527,"Incredible to find you, your country is running out of farmers to probe."
3941,1,1,40,42,1.0714285714285714,0.05271774316741633,527,Get in. I don't to be taken to your leader.
3941,1,1,40,42,1.0714285714285714,0.05271774316741633,527,"We had to stop because you work those rows with hoes, and then you sows what grows."
3941,1,1,40,42,1.0714285714285714,0.05271774316741633,527,I will give you some candy if you come inside my spaceship
3941,0,3,39,42,1.0714285714285714,0.04022089331224806,527,Take me to Chuck Berry.
3941,1,1,40,42,1.0714285714285714,0.05271774316741633,527,WHAT'S A NICE LADY LIKE YOU DOING IN A PLACE LIKE THIS?
3941,1,1,40,42,1.0714285714285714,0.05271774316741633,527,Are you the one from the Wizard of Oz without the brain?
3941,0,3,39,42,1.0714285714285714,0.04022089331224806,527,Hope you like corn!
3941,1,1,40,42,1.0714285714285714,0.05271774316741633,527,Thank you for picking me up. Canada wouldn't have me because of my primary vote.
3941,0,3,39,42,1.0714285714285714,0.04022089331224806,527,"I got it - you are ordering 25 ears of corn, a sack of potatoes, and 5 heads of lettuce."
3941,0,3,39,42,1.0714285714285714,0.04022089331224806,527,Greetings. May we discuss your insurance needs?
3941,0,3,39,42,1.0714285714285714,0.04022089331224806,527,"Greetings, earthling. Is your name Donald Trump?"
3941,1,1,40,42,1.0714285714285714,0.05271774316741633,527,I'm Mork...Mindy will be right back!
3941,0,3,39,42,1.0714285714285714,0.04022089331224806,527,Feeling your oats?
3941,1,1,40,42,1.0714285714285714,0.05271774316741633,527,Welcome. And relax...we didn't invite Monsanto.
3941,0,3,39,42,1.0714285714285714,0.04022089331224806,527,"Hey Phil, can I borrow a cup of sugar? I promise I'll bring it back!"
3941,0,3,39,42,1.0714285714285714,0.04022089331224806,527,No farmers allowed - we've seen 'Green Acres'!
3941,1,1,40,42,1.0714285714285714,0.05271774316741633,527,"Well, howdee stranger! I was beginning to think you guys were never coming back. You still like your steak medium rear, right?"
3941,0,3,39,42,1.0714285714285714,0.04022089331224806,527,"Don't be afraid, it's just like your tractor. Pull back the throttle and away she goes."
3941,0,3,39,42,1.0714285714285714,0.04022089331224806,527,We welcome you and your genetically modified seeds!
3941,0,3,39,42,1.0714285714285714,0.04022089331224806,527,"I'm John, Leader of the Farm."
3941,0,3,39,42,1.0714285714285714,0.04022089331224806,527,The abduction corn maze is awesome!
3941,0,3,39,42,1.0714285714285714,0.04022089331224806,527,Happy Father's day daddy! You made it back after all!
3941,0,3,39,42,1.0714285714285714,0.04022089331224806,527,Thanks for coming. We could really use your advice about crop circles.
3941,0,3,39,42,1.0714285714285714,0.04022089331224806,527,"No, we haven't heard the good news."
3941,0,3,39,42,1.0714285714285714,0.04022089331224806,527,We are looking for Galaxy sourced produce.
3941,1,1,40,42,1.0714285714285714,0.05271774316741633,527,Can I tell you about fracking?
3941,0,3,39,42,1.0714285714285714,0.04022089331224806,527,Welocme GMO Expert. We have been awaiting you.
4106,0,3,40,43,1.069767441860465,0.03930950021993099,527,"Earthling.....what do you mean by ""how do you keep them down on the farm""?"
4106,0,3,40,43,1.069767441860465,0.03930950021993099,527,Welcome to the no TRUMP world.
4106,1,1,41,43,1.069767441860465,0.051503946641122844,527,My name is Wizard and we're going to a planet named Oz
4106,1,1,41,43,1.069767441860465,0.051503946641122844,527,What took you so long? I drew that crop circle when Brownback became Governor of Kansas. I was hoping to leave before he mucked things up.
4106,1,1,41,43,1.069767441860465,0.051503946641122844,527,"Really, don't worry, those GMO seeds will be great."
4106,1,1,41,43,1.069767441860465,0.051503946641122844,527,"OK, it's a deal. But, obviously, escrow has to close before Trump becomes president."
4106,0,3,40,43,1.069767441860465,0.03930950021993099,527,How's your brother Jeffrey?
4106,0,3,40,43,1.069767441860465,0.03930950021993099,527,Come on in. My wife's guac recipe is out of this world.
4106,1,1,41,43,1.069767441860465,0.051503946641122844,527,Please come in and tell us more about Rumspringa.
4106,0,3,40,43,1.069767441860465,0.03930950021993099,527,So about the probing...
4106,1,1,41,43,1.069767441860465,0.051503946641122844,527,We come in peas-- GMO-free peas!
4106,1,1,41,43,1.069767441860465,0.051503946641122844,527,Yes human I said our species is called the Ileegahls.
4106,1,1,41,43,1.069767441860465,0.051503946641122844,527,Greetings from Monsanto Welcome Wagon.
4106,0,3,40,43,1.069767441860465,0.03930950021993099,527,It's an honor to meet you. Your crops are always a pleasure for us to circle.
4106,0,3,40,43,1.069767441860465,0.03930950021993099,527,Can you make this one a peace sign? Might be helpful about now.
4106,0,3,40,43,1.069767441860465,0.03930950021993099,527,"Honestly, UBER treats us better than my old boss did."
4106,0,3,40,43,1.069767441860465,0.03930950021993099,527,"Toto, yes you’re in Kansas."
4106,0,3,40,43,1.069767441860465,0.03930950021993099,527,"Gotta run, Hubert. Your possum gumbo is--how do you say it?--outta this dang world!"
4106,0,3,40,43,1.069767441860465,0.03930950021993099,527,You have run circles around the other guys we hired.
4106,0,3,40,43,1.069767441860465,0.03930950021993099,527,We have some great GM animals for you.
4106,0,3,40,43,1.069767441860465,0.03930950021993099,527,Our hydroponics are out of this world!
4127,1,0,36,37,1.054054054054054,0.05405405405405408,527,"I don't mean to be corny, but..."
4127,0,2,35,37,1.054054054054054,0.03768738858261605,527,"Just like you, we're a disappearing species."
4127,0,2,35,37,1.054054054054054,0.03768738858261605,527,Is that a hat or are you happy to see me?
4127,0,2,35,37,1.054054054054054,0.03768738858261605,527,The last roundup was yesterday. You missed it.
4131,0,2,36,38,1.0526315789473684,0.0367097806559429,527,We heard you needed more space for your crops.
4131,0,2,36,38,1.0526315789473684,0.0367097806559429,527,We're now offering a stairway to space.
4131,0,2,36,38,1.0526315789473684,0.0367097806559429,527,Relax ! We have lots of sheep !
4131,0,2,36,38,1.0526315789473684,0.0367097806559429,527,Come on in and meet the Mrs.
4131,0,2,36,38,1.0526315789473684,0.0367097806559429,527,I'm a big fan of Kelly McGillis.
4131,0,2,36,38,1.0526315789473684,0.0367097806559429,527,Hi there young fella! Come in and set a spell.
4131,0,2,36,38,1.0526315789473684,0.0367097806559429,527,I must have taken a wrong turn at Alburqueque
4131,0,2,36,38,1.0526315789473684,0.0367097806559429,527,Congratulations! You must be Salt of the earth?
4131,0,2,36,38,1.0526315789473684,0.0367097806559429,527,Welcome slob. Hate spacesuits. Teach us pollution.
4131,0,2,36,38,1.0526315789473684,0.0367097806559429,527,Howdy neighbor. We'd like your help in getting subsidies from your leaders.
4131,0,2,36,38,1.0526315789473684,0.0367097806559429,527,Welcome Young man. Our research indicates that you are a likely participant in the July 5 Iowa caucus
4131,0,2,36,38,1.0526315789473684,0.0367097806559429,527,"""Remember, they haven't figured out yet that GMO stands for Gort Makes Onions""."
4131,0,2,36,38,1.0526315789473684,0.0367097806559429,527,"Hello! I wonder, do you happen to have a cup of sugar? The missus is asking."
4131,0,2,36,38,1.0526315789473684,0.0367097806559429,527,We'd like to borrow your planet.
4131,0,2,36,38,1.0526315789473684,0.0367097806559429,527,We've chose you for our next GMO project.
4131,0,2,36,38,1.0526315789473684,0.0367097806559429,527,We are here to negotiate the crop circle contract.
4131,0,2,36,38,1.0526315789473684,0.0367097806559429,527,Sorry about the dessert -- next time we'll have pie.
4148,0,2,37,39,1.0512820512820513,0.03578157512432619,527,"The wife and I, we thought maybe you'd like to design our Halloween corn maze this year, for the kids."
4148,0,2,37,39,1.0512820512820513,0.03578157512432619,527,Are we still in time for Woodstock?
4148,0,2,37,39,1.0512820512820513,0.03578157512432619,527,U-um ah we will cook your Thanksgiving meal.
4148,0,2,37,39,1.0512820512820513,0.03578157512432619,527,Howdy neighbor!
4148,0,2,37,39,1.0512820512820513,0.03578157512432619,527,"Thank you so much for the milk and cookies. By the way, do you have any Pepto Bismol."
4148,0,2,37,39,1.0512820512820513,0.03578157512432619,527,"Glad to meet you, we came for some salt and pepper."
4148,0,2,37,39,1.0512820512820513,0.03578157512432619,527,Can you loan us any unused atoms?
4148,0,2,37,39,1.0512820512820513,0.03578157512432619,527,"Greetings Farmer John! Are you voting for Hillary, too?"
4148,0,2,37,39,1.0512820512820513,0.03578157512432619,527,Hopefully you can teach us some of Matt Damon's tricks during your visit...
4148,1,0,38,39,1.0512820512820513,0.05128205128205128,527,So you're the one in charge of my GMO's
4148,0,2,37,39,1.0512820512820513,0.03578157512432619,527,This thing got a sprinkler?
4148,0,2,37,39,1.0512820512820513,0.03578157512432619,527,Our tractor's not working!
4148,0,2,37,39,1.0512820512820513,0.03578157512432619,527,These new seeds are out of this world!
4148,1,0,38,39,1.0512820512820513,0.05128205128205128,527,Greetings! While you were napping Trump won the election.
4148,1,0,38,39,1.0512820512820513,0.05128205128205128,527,"Jesus Christ, what an asshole."
4148,0,2,37,39,1.0512820512820513,0.03578157512432619,527,Our universal positioning system is on the blink.
4148,1,0,38,39,1.0512820512820513,0.05128205128205128,527,"Christ, what an asshole!"
4148,0,2,37,39,1.0512820512820513,0.03578157512432619,527,From a Twilight Zone eiposde we're here to best serve man
4148,0,2,37,39,1.0512820512820513,0.03578157512432619,527,"Have no fear, we're non-GMO."
4148,0,2,37,39,1.0512820512820513,0.03578157512432619,527,We are here to serve you-we just need some of your potatoes.
4148,0,2,37,39,1.0512820512820513,0.03578157512432619,527,I'm from FarmersOnly. You checked you're okay with anal?
4148,0,2,37,39,1.0512820512820513,0.03578157512432619,527,"Thank you for the lift, Papa. Rumspringa 2247 is going to be great."
4148,0,2,37,39,1.0512820512820513,0.03578157512432619,527,Leave quickly before Trump tries to build a wall around you too.
4148,0,2,37,39,1.0512820512820513,0.03578157512432619,527,M.I.B. online said I could find a good Edgar Suit here.
4148,0,2,37,39,1.0512820512820513,0.03578157512432619,527,Take me to your subsidy.
4148,0,2,37,39,1.0512820512820513,0.03578157512432619,527,"That double reverse convex wheel thing was tricky, but I think the Donald Trump smiley face will be easier."
4148,0,2,37,39,1.0512820512820513,0.03578157512432619,527,We've been contracted by the Koch brothers to gather up Republicans like you in order to save the Party from extinction.
4148,1,0,38,39,1.0512820512820513,0.05128205128205128,527,Loved the corn! Do you grow pizza?
4148,0,2,37,39,1.0512820512820513,0.03578157512432619,527,"Hey Bill, I'm G*#^^r. Let's make this happen!"
4148,0,2,37,39,1.0512820512820513,0.03578157512432619,527,Welcome to Believeland.
4148,0,2,37,39,1.0512820512820513,0.03578157512432619,527,We're hoping you can teach us how to make crop circles.
4148,0,2,37,39,1.0512820512820513,0.03578157512432619,527,Welcome! Can I show you how we make crop circles?
4148,0,2,37,39,1.0512820512820513,0.03578157512432619,527,I want to eat your face. Just shake my hand and I'll get my bib in a second.
4148,0,2,37,39,1.0512820512820513,0.03578157512432619,527,Now remember: Trump yes; Clinton no.
4148,0,2,37,39,1.0512820512820513,0.03578157512432619,527,"Howdy pardoner, we've been expecting you."
4148,1,0,38,39,1.0512820512820513,0.05128205128205128,527,Thanks for not planting wheat. We're gluten-free too!
4148,0,2,37,39,1.0512820512820513,0.03578157512432619,527,Thank you for your vote
4148,0,2,37,39,1.0512820512820513,0.03578157512432619,527,Welcome aboard! Let me show you to one of our probing rooms.
4148,0,2,37,39,1.0512820512820513,0.03578157512432619,527,With your help Mr. Trump will be elected instead of returning to the mothership.
4148,0,2,37,39,1.0512820512820513,0.03578157512432619,527,"We would be happy to pay you for the cattle. Come right in and have a seat at the examining table, Mr. Saunders."
4148,0,2,37,39,1.0512820512820513,0.03578157512432619,527,Thank goodness-Roswell is a scorcher and we have unimaginable presumptive candidates..
4148,0,2,37,39,1.0512820512820513,0.03578157512432619,527,"Hi, I left my planit because of Marxit."
4148,1,0,38,39,1.0512820512820513,0.05128205128205128,527,Howdy! I reckon y’all don't get too many strangers round these parts!
4148,0,2,37,39,1.0512820512820513,0.03578157512432619,527,We're looking to make locally grown non GMO organic crop circles.
4148,0,2,37,39,1.0512820512820513,0.03578157512432619,527,"Thanks again, free-range eggs are going for ?52 Qudnaps at my local GalacticFoods."
4148,1,0,38,39,1.0512820512820513,0.05128205128205128,527,So THIS is what the city looks like!
4148,0,2,37,39,1.0512820512820513,0.03578157512432619,527,Take me to your Yay-hoo.
4148,0,2,37,39,1.0512820512820513,0.03578157512432619,527,"Hey, you're just in time for our bio-diversity party!"
4148,0,2,37,39,1.0512820512820513,0.03578157512432619,527,You're real! May I bring the wife and kids? They never believed me.
4148,0,2,37,39,1.0512820512820513,0.03578157512432619,527,Come on in little feller. It's been a while since we've had the opportunity to serve man.
4148,0,2,37,39,1.0512820512820513,0.03578157512432619,527,No government subsidies where we are going.. for we have no government..only vegetables.
4199,0,2,38,40,1.05,0.03489912202260563,527,Of course it is organic
4199,0,2,38,40,1.05,0.03489912202260563,527,Take me to your followers.
4199,1,0,39,40,1.05,0.04999999999999999,527,We rushed your order of non-GMO seeds.
4199,0,2,38,40,1.05,0.03489912202260563,527,We are here to check out your drones.
4199,0,2,38,40,1.05,0.03489912202260563,527,Are you my mommy?
4199,0,2,38,40,1.05,0.03489912202260563,527,You must be the fertilizer guy. Come on in!!
4199,0,2,38,40,1.05,0.03489912202260563,527,"Hello, Earthling. We're here to fix your Trump problem."
4199,0,2,38,40,1.05,0.03489912202260563,527,Greetings Earthling. Take me to your WiFi !
4199,0,2,38,40,1.05,0.03489912202260563,527,You don't need a photo ID.
4199,0,2,38,40,1.05,0.03489912202260563,527,i thought the show was fake
4199,0,2,38,40,1.05,0.03489912202260563,527,You're sure you have enough water to share with me?
4199,0,2,38,40,1.05,0.03489912202260563,527,Got any non-GMO seeds? We're fresh out.
4199,1,0,39,40,1.05,0.04999999999999999,527,Sleepwalking and handshaking - both of them... 'We need help...'
4199,0,2,38,40,1.05,0.03489912202260563,527,Welcome to our GMO.
4199,1,0,39,40,1.05,0.04999999999999999,527,You're not Flash Gordon!
4199,1,0,39,40,1.05,0.04999999999999999,527,We just came to lend our support to Donald Trump and visit Roswell.
4199,0,2,38,40,1.05,0.03489912202260563,527,"Organ harvesting? What, I lookee likee Chinee here?"
4199,0,2,38,40,1.05,0.03489912202260563,527,Hi Vincent. How'd you like to see a starry starry night?
4199,0,2,38,40,1.05,0.03489912202260563,527,Welcome aboard. Did you bring your Farm Subsidy check?
4199,0,2,38,40,1.05,0.03489912202260563,527,Welcome! Your John Deere up on Mars awaits you.
4199,1,0,39,40,1.05,0.04999999999999999,527,Congratulations the Galactic Comity of Eradication Prevention has chosen your genes to represent the human species in case Trump becomes president.
4199,0,2,38,40,1.05,0.03489912202260563,527,Gotcha! I invented the joy buzzer and I want my royalties.
4199,0,2,38,40,1.05,0.03489912202260563,527,"Our vehicle runs well on turnip juice, and you're the man we've come to see."
4199,0,2,38,40,1.05,0.03489912202260563,527,Do you have any good manure?
4199,0,2,38,40,1.05,0.03489912202260563,527,"Fertilizer, pesticides, genetically modified seeds--we'll make you rich! Just come on in. Come on in!"
4199,0,2,38,40,1.05,0.03489912202260563,527,Thank God they passed the Farm Bill.
4199,0,2,38,40,1.05,0.03489912202260563,527,My kids were asking are there any crop fields round here?
4199,0,2,38,40,1.05,0.03489912202260563,527,Come in. I have a cellphone. You can call home.
4199,0,2,38,40,1.05,0.03489912202260563,527,"Hurry, before the yuuuge wall gets any taller."
4199,0,2,38,40,1.05,0.03489912202260563,527,Greetings. May I borrow your detachable appendage to phone home?
4199,0,2,38,40,1.05,0.03489912202260563,527,I know it looks like I’m wearing glasses; but I’m not.
4199,0,2,38,40,1.05,0.03489912202260563,527,We need someone to teach us how to shoe a horse
4199,0,2,38,40,1.05,0.03489912202260563,527,"Hello, I'm Donald your Supreme Commander. Welcome to the U.S.S Apprentice."
4199,0,2,38,40,1.05,0.03489912202260563,527,Yup! If you win the Crop Circle Design contest you'll get a helmet just like mine.
4199,0,2,38,40,1.05,0.03489912202260563,527,Sure you want to come? We don't have horses and buggies on Xenopia.
4199,0,2,38,40,1.05,0.03489912202260563,527,I always wanted to shake the hand of my CSA farmer.
4199,0,2,38,40,1.05,0.03489912202260563,527,Trump was supposed to make our appearance seem less threatening.
4199,0,2,38,40,1.05,0.03489912202260563,527,Stop tickling my palm-It makes me uncomfortable.
4199,1,0,39,40,1.05,0.04999999999999999,527,It's an honor to meet you and visit your country Mr.President.
4199,0,2,38,40,1.05,0.03489912202260563,527,"Hey, thanks for making all those crop circles; it's really upped our intergalactic street cred."
4199,0,2,38,40,1.05,0.03489912202260563,527,Are you sure you're Donald Trump?
4199,0,2,38,40,1.05,0.03489912202260563,527,This might be our last visit for awhile if alien's are made illegal and you borders are closed.
4199,1,0,39,40,1.05,0.04999999999999999,527,Please vote Clin-Ton. We need sustain food supply.
4199,0,2,38,40,1.05,0.03489912202260563,527,"Greetings, earthling. Take me to your leader, Mr. Trump."
4199,0,2,38,40,1.05,0.03489912202260563,527,"Come on in, Earthling Farmer, and taste what WE'VE been harvesting!"
4199,0,2,38,40,1.05,0.03489912202260563,527,"Greetings, I hope you're not afraid of heights."
4199,0,2,38,40,1.05,0.03489912202260563,527,We'd like to talk to you about GMOs.
4199,0,2,38,40,1.05,0.03489912202260563,527,"Hi, I'm A. Lian. We've been expecting you."
4199,0,2,38,40,1.05,0.03489912202260563,527,I'm here to tell you what it's all about Alfie.
4199,0,2,38,40,1.05,0.03489912202260563,527,Take me to your market.
4199,0,2,38,40,1.05,0.03489912202260563,527,Matt Damon? We are here to take you back.
4199,0,2,38,40,1.05,0.03489912202260563,527,Is this the way to the hog-tying contest?
4199,0,2,38,40,1.05,0.03489912202260563,527,I gave at the office.
4199,0,2,38,40,1.05,0.03489912202260563,527,Welcome. Most of our visitors drive muddy dual wheel pickups but I never seen one this shiny. What kinda car wax do you use?
4199,0,2,38,40,1.05,0.03489912202260563,527,I'll take you back to the city after the election. Remember: Vote Hillary.
4199,0,2,38,40,1.05,0.03489912202260563,527,"I'm actually a third cousin, once removed, on your wife's side."
4199,0,2,38,40,1.05,0.03489912202260563,527,John Deere.
4199,0,2,38,40,1.05,0.03489912202260563,527,Ah... Close encounters of the turd kind.
4199,0,2,38,40,1.05,0.03489912202260563,527,Our planet is starving. Can you spare us some bees?
4199,0,2,38,40,1.05,0.03489912202260563,527,Welcome aboard. We take off for our planet in five milliseconds!
4199,0,2,38,40,1.05,0.03489912202260563,527,"Welcome! I'm Qjzb,head of our Alien Assimilation Unit. We gather from your twitters that you're an advocate."
4199,0,2,38,40,1.05,0.03489912202260563,527,"Hello, neighbor! Have you heard the word of Xenu today?"
4199,0,2,38,40,1.05,0.03489912202260563,527,Welcome aboard Star Wars Airlines.
4199,0,2,38,40,1.05,0.03489912202260563,527,"Your bicolor corn is flourishing on our planet. Only now, it's transgender corn."
4199,0,2,38,40,1.05,0.03489912202260563,527,"Oh, thank God you're here. We are having serious problems with our crops this season."
4199,0,2,38,40,1.05,0.03489912202260563,527,"Good evening, sir. I'd like to talk to you about our Savior, insurance, AND space travel."
4199,0,2,38,40,1.05,0.03489912202260563,527,I guess size matters up here too.
4199,0,2,38,40,1.05,0.03489912202260563,527,It turns out I was actually holier than thou...
4199,0,2,38,40,1.05,0.03489912202260563,527,"Yes, but you're sure you can do organic."
4199,0,2,38,40,1.05,0.03489912202260563,527,Welcome aboard sir. As an illegal immigrant to our planet you will receive minimum wage for picking cotton. I will help you over the wall.
4199,0,2,38,40,1.05,0.03489912202260563,527,We come from your future. Beyond the Wall.
4199,0,2,38,40,1.05,0.03489912202260563,527,Mr. Trump isn't in now. Please check back when his polling numbers drop another 10 points.
4199,0,2,38,40,1.05,0.03489912202260563,527,"Now that you're GMO-friendly, we'd like to lease your back forty as a prenatal unit."
4199,0,2,38,40,1.05,0.03489912202260563,527,Go! Go! I'm sorry that I said 'Stay' way back then.
4199,0,2,38,40,1.05,0.03489912202260563,527,"i'm looking for ""The Wire"" on dvd"
4199,0,2,38,40,1.05,0.03489912202260563,527,Welcome aboard. We are thrilled with your organic agriculture.
4199,0,2,38,40,1.05,0.03489912202260563,527,Have you seen my wife? She should be arriving any minute from Venus.
4199,0,2,38,40,1.05,0.03489912202260563,527,"Eric Stranton, Rush Chairman. Damn Glad To Meet You"
4199,0,2,38,40,1.05,0.03489912202260563,527,I want to demonstrate how America welcomes aliens.
4199,1,0,39,40,1.05,0.04999999999999999,527,"Welcome,you're going to like my world."
4199,0,2,38,40,1.05,0.03489912202260563,527,"Welcome back Zeke. Your last test results were good, but we have to do some more probing and it's all covered by Medicare."
4199,0,2,38,40,1.05,0.03489912202260563,527,Are. Your. Loved. Ones. Provided. For. In. The. Event. Of...
4199,0,2,38,40,1.05,0.03489912202260563,527,Nice to meet you...We are looking forward to working on our landings in your cornfield.
4199,0,2,38,40,1.05,0.03489912202260563,527,Gluten-free? It's #1 down here.
4199,0,2,38,40,1.05,0.03489912202260563,527,"Welcome to my ship, ""The Dust Bowl""."
4199,0,2,38,40,1.05,0.03489912202260563,527,"Welcome, we need a good corn husker!"
4199,0,2,38,40,1.05,0.03489912202260563,527,"We've ruined our planet, so we've come to share in your paradise."
4199,0,2,38,40,1.05,0.03489912202260563,527,"And if you are ever in the neighborhood of Venus, stop by and I'll reciprocate the hospitality."
4199,0,2,38,40,1.05,0.03489912202260563,527,"Marvin, I presume."
4199,0,2,38,40,1.05,0.03489912202260563,527,Welcome aboard. I will be your health care provider with your Obamacare health plan.
4199,0,2,38,40,1.05,0.03489912202260563,527,Dance?..I thought you'd never ask.
4199,0,2,38,40,1.05,0.03489912202260563,527,"You take care of the woman who's sleeping next to me, and you got yourself a deal."
4199,0,2,38,40,1.05,0.03489912202260563,527,"Hi there, are there any cows here? I swear I just saw one go over the moon."
4199,0,2,38,40,1.05,0.03489912202260563,527,Wow! Word really does get around when you're looking to hire an illegal.
4199,0,2,38,40,1.05,0.03489912202260563,527,Just in time; we have run out of cocaine
4199,1,0,39,40,1.05,0.04999999999999999,527,"What do you mean, ""Where's Melinda Dillion""...."
4199,0,2,38,40,1.05,0.03489912202260563,527,Hi there! We heard they're giving away free land again!
4199,0,2,38,40,1.05,0.03489912202260563,527,Our genetically modified corn hasn't been working out so well.
4199,0,2,38,40,1.05,0.03489912202260563,527,"Come with us, earthling. I promise you'll be able to phone home on the range."
4199,0,2,38,40,1.05,0.03489912202260563,527,Yeah it's me Charlie. I'm your transplanetary sister.
4199,0,2,38,40,1.05,0.03489912202260563,527,Is this where I sign up for the farm share box?
4199,0,2,38,40,1.05,0.03489912202260563,527,Come on in and sit a spell. The wife was just sayin' she had a taste up for some mincemeat pie.
4199,1,0,39,40,1.05,0.04999999999999999,527,Hello! Welcome to Sweetie's flying pies !!
4199,0,2,38,40,1.05,0.03489912202260563,527,Your corn in my canvas.
4303,0,2,39,41,1.048780487804878,0.034059122057973054,527,Hello. Sorry we had to emergency land here. If we can we use your Electric Vehicle Power Station to recharge we'll be on our way lickety-split.
4303,0,2,39,41,1.048780487804878,0.034059122057973054,527,"This for June 20, 2016 contest. Sorry I am a little late. Size doesn't matter here."
4303,0,2,39,41,1.048780487804878,0.034059122057973054,527,Sorry...Klaatu got deported.
4303,0,2,39,41,1.048780487804878,0.034059122057973054,527,Too cold for your liking? Give it time.
4303,0,2,39,41,1.048780487804878,0.034059122057973054,527,The fitting room is on your right.
4303,0,2,39,41,1.048780487804878,0.034059122057973054,527,"Don't worry! I promise, you'll fit right in, Flarbnorf."
4303,0,2,39,41,1.048780487804878,0.034059122057973054,527,Yes it is the election year and they are the only candidates .
4303,0,2,39,41,1.048780487804878,0.034059122057973054,527,This is some barn you got here mistuh!
4303,0,2,39,41,1.048780487804878,0.034059122057973054,527,Welcome aboard Mr. Ziffel! Did you bring Arnold?
4312,0,1,34,35,1.0285714285714285,0.028988551782622423,527,"Delivery! Hay from Mars, for Mr. Farmer."
4313,0,1,35,36,1.0277777777777777,0.028171808490950554,527,Hello. The name's Circle.
4313,0,1,35,36,1.0277777777777777,0.028171808490950554,527,"Sorry, the party's been cancelled - something about global warming."
4313,0,1,35,36,1.0277777777777777,0.028171808490950554,527,Would you be a lamb and go 'head and take me to your leader?
4316,0,1,36,37,1.027027027027027,0.02739983121755955,527,Klatu barada nikto GMO!
4316,0,1,36,37,1.027027027027027,0.02739983121755955,527,"Come join me firend, I'm binge watching Gilmore Girls."
4316,0,1,36,37,1.027027027027027,0.02739983121755955,527,"Don't be fooled by our plain and simple ways. Your science might be 1,000 years ahead of ours but you only have the the other earthlings beat by 816."
4316,0,1,36,37,1.027027027027027,0.02739983121755955,527,Thank you. We can only land in wheat fields
4316,0,1,36,37,1.027027027027027,0.02739983121755955,527,Congratulations! You're the first human to use our shuttle service.
4316,0,1,36,37,1.027027027027027,0.02739983121755955,527,"Absolutely, glad to be of service. Did you want to check out our new Rhombus option?"
4316,0,1,36,37,1.027027027027027,0.02739983121755955,527,"Ark ""no"""
4323,0,1,37,38,1.0263157894736843,0.02666903735313325,527,"Take us to your lead- what was that? Oh I see, never mind then."
4323,0,1,37,38,1.0263157894736843,0.02666903735313325,527,Tell Kevin Costner sorry about the mix-up.
4323,0,1,37,38,1.0263157894736843,0.02666903735313325,527,C'mon in and try MY Moonshine.
4323,0,1,37,38,1.0263157894736843,0.02666903735313325,527,Welcome Mr. Brown
4323,0,1,37,38,1.0263157894736843,0.02666903735313325,527,At warp speed our migrant farmers arrive in time to practice the lost art of spring plowing ....
4323,0,1,37,38,1.0263157894736843,0.02666903735313325,527,How'd you like to farm for the Neptune Icebreakers?
4323,0,1,37,38,1.0263157894736843,0.02666903735313325,527,The optional whitewalls clashed with his onesie.
4323,0,1,37,38,1.0263157894736843,0.02666903735313325,527,You have a beautiful planet. Is Trump really running against Hillary?
4323,0,1,37,38,1.0263157894736843,0.02666903735313325,527,Sorry we couldn't make a deal. I just wouldn't feel right raisin' that kind of livestock…
4323,0,1,37,38,1.0263157894736843,0.02666903735313325,527,The names AL. AL Leon. Welcome! What's your ass size 6?
4323,0,1,37,38,1.0263157894736843,0.02666903735313325,527,We’re disappointed too.
4323,0,1,37,38,1.0263157894736843,0.02666903735313325,527,"Welcome Earthling! I kicked out the crew so you can be the first tenant in our Galactic Arms AirBnB! You can tell the wife, we'll have your bones back by supper. We Promise!"
4323,0,1,37,38,1.0263157894736843,0.02666903735313325,527,"I accept your monthly parking rate for space ships of $200 per month which is 22,000 Err%&s in our currency."
4323,0,1,37,38,1.0263157894736843,0.02666903735313325,527,"You inspire the poet in me: You work those rows with hoes, and then you sows what grows."
4323,0,1,37,38,1.0263157894736843,0.02666903735313325,527,It's more than a confined feeding facility.
4323,0,1,37,38,1.0263157894736843,0.02666903735313325,527,"Nice mission Klaatu, you really had 'em fooled for years. Now it's time to take you home."
4323,0,1,37,38,1.0263157894736843,0.02666903735313325,527,"I'm a little tired of those farmer daughter jokes, arent't you?"
4323,0,1,37,38,1.0263157894736843,0.02666903735313325,527,We need your business.
4323,0,1,37,38,1.0263157894736843,0.02666903735313325,527,Is this the best route to Paradise?
4323,0,1,37,38,1.0263157894736843,0.02666903735313325,527,Welcome to new space farming technology.
4323,0,1,37,38,1.0263157894736843,0.02666903735313325,527,I am running on empty. Could you spare a gallon of gas?
4323,0,1,37,38,1.0263157894736843,0.02666903735313325,527,That being with the orange skin convinced us its better back on planet Zorg.
4323,0,1,37,38,1.0263157894736843,0.02666903735313325,527,"Take me to your leader, Monsanto."
4323,0,1,37,38,1.0263157894736843,0.02666903735313325,527,You're just in time for dinner. I hope you like curried Martian.
4323,0,1,37,38,1.0263157894736843,0.02666903735313325,527,"Mister, that airbnb shure did you injustice..."
4323,0,1,37,38,1.0263157894736843,0.02666903735313325,527,Hey Fred it's been along time! We all decided we would like for you to be our permenant subject. What do ya say?
4323,0,1,37,38,1.0263157894736843,0.02666903735313325,527,We need you to stop growing genetically modified crops.
4323,0,1,37,38,1.0263157894736843,0.02666903735313325,527,We're from Planet Trump - take us to our leader.
4323,0,1,37,38,1.0263157894736843,0.02666903735313325,527,Tell me all about Trump. We've been without cable for almost a millennium now.
4323,0,1,37,38,1.0263157894736843,0.02666903735313325,527,We're an advanced civilization. Why would we want to see YOUR leader? We want you to show us how to sow our wild oats.
4323,0,1,37,38,1.0263157894736843,0.02666903735313325,527,"The wall around your world is nearly finished. Good luck, Gomer."
4323,0,1,37,38,1.0263157894736843,0.02666903735313325,527,So you finally decided you need me to show you how to grow crops the right way.
4323,0,1,37,38,1.0263157894736843,0.02666903735313325,527,And so the “Farmer Glorp” saga begins…
4323,0,1,37,38,1.0263157894736843,0.02666903735313325,527,Is this a GMO?
4323,0,1,37,38,1.0263157894736843,0.02666903735313325,527,Howdy. I'm the GMO you planted last year.
4323,0,1,37,38,1.0263157894736843,0.02666903735313325,527,Do you really think you're going to fool Him with that hula hoop?
4323,0,1,37,38,1.0263157894736843,0.02666903735313325,527,A farmer cosdume in dhe mid-wesd...mosd excellend Eardhling Drump.
4323,0,1,37,38,1.0263157894736843,0.02666903735313325,527,Welcome to Uber-Xterra. We'll have you in town in less than 30 seconds and that includes some crazy crop circles.
4323,0,1,37,38,1.0263157894736843,0.02666903735313325,527,"So nice to meet you, an Earthling unaware of the Simpson's and their book, How To Cook for forty Humans."
4323,0,1,37,38,1.0263157894736843,0.02666903735313325,527,Howdy. I'm gonna show you something that's faster than a horse.
4323,0,1,37,38,1.0263157894736843,0.02666903735313325,527,"Gravity-free tomatoes, corn and wheat -- light, airy and fun to eat!"
4323,0,1,37,38,1.0263157894736843,0.02666903735313325,527,"Quick, get in here before the genetically modified crops eat you alive."
4323,0,1,37,38,1.0263157894736843,0.02666903735313325,527,It works as a parental lock for both Netflix and Xenu.
4323,0,1,37,38,1.0263157894736843,0.02666903735313325,527,Are you the hillbilly life form in slaver of the cows?
4323,0,1,37,38,1.0263157894736843,0.02666903735313325,527,We really like your organic grass-fed beef.
4323,0,1,37,38,1.0263157894736843,0.02666903735313325,527,Welcome aboard...Hope you are into BBQ
4323,0,1,37,38,1.0263157894736843,0.02666903735313325,527,We are here to supernavigate the wall.
4323,0,1,37,38,1.0263157894736843,0.02666903735313325,527,"Mildred, that Trump fella needs a bigger wall!"
4323,0,1,37,38,1.0263157894736843,0.02666903735313325,527,We need your expertise. Only potatoes grow on our soil.
4323,0,1,37,38,1.0263157894736843,0.02666903735313325,527,"""Are you sure you've got those fancy-schmancy alfalfa seeds aaboard your vehicle/'"
4323,0,1,37,38,1.0263157894736843,0.02666903735313325,527,...but I'd have to leave here.
4323,0,1,37,38,1.0263157894736843,0.02666903735313325,527,Thanks for agreeing to be our surrogate.
4323,0,1,37,38,1.0263157894736843,0.02666903735313325,527,"For a little extra, we guarantee delivery in 2116."
4323,0,1,37,38,1.0263157894736843,0.02666903735313325,527,"""Welcome, was it raining on the way?"
4323,0,1,37,38,1.0263157894736843,0.02666903735313325,527,Something there is that doesn't love a wall.
4323,0,1,37,38,1.0263157894736843,0.02666903735313325,527,"So you're the species that has finally developed the technology to capture farts. Tell me more about this contraption you call a ""methane digester."""
4323,0,1,37,38,1.0263157894736843,0.02666903735313325,527,I've recently lost a bunch of weight.
4380,0,1,38,39,1.0256410256410255,0.025976216673306556,527,"Ok, late October? Thanks."
4380,0,1,38,39,1.0256410256410255,0.025976216673306556,527,Just follow the nose. It is clogged since we left Venus.
4380,0,1,38,39,1.0256410256410255,0.025976216673306556,527,I think you might be one of us.
4380,0,1,38,39,1.0256410256410255,0.025976216673306556,527,"Gorgeous cabinet, love the extra storage. We'll be back!"
4380,0,1,38,39,1.0256410256410255,0.025976216673306556,527,"You know, a bit more slope to that roof and another prop and you'd have passed us."
4380,0,1,38,39,1.0256410256410255,0.025976216673306556,527,"Welcome to Uber! And, no, we don't have unions or insurance requirements here, either!"
4380,0,1,38,39,1.0256410256410255,0.025976216673306556,527,This beats the hell out of sniffing burlap.
4380,0,1,38,39,1.0256410256410255,0.025976216673306556,527,You promise you don't use GMO'S in your feed!
4380,0,1,38,39,1.0256410256410255,0.025976216673306556,527,"Hey, did you bring some beer?"
4380,0,1,38,39,1.0256410256410255,0.025976216673306556,527,Do you think I could also book an ark on airbnb?
4380,0,1,38,39,1.0256410256410255,0.025976216673306556,527,What is your Netflix login?
4380,0,1,38,39,1.0256410256410255,0.025976216673306556,527,You're our favorite reality star.
4380,0,1,38,39,1.0256410256410255,0.025976216673306556,527,"I'd appreciate a ride, but your spaceship's a little too other worldly for me."
4380,0,1,38,39,1.0256410256410255,0.025976216673306556,527,You want T R U M P four feet high on both sides--got it!
4380,0,1,38,39,1.0256410256410255,0.025976216673306556,527,So we want to buy your entire crop of Junior Mints!
4380,0,1,38,39,1.0256410256410255,0.025976216673306556,527,We thought you were kidding when you said you couldn't take the election bickering any more.
4380,0,1,38,39,1.0256410256410255,0.025976216673306556,527,Trump hasn't built a wall around Mars yet.
4380,0,1,38,39,1.0256410256410255,0.025976216673306556,527,"Welcome to the Space Ark. Sorry, we only accept couples."
4380,0,1,38,39,1.0256410256410255,0.025976216673306556,527,"Greetings. Xrk Qrg, candidate for intergalactic emperor. Hoping I can count on your vote this November. #NeverTrump"
4380,0,1,38,39,1.0256410256410255,0.025976216673306556,527,Finally! Someone who understands GMOs.
4380,0,1,38,39,1.0256410256410255,0.025976216673306556,527,Gabba Gabba Hey
4380,0,1,38,39,1.0256410256410255,0.025976216673306556,527,I can certify your GMO crops.
4380,0,1,38,39,1.0256410256410255,0.025976216673306556,527,"Welcome to the world of Wisconsin v. Yoder, where 8th graders rule."
4380,0,1,38,39,1.0256410256410255,0.025976216673306556,527,You're on the right flight! We have a layover in Kansas before we head beyond the Milky Way.
4380,0,1,38,39,1.0256410256410255,0.025976216673306556,527,I didn't want it. It was thrust upon me.
4380,0,1,38,39,1.0256410256410255,0.025976216673306556,527,"Hi, I'm Ethan. I heard you earthlings come up with great nicknames!"
4380,0,1,38,39,1.0256410256410255,0.025976216673306556,527,I'm a genetically-modified human from the future. It's about your seeds ...
4380,0,1,38,39,1.0256410256410255,0.025976216673306556,527,Well nobody told me us was flyover country.
4380,0,1,38,39,1.0256410256410255,0.025976216673306556,527,"Welcome stranger. I am Billy Bob. What is your name? You are not from around these parts, are you? Is this one of those fancy hybrid vehicles? I got an old Chevy pickup, but thisun is sure a beauty."
4380,0,1,38,39,1.0256410256410255,0.025976216673306556,527,Welcome to Trumpism; we promise to give you an out-of-this-world experience.
4380,0,1,38,39,1.0256410256410255,0.025976216673306556,527,"Wall? What do you mean by "" Did we come to build a wall?"""
4380,0,1,38,39,1.0256410256410255,0.025976216673306556,527,"My translator is now fixed, I come for piece, not in peace."
4380,0,1,38,39,1.0256410256410255,0.025976216673306556,527,Nice doing business with you.
4380,0,1,38,39,1.0256410256410255,0.025976216673306556,527,Thanks for coming to our rescue. We did run out of helicopter money.
4380,0,1,38,39,1.0256410256410255,0.025976216673306556,527,Tom Joad? Welcome to Sandersville. You've come home to your people!
4380,0,1,38,39,1.0256410256410255,0.025976216673306556,527,"Mars meeting the extinct ""Oh Henry""."
4380,0,1,38,39,1.0256410256410255,0.025976216673306556,527,"Everyone knows of the dust bowl, but few believe in the dust saucer."
4380,0,1,38,39,1.0256410256410255,0.025976216673306556,527,Trump? Then take me to Canada.
4380,0,1,38,39,1.0256410256410255,0.025976216673306556,527,"Good morning, Mr McGregor. C'mon in. The hasenpfeffer's almost ready."
4380,0,1,38,39,1.0256410256410255,0.025976216673306556,527,We welcome you to our UFO that will soon take off to space.
4380,0,1,38,39,1.0256410256410255,0.025976216673306556,527,We'd like to pick your brain a little for help with our crop circles?
4380,0,1,38,39,1.0256410256410255,0.025976216673306556,527,%#*€¥~ GMO
4380,0,1,38,39,1.0256410256410255,0.025976216673306556,527,Sorry about all the crop circles. We were just trying to signal to you that your planet has a giant growing hole in an important looking atmospheric layer. Seemed like you guys hadn't picked up on it.
4380,0,1,38,39,1.0256410256410255,0.025976216673306556,527,Thank you for coming. It is getting harder and harder to reach across the isle these days.
4380,0,1,38,39,1.0256410256410255,0.025976216673306556,527,Thank you for having a place flat enough to land.
4380,0,1,38,39,1.0256410256410255,0.025976216673306556,527,"Welcome, stranger! Lost your way? You can park in my fields, then come on down for breakfast!"
4380,0,1,38,39,1.0256410256410255,0.025976216673306556,527,Welcome aboard to where no airline goes--true adventure!
4380,0,1,38,39,1.0256410256410255,0.025976216673306556,527,There's no Trump up here.
4380,0,1,38,39,1.0256410256410255,0.025976216673306556,527,This policy will protect you from illegeal aliens.
4380,0,1,38,39,1.0256410256410255,0.025976216673306556,527,Life form Jim on planet Z-91 kept exclaiming to life form Pam that the ethnics were finally coming to take the farm.
4380,0,1,38,39,1.0256410256410255,0.025976216673306556,527,we stopped with the probes years ago. Turns out corn niblets aren't the secret to the universe after all.
4380,0,1,38,39,1.0256410256410255,0.025976216673306556,527,"Hi, I am an intergalactic anthropologist. I have come here to study you."
4380,0,1,38,39,1.0256410256410255,0.025976216673306556,527,I knew there was a market for GMO's
4380,0,1,38,39,1.0256410256410255,0.025976216673306556,527,Please tell me that you guys are not having elections this year!
4380,0,1,38,39,1.0256410256410255,0.025976216673306556,527,"Your election rituals are most intriguing, can we vote in this area on Earth?"
4380,0,1,38,39,1.0256410256410255,0.025976216673306556,527,"Canada is no longer letting in Democrats, so......"
4380,0,1,38,39,1.0256410256410255,0.025976216673306556,527,Take me to your feeder.
4380,0,1,38,39,1.0256410256410255,0.025976216673306556,527,You should see his bottle.
4380,0,1,38,39,1.0256410256410255,0.025976216673306556,527,You're not the guest that I was expecting to see!
4380,0,1,38,39,1.0256410256410255,0.025976216673306556,527,"I'm here to see Mr Scott. Ridley Scott."""
4380,0,1,38,39,1.0256410256410255,0.025976216673306556,527,We'll take all the locally grown unsustainable GMOs you can send us.
4380,0,1,38,39,1.0256410256410255,0.025976216673306556,527,How'd you know we needed a fourth for pinochle? Come on in!
4380,0,1,38,39,1.0256410256410255,0.025976216673306556,527,No. The Donald hasn't applied to immigrate.
4443,0,1,39,40,1.025,0.025318484177091666,527,John Deere who's that?
4443,0,1,39,40,1.025,0.025318484177091666,527,www.farmers dating farmers.com meet & greet here?
4443,0,1,39,40,1.025,0.025318484177091666,527,I don’t have none of them Reese’s Pieces.
4443,0,1,39,40,1.025,0.025318484177091666,527,Independents Day
4443,0,1,39,40,1.025,0.025318484177091666,527,"Welcome. Come join the all the hard working true blue farmers and indigenous people of the land, we will preserve your truth and your purpose."
4443,0,1,39,40,1.025,0.025318484177091666,527,We will trade information for sorghum.
4443,0,1,39,40,1.025,0.025318484177091666,527,"Welcome to my farm, the nation's capital of alien invasions and abductions!"
4443,0,1,39,40,1.025,0.025318484177091666,527,Your CSA is worth the drive.
4443,0,1,39,40,1.025,0.025318484177091666,527,"Dorothy, we're still in Kansas."
4443,0,1,39,40,1.025,0.025318484177091666,527,"If you wanna fly, come and take a ride / Take a space ride with the cowboy, baby"
4443,0,1,39,40,1.025,0.025318484177091666,527,"Sorry, we're out of moon shine, but we do have milk-e way"
4443,0,1,39,40,1.025,0.025318484177091666,527,"Welcome to aboard for the journey to our alien world which, as it turns out, is much less scary than yours has become!"
4443,0,1,39,40,1.025,0.025318484177091666,527,Hi Harry! Can I borrow a cup of flour & 2 eggs?
4443,0,1,39,40,1.025,0.025318484177091666,527,"You probably don't recognize me, but I am the cockroach you have NOT burned to a crisp on June 23 1970."
4443,0,1,39,40,1.025,0.025318484177091666,527,"I told her I needed more space. Yup, a classic Midwest crisis."
4443,0,1,39,40,1.025,0.025318484177091666,527,Come join us; we have the most high-tech tractors and cultivators.
4443,0,1,39,40,1.025,0.025318484177091666,527,Glad you could make it. It's just an informal ride.
4443,0,1,39,40,1.025,0.025318484177091666,527,"Zeke, is that really you? So glad you could make it. We're all dying to hear about this whole body-snatching thing you've come up with."
4443,0,1,39,40,1.025,0.025318484177091666,527,Welcome. Thanks for giving us a hand in growing these GMO seeds.
4443,0,1,39,40,1.025,0.025318484177091666,527,Welcome Earthling the bar is open.
4443,0,1,39,40,1.025,0.025318484177091666,527,Welcome! This is Independence Day and you don't have to milk the cows.
4443,0,1,39,40,1.025,0.025318484177091666,527,"Boy, you Brexit people look funny."
4443,0,1,39,40,1.025,0.025318484177091666,527,We're starting to colonize your planet and decided to start here [translation]
4443,0,1,39,40,1.025,0.025318484177091666,527,"Come, Sir, planet Trumpton awaits."
4443,0,1,39,40,1.025,0.025318484177091666,527,Is this interstellar gentrification?
4443,0,1,39,40,1.025,0.025318484177091666,527,"Greetings, and welcome to your non-stop service to the merry old land of Oz"
4443,0,1,39,40,1.025,0.025318484177091666,527,"Is this a ""bring your own probe"" UFO?"
4443,0,1,39,40,1.025,0.025318484177091666,527,Does your wife know that new pub isn't close enough to the village?
4443,0,1,39,40,1.025,0.025318484177091666,527,Oh my Goodness! The alien from the Unidentified Combine Harvester!
4443,0,1,39,40,1.025,0.025318484177091666,527,Hi - How much do you want for your farm?
4443,0,1,39,40,1.025,0.025318484177091666,527,"John, good to see you again. Your farm seems a lot closer to water than before. Any interest in some used docking stations?"
4443,0,1,39,40,1.025,0.025318484177091666,527,"Hey, Fred! It's me, George, that guy from Ag Extension."
4443,0,1,39,40,1.025,0.025318484177091666,527,Is all of your corn genetically engineered to resist crop circles? I really need to park this thing.
4443,0,1,39,40,1.025,0.025318484177091666,527,I guess it gives extra points to remember the toilet seat.
4443,0,1,39,40,1.025,0.025318484177091666,527,"Nice to see a familiar face. Oh! By the way, is your leader. . . Jonald Donothan Trunk, because if he is, don't take me to him."
4443,0,1,39,40,1.025,0.025318484177091666,527,Wow!...so you're a human!...you're not so funny looking...would you like to have some kpim with me...that means lunch where I come from...come on in and excuse the mess.
4443,0,1,39,40,1.025,0.025318484177091666,527,"Greetings, we come in peace. May we have a cup of sugar, it powers our reactors?"
4443,0,1,39,40,1.025,0.025318484177091666,527,"It's your kids, something has to be done with your kids!"
4443,0,1,39,40,1.025,0.025318484177091666,527,"Welcome aboard, Mr. Jones. Don't worry, I'll have you back in time for the fall harvest."
4443,0,1,39,40,1.025,0.025318484177091666,527,"Miracles happen in all places, not just urban capitals."
4443,0,1,39,40,1.025,0.025318484177091666,527,Welcome. There are no Presidential elections on our Planet.
4443,0,1,39,40,1.025,0.025318484177091666,527,Mr. Rotorooter I presume?
4443,0,1,39,40,1.025,0.025318484177091666,527,"That's a nice firm handshake you have there. They say that means a lot about a man, but one shouldn't judge a book by it's cover. Say, I'm hungry. You wouldn't have any fixins' would would ya'?"
4486,0,0,36,36,1.0,0.028171808490950554,527,"Yes, I am happy to see you, but the size of my halo has nothing to do with that."
4486,0,0,37,37,1.0,0.02739983121755955,527,Alien: Hello sir it's a pleasure to meet you on this great planet named Earth. Farmer:....What?!?!!?!?!!?!?
4486,0,0,36,36,1.0,0.028171808490950554,527,"Aloha. Where I'm from we get hula hoops, not halos."
4486,0,0,37,37,1.0,0.02739983121755955,527,"No no, it's all good. We're just having a little dinner. Come on in. Time for a drink?"
4486,0,0,35,35,1.0,0.028988551782622423,527,You guy turn out to be a perfect stranger.” “Thank you.
4486,0,0,36,36,1.0,0.028171808490950554,527,You've come from my what-now?
4486,0,0,36,36,1.0,0.028171808490950554,527,Nice hat. And those overalls aren't bad either.
4486,0,0,37,37,1.0,0.02739983121755955,527,"Welcome aboard. Yes, we too know of Mr. Trump."
4486,0,0,37,37,1.0,0.02739983121755955,527,"Yes, my halo has grown since you arrived"
4486,0,0,36,36,1.0,0.028171808490950554,527,I know you Kansas people think there's no place like home but wait until I show you Comet Hyakutake from the other side of the moon.
4486,0,0,37,37,1.0,0.02739983121755955,527,Welcome aboard. I want you to taste the wine we made and tell me what you think.
4486,0,0,37,37,1.0,0.02739983121755955,527,"Hey Billy, the tracker beam is out again. Tea?"
4486,0,0,35,35,1.0,0.028988551782622423,527,Mr. Musk asked me to remind you to bring the corn.
4486,0,0,37,37,1.0,0.02739983121755955,527,I'm Hilary Clinton and I'm running for President.
4486,0,0,37,37,1.0,0.02739983121755955,527,"Dude, E-I-E-I-O is Martian for ""Please take my planet."" Thanks!"
4486,0,0,35,35,1.0,0.028988551782622423,527,"Yes, it's gluten free."
4486,0,0,38,38,1.0,0.02666903735313325,527,"Hi, I'm your new Presidential Candidate's alternative. Vote for me!"
4486,0,0,37,37,1.0,0.02739983121755955,527,Trump says he wants you.
4486,0,0,36,36,1.0,0.028171808490950554,527,Greetings. Do you have an dilithium crystals?
4486,0,0,36,36,1.0,0.028171808490950554,527,"Well, howdy Pilgrim"
4486,0,0,37,37,1.0,0.02739983121755955,527,Don't give in to fear.
4486,0,0,36,36,1.0,0.028171808490950554,527,It is nice to meet you Mr. Wizard of Mars.
4486,0,0,36,36,1.0,0.028171808490950554,527,Perfect timing!
4486,0,0,37,37,1.0,0.02739983121755955,527,"Cosmos Delivery, 6 low-fat chocolate milk cows."
4486,0,0,37,37,1.0,0.02739983121755955,527,"Oooo, that's a nice Edgar Suit."
4486,0,0,37,37,1.0,0.02739983121755955,527,"we have ""fun"" and peace up here.(join us)"
4486,0,0,37,37,1.0,0.02739983121755955,527,"You'uns, Supper's at six. No sense gettin gussied up. Y'all best take some measures fore yo stomach's get tore up. Wife never did master the cooking thing y'all."
4486,0,0,35,35,1.0,0.028988551782622423,527,"Man, am I glad to see you! This ship runs on corn. We'll take all you can spare."
4486,0,0,36,36,1.0,0.028171808490950554,527,Sometimes strangers make you feel home.
4486,0,0,37,37,1.0,0.02739983121755955,527,Do you agree to the 3X surge?
4486,0,0,36,36,1.0,0.028171808490950554,527,Do you have elections?
4486,0,0,37,37,1.0,0.02739983121755955,527,We're just curious about how someone can wear a bale of straw on his head?
4486,0,0,36,36,1.0,0.028171808490950554,527,I'm Bernie's cousin and he needs your help now !
4486,0,0,36,36,1.0,0.028171808490950554,527,Thanks for the corn. Are apples in season yet?
4486,0,0,37,37,1.0,0.02739983121755955,527,We're here to set up a dairy trade business with you
4486,0,0,37,37,1.0,0.02739983121755955,527,"Greetings, Earth Buddy! Okay to use your farm as a base for our warships?"
4486,0,0,36,36,1.0,0.028171808490950554,527,My name is death.
4486,0,0,36,36,1.0,0.028171808490950554,527,"Jim? From Craigslist? So, you're down to crank hogs together? Great! Just remember my one and only ground rule: no gay stuff."
4486,0,0,37,37,1.0,0.02739983121755955,527,Welcome Donald. We will now start your transformation into the President of the United States.
4486,0,0,36,36,1.0,0.028171808490950554,527,. . . and you've got 90 parsecs to vacate the planet.
4486,0,0,36,36,1.0,0.028171808490950554,527,Greetings. And Gesundheit! We hear Best Foreign Film's weak this year...
4486,0,0,37,37,1.0,0.02739983121755955,527,Dorothy and Toto aren't interested in leaving Kansas anymore.
4486,0,0,36,36,1.0,0.028171808490950554,527,Roy Neary?
4486,0,0,37,37,1.0,0.02739983121755955,527,We thought intelligent life was near. No wonder our siblings have been left to taking just the cows. Nice to know the quota was high here. Thanks for the info you left on Facebook. We'll take it from here.
4486,0,0,37,37,1.0,0.02739983121755955,527,"Major Tom, I'm Farmer Dell,. I hearGrounds Major Tom, I'm Farmer Dell. Grounds control ordered me to weed. Major Tom, I'm Farmer Dell. Grounds control sent me to weed."
4486,0,0,36,36,1.0,0.028171808490950554,527,Don't mind the smell. Flatular farted again.
4486,0,0,36,36,1.0,0.028171808490950554,527,Thanks for pruning the high parts for me.
4486,0,0,37,37,1.0,0.02739983121755955,527,A poor specimen but we'll take him
4486,0,0,37,37,1.0,0.02739983121755955,527,Great to meet you Olde McDonald. We have heard about your farm. E-O-E-O.
4486,0,0,37,37,1.0,0.02739983121755955,527,"Good to meet you, Joe. I'm the new guy on our CSA run."
4486,0,0,36,36,1.0,0.028171808490950554,527,Yeah. Right.
4486,0,0,35,35,1.0,0.028988551782622423,527,"Hank? Welcome! I'm Pproab, one of the analysts on board."
4486,0,0,37,37,1.0,0.02739983121755955,527,YOU NEED SOIL?
4486,0,0,37,37,1.0,0.02739983121755955,527,Thanks for the GM seeds; should grow like crazy up here in space.
4486,0,0,35,35,1.0,0.028988551782622423,527,Greetings. You must be the space cowboy.
4486,0,0,37,37,1.0,0.02739983121755955,527,"All aboard to the ISS ""International Space Station"" where all of us aliens live. BTW, this is a UFO."
4486,0,0,36,36,1.0,0.028171808490950554,527,I don't know what I'd do without my CSA. See you next week!
4486,0,0,37,37,1.0,0.02739983121755955,527,"What makes this thing go? As long as it isn't electricity, I'll take some."
4486,0,0,36,36,1.0,0.028171808490950554,527,Congratulations! You have won the 1st annual celestial sweepstakes.
4486,0,0,37,37,1.0,0.02739983121755955,527,It's like Brexit or divorce. Just you and God navigating the universe.
4486,0,0,37,37,1.0,0.02739983121755955,527,Come along little framer.
4486,0,0,37,37,1.0,0.02739983121755955,527,"I don't think you're going to like our ""Hubble."""
4486,0,0,34,34,1.0,0.029854071701326604,527,"Welcome, my space savours locavores."
4486,0,0,37,37,1.0,0.02739983121755955,527,Rodgers and Hmrztnx Boffo with New Musical
4486,0,0,36,36,1.0,0.028171808490950554,527,Hi! We just ran out of ethanol; do you happen to have any for salle?
4486,0,0,37,37,1.0,0.02739983121755955,527,"Hi, I am sure you seen our cloud-seeding television commercials."
4486,0,0,36,36,1.0,0.028171808490950554,527,Hi Zeke. Come on in. My wife is baking a shasbot.
4486,0,0,38,38,1.0,0.02666903735313325,527,""" thank you for all your help, i'm going to miss big guy "" said Sean."
4486,0,0,36,36,1.0,0.028171808490950554,527,I'm sorry. You must understand that we came in the name of peace but we are concerned we would leave America in pieces.
4486,0,0,37,37,1.0,0.02739983121755955,527,Welcome! Won't you come in for a bite to eat and coffee?
4486,0,0,36,36,1.0,0.028171808490950554,527,"Are you from Washington, D.C., and are you here to save us?"
4486,0,0,36,36,1.0,0.028171808490950554,527,Ving ton rapth thfffft!
4486,0,0,38,38,1.0,0.02666903735313325,527,Sarah Bellum? How do you stop tornadoes?
4486,0,0,36,36,1.0,0.028171808490950554,527,Welcome back to Earth Mr.K. How was your trip to Xenon 3. Ughh it was weightless.
4486,0,0,36,36,1.0,0.028171808490950554,527,"Thank you so much, the stop before made you buy something before you could use the bathroom and we're on a budget"
4486,0,0,34,34,1.0,0.029854071701326604,527,"Welcome, Earthling -- just in time for our 2-for-1 sale!"
4486,0,0,38,38,1.0,0.02666903735313325,527,"""To Serve Man is a cookbook?"" Pshaw."
4486,0,0,36,36,1.0,0.028171808490950554,527,Welcome old Hipster; we'll party like it's 2099!
4486,0,0,36,36,1.0,0.028171808490950554,527,Welcome to our galaxy
4486,0,0,37,37,1.0,0.02739983121755955,527,E.T came back to earth after 20years!
4486,0,0,36,36,1.0,0.028171808490950554,527,"Ahhh... you finally saw my crop circle. I've been telling the locals 'if you build it, they will come', but they thought I meant Babe Ruth. Jokes on them, eh? Martians are way better!"
4486,0,0,35,35,1.0,0.028988551782622423,527,"I could really go for an ice-cold Coke. In a tall glass, please."
4486,0,0,37,37,1.0,0.02739983121755955,527,New tractor? You've--uh--come to the right place!
4486,0,0,37,37,1.0,0.02739983121755955,527,"I don't need any of this Amway, I assure you. I really must be getting back to my umm...home office."
4486,0,0,36,36,1.0,0.028171808490950554,527,Farmer Brown reluctantly accepting a ride to the Crop Circle Treaty Summit.
4486,0,0,36,36,1.0,0.028171808490950554,527,Best corn liquor in the galaxy! Let's talk distribution rights.
4486,0,0,37,37,1.0,0.02739983121755955,527,"I thought this was the plane to Mars, California."
4486,0,0,37,37,1.0,0.02739983121755955,527,Take me to your Trump.
4486,0,0,36,36,1.0,0.028171808490950554,527,"Ethanol?! Ethanol!? But the space travel brochure said, ""Earth and all""!"
4486,0,0,36,36,1.0,0.028171808490950554,527,Welcome to Space Real Estate.
4486,0,0,37,37,1.0,0.02739983121755955,527,Weren't you a greeter last week at the big box?
4486,0,0,36,36,1.0,0.028171808490950554,527,"I'm from Kansas, what about you?"
4486,0,0,37,37,1.0,0.02739983121755955,527,"Welcome to Nebula Market Research, we're so excited to add you to our participants."
4486,0,0,37,37,1.0,0.02739983121755955,527,''You remind me of Mr clean.''
4486,0,0,35,35,1.0,0.028988551782622423,527,Delighted you're coming to clue us in on seed planting on Galactica!
4486,0,0,37,37,1.0,0.02739983121755955,527,Have you ever been to Californee?
4486,0,0,36,36,1.0,0.028171808490950554,527,We’ve been told the term ‘peasant’ is politically non-bias-free. Would you prefer the term ‘pastorally-oriented provincialist’?
4486,0,0,37,37,1.0,0.02739983121755955,527,Can you put a corn head on this contraption?
4486,0,0,36,36,1.0,0.028171808490950554,527,We'll keep you posted about the wall.
4486,0,0,36,36,1.0,0.028171808490950554,527,"Thank you for accepting me on your planet, with Trump in charge I no longer have labor to farm my crops."
4486,0,0,37,37,1.0,0.02739983121755955,527,"Naow, jes come awn up Jacob's ladder and we's a gonna rectalfy that boredom you've a been feelin!"
4486,0,0,37,37,1.0,0.02739983121755955,527,"Welcome back, Plo Koon, you're just in time for grits , eggs, and bacon!"
4486,0,0,37,37,1.0,0.02739983121755955,527,Vote for me. My plane AND hands are bigger.
4486,0,0,37,37,1.0,0.02739983121755955,527,"Farmer Brown, Dad, we're so glad you're coming to our place this Thanksgiving!"
4486,0,0,37,37,1.0,0.02739983121755955,527,*astronaut/alien* Hi Jerry. I'm Steve. I've been watching you.
4486,0,0,35,35,1.0,0.028988551782622423,527,Klaatu barata ni . . . Nike!! . . . Nitre! . . . Ninja? . . . Nirvana??
4486,0,0,37,37,1.0,0.02739983121755955,527,That's why Mr. Paul is counting on people just like you.
4486,0,0,37,37,1.0,0.02739983121755955,527,"Welcome, friend! This home is recently renovated... Best of all, it's listed at only fifty thousand Blartniks!"
4486,0,0,37,37,1.0,0.02739983121755955,527,"Pleased to meet you, Governor Brownback. Come in, won't you? I'll get the cash."
4486,0,0,35,35,1.0,0.028988551782622423,527,Don't worry... on Mars you'll be safe from Trump.
4486,0,0,36,36,1.0,0.028171808490950554,527,...and no GM foods.
4486,0,0,37,37,1.0,0.02739983121755955,527,"Howdy! Something tells me you're not in Jupiter, anymore."
4486,0,0,37,37,1.0,0.02739983121755955,527,"I learned from ""My Space"" about your area's 'out of this world' special country appeal."
4486,0,0,36,36,1.0,0.028171808490950554,527,Come in. We have delicious apple pie.
4486,0,0,37,37,1.0,0.02739983121755955,527,I can do zero to sixty in this baby before you can say 'Jack Robinson'.
4486,0,0,37,37,1.0,0.02739983121755955,527,Escape now. The planet is filling up.
