rank,funny,somewhat_funny,unfunny,count,score,precision,contest,caption
1,612,1118,935,2665,1.878799249530957,0.014573493243445028,564,They're willing to work nights.
2,343,469,538,1350,1.8555555555555556,0.021640098050461815,564,"Yes, I found my laptop. But, now I can't find my mouse."
3,379,559,609,1547,1.8513251454427926,0.019970081921020143,564,They are demanding equal prey
4,680,1021,1133,2834,1.8401552575864502,0.014723975062004593,564,"I only needed one, but Costco makes you buy a whole case."
5,672,1050,1203,2925,1.8184615384615384,0.014420751738867584,564,"No, I have no idea why your computer doesn't have a mouse anymore."
6,382,632,728,1742,1.801377726750861,0.018529325606562147,564,"Not whom, Miss Ferguson, who."
7,697,851,1256,2804,1.800641940085592,0.015307076293808206,564,"Mrs. Jenkins, you may have misunderstood me when I said. ""Reserve Hooters for the office party."""
8,244,311,460,1015,1.787192118226601,0.02528552658348179,564,HR says you're not allowed to refer to them as hooters.
9,321,433,639,1393,1.7717157214644652,0.021392715054726702,564,Best damn owl salesman I've ever met.
10,550,732,1095,2377,1.7707193941943626,0.016405519786521276,564,"Go ahead, ask what our first baseman's name is."
11,266,311,529,1106,1.7622061482820977,0.024481234738603763,564,Knock. Knock.
12,516,907,1128,2551,1.760094080752646,0.015170899717852853,564,"I think the more appropriate question is ""why""."
13,179,323,419,921,1.739413680781759,0.025138507954879565,564,"Please tell me you see them, too."
14,233,320,520,1073,1.7325256290773532,0.024246637656441174,564,"I said, ""Get me a table at Hooters, not a table of Hooters."""
15,197,318,488,1003,1.7098703888334994,0.024445465708333305,564,I'm sorry but they're all the same. No one's the wiser.
16,348,518,862,1728,1.7025462962962963,0.018820961463429355,564,Knock. Knock.
17,177,218,424,819,1.6984126984126984,0.0280339218493948,564,Irritable Owl Syndrome. I've had it for years...
18,369,584,975,1928,1.6856846473029046,0.01762053595553863,564,"It's called irritable owl syndrome, but I have it under control."
19,304,545,894,1743,1.6615031554790591,0.018132384044268795,564,"You know how it is, you get one for Christmas and suddenly you're the ""Owl"" guy."
20,187,396,587,1170,1.6581196581196582,0.02158509714192603,564,They've been turning heads all day.
21,362,462,1016,1840,1.6445652173913043,0.018399517081017797,564,"Gladys, get me a BLT and nine mice."
22,260,502,828,1590,1.6427672955974844,0.01871688852247825,564,They're going to keep asking until you introduce yourself to them.
23,274,349,793,1416,1.6334745762711864,0.02091865766029578,564,They all know the difference between who and whom.
24,160,321,540,1021,1.6278158667972575,0.02315932289361965,564,Corporate says we have a mole.
25,213,481,758,1452,1.6246556473829201,0.019073101046962183,564,"Yes, It's a veritable who's who around here."
26,98,213,349,660,1.6196969696969696,0.02842988693328808,564,Hire the one that said 'Whom'.
27,170,379,612,1161,1.6192937123169682,0.021347292502293762,564,"I appreciate the effort, but I'm pretty sure I said towels."
28,133,351,520,1004,1.6145418326693226,0.022367821737146947,564,The early birds went home. This is the night shift.
29,135,307,499,941,1.6131774707757705,0.023613007127307992,564,One coffee and nine dead mice.
30,175,329,616,1120,1.60625,0.02219442356638591,564,Next time don't use the speech recognition app to order towels!
31,173,240,576,989,1.5925176946410515,0.024463655762490245,564,"Someone at Hogwart's must have hit ""reply all"""
32,143,342,575,1060,1.5924528301886793,0.021972250396427424,564,"Pick any... In my opinion, they're all wise choices."
33,137,262,509,908,1.5903083700440528,0.024481537107322125,564,This used to be their tree.
34,119,231,447,797,1.588456712672522,0.026065129922849768,564,We had to close the branch.
35,95,152,344,591,1.5786802030456852,0.030953722356061877,564,I accidentally hit 'reply owl'.
36,83,182,340,605,1.5752066115702479,0.029305541902530263,564,"No, they do not Tweet."
37,106,167,386,659,1.575113808801214,0.029330354528996246,564,"Well, because ten owls would be complete lunacy. That's why."
38,130,177,467,774,1.5645994832041343,0.02743318873235324,564,I've noticed you can't seem to take your eyes off my hooters.
39,120,176,442,738,1.5636856368563685,0.027838148997508586,564,Never get in a twitter fight with J. K. Rowling.
40,97,184,402,683,1.5534407027818449,0.027908130782513803,564,"You can still turn heads, Miss Kranston."
41,128,113,428,669,1.5515695067264574,0.030710188521012486,564,HOOTUS - the real wisdoms behind the Bench.
42,88,185,384,657,1.5494672754946728,0.02803083317956887,564,"Just the usual, please. Tuna salad, coffee, box of mice."
43,74,193,359,626,1.5447284345047922,0.027840146332557013,564,They'll work night shift.
44,69,169,334,572,1.5367132867132867,0.029291424058212924,564,We are the Who's Who of Who's Whos.
45,54,196,317,567,1.5361552028218695,0.02785528579312703,564,"On the other hand, you'll notice our pigeon problem has disappeared."
46,79,126,325,530,1.5358490566037737,0.032151227392593636,564,You haven't mentioned my new glasses.
47,81,141,344,566,1.5353356890459364,0.030770934175014388,564,"Calm down, Miss Frobisher. That remark was directed at my hooters, not yours."
48,74,146,332,552,1.5326086956521738,0.030633143829873595,564,Tell that Potter kid he's got to start using email like everyone else.
49,62,132,297,491,1.5213849287169043,0.03201047372189371,564,I used to give a hoot. Now I outsource.
50,56,136,285,477,1.519916142557652,0.03190071868477481,564,Send one out to every branch.
51,66,119,298,483,1.5196687370600415,0.03293729318983005,564,Does displaying my hooters make you uncomfortable?
52,52,134,276,462,1.5151515151515151,0.03209525737519684,564,Says Who?
53,76,81,297,454,1.513215859030837,0.03592447016587619,564,Top talon'd. They hoot in harmony.
54,47,129,262,438,1.5091324200913243,0.032603592024923814,564,"Be a dear Helen and get us a cup of coffee and nine mice, would you?"
55,42,128,250,420,1.5047619047619047,0.03277089503640335,564,I am still none the wiser
56,57,90,259,406,1.5024630541871922,0.03620183852857911,564,"Beats us. He just showed up this morning, sat down behind the desk, and said he works here."
57,48,108,251,407,1.5012285012285012,0.03459372671058324,564,"Believe me, Ms. Henderson, you'll know when I give a hoot."
58,60,84,264,408,1.5,0.036563621206356534,564,Because I'm sick and tired of wasting time searching all over the office every time I want an owl.
58,46,110,248,404,1.5,0.03442987523038993,564,They're here for the branch manager position.
60,41,115,240,396,1.4974747474747474,0.03401653842629079,564,"Ok, so that's nine field mice and a double decaf espresso?"
61,44,102,238,384,1.4947916666666667,0.03536971975485102,564,They all say they're on first.
62,48,92,242,382,1.4921465968586387,0.036271331838523845,564,I've named the new one Gorsuch.
63,46,91,236,373,1.4906166219839143,0.03653547200283033,564,"A coffee and nine voles, Miss Fenway."
64,44,85,225,354,1.4887005649717515,0.03757748909461407,564,My ex has them on the weekends.
65,38,92,218,348,1.4827586206896552,0.036728364190774895,564,What did you think we meant by organic pest control?
66,38,91,217,346,1.4826589595375723,0.03688416916240967,564,The will was very explicit.
67,27,67,157,251,1.4820717131474104,0.043119277301996,564,"Honestly, I can't tell who's who."
68,41,77,215,333,1.4774774774774775,0.03864181291681848,564,If I can't comment on your hooters you can't comment on mine
69,41,77,216,334,1.4760479041916168,0.03855245944886654,564,I said the office was out of TOWELS.
70,35,86,208,329,1.4741641337386018,0.03753447461924949,564,You think I give a hoot?
71,40,70,208,318,1.471698113207547,0.03974569517185534,564,We voted. It's mice for lunch again.
72,38,71,204,313,1.4696485623003195,0.03970606311589557,564,"When they asked if I needed an owl, Frau Schultz, I said, ""Nein."""
73,30,85,195,310,1.467741935483871,0.037842622686776684,564,"You can relax, Mr. Purdue. We caught the mouse."
73,28,89,193,310,1.467741935483871,0.03728680838440227,564,Night workers.
73,28,89,193,310,1.467741935483871,0.03728680838440227,564,"Say ""knock-knock.'"
76,37,70,201,308,1.4675324675324675,0.039918712175411604,564,"Miss Nelson, I asked for a table at Hooters, not a table of hooters."
77,28,85,190,303,1.4653465346534653,0.0378922146500435,564,Meet the new night shift.
78,33,71,192,296,1.462837837837838,0.03998270586634423,564,"Well obviously Susan, I do give a hoot."
79,9,13,45,67,1.462686567164179,0.0885287510349995,564,I just can't tell who is who.
80,25,84,182,291,1.4604810996563573,0.03806797741778802,564,The mouse problem has been solved.
81,26,76,176,278,1.460431654676259,0.03965030834942181,564,"Yes, but my next one's free!"
82,27,75,180,282,1.4574468085106382,0.0395561939846182,564,"Apparently, they heard this is a sanctuary city."
83,39,47,190,276,1.4528985507246377,0.04391686978116451,564,We're what's left of the EPA.
83,30,65,181,276,1.4528985507246377,0.04112830292120175,564,I have irritable owl syndrome.
85,29,66,179,274,1.4525547445255473,0.04102298917040643,564,I think you'll agree that I've successfully addressed our mouse problem.
86,34,55,183,272,1.4522058823529411,0.04285544750960471,564,Are you looking at my hooters?
86,31,61,180,272,1.4522058823529411,0.04189500576973617,564,Don't mention my hooters and I won't mention yours.
86,30,63,179,272,1.4522058823529411,0.0415699276422128,564,"We did ask for ""high-flying, wise visionaries who aren't afraid to eat the other guy for lunch."""
89,33,54,180,267,1.449438202247191,0.043122247796844704,564,"Yes. Unless they're referring to the object of a verb. Then they say ""whom""."
90,26,67,172,265,1.4490566037735848,0.04099294033249201,564,Go ahead. Ask me a knock-knock joke.
91,20,78,166,264,1.446969696969697,0.03893559752540503,564,"I'm not saying ""Knock, Knock,"" again."
92,25,66,169,260,1.4461538461538461,0.041189283571973746,564,I bet you can't guess their favorite band.
92,23,70,167,260,1.4461538461538461,0.0404617970655334,564,Ask them about the first baseman.
94,26,62,169,257,1.443579766536965,0.041886723527110675,564,It's my defense against the rat race
95,32,49,174,255,1.4431372549019608,0.04426775280597889,564,Paper jam in the 3D printer again?
95,26,61,168,255,1.4431372549019608,0.0421231881475517,564,Who's the wiser now Miss Jenkins?
97,26,59,167,252,1.4404761904761905,0.04247362070711692,564,Get a picture and email it to my wife. I'm going to have to explain several charges to Hooters.
98,21,66,159,246,1.4390243902439024,0.041256474189869496,564,Because I don't give a hoot.
98,22,64,160,246,1.4390243902439024,0.041656700156023026,564,"Ducks, Melvin. You need to get your ducks in a row."
100,21,65,159,245,1.436734693877551,0.04136136593597172,564,"I smell a rat, Doris. And so do my friends."
101,31,44,168,243,1.4362139917695473,0.045503400021718265,564,"This is how many hoots I don't give, Ms. Patterson."
102,25,54,160,239,1.4351464435146444,0.04372368534578529,564,"To you, it's a desk. To me, it's a tax-deductible endangered species refuge."
103,24,54,157,235,1.4340425531914893,0.04384826860499421,564,"Soy Latte, two pumps, a hint of vanilla and no foam, plus a dozen mice."
104,38,27,173,238,1.4327731092436975,0.04881759194964814,564,You're to give these a 'comb-over' for Spicer's press briefing on the Supreme Court.
105,28,46,162,236,1.4322033898305084,0.04532115917668114,564,I don't understand why Hogwarts can't just e-mail their tax forms like everybody else.
105,27,48,161,236,1.4322033898305084,0.04492154764066093,564,I asked my last assistant for towelettes and didn't have the heart to correct her.
107,24,51,155,230,1.4304347826086956,0.04451859592331575,564,"Frankly, Ms. O'Hara, I don't give a hoot."
108,20,56,149,225,1.4266666666666667,0.04342481186734476,564,"""I believe the expression is ""ducks in a row""."
108,25,46,154,225,1.4266666666666667,0.04565223963976997,564,Don't ask us--he was here when we flew in this morning.
108,20,56,149,225,1.4266666666666667,0.04342481186734476,564,They're not as smart as they look.
108,23,50,152,225,1.4266666666666667,0.0447745676111105,564,They're not so much wise as sarcastic.
112,21,53,149,223,1.4260089686098654,0.04415707703722786,564,"Ducks, owls, whatever -- let's just get them in a row, okay Ms. Selkirk?"
112,14,67,142,223,1.4260089686098654,0.040829565852511546,564,"Say ""knock-knock.'"
114,20,53,147,220,1.4227272727272726,0.04409656834606996,564,Escort them out. I'm sick of answering the same question.
115,21,49,146,216,1.4212962962962963,0.04514834316503474,564,"Actually, I asked for nine towels."
115,15,61,140,216,1.4212962962962963,0.04218974943906638,564,"From what I can gather, the desk was made from their favorite tree."
115,22,47,147,216,1.4212962962962963,0.04562279268834635,564,The night shift has arrived.
115,14,63,139,216,1.4212962962962963,0.04167623586164077,564,I said the bathroom needed towels.
115,18,55,143,216,1.4212962962962963,0.043694094842890045,564,"I'll have a ham sandwich, sweet tea, and 9 mice."
120,31,28,156,215,1.4186046511627908,0.049847753734621775,564,"Now that Gorsuch is in place and the nuclear option is history, tell the President we have the next Supreme Court nominees lined up...plus an extra for the cabinet."
121,16,57,140,213,1.4178403755868545,0.04308200484006386,564,"If you saw the size of the rat in your office, you wouldn't ask."
122,21,46,144,211,1.4170616113744077,0.045886680108699875,564,Turns out I'm a wizard.
123,18,51,140,209,1.4162679425837321,0.044680368386752524,564,Let me guess: all the dead mice in the fridge are yours?
123,18,51,140,209,1.4162679425837321,0.044680368386752524,564,I'd introduce you but I don't know who's who.
123,21,45,143,209,1.4162679425837321,0.04619908217744043,564,"It's 'ducks in a row', sir - and it's a figure of speech."
126,21,44,142,207,1.4154589371980677,0.04651711029940048,564,"I asked for ""towels"" Linda!"
126,20,46,141,207,1.4154589371980677,0.04601021012037644,564,They only want to work the night shift.
126,19,48,140,207,1.4154589371980677,0.045497662797508526,564,I need another mouse for my desktop.
129,25,35,146,206,1.412621359223301,0.04864422457072989,564,I can't find my mouse.
130,18,48,138,204,1.411764705882353,0.045414626292820955,564,I'm gathering my wits about me.
130,14,56,134,204,1.411764705882353,0.0432354895976962,564,Is your mouse missing too?
130,15,54,135,204,1.411764705882353,0.04379044120459987,564,Strange. Nine computer mice are missing.
133,16,51,135,202,1.4108910891089108,0.0446364777083583,564,"For the last time, please tell Hogwart's to take us off their mailing list."
133,15,53,134,202,1.4108910891089108,0.04408124867786487,564,Never order bowls online.
135,23,36,141,200,1.41,0.048696578770172326,564,"For the last time, Meredith, my eyes are up here."
136,13,55,130,198,1.4090909090909092,0.04351606672791202,564,Well someone has to give a hoot around here!
137,23,28,130,181,1.408839779005525,0.05248457236375266,564,I changed the new one's name from 'Garland' to 'Gorsuch'.
138,28,24,144,196,1.4081632653061225,0.05200001478673616,564,"I said tax attorney, not TAXIDERMY!"
138,15,50,131,196,1.4081632653061225,0.0449858803290237,564,Please have the deli deliver a ham and cheddar on rye and nine field mice.
140,19,40,134,193,1.4041450777202074,0.04774623815813156,564,Is that a new tie?
141,18,39,130,187,1.4010695187165776,0.048233645557299996,564,They're terrible with names.
141,16,43,128,187,1.4010695187165776,0.04702640270329027,564,"Is that really wise, sir?"
141,14,47,126,187,1.4010695187165776,0.04578734037566287,564,We are investing more in survelliance
141,23,29,135,187,1.4010695187165776,0.05112719036956064,564,Yes there are 9 now… The last ones name is Gorsuch.
145,16,41,126,183,1.3989071038251366,0.0477311388628955,564,I'd like to introduce you to our night staff.
146,8,13,52,73,1.3972602739726028,0.0798107684609522,564,"There was a typo in our football article, so here are the entrants for the superb owl contest."
147,18,37,129,184,1.3967391304347827,0.04875439544313483,564,"Chicken salad on rye, coffee, and nine mice, please."
147,21,31,132,184,1.3967391304347827,0.05054879492879423,564,"Symbols of wisdom or ruthless predators: either way, we can pay them as consultants."
147,16,41,127,184,1.3967391304347827,0.04752050097105896,564,It's Hogwarts' spam
150,16,39,124,179,1.3966480446927374,0.048464589358173486,564,"It's ok, they're service owls."
151,17,38,127,182,1.3956043956043955,0.048508969643663344,564,"Yes, Horton. I hear it too."
151,16,40,126,182,1.3956043956043955,0.04787909113584722,564,"Miss Miller, do you know anything about omens?"
153,14,43,123,180,1.3944444444444444,0.04694068408756371,564,"It's actually ""whom."""
153,20,31,129,180,1.3944444444444444,0.05075300287858036,564,"Really, Ms. Scarlett, I don't give a hoot."
155,24,22,132,178,1.3932584269662922,0.05358709885291738,564,"Miss Wilkins, you will begin with 'Mr. Chief Justice and may it please the Court.'"
155,20,30,128,178,1.3932584269662922,0.051163045992171835,564,It's a Model Supreme Court: nine old birds who don't give a hoot.
157,15,39,122,176,1.3920454545454546,0.048332205268492585,564,"Eunice, when you leave the office at night, please close the window."
158,13,42,119,174,1.3908045977011494,0.04732751777931047,564,This is night owls. Early birds are two doors down.
158,12,44,118,174,1.3908045977011494,0.04662030856928845,564,"Towels, Miss Dinglebranch. Towels."
160,15,34,115,164,1.3902439024390243,0.05081425505976652,564,They heard we were a predatory lender.
161,18,31,124,173,1.3872832369942196,0.050886753935430656,564,So this is all that's left of the EPA?
161,21,25,127,173,1.3872832369942196,0.0528308785793132,564,How dare you call me the crazy cat lady.
163,11,44,116,171,1.3859649122807018,0.04637766764352695,564,A tuna sandwich on rye and nine mice.
163,13,40,118,171,1.3859649122807018,0.047838132857190956,564,"Oh, Miss Helpler, I'm way beyond having my ducks in a row!"
165,8,49,112,169,1.3846153846153846,0.04441155916843275,564,"No, sir, I'm almost certain the promotion department suggested giving a TOWEL to new customers when they open an account."
165,17,31,121,169,1.3846153846153846,0.05105260023723939,564,The acceptance letters to the seniors at Hogwarts are ready to be sent.
165,13,39,117,169,1.3846153846153846,0.04821409004061605,564,"Yeah, hi...the keyboard works fine but my mouse is missing again"
165,10,45,114,169,1.3846153846153846,0.04597033112824591,564,"It’s a ‘parliament,’ Ms. Simpson, not a ‘flock.’"
169,14,36,117,167,1.3832335329341316,0.049334746841852004,564,The new edition of Who's Who just arrived
169,22,20,125,167,1.3832335329341316,0.05487327383245318,564,May I introduce the new Supreme Court?
169,14,36,117,167,1.3832335329341316,0.049334746841852004,564,We'll be paying them on an owly basis.
172,12,39,114,165,1.3818181818181818,0.048230114271026255,564,"Bill, I'm having some trouble with my m-o-u-s-e."
173,17,28,118,163,1.3803680981595092,0.05236842213133965,564,"Is this wise, sir?"
174,7,8,43,58,1.3793103448275863,0.09146117165599603,564,"Alexa, I asked for a towel."
175,20,21,120,161,1.3788819875776397,0.054987364005048986,564,"I'm not kidding, Trump plans to replace the entire Supreme Court!"
176,2,21,43,66,1.378787878787879,0.06747235129207982,564,Mother always told me: choose your friends wisely or choose wise friends.
177,14,32,114,160,1.375,0.050741359211112926,564,"I like hooters. There, I said it."
177,13,34,113,160,1.375,0.04996067636041306,564,Put name tags on them. I have no clue who's who.
177,10,40,110,160,1.375,0.04754177243000268,564,Have you met our new branch managers?
177,13,34,113,160,1.375,0.04996067636041306,564,We're being spammed by Hogwarts.
181,14,31,113,158,1.3734177215189873,0.05117673365721463,564,"What,Where,When & Why are in the lobby."
181,11,37,110,158,1.3734177215189873,0.04875634422894257,564,"I wanted to soar with the eagles, but I'm middle-management."
181,9,41,108,158,1.3734177215189873,0.04707366346912302,564,We hired them to work the night shift.
181,16,27,115,158,1.3734177215189873,0.052728639068236716,564,"You work nights, you make friends."
181,12,35,111,158,1.3734177215189873,0.04957627212341192,564,This isn't the kind of 'collective wisdom' I had in mind.
181,14,31,113,158,1.3734177215189873,0.05117673365721463,564,"It appears you had another successful trip to Costco, Sir."
187,9,29,88,126,1.373015873015873,0.05489861013550139,564,It's our new motto: 'The Company That Gives a Hoot!'
188,13,32,111,156,1.3717948717948718,0.050814660811085176,564,Careful. They have Irritable Owl Syndrome.
188,13,32,111,156,1.3717948717948718,0.050814660811085176,564,Could you please bring us nine dead mice and a decaf latte?
188,12,34,110,156,1.3717948717948718,0.04999416733386849,564,Oh. So you can see them as well?
188,14,30,112,156,1.3717948717948718,0.05162211482770178,564,"Nadine, I have a somewhat unusual project I'd like you to take on."
192,13,31,110,154,1.37012987012987,0.051256430694822094,564,"Thanks, Gladys. I'll have the usual for lunch. Pastrami on rye, chips, a Diet Coke, and nine mice."
192,11,35,108,154,1.37012987012987,0.049572742630662185,564,"Yes, as a matter of fact, we ARE a 'fly-by-night' outfit. Your point?"
194,15,18,97,130,1.3692307692307693,0.0599527358449683,564,"What, when, why, where, but the greatest of all is WHO?"
195,7,41,102,150,1.3666666666666667,0.04674330555776746,564,Please let maintenance know the mouse problem is taken care of.
195,12,31,107,150,1.3666666666666667,0.05130656787909022,564,No. I said I need more HOURS to get the job done.
195,19,17,114,150,1.3666666666666667,0.05708556838485993,564,"As your new President, after great contemplation, these are my nominees to fill the entire Supreme Court!"
195,14,27,109,150,1.3666666666666667,0.05302202207345211,564,"Ms. Jones, I've gotten a distressingly high number of complaints regarding your parrot's abusive language."
195,11,33,106,150,1.3666666666666667,0.050426961527725585,564,"Yes, I'm the night manager."
200,11,32,105,148,1.364864864864865,0.0508691227129258,564,I guess word has gotten out about our mouse problem.
200,10,34,104,148,1.364864864864865,0.04995737165049287,564,Can't you see I'm in a meeting?
200,13,28,107,148,1.364864864864865,0.05264527492849831,564,Your 3 a.m. is here.
200,10,34,104,148,1.364864864864865,0.04995737165049287,564,"No, I'm asking you - who's my first appointment?"
204,9,35,102,146,1.3630136986301369,0.04944676165051988,564,I believe the correct word is 'whom'.
204,7,39,100,146,1.3630136986301369,0.04749774326369835,564,"The new guys from corporate want us to focus less on ""the how"" and more on ""the who"""
204,9,35,102,146,1.3630136986301369,0.04944676165051988,564,This desk was made from the tree they lived in
204,9,35,102,146,1.3630136986301369,0.04944676165051988,564,One of our owls is missing.
204,12,29,105,146,1.3630136986301369,0.05223410927346235,564,I'm here for the Hooters interview.
204,6,41,99,146,1.3630136986301369,0.046492604829742996,564,It's whom.
204,11,31,104,146,1.3630136986301369,0.05132181661148059,564,"Around here, we don't ask ""why""."
211,7,38,99,144,1.3611111111111112,0.04788769633108411,564,"Do it, do it, do it: Say 'Knock, knock.'"
212,2,18,41,61,1.360655737704918,0.07025631016229583,564,It's Monday. Of course I'm in a fowl mood.
213,12,27,103,142,1.3591549295774648,0.05320752563984046,564,My wife swears she sent me out for towels.
213,10,31,101,142,1.3591549295774648,0.05129581408828782,564,"Nine mice and a vodka martini, Ms. Phipps."
213,12,27,103,142,1.3591549295774648,0.05320752563984046,564,"When we are at work, it's Dr. Who."
213,16,19,107,142,1.3591549295774648,0.05683837847953146,564,I've come up with the solution for the appointment of Supreme Court Justices that should please both partys.
213,8,35,99,142,1.3591549295774648,0.049310042600327314,564,We're looking for someone who can come in during the day.
213,11,29,102,142,1.3591549295774648,0.052260412013753144,564,Once you tell someone you collect owls it quickly gets out of hand.
219,16,18,106,140,1.3571428571428572,0.057412007449005154,564,The takeaway? Don't order awls from a hardware store in Boston.
219,10,30,100,140,1.3571428571428572,0.0517637813708753,564,"If I buy one more, I earn a free barn."
221,10,29,99,138,1.355072463768116,0.05224336268908296,564,"Surrounding yourself with an endangered species won't protect you from getting fired, Bob."
222,17,16,108,141,1.3546099290780143,0.05794063951582255,564,"Crazy, you say? Well, maybe, but do you see any squirrels around here?"
222,11,28,102,141,1.3546099290780143,0.052432956925393674,564,I said towels.
222,13,24,104,141,1.3546099290780143,0.054330923212546504,564,Costco.
222,12,26,103,141,1.3546099290780143,0.053390374549481354,564,Oh my gosh! When did you shave your head?!
222,10,30,101,141,1.3546099290780143,0.051457728762028254,564,They're ok with working nights.
222,14,22,105,141,1.3546099290780143,0.05525546434264527,564,"Yes. And again sir, who is here and I don't know what is waiting outside."
222,10,30,101,141,1.3546099290780143,0.051457728762028254,564,"I promoted THEM, because they're the only ones who give a hoot."
229,13,22,102,137,1.3503649635036497,0.055398979189373185,564,We've just welcomed Mr. Gorsuch to the bench.
229,10,28,99,137,1.3503649635036497,0.05241202413909692,564,I accidentally clicked 'Reply Owl.'
229,10,28,99,137,1.3503649635036497,0.05241202413909692,564,"Will you be needing any more owls before I go, sir?"
232,8,31,96,135,1.348148148148148,0.05077456273522056,564,I'm working nine owls a day.
232,11,25,99,135,1.348148148148148,0.053941924135995356,564,This week. Tiny Desk Concert. The Who.
232,12,23,100,135,1.348148148148148,0.05495716057991917,564,It's spam from Hogwarts.
232,8,31,96,135,1.348148148148148,0.05077456273522056,564,"As a matter of fact, I do give a hoot."
236,10,26,97,133,1.3458646616541354,0.05341505840645854,564,Do these glasses make me look smart?
236,14,18,101,133,1.3458646616541354,0.057522631466027,564,Guess which one of us is the supreme court nominee.
238,9,27,95,131,1.3435114503816794,0.05283617015694881,564,Ask them who's on first.
238,10,25,96,131,1.3435114503816794,0.05393607965870664,564,Our pigeon problem is solved.
238,10,25,96,131,1.3435114503816794,0.05393607965870664,564,The EPA just cut all their branches.
238,12,21,98,131,1.3435114503816794,0.05607120752349596,564,I hardly think this is an HR matter. I only asked to see her hooters.
238,12,21,98,131,1.3435114503816794,0.05607120752349596,564,"I think a better question is, ""Why?"""
238,6,33,92,131,1.3435114503816794,0.04938968961802803,564,Tell IT support I need another mouse. And please close the window.
238,8,29,94,131,1.3435114503816794,0.05171287136446542,564,And I suppose you thought my affinity for hooters meant something else?
238,11,23,97,131,1.3435114503816794,0.05501400277244557,564,"They were brought in as consultants on this year's edition of ""Who's Who."""
238,10,25,96,131,1.3435114503816794,0.05393607965870664,564,I'm taking a break from the Internet.
247,7,30,92,129,1.3410852713178294,0.05102643622357204,564,I see the new secure mail server system has been installed.
247,11,22,96,129,1.3410852713178294,0.055571515344727394,564,"Why don't you just buy mousetraps, like everyone else?"
247,12,20,97,129,1.3410852713178294,0.056650837140478555,564,Our department is moving to night shift only
247,13,18,98,129,1.3410852713178294,0.05770997643150425,564,Which one is Chief Justice?
247,7,30,92,129,1.3410852713178294,0.05102643622357204,564,They were all out of penguins.
247,7,30,92,129,1.3410852713178294,0.05102643622357204,564,"What makes you think we are a "" fly by night"" company?"
247,13,18,98,129,1.3410852713178294,0.05770997643150425,564,You did ask me to order you Hooters for lunch.
247,9,26,94,129,1.3410852713178294,0.05334740158333645,564,Clever bunch. They'll find our mole.
247,11,22,96,129,1.3410852713178294,0.055571515344727394,564,"We'll all have mice Margaret, thank you"
247,9,26,94,129,1.3410852713178294,0.05334740158333645,564,Go ahead -- ask me anything.
247,10,24,95,129,1.3410852713178294,0.05447081132773332,564,"Laugh, but I haven't seen a pigeon in weeks."
258,12,19,96,127,1.3385826771653544,0.057246392125981885,564,Who who who who who who should I say is calling?
258,9,25,93,127,1.3385826771653544,0.05387203616518535,564,"They were all asking, ""Who?"" and I thought, ""Well, why not me?"""
258,6,31,90,127,1.3385826771653544,0.050271693324617533,564,"No, Mrs. Johnson, I don't give a hoot."
258,7,29,91,127,1.3385826771653544,0.051499781811938546,564,"Bunch, flock, parliament, whatever. Just get the damn things off my desk."
258,7,29,91,127,1.3385826771653544,0.051499781811938546,564,"Yes, they ARE very cute, Mrs. Gunderson, but I think mouse traps would have worked just as well."
258,8,27,92,127,1.3385826771653544,0.05269925904251555,564,Apparently I've been accepted to Hogwarts.
258,3,37,87,127,1.3385826771653544,0.046392779813951145,564,You are looking for whom?
258,6,31,90,127,1.3385826771653544,0.050271693324617533,564,"Miss Johnson, could you settle an argument? Is it ""who"" or ""whom""?"
258,7,29,91,127,1.3385826771653544,0.051499781811938546,564,"I don't know where they came from, but at least the pigeons have left."
267,9,24,92,125,1.336,0.05441062514833163,564,Fire the cat.
267,11,20,94,125,1.336,0.05673253603675135,564,Looks like spam from Hogwarts
267,9,24,92,125,1.336,0.05441062514833163,564,This isn't the Hooters happy hour I had in mind.
270,10,21,92,123,1.3333333333333333,0.056163100324148306,564,Don't tell the pigeons. It's a surprise.
270,9,23,91,123,1.3333333333333333,0.054963750023952554,564,Please tell Harry Potter to start using e-mails if he wants to contact me again.
270,4,7,34,45,1.3333333333333333,0.09534625892455922,564,I got tired of employees asking ‘How?’ or ‘Why?’
270,11,19,93,123,1.3333333333333333,0.05733736878637832,564,They’re wiser and cheaper than the previous board and we no longer have a rodent problem.
270,8,25,90,123,1.3333333333333333,0.053737638535487776,564,I'm writing a whoodunit.
270,6,29,88,123,1.3333333333333333,0.05119739986289474,564,My mouse is missing again
270,11,19,93,123,1.3333333333333333,0.05733736878637832,564,I can't find my mouse.
277,6,28,87,121,1.3305785123966942,0.051677680002854484,564,Of course we'll need you to work nights.
277,4,32,85,121,1.3305785123966942,0.04893976416793929,564,"They're having trouble with ""whom."""
277,8,24,89,121,1.3305785123966942,0.05427766303131831,564,"We're in a tight spot, Margaret. They're asking me to name names."
277,8,24,89,121,1.3305785123966942,0.05427766303131831,564,Good news Stella. You're off the night shift.
277,10,20,91,121,1.3305785123966942,0.05675867156483889,564,Please don't say who again.
277,7,26,88,121,1.3305785123966942,0.052993619024457865,564,"Something tells me, Miss Hadley, that this may be a fly-by-night operation we're dealing with."
277,10,20,91,121,1.3305785123966942,0.05675867156483889,564,"At this magazine, what, when, where, why, and how are secondary."
277,5,30,86,121,1.3305785123966942,0.05032734409489011,564,"Carl, would you know what might have happened to my computer's mouse?"
285,9,17,80,106,1.330188679245283,0.06102110767503446,564,Spam from Hogwarts.
286,11,17,91,119,1.3277310924369747,0.0585992836384508,564,"For the last time, I didn't call you in here, Mrs. Hoo."
286,9,21,89,119,1.3277310924369747,0.05611609694503981,564,I call them my little Supreme Court.
286,10,19,90,119,1.3277310924369747,0.05737112679425389,564,"Why yes, I was raised in a barn."
286,7,25,87,119,1.3277310924369747,0.0535178160031835,564,Which one of you left a half-eaten mouse in the breakroom?
286,5,29,85,119,1.3277310924369747,0.05078677901930877,564,To whom are you speaking?
286,7,25,87,119,1.3277310924369747,0.0535178160031835,564,"Personally my dear, I don't give a hoot."
286,9,21,89,119,1.3277310924369747,0.05611609694503981,564,"Miss Brooks, I ordered towels."
286,13,13,93,119,1.3277310924369747,0.060981437745711686,564,I'm sorry ... the Supreme Court vacancy has been filled.
286,8,23,88,119,1.3277310924369747,0.05483234887407118,564,"Despite what you may have heard, Miss Jones, HR does not give a hoot."
295,9,20,88,117,1.3247863247863247,0.056716652199869426,564,"Relax, Sharon. These are service owls."
295,11,16,90,117,1.3247863247863247,0.059257936763073525,564,I'm old school when it comes to tweeting.
295,9,20,88,117,1.3247863247863247,0.056716652199869426,564,Please stop staring at my hooters.
295,11,16,90,117,1.3247863247863247,0.059257936763073525,564,I left my barn door open.
295,3,32,82,117,1.3247863247863247,0.04829705310673263,564,Pay no attention to the man behind the owls.
295,5,28,84,117,1.3247863247863247,0.05125748502853041,564,I'm beefing up overnight security.
295,5,28,84,117,1.3247863247863247,0.05125748502853041,564,"Ms. Hendricks, have IT send me up a new mouse."
302,8,21,86,115,1.3217391304347825,0.05598821125637304,564,"Go ahead, pick an owl, any owl."
302,9,19,87,115,1.3217391304347825,0.05733441463017632,564,"Sir,there's a pussycat waiting outside who wants to go to sea with one of you."
302,6,25,84,115,1.3217391304347825,0.05319369508780919,564,"We just need the who, what, where and why. We have the ""who"" covered."
302,10,17,88,115,1.3217391304347825,0.05864972636152445,564,Admit it Frank. Working the night shift for 30 years has changed you.
302,9,19,87,115,1.3217391304347825,0.05733441463017632,564,Our email is down.
302,5,27,83,115,1.3217391304347825,0.05173986756649167,564,"No, they don't make you look smarter."
302,10,17,88,115,1.3217391304347825,0.05864972636152445,564,Needed a hobby for my Match.com profile.
309,7,22,84,113,1.3185840707964602,0.05517683147495543,564,And what do you collect?
309,8,20,85,113,1.3185840707964602,0.05659072843240933,564,I keep losing my mouse.
309,8,20,85,113,1.3185840707964602,0.05659072843240933,564,Let's start again. I don't need a table for 9 hooters. I need a table for 9 at Hooters.
309,0,36,77,113,1.3185840707964602,0.04402599279232832,564,"Marcy, I don't know either if it's to who they belong, or to whom they belong."
309,8,20,85,113,1.3185840707964602,0.05659072843240933,564,Just answer yes or no—have you ever seen a mouse in my office?
309,7,22,84,113,1.3185840707964602,0.05517683147495543,564,"I'd like to return these owls, they keep saying ""whom""."
309,7,22,84,113,1.3185840707964602,0.05517683147495543,564,It may require working nights.
309,1,34,78,113,1.3185840707964602,0.04578554197828409,564,You are looking for whom?
309,8,20,85,113,1.3185840707964602,0.05659072843240933,564,I want you to get rid of the suggestion box immediately.
318,5,25,81,111,1.3153153153153154,0.05274136356125124,564,"Let's try this again, Ms. Beasley. Please order 9 towels."
318,8,19,84,111,1.3153153153153154,0.05721059274033587,564,"I understand that ""where"" and ""when"" are pressing concerns, but I'm focusing on ""who."""
318,5,25,81,111,1.3153153153153154,0.05274136356125124,564,Have you seen the mouse for my computer?
318,7,21,83,111,1.3153153153153154,0.05576066497003428,564,"That's right, I run Who's Who."
318,5,25,81,111,1.3153153153153154,0.05274136356125124,564,"No, Mrs. Hoo, I didn't call for you this time either."
318,6,23,82,111,1.3153153153153154,0.05427201483361608,564,"In recognition of your 40 years of service, I'd like you to have one of these."
318,5,25,81,111,1.3153153153153154,0.05274136356125124,564,My wife suggested I take up bird watching.
318,8,19,84,111,1.3153153153153154,0.05721059274033587,564,They refuse to go to sea untill we rehire all the Pussycats.
318,11,13,87,111,1.3153153153153154,0.06135513355132611,564,"I'm as perplexed as you Susan, but the doctor's orders were to keep a close eye on my owl movements."
318,6,23,82,111,1.3153153153153154,0.05427201483361608,564,'They offered free shipping'
318,10,15,86,111,1.3153153153153154,0.0600054351646657,564,Quit staring at my hooters.
329,7,20,82,109,1.311926605504587,0.05636100284109719,564,Let us prey.
329,6,22,81,109,1.311926605504587,0.05483309197871898,564,My doctor says it's important to have regular owl movements.
329,10,14,85,109,1.311926605504587,0.06071446810420638,564,"Yes, sir. The glasses do make you look smarter."
329,3,28,78,109,1.311926605504587,0.04996983069837368,564,I see you guys have been at it all night.
329,9,16,84,109,1.311926605504587,0.05929883617634653,564,"I can't right now, i've irritable owl syndrome."
329,7,20,82,109,1.311926605504587,0.05636100284109719,564,"Mrs. Skolnik, we've heard things."
329,8,18,83,109,1.311926605504587,0.05784857220849686,564,"Ironically, Mort, this makes you look stupid!"
336,10,13,83,106,1.3113207547169812,0.06195846440367467,564,"Not to be a stickler, but I think you meant 'whom'."
336,4,25,77,106,1.3113207547169812,0.05254221346078271,564,"For the last time, it's ""whom""!"
336,8,17,81,106,1.3113207547169812,0.05898696697260421,564,They're all trained killers with built in GPS and no empathy.
336,4,25,77,106,1.3113207547169812,0.05254221346078271,564,"Actually, it's ""whom""."
336,7,19,80,106,1.3113207547169812,0.05744360498184231,564,Do you know where my mouse is?
336,7,19,80,106,1.3113207547169812,0.05744360498184231,564,"We also need to know What, When, and Where."
342,3,26,74,103,1.3106796116504855,0.051678703633240494,564,"I think we may have a diversity problem, Susan."
343,3,26,75,104,1.3076923076923077,0.05126649004628654,564,"I think you mean ""whom"""
343,8,16,80,104,1.3076923076923077,0.05968069611353861,564,I see you still haven't sent the Dumbledore letter.
343,9,14,81,104,1.3076923076923077,0.06122492944857226,564,One more and I'll have a minyan!
343,10,12,82,104,1.3076923076923077,0.06273116038595779,564,With the right marketing we can get these guys to replace the Supreme Court.
343,5,22,77,104,1.3076923076923077,0.05478746203684028,564,"If this doesn't protect my job here at the Department of Interior, then I don't know what will."
343,5,22,77,104,1.3076923076923077,0.05478746203684028,564,"A cup of coffee, cream, no sugar, and nine voles."
343,4,24,76,104,1.3076923076923077,0.05305619190115425,564,Turns out they're more afraid of the mice than we are.
343,6,20,78,104,1.3076923076923077,0.056465675359676025,564,"On the plus side, I haven't found a pigeon on my desk in weeks."
343,7,18,79,104,1.3076923076923077,0.05809543003722783,564,"Get me nine pussy cats and nine beautiful pea-green boats, ASAP!"
343,4,24,76,104,1.3076923076923077,0.05305619190115425,564,The new mousepad you got me seems to have attracted quite a bit of attention.
343,7,18,79,104,1.3076923076923077,0.05809543003722783,564,"In retrospect, I think the anxiety labradoodle would have been a better choice."
343,5,22,77,104,1.3076923076923077,0.05478746203684028,564,Bring me the Hitchcock file.
343,7,18,79,104,1.3076923076923077,0.05809543003722783,564,"For the third time, my name is Janet and I work in sales."
343,7,18,79,104,1.3076923076923077,0.05809543003722783,564,I've got a lot on my desk but I'll try to squeeze him in.
343,9,14,81,104,1.3076923076923077,0.06122492944857226,564,"They're very good at the Who, but not so good at the What, Where, When or Why."
343,5,10,50,65,1.3076923076923077,0.07571161417319047,564,I've assembled a real whoos hooooooo to assist you.
343,7,18,79,104,1.3076923076923077,0.05809543003722783,564,Welcome to Who's Who
343,7,18,79,104,1.3076923076923077,0.05809543003722783,564,Wise guys.
343,9,14,81,104,1.3076923076923077,0.06122492944857226,564,"Yes, Linda. I hit ""Reply all."""
362,8,15,79,102,1.303921568627451,0.06039605208464448,564,"Pick an owl, any owl."
362,7,17,78,102,1.303921568627451,0.05876687882341709,564,It's bring your owls to work day.
362,8,15,79,102,1.303921568627451,0.06039605208464448,564,The A.M.A. says that only with a 10th owl is it officially termed an 'obsession.'
362,6,19,77,102,1.303921568627451,0.05709123387947828,564,"Next year's ""Bring your pet to work day"" will have some restrictions."
366,7,16,77,100,1.3,0.059458839001056314,564,These are all incredibly stupid. Bring me another.
366,5,20,75,100,1.3,0.05595813731096785,564,"They ask the questions, not you."
366,8,14,78,100,1.3,0.0611340636419152,564,"Regretfully, sir, I can't work for a messenger service that's fly-by-night."
366,6,18,76,100,1.3,0.05773502691896258,564,H.R. said we can't call them hooters.
366,7,16,77,100,1.3,0.059458839001056314,564,I just need one more and then I can get the set of steak knives.
366,1,28,71,100,1.3,0.04819992036541475,564,To whom are you speaking?
366,4,22,74,100,1.3,0.054122942725732585,564,"Come on, Meredith, it's for my kid's school. Buy at least one. Jeez!"
366,8,14,78,100,1.3,0.0611340636419152,564,"They can't all be on first, sir."
374,5,19,73,97,1.2989690721649485,0.05707080302488788,564,We're anticipating a resurgence in predatory lending
375,8,13,77,98,1.2959183673469388,0.0618958214648231,564,I think I've assembled absolutely the wisest cabinet ever assembled.
375,8,13,77,98,1.2959183673469388,0.0618958214648231,564,"Miss Pursley, please tell the exaltation of larks I'll see them now."
375,7,15,76,98,1.2959183673469388,0.0601722467511431,564,You don't have to say your name each time. It's a rhetorical question.
375,6,17,75,98,1.2959183673469388,0.05839782396079194,564,"Only one therapy animal allowed, Stu."
375,6,17,75,98,1.2959183673469388,0.05839782396079194,564,"Cream, no sugar, and nine mice"
375,4,21,73,98,1.2959183673469388,0.054676493778460546,564,"A box of field mice and a lot of newspaper, pronto."
375,7,15,76,98,1.2959183673469388,0.0601722467511431,564,"Frankly, I don't give a hoot if we have to work the night shift."
382,4,21,74,99,1.292929292929293,0.0542038671601528,564,I'm surrounding myself with wisdom.
382,5,19,75,99,1.292929292929293,0.05607318680440244,564,Have you seen my mouse?
382,7,15,77,99,1.292929292929293,0.05963630106716254,564,"Let's see. there's happy, dopey, doc, snoopy, lucy, kermit, curley, moe, and I forget the one on the right."
382,4,21,74,99,1.292929292929293,0.0542038671601528,564,Good news. The mice are gone.
382,6,17,76,99,1.292929292929293,0.05788216773486746,564,"Apparently, more people give a hoot than anticipated."
382,6,17,76,99,1.292929292929293,0.05788216773486746,564,They really don't make you look any wiser
382,8,13,78,99,1.292929292929293,0.06134029237181033,564,"We'll have five chipmunks, four field mice and a tuna salad on rye."
382,6,17,76,99,1.292929292929293,0.05788216773486746,564,"Yes Ms. Jenkins--although it's a real hoot to work in this office, there is always a lot of crap to deal with."
382,3,23,73,99,1.292929292929293,0.05226773528506444,564,They're looking for my mouse.
382,6,17,76,99,1.292929292929293,0.05788216773486746,564,"If you're not a varmint, Marjory, then you have nothing to worry about."
382,7,15,77,99,1.292929292929293,0.05963630106716254,564,It's high time we do something about the lack of vision around here.
382,5,19,75,99,1.292929292929293,0.05607318680440244,564,"'What?', Alice, is a REFRESHING question."
382,3,23,73,99,1.292929292929293,0.05226773528506444,564,I'm not a people person.
382,7,15,77,99,1.292929292929293,0.05963630106716254,564,"Sir, you did say you wanted a team of blood thirsty carnivores that would work all night."
382,7,15,77,99,1.292929292929293,0.05963630106716254,564,"It's one too many owls, isn't it?"
382,9,11,79,99,1.292929292929293,0.06299821054240425,564,The ad said eco-friendly drones.
382,4,21,74,99,1.292929292929293,0.0542038671601528,564,Remember when I told you that my desk drawer squeaked?
382,3,23,73,99,1.292929292929293,0.05226773528506444,564,Have you seen the mouse for my computer?
382,2,25,72,99,1.292929292929293,0.050257070035405464,564,"It's from WHOM did I get them, not from WHO."
382,6,17,76,99,1.292929292929293,0.05788216773486746,564,Who needs security cameras. They can swivel their heads 270 degrees.
402,2,24,70,96,1.2916666666666667,0.05112048604588235,564,"Apparently, people have been abusing the ""Reply Owl"" button again."
402,8,12,76,96,1.2916666666666667,0.06268248214015988,564,Towels! I asked for a gift set of towels!
402,3,22,71,96,1.2916666666666667,0.053222197804875436,564,"For the late shift, I said I needed a night owl - not nine owls."
402,6,16,74,96,1.2916666666666667,0.059080428874741533,564,"I wanted a table for 9 at Hooters, not a table of 9 hooters!!"
402,4,20,72,96,1.2916666666666667,0.05524400949239042,564,Unhackable.
402,5,18,73,96,1.2916666666666667,0.05719439509610499,564,"Madam, this is the ""who"" department. The ""what"" department is down the hall."
402,6,16,74,96,1.2916666666666667,0.059080428874741533,564,"Nine mice and a Caesar Salad, please."
402,7,14,75,96,1.2916666666666667,0.06090808913139065,564,"If it's a ""WHO"" question we can help"
402,6,16,74,96,1.2916666666666667,0.059080428874741533,564,"The word you are looking for is Parliament'. It's a 'Congress' of loons,"
402,9,10,77,96,1.2916666666666667,0.06440801047125659,564,"Yes, they WOULD make a nice Supreme Court, but . . ."
402,8,12,76,96,1.2916666666666667,0.06268248214015988,564,Their collective wisdom could easily replace the Supreme Court's.
402,6,16,74,96,1.2916666666666667,0.059080428874741533,564,I see nine wise old owls and one bird brain.
402,5,18,73,96,1.2916666666666667,0.05719439509610499,564,"No, I said the washroom needed more towels."
402,4,20,72,96,1.2916666666666667,0.05524400949239042,564,"Herbert, have you seen my mouse?"
402,6,16,74,96,1.2916666666666667,0.059080428874741533,564,They don't give a hoot and neither do I.
402,2,24,70,96,1.2916666666666667,0.05112048604588235,564,Can't you see that I already have enough on my desk?
402,7,14,75,96,1.2916666666666667,0.06090808913139065,564,"There are precisely nine, Ms. Jones, so they will never become deadlocked on what to do with the gerbils."
402,4,20,72,96,1.2916666666666667,0.05524400949239042,564,"We use email here, Mr. Weasley."
402,5,18,73,96,1.2916666666666667,0.05719439509610499,564,Please get me a cup of coffee and nine mice.
402,5,18,73,96,1.2916666666666667,0.05719439509610499,564,This is a fly-by -night operation.
402,6,16,74,96,1.2916666666666667,0.059080428874741533,564,"Goddammit Howard, I said nine towels!"
402,9,10,77,96,1.2916666666666667,0.06440801047125659,564,I got you Hooters like you asked.
402,5,18,73,96,1.2916666666666667,0.05719439509610499,564,"You may send in the pussycats now, Mrs. Gundersen."
402,7,14,75,96,1.2916666666666667,0.06090808913139065,564,"One ham and swiss on wheat, a diet Coke, and 45 field mice"
402,7,14,75,96,1.2916666666666667,0.06090808913139065,564,What happened to the Penguin paperbacks?
402,8,12,76,96,1.2916666666666667,0.06268248214015988,564,Who's the wise guy now?
402,5,18,73,96,1.2916666666666667,0.05719439509610499,564,Owls are the new ficus.
402,10,8,78,96,1.2916666666666667,0.06608850171156502,564,It's what the Supreme Court is supposed to look like.
402,6,16,74,96,1.2916666666666667,0.059080428874741533,564,Bring me the Jones file and a bucket of mice.
402,7,14,75,96,1.2916666666666667,0.06090808913139065,564,Want one?
402,6,16,74,96,1.2916666666666667,0.059080428874741533,564,"Coffee, black, and a dozen mice for the owls."
402,5,18,73,96,1.2916666666666667,0.05719439509610499,564,"I said I wanted to be a night owl, not I wanted nine owls."
402,7,14,75,96,1.2916666666666667,0.06090808913139065,564,Is this the Hogwarts mail room?
402,6,16,74,96,1.2916666666666667,0.059080428874741533,564,Are you able to identify which one stared at you?
402,6,16,74,96,1.2916666666666667,0.059080428874741533,564,"It's a start, but it still doesn't explain the hollering."
402,4,20,72,96,1.2916666666666667,0.05524400949239042,564,They're here to protest EPA funding cuts...and for the air conditioning.
402,5,18,73,96,1.2916666666666667,0.05719439509610499,564,Can any of them play first base?
402,6,16,74,96,1.2916666666666667,0.059080428874741533,564,"Well, your taxes are done. They had to pull an all-dayer to finish them though."
402,7,14,75,96,1.2916666666666667,0.06090808913139065,564,You said that you wanted to see my hooters. Did you not?
441,6,15,73,94,1.2872340425531914,0.05978368010305837,564,"What I need from you are the 'what,' 'where,' and 'why.'"
441,6,15,73,94,1.2872340425531914,0.05978368010305837,564,It seems I've been accepted at Hogwart's.
441,5,17,72,94,1.2872340425531914,0.057838635938787894,564,"Excuse me sir, but your taxidermist is on line one."
441,4,19,71,94,1.2872340425531914,0.05582586504349464,564,Meet the company softball team. Hoo's on first.
441,4,19,71,94,1.2872340425531914,0.05582586504349464,564,Fixed the rodent problem.
441,7,13,74,94,1.2872340425531914,0.06166740635108621,564,Housekeeping called in sick. Again.
441,8,11,75,94,1.2872340425531914,0.06349527230806368,564,I was told a nine owl day was the norm around here...
441,4,19,71,94,1.2872340425531914,0.05582586504349464,564,Say goodbye to the office rodent problem.
441,7,13,74,94,1.2872340425531914,0.06166740635108621,564,Tell the student assembly that I'm not any closer to choosing a mascot.
441,4,19,71,94,1.2872340425531914,0.05582586504349464,564,"Ms Blake - By any chance, did I miss a Hogwarts tuition payment for Ida?"
441,4,19,71,94,1.2872340425531914,0.05582586504349464,564,I'm afraid of mice.
441,6,15,73,94,1.2872340425531914,0.05978368010305837,564,No one has a fax machine anymore.
441,4,19,71,94,1.2872340425531914,0.05582586504349464,564,It's a veritable who's who around here.
441,5,17,72,94,1.2872340425531914,0.057838635938787894,564,"It's me, Janice, you're secretary. Why do you keep asking who I am?"
441,5,17,72,94,1.2872340425531914,0.057838635938787894,564,They’ve agreed to help us find the mole.
441,10,7,77,94,1.2872340425531914,0.06700157314784108,564,They're benchwarmers for each of the Supreme Court justices.
441,6,15,73,94,1.2872340425531914,0.05978368010305837,564,We believe these messengers can't be hacked.
441,7,13,74,94,1.2872340425531914,0.06166740635108621,564,I know who. I just don't know why.
441,8,11,75,94,1.2872340425531914,0.06349527230806368,564,Your 3 a.m. is here.
441,2,23,69,94,1.2872340425531914,0.05156516274621981,564,Can I give you a word to the wise?
441,6,15,73,94,1.2872340425531914,0.05978368010305837,564,Lots of Hogwarts mail today.
441,9,9,76,94,1.2872340425531914,0.06527197105098274,564,I would like to introduce you to our newly confirmed Supreme Court Justices.
441,4,19,71,94,1.2872340425531914,0.05582586504349464,564,We're going to be working late tonight.
441,2,23,69,94,1.2872340425531914,0.05156516274621981,564,So who's working the day shift?
441,6,15,73,94,1.2872340425531914,0.05978368010305837,564,Not so foolish as your standing between them and their mother.
441,8,11,75,94,1.2872340425531914,0.06349527230806368,564,"Yes Mary, for the last time, a fucking parliament."
441,6,15,73,94,1.2872340425531914,0.05978368010305837,564,"On the bright side, we've solved our pigeon problem."
441,5,17,72,94,1.2872340425531914,0.057838635938787894,564,Not exactly what I meant when I asked you to book The Who.
441,7,13,74,94,1.2872340425531914,0.06166740635108621,564,I'm helping my kid raise money for his school. Want to buy an owl?
441,6,15,73,94,1.2872340425531914,0.05978368010305837,564,I can't resist a sale.
441,10,7,77,94,1.2872340425531914,0.06700157314784108,564,And why do you want to work at Hooters.
441,4,19,71,94,1.2872340425531914,0.05582586504349464,564,"Oh, and J.K. Rowling called nine times."
441,7,13,74,94,1.2872340425531914,0.06166740635108621,564,"The real question is, why?"
441,4,19,71,94,1.2872340425531914,0.05582586504349464,564,"You hooted, sir?"
441,6,15,73,94,1.2872340425531914,0.05978368010305837,564,It's a veritable who's who.
441,6,15,73,94,1.2872340425531914,0.05978368010305837,564,Can you prove my committee is responsible for the droppings on your desk?
441,5,17,72,94,1.2872340425531914,0.057838635938787894,564,Wait until you see what's in the filing cabinet.
441,4,19,71,94,1.2872340425531914,0.05582586504349464,564,"No, I said I wanted nine outlets."
441,5,17,72,94,1.2872340425531914,0.057838635938787894,564,The pigeon situation seemed completely controlled and they asked for more responsibility
480,6,14,72,92,1.2826086956521738,0.06050845035913782,564,"Ten, or no deal."
480,5,16,71,92,1.2826086956521738,0.05850111983222951,564,I figure my job is now protected by the Endangered Species Act.
480,5,16,71,92,1.2826086956521738,0.05850111983222951,564,The mousetrap doesn't have to be organic next time.
480,6,14,72,92,1.2826086956521738,0.06050845035913782,564,"They are wise and they are predators. Don't you forget that, Mrs. Jennings."
480,4,18,70,92,1.2826086956521738,0.05642241999759943,564,"""Clean up on 'owl 9.'"" It was a joke Ms. Smithers."
480,4,18,70,92,1.2826086956521738,0.05642241999759943,564,I'm replacing the annual year-end bonus with my new 'give a hoot' program.
480,4,18,70,92,1.2826086956521738,0.05642241999759943,564,I thought we could use more hooting and less hollering around here.
480,5,16,71,92,1.2826086956521738,0.05850111983222951,564,"We tried the mousetraps, Mrs. Kravitz, and we tried the cat- but now we are going to try it my way."
480,5,16,71,92,1.2826086956521738,0.05850111983222951,564,"They mulled it rigorously. It's 'whom'."""
480,3,20,69,92,1.2826086956521738,0.054264149630728925,564,"Despite my colleagues opinion, the correct word is ""whom""."
480,5,16,71,92,1.2826086956521738,0.05850111983222951,564,"Yes, the glasses make you look smarter. The owls -- not so much."
480,8,10,74,92,1.2826086956521738,0.06433549293619335,564,"""I don't care how what your advisors say, it's 'whom'."
480,7,12,73,92,1.2826086956521738,0.06245129388654502,564,"Frankly, Scarlet, I don't give a hoot!"
480,5,16,71,92,1.2826086956521738,0.05850111983222951,564,"Nice set, sir, but I'm still not showing you mine."
480,8,10,74,92,1.2826086956521738,0.06433549293619335,564,"You have messages from Roger Daltrey, Alfred Hitchcock, and Temple University."
480,4,18,70,92,1.2826086956521738,0.05642241999759943,564,"Get me What, Where, When and Why."
480,7,12,73,92,1.2826086956521738,0.06245129388654502,564,I thought I'd add some hooting to all of my hollering.
480,5,16,71,92,1.2826086956521738,0.05850111983222951,564,"I got the idea from Trump, Miss Crenshaw. Always surround yourself with the best and wisest council."
480,2,22,68,92,1.2826086956521738,0.052016405026748716,564,"I told you, George, a full desk doesn't mean you're busy."
480,4,18,70,92,1.2826086956521738,0.05642241999759943,564,"""Meet our new interns. They're a hoot""."
480,6,14,72,92,1.2826086956521738,0.06050845035913782,564,Did Mr Potter leave a forwarding address?
480,9,8,75,92,1.2826086956521738,0.0661660577228412,564,"Nancy, would you mind printing a return label for these owls? I ordered the wrong size."
480,6,14,72,92,1.2826086956521738,0.06050845035913782,564,Can you pick up a few dozen field mice at lunch?
480,5,16,71,92,1.2826086956521738,0.05850111983222951,564,They heard we've been working on a better mousetrap
480,2,22,68,92,1.2826086956521738,0.052016405026748716,564,"Overkill, Lois? Well, you don't see any more mice, frogs or field snakes, do you?"
480,4,18,70,92,1.2826086956521738,0.05642241999759943,564,"OK, you do look wiser."
480,5,16,71,92,1.2826086956521738,0.05850111983222951,564,Ask me if I give a hoot.
507,6,13,71,90,1.2777777777777777,0.06125564567275379,564,"There's something different, are those new glasses?"
507,5,15,70,90,1.2777777777777777,0.05918248251508745,564,Please stop staring at my hooters.
507,5,15,70,90,1.2777777777777777,0.05918248251508745,564,"I told them I don't know, but they all keep asking me the same question."
507,6,13,71,90,1.2777777777777777,0.06125564567275379,564,"Unusual yes, but try and find a single vole in this office!"
507,6,13,71,90,1.2777777777777777,0.06125564567275379,564,They came with the tree.
507,5,15,70,90,1.2777777777777777,0.05918248251508745,564,Choose the best one for yourself and then send the others in for their bonuses.
507,8,9,73,90,1.2777777777777777,0.06520452367022259,564,Stop staring at my Hooters
507,2,21,67,90,1.2777777777777777,0.05247382744032159,564,"For the last time, it's who not whom in this case."
507,4,17,69,90,1.2777777777777777,0.057034010436855166,564,"Alice, you're going to have to stop shopping at Costco."
507,5,15,70,90,1.2777777777777777,0.05918248251508745,564,"You realize sir, there's an app for that."
507,4,17,69,90,1.2777777777777777,0.057034010436855166,564,This is not what I meant by improving our corporate vision!
507,6,13,71,90,1.2777777777777777,0.06125564567275379,564,They're willing to work the night shift.
507,5,15,70,90,1.2777777777777777,0.05918248251508745,564,"Frankly, I don't give a hoot what the rest of the office thinks."
507,4,17,69,90,1.2777777777777777,0.057034010436855166,564,Show in Mr. Pigeon.
507,4,17,69,90,1.2777777777777777,0.057034010436855166,564,"But, unlike drones, they require no FAA approval."
507,9,7,74,90,1.2777777777777777,0.06709186088638432,564,"If that's all, Miss Felson, I'd like to get back to regurgitating into their mouths."
507,5,15,70,90,1.2777777777777777,0.05918248251508745,564,I'm afraid of mice.
507,4,17,69,90,1.2777777777777777,0.057034010436855166,564,"Actually, I really don't give a hoot Ms Guthrie."
507,4,17,69,90,1.2777777777777777,0.057034010436855166,564,I said I needed a Night Owl for the project. Not Nine Owls!
507,3,19,68,90,1.2777777777777777,0.05480137275994074,564,"Actually, it's whom, not who."
507,7,11,72,90,1.2777777777777777,0.06326090433216465,564,"Take a letter, Miss Bronson. And an owl."
507,7,11,72,90,1.2777777777777777,0.06326090433216465,564,This used to be the Night Desk.
507,7,11,72,90,1.2777777777777777,0.06326090433216465,564,Your obsession with hooters is making me feel uncomfortable.
507,3,19,68,90,1.2777777777777777,0.05480137275994074,564,"For the last time, it's ""whom""!"
507,5,15,70,90,1.2777777777777777,0.05918248251508745,564,Nine dead mice and a macchiato please.
507,5,15,70,90,1.2777777777777777,0.05918248251508745,564,Welcome to Whoo's Whoo in America.
507,8,9,73,90,1.2777777777777777,0.06520452367022259,564,"I don't care how many of these owls you make to give POTUS, they still won't make him wise."
507,7,11,72,90,1.2777777777777777,0.06326090433216465,564,Stop staring at my Hooters
507,2,21,67,90,1.2777777777777777,0.05247382744032159,564,"You can cross 'rodent infestation"" off the list of grievances."
536,4,16,67,87,1.2758620689655173,0.058241299466009394,564,Meet my Cabinet.
536,3,18,66,87,1.2758620689655173,0.05589938065066062,564,"It's a trade off--more hooey, less fake news."
536,3,18,66,87,1.2758620689655173,0.05589938065066062,564,Not 'who.' Whom.
536,4,16,67,87,1.2758620689655173,0.058241299466009394,564,A word to the wise Ms. Fitch.
536,3,18,66,87,1.2758620689655173,0.05589938065066062,564,I asked you to book 9 holes.
536,6,12,69,87,1.2758620689655173,0.06266311017028485,564,"I used to have coffee mugs, but people kept taking them."
536,5,14,68,87,1.2758620689655173,0.060492620788417835,564,This isn't what I meant when I said I'll have Hooters for lunch.
536,4,16,67,87,1.2758620689655173,0.058241299466009394,564,"They may be wise, but they still can't reach a concensus."
536,5,14,68,87,1.2758620689655173,0.060492620788417835,564,Wisest decision I ever made!
536,4,16,67,87,1.2758620689655173,0.058241299466009394,564,At least the snakes don't bother me anymore.
536,3,18,66,87,1.2758620689655173,0.05589938065066062,564,"Another letter campaign from Hogwarts, Mr. Senator?"
536,5,14,68,87,1.2758620689655173,0.060492620788417835,564,Choose wisely
548,4,9,49,62,1.2741935483870968,0.07333325062427716,564,I like to say that I have the biggest hooters in the company.
549,3,17,64,84,1.2738095238095237,0.0570633171799703,564,Email is down again.
550,7,10,71,88,1.2727272727272727,0.06409744884633352,564,"Helen, this guy's in our chair again."
550,6,12,70,88,1.2727272727272727,0.06202620356554665,564,"I thought you said you wanted hooters for lunch, Sir."
552,2,19,64,85,1.2705882352941176,0.05394320930650174,564,This ten owl workday is not what I expected.
552,6,11,68,85,1.2705882352941176,0.06348478565417674,564,I saw a mouse.
552,5,13,67,85,1.2705882352941176,0.06123892524153929,564,"There's no easy way to ask this, Donna, but I've received reports that you're using psychedelic drugs at work. Is there any truth to these allegations?"
552,8,7,70,85,1.2705882352941176,0.0677535393849843,564,May I tempt you with one?
552,6,11,68,85,1.2705882352941176,0.06348478565417674,564,"We've decided, Mrs. Carlisle. We'll have one Chicken Caesar and nine live mice."
552,5,13,67,85,1.2705882352941176,0.06123892524153929,564,Now who's the wise guy?
552,3,17,65,85,1.2705882352941176,0.05647992453166862,564,Let me rephrase that: Whom are you looking for?
552,4,15,66,85,1.2705882352941176,0.05890750308679626,564,"It's 'WHO', not 'WHOM'!"
552,5,13,67,85,1.2705882352941176,0.06123892524153929,564,"For the last time, Martha, stop staring at my hooters."
552,6,11,68,85,1.2705882352941176,0.06348478565417674,564,"I don't give a hoot, you're fired."
552,4,15,66,85,1.2705882352941176,0.05890750308679626,564,"When we need you, Estelle, we'll hoot."
552,6,11,68,85,1.2705882352941176,0.06348478565417674,564,They really do help keep small rodents from cluttering my desk.
552,7,9,69,85,1.2705882352941176,0.06565386549453651,564,"They are weary, Ms. Jenson, of your inappropriate use of ""whom."""
552,5,13,67,85,1.2705882352941176,0.06123892524153929,564,They were the only ones who would work the night shift.
552,3,17,65,85,1.2705882352941176,0.05647992453166862,564,The Hoot is mightier than the Tweet.
552,4,15,66,85,1.2705882352941176,0.05890750308679626,564,"Frankly, Susan, I don't give a hoot."
552,5,13,67,85,1.2705882352941176,0.06123892524153929,564,I wanted a reservation for nine at Hooters.
552,5,13,67,85,1.2705882352941176,0.06123892524153929,564,They're the night shift.
552,5,13,67,85,1.2705882352941176,0.06123892524153929,564,We're outsourcing wisdom.
552,3,17,65,85,1.2705882352941176,0.05647992453166862,564,"Sorry, whom."
552,6,11,68,85,1.2705882352941176,0.06348478565417674,564,"...because at Hoot, Beak, and Clawamouse we have traditions, Alice."
552,5,13,67,85,1.2705882352941176,0.06123892524153929,564,"Frankly, I don't really give a hoot. And neither do they."
552,6,11,68,85,1.2705882352941176,0.06348478565417674,564,More airmail from Hogwarts?
552,7,9,69,85,1.2705882352941176,0.06565386549453651,564,"Apparently, Hogwarts won't take 'No' as an answer."
552,7,9,69,85,1.2705882352941176,0.06565386549453651,564,Because pigeons would be nonsensical.
552,2,19,64,85,1.2705882352941176,0.05394320930650174,564,I'm teaching them to say whom.
578,5,12,66,83,1.2650602409638554,0.0620075956534203,564,Think of it as a rustic surveillance system. I saw them at the EPA liquidation sale and couldn't resist.
578,4,14,65,83,1.2650602409638554,0.0595909687658098,564,Don't you think they make me look wiser?
578,6,10,67,83,1.2650602409638554,0.06433350821297108,564,They want to know who.
578,4,14,65,83,1.2650602409638554,0.0595909687658098,564,I'm just going to have to keep interviewing until I find the right one.
582,8,3,61,72,1.2638888888888888,0.07658869160745754,564,I never meet alone with a woman who is not my wife.
583,6,8,63,77,1.2597402597402598,0.06767952860963261,564,All you did was go from an ass to a wise ass.
584,8,5,68,81,1.2592592592592593,0.06978312474598804,564,We have them in training for the Supreme Court.
584,6,9,66,81,1.2592592592592593,0.06521043282095929,564,I really need to get off of the Hogwart's mailing list.
584,3,15,63,81,1.2592592592592593,0.057675598157027524,564,The night staff has some demands.
584,2,17,62,81,1.2592592592592593,0.054934803608116006,564,"Corporate's ""organic"" solution to our mouse problem..."
584,5,11,65,81,1.2592592592592593,0.06279935169560431,564,"So you see, it was perfectly innocent when I asked to see your hooters."
584,5,11,65,81,1.2592592592592593,0.06279935169560431,564,"""Buy Hooters"" meant shares in the restaurant."
584,5,11,65,81,1.2592592592592593,0.06279935169560431,564,"Yes, but have you ever seen any mice around here?"
584,2,17,62,81,1.2592592592592593,0.054934803608116006,564,Their union wants the night shift.
584,3,15,63,81,1.2592592592592593,0.057675598157027524,564,"They're protected, but you're fired."
584,4,13,64,81,1.2592592592592593,0.0602919281337026,564,I said we need more TOWELS!
584,4,13,64,81,1.2592592592592593,0.0602919281337026,564,We're looking for someone who gives a hoot.
584,5,11,65,81,1.2592592592592593,0.06279935169560431,564,I'm their consigliere.
584,5,11,65,81,1.2592592592592593,0.06279935169560431,564,"Nine?!"" I told you, ""Night Owls are needed to fill the position."
584,3,15,63,81,1.2592592592592593,0.057675598157027524,564,"Three more, and I can retire."
584,6,9,66,81,1.2592592592592593,0.06521043282095929,564,"I said Nice Hooters, Not Nine Hooters."
584,4,13,64,81,1.2592592592592593,0.0602919281337026,564,"Well, I think we can all agree--never order new company towels using a cell phone."
584,5,11,65,81,1.2592592592592593,0.06279935169560431,564,"Who's Who in the office now, Ms. Jenkins?"
601,3,10,49,62,1.2580645161290323,0.06874059282197471,564,"sir, someone from endangered species act is here"
602,5,10,64,79,1.2531645569620253,0.06361488119538797,564,"It's called a ""Parliament,"" Sheila. Frankly, I'm surprised you don't know that by now."
602,5,10,64,79,1.2531645569620253,0.06361488119538797,564,This represents our collective wisdom
602,6,8,65,79,1.2531645569620253,0.06611673807990255,564,"Frankly sir, I just don't give a hoot."
602,6,8,65,79,1.2531645569620253,0.06611673807990255,564,"Yes Ms. Crimshack, please stop the ad we ran for a Night Owl."
602,4,12,63,79,1.2531645569620253,0.0610105168366915,564,"Because I give a hoot, Miss Pinkley. That's why."
602,5,10,64,79,1.2531645569620253,0.06361488119538797,564,I said I wanted nine towels.
602,4,12,63,79,1.2531645569620253,0.0610105168366915,564,"Now, more than ever Ms. Jones, we must give a hoot."
602,5,10,64,79,1.2531645569620253,0.06361488119538797,564,"I'm still a man, Marjorie. But now I'm a man with hooters."
602,5,10,64,79,1.2531645569620253,0.06361488119538797,564,Because nine was all they had.
602,3,14,62,79,1.2531645569620253,0.05828990667222849,564,It's whom.
602,3,14,62,79,1.2531645569620253,0.05828990667222849,564,I really do give a hoot.
602,4,12,63,79,1.2531645569620253,0.0610105168366915,564,You know very well where we want to eat.
602,2,16,61,79,1.2531645569620253,0.05543593847887846,564,Do I look any smarter?
602,5,10,64,79,1.2531645569620253,0.06361488119538797,564,"Irene, the client owed us nine hours."
602,6,8,65,79,1.2531645569620253,0.06611673807990255,564,"I think you've got the Whos covered, but you are a little short on What, When, Where, Why and How."
602,2,16,61,79,1.2531645569620253,0.05543593847887846,564,"So, should I cancel the exterminator?"
602,0,20,59,79,1.2531645569620253,0.04923416888084716,564,"it's not who, it's WHOM."
602,4,12,63,79,1.2531645569620253,0.0610105168366915,564,I need you to handle my correspondence with Hogwarts
602,5,10,64,79,1.2531645569620253,0.06361488119538797,564,Meet the nightshift.
602,4,12,63,79,1.2531645569620253,0.0610105168366915,564,The boys would like a few more mice on today's pizza.
602,1,18,60,79,1.2531645569620253,0.05242683788109758,564,Who knows?
602,3,14,62,79,1.2531645569620253,0.05828990667222849,564,Change the memo from smart ass to wise guy
602,3,14,62,79,1.2531645569620253,0.05828990667222849,564,"On the contrary, Ms. Johnson; as you can see, I actually give several hoots."
602,5,10,64,79,1.2531645569620253,0.06361488119538797,564,"Please show them around, they start tonight."
602,4,12,63,79,1.2531645569620253,0.0610105168366915,564,HR said to stop hiring owly employees........and my mouse is missing again.
602,3,14,62,79,1.2531645569620253,0.05828990667222849,564,"Have you decided on a title for your new movie, Mr. Hitchcock?"
602,2,16,61,79,1.2531645569620253,0.05543593847887846,564,"It's not ""Who did you call?"" its ""Whom did you call?"""
602,6,8,65,79,1.2531645569620253,0.06611673807990255,564,What owls?
602,6,8,65,79,1.2531645569620253,0.06611673807990255,564,I'm not questioning their wisdom; I'm questioning your sanity.
602,5,10,64,79,1.2531645569620253,0.06361488119538797,564,We ascribe to conventional wisdom.
602,5,10,64,79,1.2531645569620253,0.06361488119538797,564,They work nights.
602,3,14,62,79,1.2531645569620253,0.05828990667222849,564,"What I said, Miss Hotchkiss, was that I'll need nine solid HOURS for the Acme project."
602,4,12,63,79,1.2531645569620253,0.0610105168366915,564,I think we've got the third shift covered.
602,3,14,62,79,1.2531645569620253,0.05828990667222849,564,I said towels.
602,5,10,64,79,1.2531645569620253,0.06361488119538797,564,"Sharon, I'd like you to meet our legal team."
602,5,10,64,79,1.2531645569620253,0.06361488119538797,564,"My daughter isn't selling cookies this year, but I know I can count on your continued support."
602,7,6,66,79,1.2531645569620253,0.06852731571533752,564,Of course they're stuffed. Who would keep nine live barred owls on his desk?
602,2,16,61,79,1.2531645569620253,0.05543593847887846,564,Don't you mean whom?
602,4,12,63,79,1.2531645569620253,0.0610105168366915,564,Just pick the one that looks most familiar.
602,6,8,65,79,1.2531645569620253,0.06611673807990255,564,"Ms. Sturpitz, can you have General Services find some black robes for our new Supreme Court?"
602,4,12,63,79,1.2531645569620253,0.0610105168366915,564,Miss Rowling is on hold again sir. She wants to know if you received her letters.
602,5,10,64,79,1.2531645569620253,0.06361488119538797,564,It's all Betsy DeVos's idea. She figures we won't need as many teachers.
602,3,14,62,79,1.2531645569620253,0.05828990667222849,564,Pulling another owl-nighter?
602,3,14,62,79,1.2531645569620253,0.05828990667222849,564,I'm just saying you're the only one here who doesn't give a hoot.
602,4,12,63,79,1.2531645569620253,0.0610105168366915,564,They're my eyes in ears in the field.
602,4,12,63,79,1.2531645569620253,0.0610105168366915,564,Yes. I am the head of this parliament!
602,3,14,62,79,1.2531645569620253,0.05828990667222849,564,Our night shift is particularly well staffed
602,4,12,63,79,1.2531645569620253,0.0610105168366915,564,You had fewer owls in your profile pic.
650,2,15,59,76,1.25,0.056584047097789955,564,I don't think any of us will come out any the wiser.
650,1,17,58,76,1.25,0.05339360629309896,564,I think we're all a little wiser now.
650,1,17,58,76,1.25,0.05339360629309896,564,"I'm going through another Harry Potter phase. --Willa Ross, Age 11, Santa Monica, CA"
650,3,13,60,76,1.25,0.05960395606792697,564,"First, I'd like to address the elephant in the room."
650,4,11,61,76,1.25,0.06247806632675042,564,"I don't care if the proper term is ""parliament of owls,"" Mrs. Munson. To me, they're just a bunch of owls, and I want them off my desk."
650,5,9,62,76,1.25,0.0652256541930572,564,Winged monkeys were too expensive.
650,4,11,61,76,1.25,0.06247806632675042,564,Tell the help desk I need another mouse.
650,4,11,61,76,1.25,0.06247806632675042,564,I'll have a roast beef on rye for lunch and our new board of directors would like nine plump mice.
650,4,11,61,76,1.25,0.06247806632675042,564,I received more spam from Hogwarts.
650,3,13,60,76,1.25,0.05960395606792697,564,Our mice problem is solved. Now we need to find a hawk.
650,4,11,61,76,1.25,0.06247806632675042,564,"Pastrami on rye, Miss Gordon. And a side of nine small rodents, live."
650,5,9,62,76,1.25,0.0652256541930572,564,Would you think I was sweet on you if I offered you one?
650,4,11,61,76,1.25,0.06247806632675042,564,"I was very satisfied with 8 owls, but you just had to get the ninth, didn't you?"
650,5,9,62,76,1.25,0.0652256541930572,564,"You didn't know that it's ""Take Your Owls to Work Day?"""
650,4,11,61,76,1.25,0.06247806632675042,564,"Because they do give a Hoot, Cynthia."
650,3,13,60,76,1.25,0.05960395606792697,564,Because it avoids the whole hacking problem. That's why.
650,4,11,61,76,1.25,0.06247806632675042,564,"Sir, the courier pigeons are not gonna like this. They will never come back."
650,5,9,62,76,1.25,0.0652256541930572,564,Give me an example of a time you had difficulties with a co-worker
650,4,11,61,76,1.25,0.06247806632675042,564,They said I wasn't wise enough for the job.
650,5,9,62,76,1.25,0.0652256541930572,564,And how is your night vision?
650,5,9,62,76,1.25,0.0652256541930572,564,what's next Mr. Hootie...a blowfish?
650,4,11,61,76,1.25,0.06247806632675042,564,"No, Who is on line one."
650,4,11,61,76,1.25,0.06247806632675042,564,I understand one of you has requested a transfer to the day shift.
650,1,17,58,76,1.25,0.05339360629309896,564,I'm going to need more mice
650,4,11,61,76,1.25,0.06247806632675042,564,Just when nobody thought you gave a hoot.
650,2,15,59,76,1.25,0.056584047097789955,564,"Don't blink, Miss Hitchcock. They hate that."
650,4,11,61,76,1.25,0.06247806632675042,564,"C'mon, I showed you my hooters; you show me yours."
650,3,13,60,76,1.25,0.05960395606792697,564,They were the only nine we could get confirmed
650,4,11,61,76,1.25,0.06247806632675042,564,"Now, get a herd of goats. Then we'll be ready for the office Hootenanny."
650,4,11,61,76,1.25,0.06247806632675042,564,Send in the mice.
650,3,13,60,76,1.25,0.05960395606792697,564,"They're real, and they're magnificent."
650,3,13,60,76,1.25,0.05960395606792697,564,People are starting to say we're in cahoots.
650,4,11,61,76,1.25,0.06247806632675042,564,These are service owls....I have bad night vision.
650,5,9,62,76,1.25,0.0652256541930572,564,"I'm sorry, we're short two Pussy-cats for Friday's Dance by the Light of the Moon"
650,5,9,62,76,1.25,0.0652256541930572,564,Owligarchy
650,4,11,61,76,1.25,0.06247806632675042,564,No one gives a hoot about your tweets.
650,3,13,60,76,1.25,0.05960395606792697,564,Nice hooters.
650,2,15,59,76,1.25,0.056584047097789955,564,You screeched?
650,5,9,62,76,1.25,0.0652256541930572,564,Stop looking at my hooters.
650,6,6,60,72,1.25,0.07062763560249007,564,They were out of penguins.
650,4,11,61,76,1.25,0.06247806632675042,564,"I've been told I need to give a hoot, so take one."
650,3,13,60,76,1.25,0.05960395606792697,564,"I ordered a Gaggle of Geese, and they sent me an Osculant of Owls."
650,4,11,61,76,1.25,0.06247806632675042,564,I don't think the memo regarding the supreme court justices being nocturnal at their desks implied anything to do with hooters....
650,2,15,59,76,1.25,0.056584047097789955,564,The wise have it.
650,4,11,61,76,1.25,0.06247806632675042,564,"You don't see any pigeons, do you?"
650,4,11,61,76,1.25,0.06247806632675042,564,Who says I don't give a hoot?
650,5,9,62,76,1.25,0.0652256541930572,564,It's a feng shui thing.
650,4,11,61,76,1.25,0.06247806632675042,564,Are you in the middle of anything?
650,2,15,59,76,1.25,0.056584047097789955,564,The President picks his advisors; I pick mine!
650,3,13,60,76,1.25,0.05960395606792697,564,"The CEO sent them with a note: ""Wise Up"""
650,3,13,60,76,1.25,0.05960395606792697,564,They seem interested in what I say.
650,3,13,60,76,1.25,0.05960395606792697,564,"Sir, I'm sorry, but I don't know which one is Hedwig."
650,3,13,60,76,1.25,0.05960395606792697,564,"Professor McGonagall has been trying all day to get a hold of you, sir."
650,3,13,60,76,1.25,0.05960395606792697,564,I know one of you stole my mouse.
650,3,13,60,76,1.25,0.05960395606792697,564,I thought I was applying to Who’s Who.
650,1,17,58,76,1.25,0.05339360629309896,564,The mice cancelled their appointment.
706,0,18,56,74,1.2432432432432432,0.05021542194205399,564,That will be enough wisdom for today Delores.
706,1,16,57,74,1.2432432432432432,0.05377566222524919,564,"That's ""To whom ..."""
706,5,8,61,74,1.2432432432432432,0.06612680875066024,564,"Frankly, Ms Jones, I give a hoot!"
706,6,6,62,74,1.2432432432432432,0.06886935517697237,564,I think you are being duped; these are not the justices of the Supreme Court.
706,1,16,57,74,1.2432432432432432,0.05377566222524919,564,They cost less than drones and they can make deliveries at night.
706,3,12,59,74,1.2432432432432432,0.06026846888427848,564,The website advertised natural rodent control.
706,7,4,63,74,1.2432432432432432,0.07150679219093489,564,"It's a working lunch, Miss Jenkins. Bring us the field mouse menu."
706,3,12,59,74,1.2432432432432432,0.06026846888427848,564,We've got a real who's who on the board this year.
706,2,14,58,74,1.2432432432432432,0.057114403566085395,564,"I keep telling them it’s ‘To whom it may concern’, but they just won’t listen."
706,4,10,60,74,1.2432432432432432,0.06326548497088139,564,"It's not 'who' madame, it's 'whom'."
706,3,12,59,74,1.2432432432432432,0.06026846888427848,564,"While your point is valid, neither me nor my colleagues give a hoot."
706,3,12,59,74,1.2432432432432432,0.06026846888427848,564,I seem to have displaced my mouse.
706,3,12,59,74,1.2432432432432432,0.06026846888427848,564,Sir...your wife is on line one...she has a question about the credit card bill.
706,4,10,60,74,1.2432432432432432,0.06326548497088139,564,The email server is down again.
706,4,10,60,74,1.2432432432432432,0.06326548497088139,564,"Do not ask for whom the owls hoot, Doris, you know damn well they hoot for thee."
706,4,10,60,74,1.2432432432432432,0.06326548497088139,564,"I don't care how many invitations they send, Janet. I'm not going to the Hogwarts reunion."
706,4,10,60,74,1.2432432432432432,0.06326548497088139,564,Nice set of hooters.
706,5,8,61,74,1.2432432432432432,0.06612680875066024,564,I smell it too. One of them must have had an owl movement!
706,2,14,58,74,1.2432432432432432,0.057114403566085395,564,I think we've overreacted to our mouse problem.
706,4,10,60,74,1.2432432432432432,0.06326548497088139,564,Temple University class of '62.
706,5,8,61,74,1.2432432432432432,0.06612680875066024,564,"No no, I distinctly said ""moist towelettes"""
706,3,12,59,74,1.2432432432432432,0.06026846888427848,564,Go ahead -- ask me anything.
706,3,12,59,74,1.2432432432432432,0.06026846888427848,564,I had no idea this job would be such a hoot.
706,5,8,61,74,1.2432432432432432,0.06612680875066024,564,"This is not what I meant when I said ""Show me your hooters."""
706,4,10,60,74,1.2432432432432432,0.06326548497088139,564,I said a bunch of moist towelettes!
706,5,8,61,74,1.2432432432432432,0.06612680875066024,564,"Don't ask questions, Miss Jenkins- just get me the Tootsie Roll Pops."
706,2,14,58,74,1.2432432432432432,0.057114403566085395,564,Get Dumbledore on line one please.
706,4,10,60,74,1.2432432432432432,0.06326548497088139,564,All my ducks in a row didn't work.
706,2,14,58,74,1.2432432432432432,0.057114403566085395,564,"Who?” “Who?” “Who?” “Who?” “Who?” “Who?” “Who?” “Who?” “Who?” ""What?"
706,2,14,58,74,1.2432432432432432,0.057114403566085395,564,Who indeed.
706,5,8,61,74,1.2432432432432432,0.06612680875066024,564,"They keep the pigeons off my desk, why you ask?"
706,2,14,58,74,1.2432432432432432,0.057114403566085395,564,My HR team and I have narrowed the application process down to only one question.
706,0,18,56,74,1.2432432432432432,0.05021542194205399,564,"Knock knock."" ""Who's there?"" ""Precisely."
706,3,12,59,74,1.2432432432432432,0.06026846888427848,564,"Quite frankly my dear, I don't give a hoot."
706,4,10,60,74,1.2432432432432432,0.06326548497088139,564,"One tuna fish sandwich and nine mice, please."
706,3,12,59,74,1.2432432432432432,0.06026846888427848,564,The HR handbook doesn't say anything about hooters in my office.
706,4,10,60,74,1.2432432432432432,0.06326548497088139,564,Surrounding yourself with wisdom?
706,2,14,58,74,1.2432432432432432,0.057114403566085395,564,"As you can see, Mrs. Snodgrass, our rodent problem is well in hand."
706,3,12,59,74,1.2432432432432432,0.06026846888427848,564,"Diane, when you asked if I wanted to see your hooters, I may have misunderstood."
706,4,10,60,74,1.2432432432432432,0.06326548497088139,564,They were all out of mouse traps
706,3,12,59,74,1.2432432432432432,0.06026846888427848,564,I don't give a hoot what they told you!
706,3,12,59,74,1.2432432432432432,0.06026846888427848,564,Cancel my 2 a.m. meeting.
706,2,14,58,74,1.2432432432432432,0.057114403566085395,564,I've chosen the nuclear option on our mouse problem
706,6,6,62,74,1.2432432432432432,0.06886935517697237,564,"What, when and where are on the second floor."
706,3,12,59,74,1.2432432432432432,0.06026846888427848,564,"Because it's not what you know, but whoo."
706,3,12,59,74,1.2432432432432432,0.06026846888427848,564,"I assure you, I most certainly give a hoot."
706,1,16,57,74,1.2432432432432432,0.05377566222524919,564,"I can't seem to find my mouse, any idea where it went?"
706,3,12,59,74,1.2432432432432432,0.06026846888427848,564,"Look, I solved our mouse problem, and then I solved our cat problem. At this point, I think you just like having something to complain about."
706,2,14,58,74,1.2432432432432432,0.057114403566085395,564,They give me any more crap and I'm outta here.
706,6,6,62,74,1.2432432432432432,0.06886935517697237,564,"Despite appearances, I really couldn't give a hoot about whatever it is you're here to tell me."
706,4,10,60,74,1.2432432432432432,0.06326548497088139,564,"I've already answered, ""Who."" What matters is, ""Why."""
706,3,12,59,74,1.2432432432432432,0.06026846888427848,564,"Frankly my dear, we just don't give a hoot."
706,2,14,58,74,1.2432432432432432,0.057114403566085395,564,Have you seen my computer mouse?
706,3,12,59,74,1.2432432432432432,0.06026846888427848,564,"Don't see them as owls Jan, see them as an opportunity."
706,4,10,60,74,1.2432432432432432,0.06326548497088139,564,Less wisdom than I expected and way more wiping.
706,3,12,59,74,1.2432432432432432,0.06026846888427848,564,That pellet could have come from anyone.
706,5,8,61,74,1.2432432432432432,0.06612680875066024,564,Does this mean I have to pull another all-nighter?
706,4,10,60,74,1.2432432432432432,0.06326548497088139,564,"When I said this was odd, I wasn't referring to the number of owls."
706,5,8,61,74,1.2432432432432432,0.06612680875066024,564,It turns heads.
706,3,12,59,74,1.2432432432432432,0.06026846888427848,564,They don't give a hoot
706,3,12,59,74,1.2432432432432432,0.06026846888427848,564,I thought I was buying a vowel.
706,4,10,60,74,1.2432432432432432,0.06326548497088139,564,"Yes, those glasses make you look very smart."
706,2,14,58,74,1.2432432432432432,0.057114403566085395,564,What happened to the bald eagles?
706,2,14,58,74,1.2432432432432432,0.057114403566085395,564,"'Sir, shall I give the eagles tomorrow morning off?'"
706,3,12,59,74,1.2432432432432432,0.06026846888427848,564,I want those Hogwarts acceptance letters to go out today.
771,4,10,61,75,1.24,0.06250045044882722,564,Because _ten_ owls would be ridiculous.
771,4,10,61,75,1.24,0.06250045044882722,564,Of course I'm wearing pants. Why do you ask?
771,5,8,62,75,1.24,0.06531972647421809,564,Athens rejected your offer.
771,5,8,62,75,1.24,0.06531972647421809,564,"It's not you, it's me"
771,2,14,59,75,1.24,0.0564409920676948,564,They were on sale.
771,5,8,62,75,1.24,0.06531972647421809,564,I really need to get off of the Hogwart's mailing list.
771,3,12,60,75,1.24,0.059547845854790976,564,"No, Miss McFadden, I said I needed nine medium-sized TOWELS for the workshop attendees."
771,4,10,61,75,1.24,0.06250045044882722,564,I'll match my team of advisors against his any day.
771,3,12,60,75,1.24,0.059547845854790976,564,The board told me I'd better wise up.
771,0,18,57,75,1.24,0.049647405419265024,564,"It's according to ""WHOM"""
771,3,12,60,75,1.24,0.059547845854790976,564,You are correct. The newest one definitely leans to the right.
771,4,10,61,75,1.24,0.06250045044882722,564,We're all working late tonight.
771,3,12,60,75,1.24,0.059547845854790976,564,One more and we have enough for a meme.
771,4,10,61,75,1.24,0.06250045044882722,564,Apparently wiser heads have prevailed.
771,3,12,60,75,1.24,0.059547845854790976,564,"A word to the wise, Miss Johnson."
771,2,14,59,75,1.24,0.0564409920676948,564,"Still waiting on some new ideas, but our mice problem has been resolved."
771,2,14,59,75,1.24,0.0564409920676948,564,Nice tie.
771,1,16,58,75,1.24,0.05315284776213995,564,"Joanne, have you seen my mouse anywhere?"
771,3,12,60,75,1.24,0.059547845854790976,564,It's a special: Buy one get Eight free!
771,1,16,58,75,1.24,0.05315284776213995,564,Cleverly asking me 'who's who' will make for a long day around here.
771,5,8,62,75,1.24,0.06531972647421809,564,Has the council of elders reached a consensus on what it would like for lunch today?
771,5,8,62,75,1.24,0.06531972647421809,564,"""No, he's on first""!"
771,2,14,59,75,1.24,0.0564409920676948,564,"They were buy 1, get 8 free."
771,2,14,59,75,1.24,0.0564409920676948,564,Three dozen mice and a corned beef on rye.
771,7,4,64,75,1.24,0.07062143716597241,564,"Ma'am, I'm sorry. The court has ruled and they just don't give a hoot about your problem"
771,5,8,62,75,1.24,0.06531972647421809,564,Who is on the phone.
771,4,10,61,75,1.24,0.06250045044882722,564,Do you have a word to the wise?
771,1,16,58,75,1.24,0.05315284776213995,564,"Due to budget cuts, we've merged the ornithology and library science departments."
771,4,10,61,75,1.24,0.06250045044882722,564,"But sir, the security cameras also rotate 360 degrees and have nocturnal vision and they won't dive-bomb at the lobby fish tank."
771,5,8,62,75,1.24,0.06531972647421809,564,They're cheaper than interns.
771,3,12,60,75,1.24,0.059547845854790976,564,I'm being spammed by JK Rowling
771,5,8,62,75,1.24,0.06531972647421809,564,"Ok, WHO said WHAT?"
803,3,8,48,59,1.2372881355932204,0.06981223481771649,564,"Finally, I've found someone who gives a hoot."
804,3,11,58,72,1.2361111111111112,0.0609428256247713,564,"In fact, I did stop at Costco on the way home yesterday."
804,2,13,57,72,1.2361111111111112,0.05764366130288757,564,"Yes, we know who, but why?"
804,4,9,59,72,1.2361111111111112,0.06407233647886229,564,The good news is we no longer have a mouse problem...
804,7,3,62,72,1.2361111111111112,0.07265654287157035,564,And I find your mousiness unprofessional.
804,4,9,59,72,1.2361111111111112,0.06407233647886229,564,No...What I said was that I wanted to meet with our hourly workers.
804,4,9,59,72,1.2361111111111112,0.06407233647886229,564,This our weirdest paternity suit yet.
804,3,11,58,72,1.2361111111111112,0.0609428256247713,564,Choose wisely
804,2,13,57,72,1.2361111111111112,0.05764366130288757,564,Says Who?
804,4,9,59,72,1.2361111111111112,0.06407233647886229,564,They were on sale.
804,4,9,59,72,1.2361111111111112,0.06407233647886229,564,They're smarter than carrier pigeons and they'll work all night.
804,2,13,57,72,1.2361111111111112,0.05764366130288757,564,Would you like to buy a owl?
804,2,13,57,72,1.2361111111111112,0.05764366130288757,564,"No, I'm not Lou Costello and I don't know whose on first!"
804,2,13,57,72,1.2361111111111112,0.05764366130288757,564,IN TODAY'S WORLD AN MBA IS NOT ENOUGH.
817,4,8,57,69,1.2318840579710144,0.06575979804152392,564,No one can say you don't give a hoot Mr. Johnson!
817,4,8,57,69,1.2318840579710144,0.06575979804152392,564,They're my Cabinet.
817,2,12,55,69,1.2318840579710144,0.05892228881714398,564,This is not what I meant when I said I was hoping to judge a Hooters contest!
817,4,8,57,69,1.2318840579710144,0.06575979804152392,564,They're my eyes around the office.
817,4,8,57,69,1.2318840579710144,0.06575979804152392,564,Thank you for not mentioning my irritable owl syndrome.
817,0,16,53,69,1.2318840579710144,0.05117930441535766,564,I said we could use some more TOWELS around here . . .
817,0,16,53,69,1.2318840579710144,0.05117930441535766,564,It's a computer mouse I needed help finding.
817,3,10,56,69,1.2318840579710144,0.06243471453411533,564,"Well, because nine is a perfect square and they do that cute thing with their heads."
817,3,10,56,69,1.2318840579710144,0.06243471453411533,564,I wanted to raise our level of cuteness while maintaining a certain degree of creepiness.
817,0,16,53,69,1.2318840579710144,0.05117930441535766,564,They make horrible assistants but our mice problem is gone.
817,4,8,57,69,1.2318840579710144,0.06575979804152392,564,The secret is not to give a hoot.
817,3,10,56,69,1.2318840579710144,0.06243471453411533,564,"Order me a tuna on rye, nine small rodents and a chocolate rugelach."
817,3,10,56,69,1.2318840579710144,0.06243471453411533,564,Look at all the hoots I don't give!
817,1,14,54,69,1.2318840579710144,0.05518676163669498,564,"I assure you, they're not hooting at you in that way."
817,4,8,57,69,1.2318840579710144,0.06575979804152392,564,"We all have tickets to see ""The Who""."
817,3,10,56,69,1.2318840579710144,0.06243471453411533,564,It's unanimous. We'll have mice for lunch.
817,4,8,57,69,1.2318840579710144,0.06575979804152392,564,I'm not cleaning up after this.
817,5,6,58,69,1.2318840579710144,0.06892465812731721,564,Like my hooters?
817,2,12,55,69,1.2318840579710144,0.05892228881714398,564,"'Have you seen my other owl, Miss Grimly?"""
817,1,14,54,69,1.2318840579710144,0.05518676163669498,564,"Dorothy, I believe I asked you to order the #9 from Al's."
817,3,10,56,69,1.2318840579710144,0.06243471453411533,564,"Since you're allergic to cats, I brought these guys in to handle the mice problem."
817,4,8,57,69,1.2318840579710144,0.06575979804152392,564,but I'm sure I ordered towels
817,4,8,57,69,1.2318840579710144,0.06575979804152392,564,All we want to know is who did this Who ? Who?
817,2,12,55,69,1.2318840579710144,0.05892228881714398,564,Correction: we had a rodent problem
817,4,8,57,69,1.2318840579710144,0.06575979804152392,564,I seem to be missing an owl.
817,1,14,54,69,1.2318840579710144,0.05518676163669498,564,I'm not cleaning your desk.
817,3,10,56,69,1.2318840579710144,0.06243471453411533,564,"A table AT Hooters, Miss Simpson."
817,2,12,55,69,1.2318840579710144,0.05892228881714398,564,"It's 'WHO', not 'WHOM'!"
817,3,10,56,69,1.2318840579710144,0.06243471453411533,564,I think I've solved our mice problem.
817,4,8,57,69,1.2318840579710144,0.06575979804152392,564,And please see that all of our Hogwarts interns are set up on email as soon as possible.
817,4,8,57,69,1.2318840579710144,0.06575979804152392,564,"Ironically, I'm more concerned with why someone left these owls here."
817,2,12,55,69,1.2318840579710144,0.05892228881714398,564,"Once we clarify ""who"" and ""whom,"" we'll take on the Oxford comma."
817,4,8,57,69,1.2318840579710144,0.06575979804152392,564,That moment when you start feeling better about yourself and the 5 cats you have at home.
817,1,14,54,69,1.2318840579710144,0.05518676163669498,564,"I believe you mean ""whom."""
817,2,12,55,69,1.2318840579710144,0.05892228881714398,564,One pastrami on rye. And nine field mice.
817,5,6,58,69,1.2318840579710144,0.06892465812731721,564,"Actually, they don't give a hoot what you think."
817,3,10,56,69,1.2318840579710144,0.06243471453411533,564,I see you've met the new call center team.
817,3,10,56,69,1.2318840579710144,0.06243471453411533,564,They're filing a class action lawsuit against the new EPA administration.
817,4,8,57,69,1.2318840579710144,0.06575979804152392,564,Who's the boss.
817,2,12,55,69,1.2318840579710144,0.05892228881714398,564,"This firm will no longer concern itself with 'what, where, when, and why?'"
817,2,12,55,69,1.2318840579710144,0.05892228881714398,564,I guess you could say I don't give a hoot.
817,2,12,55,69,1.2318840579710144,0.05892228881714398,564,"Miss Smith, I'd like you to go out for nine dead mice for my guests and a prune Danish and coffee for me."
817,5,6,58,69,1.2318840579710144,0.06892465812731721,564,"I don't give a hoot, after a year, we finally have 9 on the bench again."
817,0,16,53,69,1.2318840579710144,0.05117930441535766,564,Don't you mean whom?
817,2,12,55,69,1.2318840579710144,0.05892228881714398,564,They have a problem with the new swivel chairs.
817,3,10,56,69,1.2318840579710144,0.06243471453411533,564,Please bring me a box of mice...and then stand back.
817,6,4,59,69,1.2318840579710144,0.0719504409817834,564,"Wait, better make that one tuna on rye and three of the small prey and rodent samplers."
817,2,12,55,69,1.2318840579710144,0.05892228881714398,564,Welcome to the night shift!
817,3,10,56,69,1.2318840579710144,0.06243471453411533,564,"I wanted penguins, but they ran out of them."
817,1,14,54,69,1.2318840579710144,0.05518676163669498,564,"Bob, my mouse is missing from my desk."
817,2,12,55,69,1.2318840579710144,0.05892228881714398,564,"Okay, which hoot would you like me to give?"
817,3,10,56,69,1.2318840579710144,0.06243471453411533,564,"One can never have too much wisdom, Ms. Jones."
817,3,10,56,69,1.2318840579710144,0.06243471453411533,564,"When I said, 'who gives a hoot,' I didn't mean it literally."
817,4,8,57,69,1.2318840579710144,0.06575979804152392,564,They were the exterminator's idea.
817,4,8,57,69,1.2318840579710144,0.06575979804152392,564,I get my best work done at night.
817,2,12,55,69,1.2318840579710144,0.05892228881714398,564,They're requesting re-assignment to the night shift.
817,4,8,57,69,1.2318840579710144,0.06575979804152392,564,They save me from having to remember anyone's name.
817,2,12,55,69,1.2318840579710144,0.05892228881714398,564,"Madeline, that will be nine tickets to The Who, please."
817,2,12,55,69,1.2318840579710144,0.05892228881714398,564,Those glasses DO make you look smarter.
817,4,8,57,69,1.2318840579710144,0.06575979804152392,564,This large order goes to the White House.
817,3,10,56,69,1.2318840579710144,0.06243471453411533,564,I give a hoot.
817,4,8,57,69,1.2318840579710144,0.06575979804152392,564,It's been two years already... shouldn't you start dating again?
817,3,10,56,69,1.2318840579710144,0.06243471453411533,564,A cup of coffee and nine mice Ms. Stuart.
817,4,8,57,69,1.2318840579710144,0.06575979804152392,564,"Pellets, actually. Much better than seagulls."
817,5,6,58,69,1.2318840579710144,0.06892465812731721,564,We bought the wrong Hooters.
817,2,12,55,69,1.2318840579710144,0.05892228881714398,564,Order in a cob salad and nine dead rats. Thanks.
817,3,10,56,69,1.2318840579710144,0.06243471453411533,564,"around here its not the what, why, when, and where that's important"
884,4,8,58,70,1.2285714285714286,0.06489816380443914,564,They think differently but I insist the proper usage is 'whom.'
884,5,6,59,70,1.2285714285714286,0.06801360408136047,564,They're day owls.
884,1,14,55,70,1.2285714285714286,0.054493445847579626,564,"Actually, it's ""whom""."
884,2,12,56,70,1.2285714285714286,0.05816884316617732,564,It's my new audit team. If its shiny they'll find it.
888,3,9,55,67,1.2238805970149254,0.06316288636259094,564,"Well, if you must ask, the place was overrun with moles and shrews."
888,4,7,56,67,1.2238805970149254,0.06664708731840546,564,They want me to file a cultural appropriation lawsuit against Hooters.
888,2,11,54,67,1.2238805970149254,0.05947492059078339,564,"Have you tried turning them off, then turning them on again?"
888,4,7,56,67,1.2238805970149254,0.06664708731840546,564,We really need to get off the night shift.
888,6,3,58,67,1.2238805970149254,0.07311909679949785,564,"No, I was referring to these hooters."
888,3,9,55,67,1.2238805970149254,0.06316288636259094,564,"Yes, your on-line profile ""works with parliament"" is misleading."
888,1,13,53,67,1.2238805970149254,0.055542615574947524,564,It's mostly night work.
888,2,11,54,67,1.2238805970149254,0.05947492059078339,564,Please don't tell them Who's On First.
888,4,7,56,67,1.2238805970149254,0.06664708731840546,564,We were wondering if something could be done about the lights.
888,1,13,53,67,1.2238805970149254,0.055542615574947524,564,"I already know the who, I need you to tell me the what, where, when, and why."
888,4,7,56,67,1.2238805970149254,0.06664708731840546,564,One ham and cheese and 9 field mice.
888,1,13,53,67,1.2238805970149254,0.055542615574947524,564,"No, I requested nine copies of Howl by Allen Ginsberg"
888,2,11,54,67,1.2238805970149254,0.05947492059078339,564,I'm the token wise guy.
888,5,5,57,67,1.2238805970149254,0.0699579751164994,564,They're applying for political asylum because of the war on knowledge.
888,3,9,55,67,1.2238805970149254,0.06316288636259094,564,I can't help it. I love hooters.
888,0,15,52,67,1.2238805970149254,0.05130982469793496,564,I just hired them for the night shift!
888,3,9,55,67,1.2238805970149254,0.06316288636259094,564,"Oh, just an obscure parliamentary maneuver, that's all."
888,4,7,56,67,1.2238805970149254,0.06664708731840546,564,Why do you keep saying first base?
888,4,7,56,67,1.2238805970149254,0.06664708731840546,564,Try closing the window.
888,2,11,54,67,1.2238805970149254,0.05947492059078339,564,"Right now I'm more focused on what, where, when, and why."
888,3,9,55,67,1.2238805970149254,0.06316288636259094,564,It's a hacker-proof mail system. My kid told me about it. Put one on every desk.
888,2,11,54,67,1.2238805970149254,0.05947492059078339,564,Is it 'who' or 'whom'........ I never really know for sure!
888,3,9,55,67,1.2238805970149254,0.06316288636259094,564,Irritable owl syndrome again? I 'll get your pills.
888,3,9,55,67,1.2238805970149254,0.06316288636259094,564,"Frankly, Ms. Johnson, I don't give a hoot."
888,5,5,57,67,1.2238805970149254,0.0699579751164994,564,"For heavens sake, don't make me ask who."
888,3,9,55,67,1.2238805970149254,0.06316288636259094,564,They are the parliament.
888,3,9,55,67,1.2238805970149254,0.06316288636259094,564,Please take an owl and wait until we call your name.
915,3,9,56,68,1.2205882352941178,0.06231412478072636,564,"It's not my fault that for every 9 owls I make, you only make 7.2."
915,1,13,54,68,1.2205882352941178,0.05481867402299337,564,The new nightguards are cheaper by the dozen.
915,1,13,54,68,1.2205882352941178,0.05481867402299337,564,"1, 2, 3, 4, 5, 6, 7, 8, 9, 10."
915,3,9,56,68,1.2205882352941178,0.06231412478072636,564,"I find it surprising, Ms. Ferguson, that you think saying 'hooters' in an office environment is offensive."
915,2,11,55,68,1.2205882352941178,0.05868618733921613,564,"Well, let me just say that I haven't had a single pigeon land on my desk since I acquired these."
915,4,7,57,68,1.2205882352941178,0.06574216082516834,564,"No, Miss Filbert, I'm pretty sure I asked, ""whom?"""
915,2,11,55,68,1.2205882352941178,0.05868618733921613,564,No appointments after sundown please.
915,4,7,57,68,1.2205882352941178,0.06574216082516834,564,I said we needed nine store outlets.
915,5,5,58,68,1.2205882352941178,0.06900009617918414,564,I thought you wanted Hooters.
915,2,11,55,68,1.2205882352941178,0.05868618733921613,564,"We're all working nights, effective immediately."
915,2,11,55,68,1.2205882352941178,0.05868618733921613,564,"No one wants to work nights anymore, I'm looking at outside talent."
915,4,7,57,68,1.2205882352941178,0.06574216082516834,564,"A NITE owl, not nine owls!"
915,3,9,56,68,1.2205882352941178,0.06231412478072636,564,"If you're going to bring a bag of dead mice to the office, we ask that you bring emough for everyone."
915,2,11,55,68,1.2205882352941178,0.05868618733921613,564,Alright......Who's the wise guy?
915,3,9,56,68,1.2205882352941178,0.06231412478072636,564,Your bosses called to say you'd gone AWOWL
915,2,11,55,68,1.2205882352941178,0.05868618733921613,564,I'm surprised you don't recognize Justice Gorsuch.
915,4,7,57,68,1.2205882352941178,0.06574216082516834,564,When you said you had a meeting with parliament this isn't what we thought.
915,2,11,55,68,1.2205882352941178,0.05868618733921613,564,"Barbara, I said I wanted more ""tweets,"" not ""hoots."""
915,2,11,55,68,1.2205882352941178,0.05868618733921613,564,This is not what I meant by a wise investment.
915,5,5,58,68,1.2205882352941178,0.06900009617918414,564,"Sir, one of those owls ate my mouse."
915,0,15,53,68,1.2205882352941178,0.050656741494739324,564,We'll be pulling an all-nighter.
915,3,9,56,68,1.2205882352941178,0.06231412478072636,564,"Yes, but you don't see any starlings landing on my desk, do you?"
915,1,13,54,68,1.2205882352941178,0.05481867402299337,564,"Whom!?,"" not ""Who?"
915,4,7,57,68,1.2205882352941178,0.06574216082516834,564,Why no one told me our new printer is a 3D printer?
915,1,13,54,68,1.2205882352941178,0.05481867402299337,564,Now my computer's mouse is missing too!
915,1,13,54,68,1.2205882352941178,0.05481867402299337,564,Apple's trademark prevents us from calling it a 'Genius Bar.'
915,3,9,56,68,1.2205882352941178,0.06231412478072636,564,"We're not out of the woods yet, Ms. Meyers"
915,1,13,54,68,1.2205882352941178,0.05481867402299337,564,I'm a bit of a nine owl.
915,1,13,54,68,1.2205882352941178,0.05481867402299337,564,"Tell him we have plenty of whos, but we're completely out of whats, whens, wheres, whys and hows."
915,3,9,56,68,1.2205882352941178,0.06231412478072636,564,Meet the new graveyard shift workers.
915,2,11,55,68,1.2205882352941178,0.05868618733921613,564,Lose the glasses
915,3,9,56,68,1.2205882352941178,0.06231412478072636,564,Pidgeon problem solved.
947,3,9,57,69,1.2173913043478262,0.061487546190134565,564,I'm an unofficial member of the parliament.
947,2,11,56,69,1.2173913043478262,0.057917707801486674,564,#OWLLIVESMATTER
947,3,9,57,69,1.2173913043478262,0.061487546190134565,564,Do these owls make me look Wise?
947,2,11,56,69,1.2173913043478262,0.057917707801486674,564,"Miss Greeley, tell the lab rat's union's representative that I'm ready to discuss their working conditions complaints."
947,2,11,56,69,1.2173913043478262,0.057917707801486674,564,"Come for lunch with us Ms Haversham, It'll be a hoot!"
947,5,5,59,69,1.2173913043478262,0.06806785772664668,564,They needed me for a minyan.
947,2,11,56,69,1.2173913043478262,0.057917707801486674,564,"I told you not to turn on the lights when you entered, Mrs. Jeffries."
954,3,8,54,65,1.2153846153846153,0.06389710663783134,564,"One question at a time, please."
954,2,10,53,65,1.2153846153846153,0.06001725590125859,564,"Take an owl , Miss Jones"
954,3,8,54,65,1.2153846153846153,0.06389710663783134,564,There's Danish and a box of mice in the conference room.
954,1,12,52,65,1.2153846153846153,0.05586861171666903,564,Not 'who.' Whom.
954,3,8,54,65,1.2153846153846153,0.06389710663783134,564,It's bring your owls to work day.
954,1,12,52,65,1.2153846153846153,0.05586861171666903,564,They volunteered to help me with my all-nighter.
954,4,6,55,65,1.2153846153846153,0.06755449257788575,564,They call me the who's-who of Accounts Payable.
954,2,10,53,65,1.2153846153846153,0.06001725590125859,564,They're prescription.
954,2,10,53,65,1.2153846153846153,0.06001725590125859,564,They just showed up on my desktop.
954,2,10,53,65,1.2153846153846153,0.06001725590125859,564,"I'm sorry, you need the ""what"" desk. And no, I can't tell you ""where"" it is."
954,2,10,53,65,1.2153846153846153,0.06001725590125859,564,"I said, ""Bring me some towels."""
954,3,8,54,65,1.2153846153846153,0.06389710663783134,564,"What, Where, How and When are arriving next week."
954,2,10,53,65,1.2153846153846153,0.06001725590125859,564,"Ms. Jones, cancel all my nocturnal apppintments."
954,1,12,52,65,1.2153846153846153,0.05586861171666903,564,Unleash the mice.
954,3,8,54,65,1.2153846153846153,0.06389710663783134,564,I find less people bother me when I have birds of prey all over my desk.
954,1,12,52,65,1.2153846153846153,0.05586861171666903,564,The boss said to hire more workers who give a hoot.
954,3,8,54,65,1.2153846153846153,0.06389710663783134,564,Your new assistants are really turning some heads.
954,3,8,54,65,1.2153846153846153,0.06389710663783134,564,Hold all my calls. I'm waiting for an owl movement.
954,3,8,54,65,1.2153846153846153,0.06389710663783134,564,"What did you THINK I meant by ""hooters""?"
954,2,10,53,65,1.2153846153846153,0.06001725590125859,564,Drones were too expensive.
954,4,6,55,65,1.2153846153846153,0.06755449257788575,564,"Hogwarts called, sir, and they're ready to negotiate."
954,4,6,55,65,1.2153846153846153,0.06755449257788575,564,"That's nine ""who?"" from them and one ""hello"" from me."
954,3,8,54,65,1.2153846153846153,0.06389710663783134,564,You've got mail.
954,4,6,55,65,1.2153846153846153,0.06755449257788575,564,They'll be taking over the night shift.
954,1,12,52,65,1.2153846153846153,0.05586861171666903,564,We're going to need newspaper. Lots of newspaper.
954,2,10,53,65,1.2153846153846153,0.06001725590125859,564,"Well, you said I should pick up a hobby, so I've picked up taxiderming. Do you want one?"
954,2,10,53,65,1.2153846153846153,0.06001725590125859,564,Is this a bad time to ask you for a raise
954,1,12,52,65,1.2153846153846153,0.05586861171666903,564,Since Brexit this parliament has been meeting here.
954,4,6,55,65,1.2153846153846153,0.06755449257788575,564,They keep my garden rodent-free. I want them to see what I do.
954,2,10,53,65,1.2153846153846153,0.06001725590125859,564,"Ms. Dorchester... When I left my office last night, I had 10 owls. Today I have 9. Can you explain?"
954,3,8,54,65,1.2153846153846153,0.06389710663783134,564,"When the pigeon comes, send him in."
954,3,8,54,65,1.2153846153846153,0.06389710663783134,564,They remove the temptation to clutter my desk.
954,1,12,52,65,1.2153846153846153,0.05586861171666903,564,"A turkey club and nine mice, thank you."
954,2,10,53,65,1.2153846153846153,0.06001725590125859,564,"Well, at least I'm moving forward on a plan for the pigeon problem.."
954,1,12,52,65,1.2153846153846153,0.05586861171666903,564,You really need to get over your fear of mice.
954,0,14,51,65,1.2153846153846153,0.051386112368797636,564,The pet store assured me that I had purchased two females ...
954,3,8,54,65,1.2153846153846153,0.06389710663783134,564,This is not what I meant when I asked you to send me workers who gave a hoot about our company.
954,0,14,51,65,1.2153846153846153,0.051386112368797636,564,"Whom!?,"" not ""Who?"
954,2,10,53,65,1.2153846153846153,0.06001725590125859,564,"When I said I wanted hooters around, I wasn't trying to be politically correct."
954,3,8,54,65,1.2153846153846153,0.06389710663783134,564,Do we have any newspapers?
954,2,10,53,65,1.2153846153846153,0.06001725590125859,564,"Tell Mr. Potter the answer is still ""no."""
954,3,8,54,65,1.2153846153846153,0.06389710663783134,564,"We've figured out who. Now for where, what, and how."
954,1,12,52,65,1.2153846153846153,0.05586861171666903,564,"Worse still, I can't find my mouse."
997,3,7,51,61,1.2131147540983607,0.06659047872652427,564,"It's not what you know,......."
997,2,9,50,61,1.2131147540983607,0.06235257628675809,564,"They keep away the tired, the poor, the huddled masses yearning to breathe free."
997,2,9,50,61,1.2131147540983607,0.06235257628675809,564,What were you expecting when you ordered the 'Harry Potter' desk?
997,3,7,51,61,1.2131147540983607,0.06659047872652427,564,But they will be worth eighteen in the bush.
1001,1,11,50,62,1.2096774193548387,0.0569686228972945,564,You must have mistaken me for someone who gives a hoot.
1001,2,9,51,62,1.2096774193548387,0.061434881985617536,564,"If you're going to ask my name, be sure you start with the word 'what.'"
1001,3,7,52,62,1.2096774193548387,0.06559775494907856,564,Those do not make you look any wiser.
1001,2,9,51,62,1.2096774193548387,0.061434881985617536,564,"You wouldn't happen to have a field mouse on you, by any chance?"
1001,1,11,50,62,1.2096774193548387,0.0569686228972945,564,"I don't care how you communicated in your old job, in this office we use e-mail."
1001,2,9,51,62,1.2096774193548387,0.061434881985617536,564,You weren't kidding when you said this place is for the birds.
1001,2,9,51,62,1.2096774193548387,0.061434881985617536,564,"Yes, it is owl about me."
1001,3,7,52,62,1.2096774193548387,0.06559775494907856,564,Let me tell you who's who.
1001,4,5,53,62,1.2096774193548387,0.06951177011220451,564,Owl call you.
1001,2,9,51,62,1.2096774193548387,0.061434881985617536,564,"Don't worry, they only work nights."
1001,3,7,52,62,1.2096774193548387,0.06559775494907856,564,I specifically asked for nite owls - not nine owls - nite owls.
1001,2,9,51,62,1.2096774193548387,0.061434881985617536,564,Let us prey.
1001,1,11,50,62,1.2096774193548387,0.0569686228972945,564,I'm not a morning person either.
1001,4,5,53,62,1.2096774193548387,0.06951177011220451,564,One more and I get the 11th one free.
1001,2,9,51,62,1.2096774193548387,0.061434881985617536,564,"In my day, students gave me apples."
1001,2,9,51,62,1.2096774193548387,0.061434881985617536,564,I know; it's weird. These seem to be day owls.
1001,2,9,51,62,1.2096774193548387,0.061434881985617536,564,St Louis is looking for a new first baseman.
1001,4,5,53,62,1.2096774193548387,0.06951177011220451,564,File these under 'O'.
1001,0,13,49,62,1.2096774193548387,0.05212104435869968,564,I need you to train the night shift.
1001,2,9,51,62,1.2096774193548387,0.061434881985617536,564,"When the cat's away, the mice WON'T play."
1001,2,9,51,62,1.2096774193548387,0.061434881985617536,564,I told IT I wanted a messaging system that couldn't be hacked.
1001,5,3,54,62,1.2096774193548387,0.07321684856578146,564,"If you can't dazzle them with brilliance, befuddle them with owls."
1001,3,7,52,62,1.2096774193548387,0.06559775494907856,564,This job's a hoot!
1001,2,9,51,62,1.2096774193548387,0.061434881985617536,564,I'm pulling an all nighter.
1001,2,9,51,62,1.2096774193548387,0.061434881985617536,564,What's the second part of your potato chip advertising idea?
1001,2,9,51,62,1.2096774193548387,0.061434881985617536,564,I am still none the wiser
1001,3,7,52,62,1.2096774193548387,0.06559775494907856,564,"I agree Ms. Keller, they are nice hooters."
1001,2,9,51,62,1.2096774193548387,0.061434881985617536,564,"Will that be owl for today, sir?"
1001,2,9,51,62,1.2096774193548387,0.061434881985617536,564,Tell IT that I need more mice.
1001,4,5,53,62,1.2096774193548387,0.06951177011220451,564,"Well, after spending an hour with them, I can safely say they may be wise. But they are not good communicators."
1001,3,7,52,62,1.2096774193548387,0.06559775494907856,564,"Your boss, that's who."
1001,4,5,53,62,1.2096774193548387,0.06951177011220451,564,They're my service animals.
1001,4,5,53,62,1.2096774193548387,0.06951177011220451,564,"Frankly, my dear, I don't give a hoot!"
1001,2,9,51,62,1.2096774193548387,0.061434881985617536,564,The prey are here to see you. Shall I invite them in?
1001,1,11,50,62,1.2096774193548387,0.0569686228972945,564,That's the last time I ever get drunk and shop on Etsy.
1001,2,9,51,62,1.2096774193548387,0.061434881985617536,564,Again?! You know nothing ever gets done when the parliament is involved.
1001,3,7,52,62,1.2096774193548387,0.06559775494907856,564,"I'll only answer questions regarding the what, where, when, or why."
1001,1,11,50,62,1.2096774193548387,0.0569686228972945,564,"I was quite clear, Miss Hughes, I asked you to order me a new set of towels...."
1001,3,7,52,62,1.2096774193548387,0.06559775494907856,564,I see you've gone back to using your old twitter account.
1001,3,7,52,62,1.2096774193548387,0.06559775494907856,564,"No, the glasses don't make you look wiser."
1001,2,9,51,62,1.2096774193548387,0.061434881985617536,564,I asked you to order nine awls!
1001,2,9,51,62,1.2096774193548387,0.061434881985617536,564,"No, they don't make you look smarter."
1001,3,7,52,62,1.2096774193548387,0.06559775494907856,564,"There are twenty more in the lobby, Senator. Something about their Uncle Woodsy and your coal vote."
1001,2,9,51,62,1.2096774193548387,0.061434881985617536,564,"""Sir - just because they abolished the EPA doesn't mean you can take matters into your own hands - the ADA will be next."
1001,2,9,51,62,1.2096774193548387,0.061434881985617536,564,"They can't file or type, but they'll work for mice."
1001,3,7,52,62,1.2096774193548387,0.06559775494907856,564,"So, where are the pussycats?"
1001,1,11,50,62,1.2096774193548387,0.0569686228972945,564,Who is on line 1
1001,3,7,52,62,1.2096774193548387,0.06559775494907856,564,I hate mice.
1001,2,9,51,62,1.2096774193548387,0.061434881985617536,564,Who's asking?
1001,0,13,49,62,1.2096774193548387,0.05212104435869968,564,And we say it's who not whom
1001,2,9,51,62,1.2096774193548387,0.061434881985617536,564,Is this how the EPA is sending its warnings these days?
1001,2,9,51,62,1.2096774193548387,0.061434881985617536,564,"Frankly, my dear, I couldn't give a hoot."
1001,3,7,52,62,1.2096774193548387,0.06559775494907856,564,"I don't give a hoot, but they do."
1001,3,7,52,62,1.2096774193548387,0.06559775494907856,564,This is what happens when you call the wrong exterminator.
1001,2,9,51,62,1.2096774193548387,0.061434881985617536,564,Horton in personnel wants to see you.
1001,3,7,52,62,1.2096774193548387,0.06559775494907856,564,I'm trying to teach them to when to use whom
1001,1,11,50,62,1.2096774193548387,0.0569686228972945,564,"You have got that covered....so what's, where, when, and how?"
1001,4,5,53,62,1.2096774193548387,0.06951177011220451,564,"Attorney General, Secretaries of State, Defense, Treasury, Education, Jared, Ivanka, Eric, Donald Jr. They're all fantastically smart. Believe me."
1001,4,5,53,62,1.2096774193548387,0.06951177011220451,564,"You may wish to rethink your mousy appearance, Ms. Smithers."
1001,3,7,52,62,1.2096774193548387,0.06559775494907856,564,"Do you recall Pokemon Go, Ms. Levitt?"
1001,1,11,50,62,1.2096774193548387,0.0569686228972945,564,They call themselves The Who.
1001,1,11,50,62,1.2096774193548387,0.0569686228972945,564,"It's owl or nothing, Cynthia."
1001,2,9,51,62,1.2096774193548387,0.061434881985617536,564,I'm counting nine. I believe ten is a Hoot.
1001,2,9,51,62,1.2096774193548387,0.061434881985617536,564,"In human resourcss, we do not focus on what, why, when or how"
1001,3,7,52,62,1.2096774193548387,0.06559775494907856,564,I'm what's referred to as a hootenanny.
1001,2,9,51,62,1.2096774193548387,0.061434881985617536,564,"At long last, I've confirmed the ""Three Licks"" hypothesis."
1001,4,5,53,62,1.2096774193548387,0.06951177011220451,564,"""How many more times are you gonna make me say it""?"
1001,2,9,51,62,1.2096774193548387,0.061434881985617536,564,This isn't exactly what I had in mind when I asked if I could see your hooters.
1001,2,9,51,62,1.2096774193548387,0.061434881985617536,564,"""Tell them I said, 'Tax Attorney'""."
1001,3,7,52,62,1.2096774193548387,0.06559775494907856,564,"They don't win many games. But between innings they do a great cover of ""Who's on First."
1001,2,9,51,62,1.2096774193548387,0.061434881985617536,564,'They will be great for the night shift'
1001,1,11,50,62,1.2096774193548387,0.0569686228972945,564,"I know the who...but how about the what, why, where, when and how?"
1001,1,11,50,62,1.2096774193548387,0.0569686228972945,564,"Miss Tompkins, I ordered nine ""awls""."
1001,3,7,52,62,1.2096774193548387,0.06559775494907856,564,Helen had to think long and hard about how to tell George his idea for removing the rat problem wasn't going to be received well.
1001,1,11,50,62,1.2096774193548387,0.0569686228972945,564,Contact Hogwarts. Tell them them my inbox is full.
1001,1,11,50,62,1.2096774193548387,0.0569686228972945,564,Meet the nightshift.
1001,2,9,51,62,1.2096774193548387,0.061434881985617536,564,Looks like we will be working late tonight...
1001,1,11,50,62,1.2096774193548387,0.0569686228972945,564,PR video. They ran out of puppies
1001,4,5,53,62,1.2096774193548387,0.06951177011220451,564,Who or whom is in charge here ?
1001,2,9,51,62,1.2096774193548387,0.061434881985617536,564,"The night shift and I have a few questions for you, Martha."
1001,2,9,51,62,1.2096774193548387,0.061434881985617536,564,"Who, who, who, who did you say was my next appointment?"
1001,2,9,51,62,1.2096774193548387,0.061434881985617536,564,Sure. You do seem wiser now.
1001,2,9,51,62,1.2096774193548387,0.061434881985617536,564,The Tootsie pop licking focus group is ready.
1001,2,9,51,62,1.2096774193548387,0.061434881985617536,564,"They're protected. See if you can find them their own office, ok?"
1001,2,9,51,62,1.2096774193548387,0.061434881985617536,564,"Yes, it is the 21st century, Ms Stemphel, but this is the secretarial reality at Hogwarts, Inc."
1001,2,9,51,62,1.2096774193548387,0.061434881985617536,564,"If you were a proctologist, what would you display on your desk?"
1001,3,7,52,62,1.2096774193548387,0.06559775494907856,564,"No, I don't think they make you look smarter."
1088,1,10,47,58,1.206896551724138,0.05902320792875932,564,"With all due respect, sir, you requested a pack of all-natural mouse traps."
1088,1,10,47,58,1.206896551724138,0.05902320792875932,564,Your job is being owlsourced.
1088,2,8,48,58,1.206896551724138,0.06394294137555384,564,"...and then we thought, maybe Rowling is onto something here."
1088,1,10,47,58,1.206896551724138,0.05902320792875932,564,More spam from Hogwarts?
1092,2,9,52,63,1.2063492063492063,0.06054340949726558,564,"Is it just possible, Ms. Barnes, that we've misinterpreted, ""hygge""?"
1093,1,10,49,60,1.2,0.057243656051933725,564,"To whoo, whoo, whom are you speaking?"
1093,2,8,50,60,1.2,0.061982319330632654,564,Can IT add 'Hogwarts' to our spam filter please?
1093,0,12,48,60,1.2,0.052075564392329535,564,A venti non-fat latte and nine field mice.
1093,1,10,49,60,1.2,0.057243656051933725,564,I know you're wondering...why not an even ten?
1093,2,8,50,60,1.2,0.061982319330632654,564,No Janice! I hadn't noticed.
1093,0,12,48,60,1.2,0.052075564392329535,564,The proper response is Who not Whom.
1093,2,8,50,60,1.2,0.061982319330632654,564,"I was willing to sit on all nine eggs for you, but you can make your own damn coffee."
1093,1,10,49,60,1.2,0.057243656051933725,564,"|What are all these owls doing on my desk, Miss Johnson?"""
1093,0,12,48,60,1.2,0.052075564392329535,564,They keep away the pigeons.
1093,2,8,50,60,1.2,0.061982319330632654,564,I thought I mentioned them in the interview.
1093,3,6,51,60,1.2,0.06638357975446148,564,"I said: ""Night owl NOT nine owls"""
1093,2,8,50,60,1.2,0.061982319330632654,564,"Janet, this isn't what I meant when I said I wanted to be a parliament member."
1093,3,6,51,60,1.2,0.06638357975446148,564,"I understand you don't give a hoot, but corporate reports are still due on Friday."
1093,2,8,50,60,1.2,0.061982319330632654,564,"Yes, Miss Winters, we USED to have a mouse problem."
1093,2,8,50,60,1.2,0.061982319330632654,564,I have the solution to our pigeon problem.
1093,4,4,52,60,1.2,0.07051064751106302,564,Because I like them.
1093,2,8,50,60,1.2,0.061982319330632654,564,"Yes, we're rid of the mouse. But at what cost?"
1093,3,6,51,60,1.2,0.06638357975446148,564,Yes. I charge by the owl.
1093,1,10,49,60,1.2,0.057243656051933725,564,Turns out I'm a cat person.
1093,4,4,52,60,1.2,0.07051064751106302,564,I've got the taxidermist on the line.
1093,3,6,51,60,1.2,0.06638357975446148,564,Apparently there was a mix-up at the Easter Bunny factory
1093,2,8,50,60,1.2,0.061982319330632654,564,"Is this job a hoot, or what?!"
1093,2,8,50,60,1.2,0.061982319330632654,564,I wasn't being taken seriously with the barrel of monkeys.
1093,3,6,51,60,1.2,0.06638357975446148,564,Add some live mice to the lunch order.
1093,4,4,52,60,1.2,0.07051064751106302,564,It appeared to Mildred that Bob's obsession with hooters had gone too far.
1093,2,8,50,60,1.2,0.061982319330632654,564,"Well, Mrs. Contell who is the wisest of us all?"
1093,3,6,51,60,1.2,0.06638357975446148,564,Order more mice.
1093,1,10,49,60,1.2,0.057243656051933725,564,"Miss Horton, you heard what?!"
1093,1,10,49,60,1.2,0.057243656051933725,564,Would you like it better if I said it was for science?
1093,3,6,51,60,1.2,0.06638357975446148,564,"Frankly, I don't give a Hoot"
1093,1,10,49,60,1.2,0.057243656051933725,564,You've got mail.
1093,3,6,51,60,1.2,0.06638357975446148,564,They are here to help us with our 360 review.
1093,2,8,50,60,1.2,0.061982319330632654,564,"I said, I needed towels, not owls"
1093,3,6,51,60,1.2,0.06638357975446148,564,Get me the Barnstall contract and two dozen mice.
1093,2,8,50,60,1.2,0.061982319330632654,564,We're hoping this will get rid of the pigeons.
1093,3,6,51,60,1.2,0.06638357975446148,564,And a basket of voles with that coffee.
1093,2,8,50,60,1.2,0.061982319330632654,564,"Sorry to tell you, but, not one of us gives a hoot."
1093,2,8,50,60,1.2,0.061982319330632654,564,It's the definitive who's who.
1093,1,10,49,60,1.2,0.057243656051933725,564,Casting call for 'The Maltese Owl'.
1093,1,10,49,60,1.2,0.057243656051933725,564,It's a real Who done it.
1093,2,8,50,60,1.2,0.061982319330632654,564,"It's burning the night OIL, sir."
1093,2,8,50,60,1.2,0.061982319330632654,564,We'll be saving on night security.
1093,0,12,48,60,1.2,0.052075564392329535,564,"Now we're working on what, when, where and why."
1093,3,6,51,60,1.2,0.06638357975446148,564,"""Right now we only have day shift positions available""."
1093,3,6,51,60,1.2,0.06638357975446148,564,Why would somebody who spills coffee request paper owls?
1093,2,8,50,60,1.2,0.061982319330632654,564,"Miss Jones, bring me nine pussycats."
1093,1,10,49,60,1.2,0.057243656051933725,564,You really think this is wise?
1093,3,6,51,60,1.2,0.06638357975446148,564,"Well, Mrs Jackson, if you have an issue with our new owners then I suggest you find a position in a different mouse hospital."
1093,2,8,50,60,1.2,0.061982319330632654,564,"Apparently, I really pissed off J.K. Rowling this time."
1093,1,10,49,60,1.2,0.057243656051933725,564,I have to leave a little early again today. We're still barn hunting.
1093,3,6,51,60,1.2,0.06638357975446148,564,"Irving, no matter how many owls you adopt, you won't get any wiser. Now, clean off your desk."
1093,2,8,50,60,1.2,0.061982319330632654,564,You didn't say a word when Jim brought his service flamingoes!
1093,2,8,50,60,1.2,0.061982319330632654,564,Where's Waldo?
1093,2,8,50,60,1.2,0.061982319330632654,564,"Actually, they are quite stupid."
1093,1,10,49,60,1.2,0.057243656051933725,564,They're a veritable who's who.
1093,4,4,52,60,1.2,0.07051064751106302,564,"You're too old to get a Hogwarts letter, Jerry."
1093,3,6,51,60,1.2,0.06638357975446148,564,"""Who, who, who, who, who, who, who, who, who may I say is calling?"
1093,3,6,51,60,1.2,0.06638357975446148,564,"Correctly guess which owl is the wisest, and I'll close the wage gap for you."
1093,1,10,49,60,1.2,0.057243656051933725,564,"No wise cracks, please."
1093,2,8,50,60,1.2,0.061982319330632654,564,"Actually, I do give a hoot. Take your pick!"
1093,2,8,50,60,1.2,0.061982319330632654,564,Well yes. I guess technically that does make you the Hoot Nanny.
1093,2,8,50,60,1.2,0.061982319330632654,564,Our barn is being remodeled.
1093,0,12,48,60,1.2,0.052075564392329535,564,Its not who but whom left them there!
1093,1,10,49,60,1.2,0.057243656051933725,564,"Yes, it is now our policy to give a hoot."
1093,0,12,48,60,1.2,0.052075564392329535,564,Do you really think they make me look wiser?
1093,3,6,51,60,1.2,0.06638357975446148,564,Where's Who's Who?
1093,2,8,50,60,1.2,0.061982319330632654,564,Tread wisely.
1093,3,6,51,60,1.2,0.06638357975446148,564,"Not a very efficient desk is it? Sure your work is guarded all night, but you can never leave out your mouse."
1093,3,6,51,60,1.2,0.06638357975446148,564,Who's here to see me?
1093,1,10,49,60,1.2,0.057243656051933725,564,We need to keep track of my owl movements
1093,3,6,51,60,1.2,0.06638357975446148,564,Who's the wise guy?
1093,2,8,50,60,1.2,0.061982319330632654,564,Owl be damned.
1093,2,8,50,60,1.2,0.061982319330632654,564,"It's called a Sanctuary workspace, Barb."
1093,0,12,48,60,1.2,0.052075564392329535,564,What makes you think I give a hoot!
1093,2,8,50,60,1.2,0.061982319330632654,564,We are looking for more diversity on the night shift.
1093,2,8,50,60,1.2,0.061982319330632654,564,"It's not what you know, Ms. Parker. It's whoo."
1093,0,12,48,60,1.2,0.052075564392329535,564,Whooo's on first?
1093,1,10,49,60,1.2,0.057243656051933725,564,"We can't disturb them, it's their first Parliamentary sitting."
1093,1,10,49,60,1.2,0.057243656051933725,564,Is this wise?
1093,2,8,50,60,1.2,0.061982319330632654,564,They're our new cartoon editors.
1093,2,8,50,60,1.2,0.061982319330632654,564,They'll protest until we start paying shift differential for night work.
1093,2,8,50,60,1.2,0.061982319330632654,564,I have a difficult time telling whoo is whoo.
1093,2,8,50,60,1.2,0.061982319330632654,564,Have you seen my mouse?
1093,5,2,53,60,1.2,0.07440916048338272,564,"Are we so concerned about our emails being hacked that we are now resorting to owl message delivery, sir?"
1093,2,8,50,60,1.2,0.061982319330632654,564,Ask me if I give a hoot about the board's allegations.
1093,1,10,49,60,1.2,0.057243656051933725,564,"Sarah, have you seen my computer mouse?"
1093,3,6,51,60,1.2,0.06638357975446148,564,The Hogwarts tax returns are ready to go
1093,3,6,51,60,1.2,0.06638357975446148,564,Personally I don't give a hoot which one you choose.
1093,4,4,52,60,1.2,0.07051064751106302,564,"A word? Miss Jones, when you have a moment..."
1093,2,8,50,60,1.2,0.061982319330632654,564,"My ex-wife never used to give a hoot, but look at me now."
1093,4,4,52,60,1.2,0.07051064751106302,564,Tell marketing I want our logo to be a potato chip.
1093,2,8,50,60,1.2,0.061982319330632654,564,I upgraded from snail mail.
1093,3,6,51,60,1.2,0.06638357975446148,564,If the company handbook doesn't address it specifically then I don't see the problem.
1093,3,6,51,60,1.2,0.06638357975446148,564,"Susan, meet our board of directors."
1093,1,10,49,60,1.2,0.057243656051933725,564,I just thought it'd be a hoot.
1093,1,10,49,60,1.2,0.057243656051933725,564,"We really need to replace the intercom system, Gladys. I clearly said 'nine towels'!"
1093,2,8,50,60,1.2,0.061982319330632654,564,Our new belt-tightening policy requires additional evening shifts.
1093,3,6,51,60,1.2,0.06638357975446148,564,Please tell our facilities manager that I wanted him to distribute more TOWELS.
1093,2,8,50,60,1.2,0.061982319330632654,564,That would be unwise
1093,2,8,50,60,1.2,0.061982319330632654,564,"Is that Owl, sir?"
1093,3,6,51,60,1.2,0.06638357975446148,564,My kid is applying to Wizard School.
1093,3,6,51,60,1.2,0.06638357975446148,564,"Frankly Ms. Higgins, I don't give a hoot."
1093,3,6,51,60,1.2,0.06638357975446148,564,"technically the are a parliament, Gina."
1093,0,12,48,60,1.2,0.052075564392329535,564,I am planning to send a lot of tweets.
1093,2,8,50,60,1.2,0.061982319330632654,564,"Quite frankly, I couldn't give a hoot."
1093,2,8,50,60,1.2,0.061982319330632654,564,At least the mice are gone.
1093,2,8,50,60,1.2,0.061982319330632654,564,A word from the wise.
1093,0,12,48,60,1.2,0.052075564392329535,564,"Yes, I'm Horton"
1093,1,10,49,60,1.2,0.057243656051933725,564,I believe you mean to say 'whom.'
1093,2,8,50,60,1.2,0.061982319330632654,564,We will take nine sandwiches and Bob wants a yogurt parfait
1093,3,6,51,60,1.2,0.06638357975446148,564,Let's go for an even dozen.
1093,3,6,51,60,1.2,0.06638357975446148,564,And why do you think I give a hoot?
1093,2,8,50,60,1.2,0.061982319330632654,564,"OK, now all we need is the What,Where,When,and Why."
1093,2,8,50,60,1.2,0.061982319330632654,564,"Whatever happened to What, Where, When and Why?"
1093,3,6,51,60,1.2,0.06638357975446148,564,Your 'I don't give a hoot' behavior has been brought to my attention.
1093,1,10,49,60,1.2,0.057243656051933725,564,"I can't answer their question, of course, but they make me stop and think."
1093,3,6,51,60,1.2,0.06638357975446148,564,"""Who said,Whoo""?"
1093,1,10,49,60,1.2,0.057243656051933725,564,"Don't worry, sir. I'm sure you're wiser than at least one of them."
1093,3,6,51,60,1.2,0.06638357975446148,564,I'm afraid only one pussy cat showed up.
1093,2,8,50,60,1.2,0.061982319330632654,564,"Look, if they make you so nervous, maybe you should lose those squeaky shoes."
1093,2,8,50,60,1.2,0.061982319330632654,564,Owl get back to you.
1093,3,6,51,60,1.2,0.06638357975446148,564,"I should have been clearer when I asked you to book ""The Who."
1093,1,10,49,60,1.2,0.057243656051933725,564,"And cc Granger, Weasley, Longbottom, and Hagrid."
1093,1,10,49,60,1.2,0.057243656051933725,564,I see you've solved your squirrel problem.
1093,2,8,50,60,1.2,0.061982319330632654,564,They're looking for work now that polluting is back in style.
1093,3,6,51,60,1.2,0.06638357975446148,564,So where is the pussycat?
1093,1,10,49,60,1.2,0.057243656051933725,564,They give me gravitas.
1093,2,8,50,60,1.2,0.061982319330632654,564,"I assure you Madam, it's who not whom."
1093,3,6,51,60,1.2,0.06638357975446148,564,"The committee also wants to know what, when, where, and why."
1093,3,6,51,60,1.2,0.06638357975446148,564,"I said the office bowling team, George."
1093,3,6,51,60,1.2,0.06638357975446148,564,Who's your daddy?
1093,1,10,49,60,1.2,0.057243656051933725,564,"When you said there was a rat in accounting, I presumed it was a metaphor."
1093,1,10,49,60,1.2,0.057243656051933725,564,Meet the Mensa applicants.
1093,2,8,50,60,1.2,0.061982319330632654,564,There's a Dr. Who to see you.
1093,1,10,49,60,1.2,0.057243656051933725,564,"No Miss Jones, I asked you to buy me 'fine towels'."
1093,0,12,48,60,1.2,0.052075564392329535,564,"If you still can't guess the phrase, maybe you'd like to buy an owl?"
1093,4,4,52,60,1.2,0.07051064751106302,564,"That's right Helen, one for each department and two for the President."
1093,3,6,51,60,1.2,0.06638357975446148,564,I thought we agreed to use Muggle mail.
1093,3,6,51,60,1.2,0.06638357975446148,564,What's a harbinger?
1093,2,8,50,60,1.2,0.061982319330632654,564,"Trust me, it's going to be a hoot."
1093,2,8,50,60,1.2,0.061982319330632654,564,"Edith, I asked that we consider hiring nightowls."
1093,2,8,50,60,1.2,0.061982319330632654,564,"On second thought, Gladys, make that nine mice and one tuna on wheat."
1093,2,8,50,60,1.2,0.061982319330632654,564,"You can go home, Ms. Spencer. I'm in for all-nighter."
1093,0,12,48,60,1.2,0.052075564392329535,564,"Personally, I don't give a hoot."
1093,1,10,49,60,1.2,0.057243656051933725,564,"This would be a lot more bearable if you stopped saying, nice hooters."
1093,4,4,52,60,1.2,0.07051064751106302,564,"Yes, Mrs. Jenkins, I now officially give a hoot."
1093,2,8,50,60,1.2,0.061982319330632654,564,"Yes Mary, your April Fool's joke is a ""hoot."""
1093,4,4,52,60,1.2,0.07051064751106302,564,"You certainly turn heads, Mr. Banks."
1093,4,4,52,60,1.2,0.07051064751106302,564,Be yourself. They love shrews.
1093,2,8,50,60,1.2,0.061982319330632654,564,"Some bosses like to be surrounded by ""Yes"" men. Bill preferred ""Who"" men."
1243,2,7,48,57,1.1929824561403508,0.06351541803245206,564,That's the last time I'll ask for tech help.
1243,1,9,47,57,1.1929824561403508,0.05837501102181511,564,Please show our guests to the barn.
1243,2,7,48,57,1.1929824561403508,0.06351541803245206,564,"I need ten owls, not nine. Go find another one!"
1243,2,7,48,57,1.1929824561403508,0.06351541803245206,564,"*My inbox is too full to receive any more messages."""
1243,0,11,46,57,1.1929824561403508,0.05273590328947571,564,They pecked at the keyboard but devoured the mouse.
1243,1,9,47,57,1.1929824561403508,0.05837501102181511,564,"For my retirement party, I asked the management if I can be treated to Hooters, and this is what I found in my office."
1243,3,5,49,57,1.1929824561403508,0.06826986702694854,564,I distinctly remember saying we needed to order more towels.
1243,0,11,46,57,1.1929824561403508,0.05273590328947571,564,"Just to be clear Ms. Lombardo, I was talking about them, not your boobs."
1243,2,7,48,57,1.1929824561403508,0.06351541803245206,564,Glad you're here. Will you prey with us?
1243,1,9,47,57,1.1929824561403508,0.05837501102181511,564,Welcome to parliament!
1243,3,5,49,57,1.1929824561403508,0.06826986702694854,564,"Miss Brooks, we will have lunch in the office today--please order nine mice and a spinach salad."
1243,4,3,50,57,1.1929824561403508,0.07271410564613537,564,"Miss Shrewsbury, once again, I did not ""hoot at your caboose!"""
1243,3,5,49,57,1.1929824561403508,0.06826986702694854,564,"So that is one black coffee and nine frozen mice, correct?"
1243,3,5,49,57,1.1929824561403508,0.06826986702694854,564,I've been here all night.
1243,1,9,47,57,1.1929824561403508,0.05837501102181511,564,"Alright, so who's the wise guy?"
1243,2,7,48,57,1.1929824561403508,0.06351541803245206,564,Would you let the rodents in Ms Harper
1243,3,5,49,57,1.1929824561403508,0.06826986702694854,564,Maybe I should try to improve my disposition . . .
1243,2,7,48,57,1.1929824561403508,0.06351541803245206,564,Keeps away the vultures and hedge funders.
1243,1,9,47,57,1.1929824561403508,0.05837501102181511,564,"Got tired of ""yes"" men and went with ""who""."
1243,1,9,47,57,1.1929824561403508,0.05837501102181511,564,Your job review is on my desk Mrs. Baxter – good luck.
1243,1,9,47,57,1.1929824561403508,0.05837501102181511,564,"Alright, it was Marge who took your sandwich from the fridge."
1243,3,5,49,57,1.1929824561403508,0.06826986702694854,564,"As you can see, Miss Jones, I'm already up to my neck in hooters."
1243,2,7,48,57,1.1929824561403508,0.06351541803245206,564,You'll be working nights starting Monday.
1243,1,9,47,57,1.1929824561403508,0.05837501102181511,564,I've always wanted to be a Member of Parliament.
1243,2,7,48,57,1.1929824561403508,0.06351541803245206,564,"Miss Dobson, we have a mole in this organization"
1243,4,3,50,57,1.1929824561403508,0.07271410564613537,564,Does it make you look smarter? No. Insane? Yes.
1243,2,7,48,57,1.1929824561403508,0.06351541803245206,564,"Henderson, when I said no one gives a ""hoot "" about your project, I was speaking metaphorically."
1243,2,7,48,57,1.1929824561403508,0.06351541803245206,564,They were cheaper than a guard dog
1243,2,7,48,57,1.1929824561403508,0.06351541803245206,564,"Lets concentrate on WHAT,WHEN,WHERE and HOW."
1243,3,5,49,57,1.1929824561403508,0.06826986702694854,564,Come back later. I'm meeting with parliament right now.
1243,2,7,48,57,1.1929824561403508,0.06351541803245206,564,I couldn't leave them at home. They won't nap during the day.
1243,4,3,50,57,1.1929824561403508,0.07271410564613537,564,"Harold, did you pull another owl nighter?"
1243,1,9,47,57,1.1929824561403508,0.05837501102181511,564,"I have some bad news, we are out of mice."
1243,2,7,48,57,1.1929824561403508,0.06351541803245206,564,Who? Owl get back to him after lunch.
1243,0,11,46,57,1.1929824561403508,0.05273590328947571,564,"I'm sorry, Mr. Dalton, but a 'parliament of owls' won't help us stay in the EU."
1243,2,7,48,57,1.1929824561403508,0.06351541803245206,564,Harassment? Sorry. Our new Human Resources Department doesn't give a hoot.
1243,4,3,50,57,1.1929824561403508,0.07271410564613537,564,"That's right, Ms. Johnson, I'm putting you on the new Hooters account."
1243,3,5,49,57,1.1929824561403508,0.06826986702694854,564,"Sir, I know you think the Owls have improved office morale, but the employees see the trail of mouse carcasses coming from your doorway as a bad omen"
1243,2,7,48,57,1.1929824561403508,0.06351541803245206,564,"The vet called, she can't get you in to see the irritable owl syndrome specialist til next week."
1243,2,7,48,57,1.1929824561403508,0.06351541803245206,564,"Oops, my mistake. That should have been ONE lemon poppy seed scone and NINE dead mice."
1243,3,5,49,57,1.1929824561403508,0.06826986702694854,564,"Couldn't afford hitmen, just harbingers."
1243,2,7,48,57,1.1929824561403508,0.06351541803245206,564,I'm allergic to cats!
1243,2,7,48,57,1.1929824561403508,0.06351541803245206,564,I don't give a hoot who your advisors are
1243,1,9,47,57,1.1929824561403508,0.05837501102181511,564,Why would I give a hoot?
1243,2,7,48,57,1.1929824561403508,0.06351541803245206,564,"Marcy, I don't know either if it's to who they belong, or to whom they belong."
1243,2,7,48,57,1.1929824561403508,0.06351541803245206,564,"You may have heard 'night owl' in the interview, but I definitely said, 'I have nine owls.'"
1243,2,7,48,57,1.1929824561403508,0.06351541803245206,564,"It really took the Meyers-Briggs results to show me that the family photos, the cactus, the clicky-clacky balls and the desk pen set isn't really ME."
1243,2,7,48,57,1.1929824561403508,0.06351541803245206,564,Can you pick out the next Wise Potato Chip mascot
1243,4,3,50,57,1.1929824561403508,0.07271410564613537,564,"Of course, I said we need more night owls, but...."
1243,3,5,49,57,1.1929824561403508,0.06826986702694854,564,"I care that you see them too, more than I care what they want."
1243,1,9,47,57,1.1929824561403508,0.05837501102181511,564,It's a veritable who's who of our research wing.
1243,1,9,47,57,1.1929824561403508,0.05837501102181511,564,"You may very well not, as you so eloquently put it, ""give a hoot"", Miss Damon, but I assure you, my Board of Directors will."
1243,2,7,48,57,1.1929824561403508,0.06351541803245206,564,Parliament is in session!
1243,2,7,48,57,1.1929824561403508,0.06351541803245206,564,The good news is that our mouse problem is solved...
1243,1,9,47,57,1.1929824561403508,0.05837501102181511,564,"9 dead mice and a coffee, no sugar."
1243,1,9,47,57,1.1929824561403508,0.05837501102181511,564,It's clear ONE of us has an obsession
1243,2,7,48,57,1.1929824561403508,0.06351541803245206,564,Whoooo do I speak to?
1243,2,7,48,57,1.1929824561403508,0.06351541803245206,564,You never can have too many owls.
1243,2,7,48,57,1.1929824561403508,0.06351541803245206,564,I told my wife that I wanted Hooters for my birthday.
1243,2,7,48,57,1.1929824561403508,0.06351541803245206,564,"Good morning Miss Smith. Remember, you have only one chance, so choose wisely."
1243,2,7,48,57,1.1929824561403508,0.06351541803245206,564,"It's 'whom,' madam."
1243,2,7,48,57,1.1929824561403508,0.06351541803245206,564,I see you've noticed my hooters.
1243,3,5,49,57,1.1929824561403508,0.06826986702694854,564,They're in charge while I'm away.
1243,1,9,47,57,1.1929824561403508,0.05837501102181511,564,I was looking for something not quite so wise.
1243,3,5,49,57,1.1929824561403508,0.06826986702694854,564,"Marge, this isn't what I envisioned when you bragged about your hooters."
1243,1,9,47,57,1.1929824561403508,0.05837501102181511,564,"Okay, I got Angry Birds on my desktop - now what?"
1243,3,5,49,57,1.1929824561403508,0.06826986702694854,564,"Yes Rose, I've finally joined the rat race."
1243,2,7,48,57,1.1929824561403508,0.06351541803245206,564,"Excuse me, sir. I see you're busy meeting with your brain trust again."
1243,2,7,48,57,1.1929824561403508,0.06351541803245206,564,"Owl get back to you. Owl see you later. Owl be OK. Oh, stop me.!"
1243,0,11,46,57,1.1929824561403508,0.05273590328947571,564,"Remember, it's whom do you want to see?"
1243,0,11,46,57,1.1929824561403508,0.05273590328947571,564,I'm not sure this new messaging program is working out.
1243,2,7,48,57,1.1929824561403508,0.06351541803245206,564,I'll have the chicken salad and my friends will share the rodent platter.
1243,1,9,47,57,1.1929824561403508,0.05837501102181511,564,You have no idea how demeaning it is when you stare at my hooters.
1243,3,5,49,57,1.1929824561403508,0.06826986702694854,564,"I think you'll enjoy working here at Hooters, Miss Balmish."
1243,3,5,49,57,1.1929824561403508,0.06826986702694854,564,"Ms.Brown,can we discuss some new responsibilities I need you to handle?"
1243,1,9,47,57,1.1929824561403508,0.05837501102181511,564,I hate mice.
1243,1,9,47,57,1.1929824561403508,0.05837501102181511,564,"I said, ""let's invest in oil futures."" Oil."
1243,2,7,48,57,1.1929824561403508,0.06351541803245206,564,You would be wise to follow their advice.
1243,3,5,49,57,1.1929824561403508,0.06826986702694854,564,Turns out you can have exposed hooters at work.
1243,2,7,48,57,1.1929824561403508,0.06351541803245206,564,On the ninth day of Christmas my true love gave to me...
1243,3,5,49,57,1.1929824561403508,0.06826986702694854,564,They supervise all my private meetings with women.
1243,2,7,48,57,1.1929824561403508,0.06351541803245206,564,"It's true. I'm so wise, owls come to me for answers."
1243,2,7,48,57,1.1929824561403508,0.06351541803245206,564,"Bring your pet to work day has been a big hit, except Ferguson can't find his hamster."
1243,3,5,49,57,1.1929824561403508,0.06826986702694854,564,The ex said she couldn't take them this week.
1243,1,9,47,57,1.1929824561403508,0.05837501102181511,564,"Ever since we landed Hogwarts as a client, business is booming."
1243,1,9,47,57,1.1929824561403508,0.05837501102181511,564,"it's not who, it's WHOM."
1243,3,5,49,57,1.1929824561403508,0.06826986702694854,564,"We get it, Todd. You work late nights."
1243,3,5,49,57,1.1929824561403508,0.06826986702694854,564,Their looking for advice on building a nest egg.
1243,2,7,48,57,1.1929824561403508,0.06351541803245206,564,Parliament is about to be in session.
1243,1,9,47,57,1.1929824561403508,0.05837501102181511,564,"You can file them under ""O."""
1243,2,7,48,57,1.1929824561403508,0.06351541803245206,564,Do you want to buy an owl?
1243,3,5,49,57,1.1929824561403508,0.06826986702694854,564,At least the mouse is gone.
1243,1,9,47,57,1.1929824561403508,0.05837501102181511,564,Go ahead and ask; one of my assistants knows.
1243,3,5,49,57,1.1929824561403508,0.06826986702694854,564,Owls...what owls?
1243,1,9,47,57,1.1929824561403508,0.05837501102181511,564,"I trust their judgement, Ronda."
1243,1,9,47,57,1.1929824561403508,0.05837501102181511,564,"I'm incompetent, but surrounded by wisdom!"
1243,1,9,47,57,1.1929824561403508,0.05837501102181511,564,I actually meant the other kind of 'wise guys'
1243,1,9,47,57,1.1929824561403508,0.05837501102181511,564,Isn't this a hoot?
1243,1,9,47,57,1.1929824561403508,0.05837501102181511,564,"Linda, you've got to get better at spreadsheets - I only ordered one owl."
1243,2,7,48,57,1.1929824561403508,0.06351541803245206,564,I just can't tell whose hoo.
1243,3,5,49,57,1.1929824561403508,0.06826986702694854,564,"Ms. Pussykat, how many pea-green boats are currently in stock?"
1243,2,7,48,57,1.1929824561403508,0.06351541803245206,564,Mother was exactly right. About everything.
1243,4,3,50,57,1.1929824561403508,0.07271410564613537,564,You hooted for me sir?
1243,1,9,47,57,1.1929824561403508,0.05837501102181511,564,Tell Harry Potter to pick up his mail.
1243,3,5,49,57,1.1929824561403508,0.06826986702694854,564,I said we needed more WOWs!
1243,3,5,49,57,1.1929824561403508,0.06826986702694854,564,They work the night shift.
1243,2,7,48,57,1.1929824561403508,0.06351541803245206,564,This is not what I was expecting when you said you'd joined parliament.
1243,3,5,49,57,1.1929824561403508,0.06826986702694854,564,I asked for extra towels!
1351,1,8,45,54,1.1851851851851851,0.05954682150320808,564,"I requested the nite-owl desk, not the nine-owl."
1351,1,8,45,54,1.1851851851851851,0.05954682150320808,564,"Yeah, you're the Queen, and this is your Parliament ! """
1351,2,6,46,54,1.1851851851851851,0.06515087083609597,564,They work the night shift.
1351,0,10,44,54,1.1851851851851851,0.05335739809593593,564,5-4 decision...You're Fired!
1351,2,6,46,54,1.1851851851851851,0.06515087083609597,564,A Hootenanny
1351,2,6,46,54,1.1851851851851851,0.06515087083609597,564,"You know, I get that question a lot."
1351,3,4,47,54,1.1851851851851851,0.07030965787335618,564,They're owls.
1351,2,6,46,54,1.1851851851851851,0.06515087083609597,564,"Sorry, sir, but you still don't look any wiser to me."
1351,3,4,47,54,1.1851851851851851,0.07030965787335618,564,"They’re all wise, but the second from the left is the wisest."
1351,2,6,46,54,1.1851851851851851,0.06515087083609597,564,Who's here
1351,1,8,45,54,1.1851851851851851,0.05954682150320808,564,"You can go home, the night shift is here"
1351,2,6,46,54,1.1851851851851851,0.06515087083609597,564,"Ok, but how about the ""what"" and ""why?"""
1351,2,6,46,54,1.1851851851851851,0.06515087083609597,564,And you don't look like Tippi Hedren.
1351,3,4,47,54,1.1851851851851851,0.07030965787335618,564,That's owl I know
1351,1,8,45,54,1.1851851851851851,0.05954682150320808,564,I've decided to back the conventional wisdom .
1351,3,4,47,54,1.1851851851851851,0.07030965787335618,564,"So, where are the pussycats?"
1351,1,8,45,54,1.1851851851851851,0.05954682150320808,564,"I said, ""To WHOM it May Concern."""
1351,2,6,46,54,1.1851851851851851,0.06515087083609597,564,"Alice, please make a reservation for a party of ten at Hooters"
1351,2,6,46,54,1.1851851851851851,0.06515087083609597,564,"Frankly, Miss Wilson, I don't give a hoot."
1351,2,6,46,54,1.1851851851851851,0.06515087083609597,564,"Owl shortage, says who?"
1351,2,6,46,54,1.1851851851851851,0.06515087083609597,564,"You can change everything in here, but the owls stay. They always stay."
1351,2,6,46,54,1.1851851851851851,0.06515087083609597,564,"Turns out I'm a wizard, Ms. Rice. You have my resignation."
1351,3,4,47,54,1.1851851851851851,0.07030965787335618,564,Please check on that order of lemmings.
1351,2,6,46,54,1.1851851851851851,0.06515087083609597,564,Have you considered therapy?
1351,2,6,46,54,1.1851851851851851,0.06515087083609597,564,"They can deliver messages, answer calls and maintain eye contact without getting passive aggressive."
1351,3,4,47,54,1.1851851851851851,0.07030965787335618,564,"Good morning Mr. Weis, Mr. Wise, Mr. Wise, Mr. Wise, Mr. Wise, Mr. Wise, Mr. Wise, Mr. Wise, Mr. Wise, Mr. Wise."
1351,3,4,47,54,1.1851851851851851,0.07030965787335618,564,They get quite nasty if you don't refer to them as a parliament of owls.
1351,0,10,44,54,1.1851851851851851,0.05335739809593593,564,"In that use it would be ""who"" not ""whom""."
1351,2,6,46,54,1.1851851851851851,0.06515087083609597,564,"Crazy like an owl, Miss Frobisher."
1351,3,4,47,54,1.1851851851851851,0.07030965787335618,564,My dyslexia has reached new owls.
1351,3,4,47,54,1.1851851851851851,0.07030965787335618,564,Who called?
1351,2,6,46,54,1.1851851851851851,0.06515087083609597,564,Still convinced the mice are out to get you?
1351,2,6,46,54,1.1851851851851851,0.06515087083609597,564,"Mrs. Smelkinson,I know you just started last week, but it's time for you to identify who's ""Who."""
1351,1,8,45,54,1.1851851851851851,0.05954682150320808,564,Do I seem wiser?
1351,3,4,47,54,1.1851851851851851,0.07030965787335618,564,"Hourly reports, Ms. Blenkinsop. Not owly."
1351,2,6,46,54,1.1851851851851851,0.06515087083609597,564,9 freshly killed shrews and one danish. And something for the owls as well.
1351,2,6,46,54,1.1851851851851851,0.06515087083609597,564,Third Shift.
1351,0,10,44,54,1.1851851851851851,0.05335739809593593,564,"Well, we don't have a mice problem anymore."
1351,2,6,46,54,1.1851851851851851,0.06515087083609597,564,Working here has been a real hoot.
1351,2,6,46,54,1.1851851851851851,0.06515087083609597,564,They're looking for a pellet court.
1351,0,10,44,54,1.1851851851851851,0.05335739809593593,564,They're Wise Guys.
1351,1,8,45,54,1.1851851851851851,0.05954682150320808,564,In this job you can never have enough symbolic wisdom.
1351,1,8,45,54,1.1851851851851851,0.05954682150320808,564,I tried to tell them I'm not that kind of night owl.
1351,2,6,46,54,1.1851851851851851,0.06515087083609597,564,Would you please check my appointment book?
1351,1,8,45,54,1.1851851851851851,0.05954682150320808,564,They're afraid of the fake hawk hanging from the soffit
1351,1,8,45,54,1.1851851851851851,0.05954682150320808,564,Who may I help you?
1351,2,6,46,54,1.1851851851851851,0.06515087083609597,564,"Sorry, Personnel wondered why you called for some night owls."
1351,2,6,46,54,1.1851851851851851,0.06515087083609597,564,"You're falling behind on your messages again, Gary."
1351,2,6,46,54,1.1851851851851851,0.06515087083609597,564,"No, Eldon, I don't have time to guess their names."
1351,3,4,47,54,1.1851851851851851,0.07030965787335618,564,I'd like you to meet our night crew.
1351,3,4,47,54,1.1851851851851851,0.07030965787335618,564,I was finally accepted in to Whoooo's Who this year.
1351,3,4,47,54,1.1851851851851851,0.07030965787335618,564,They can reshelve in very dim light after hours.
1351,2,6,46,54,1.1851851851851851,0.06515087083609597,564,"If that's all, Mr. Godfrey, I'll leave you to your hooting and screeching."
1351,0,10,44,54,1.1851851851851851,0.05335739809593593,564,It's sort of like herding cats.
1351,1,8,45,54,1.1851851851851851,0.05954682150320808,564,There was a buy one get eight free sale.
1351,0,10,44,54,1.1851851851851851,0.05335739809593593,564,That's the last time I get wasted and shop on Etsy.
1351,2,6,46,54,1.1851851851851851,0.06515087083609597,564,"When I asked for a Parliament, Ms. Johnson, I meant a cigarette."
1351,3,4,47,54,1.1851851851851851,0.07030965787335618,564,"As you can see, I have accumulated a lot of wisdom."
1351,0,10,44,54,1.1851851851851851,0.05335739809593593,564,"They may look wise, but the parrots definitely could hold better conversations."
1351,2,6,46,54,1.1851851851851851,0.06515087083609597,564,It's going to be another late night.
1351,2,6,46,54,1.1851851851851851,0.06515087083609597,564,"Yes, but they all have different personalities."
1351,2,6,46,54,1.1851851851851851,0.06515087083609597,564,"I said we needed to hire talent scouts, not taloned scouts."
1351,1,8,45,54,1.1851851851851851,0.05954682150320808,564,They were just selected by Who's Hoo.
1351,2,6,46,54,1.1851851851851851,0.06515087083609597,564,"Now, what do you bring to the table?"
1351,1,8,45,54,1.1851851851851851,0.05954682150320808,564,The good news: they're smart. The bad news: they only work at night.
1351,1,8,45,54,1.1851851851851851,0.05954682150320808,564,Who let the owls out/ hoo hoo hoo
1351,2,6,46,54,1.1851851851851851,0.06515087083609597,564,Actually we have many folks here who do give a hoot.
1351,2,6,46,54,1.1851851851851851,0.06515087083609597,564,"You're all in cahoots, aren't you?"
1351,3,4,47,54,1.1851851851851851,0.07030965787335618,564,I warned you this plague was coming.
1351,2,6,46,54,1.1851851851851851,0.06515087083609597,564,But they're my therapy owls.
1351,3,4,47,54,1.1851851851851851,0.07030965787335618,564,We provide 24 hour service and look at all angles of your problem
1351,2,6,46,54,1.1851851851851851,0.06515087083609597,564,Can you order some mice for lunch?
1351,1,8,45,54,1.1851851851851851,0.05954682150320808,564,So who gives a hoot?
1351,0,10,44,54,1.1851851851851851,0.05335739809593593,564,"Bottom line is you must give a hoot and work nights to keep your job here, Miss Perkins."
1351,1,8,45,54,1.1851851851851851,0.05954682150320808,564,"The What, When, Where, Why, and How Departments are just down the hall."
1351,2,6,46,54,1.1851851851851851,0.06515087083609597,564,"Hell, yeah, they're collectable."
1351,1,8,45,54,1.1851851851851851,0.05954682150320808,564,"Bob, people are starting to talk."
1351,2,6,46,54,1.1851851851851851,0.06515087083609597,564,You're just in time for the hootenanny
1351,3,4,47,54,1.1851851851851851,0.07030965787335618,564,We have filled the 9th vacancy.
1351,3,4,47,54,1.1851851851851851,0.07030965787335618,564,They're not pigeons. Who's ever seen a flock of pigeons on an office desk before?
1351,1,8,45,54,1.1851851851851851,0.05954682150320808,564,"Hoo, what, where, when and how?"
1351,4,2,48,54,1.1851851851851851,0.07511497859838032,564,"Who, who, who, who, who, who, who, who, who, wants to know?"
1351,3,4,47,54,1.1851851851851851,0.07030965787335618,564,I said I needed 9 'hours' to get it done. Hours!!
1351,1,8,45,54,1.1851851851851851,0.05954682150320808,564,All this wisdom isn't helping me get any work done.
1351,1,8,45,54,1.1851851851851851,0.05954682150320808,564,"Come with me, Margaret, and be free of chipmunks forever."
1351,2,6,46,54,1.1851851851851851,0.06515087083609597,564,"Phyllis, what's a quorum for a parliament of owls?"
1351,0,10,44,54,1.1851851851851851,0.05335739809593593,564,You will be closely watched during your trial period.
1351,2,6,46,54,1.1851851851851851,0.06515087083609597,564,Only after molting season was Edith able to find Thomas at his desk.
1351,2,6,46,54,1.1851851851851851,0.06515087083609597,564,I said we needed nine store outlets.
1351,1,8,45,54,1.1851851851851851,0.05954682150320808,564,"Well, they can type 80 words per minute ... but they ask too many questions."
1351,2,6,46,54,1.1851851851851851,0.06515087083609597,564,"You still have to do the harrassment training, Jerry."
1351,3,4,47,54,1.1851851851851851,0.07030965787335618,564,"Mr. Horton, do you hear a who?"
1351,1,8,45,54,1.1851851851851851,0.05954682150320808,564,Please send Walter Pidgeon in.
1351,1,8,45,54,1.1851851851851851,0.05954682150320808,564,I have fully staffed the night shift.
1351,1,8,45,54,1.1851851851851851,0.05954682150320808,564,Hoos calling.
1351,1,8,45,54,1.1851851851851851,0.05954682150320808,564,"Well, yes, I am the only 9-time winner of the 'Wisest Man In the Company' Award."
1351,0,10,44,54,1.1851851851851851,0.05335739809593593,564,They're the new applicants for the night shift.
1351,3,4,47,54,1.1851851851851851,0.07030965787335618,564,Who is replacing me for my night shift?
1351,0,10,44,54,1.1851851851851851,0.05335739809593593,564,"Sir, the lab has filed a missing mice report."
1351,1,8,45,54,1.1851851851851851,0.05954682150320808,564,Who said I don't give a hoot about this company?
1351,1,8,45,54,1.1851851851851851,0.05954682150320808,564,I really didn't mean it when I said that a few hooters around here might attract more customers.
1351,2,6,46,54,1.1851851851851851,0.06515087083609597,564,I am interviewing for night watchmen.
1351,3,4,47,54,1.1851851851851851,0.07030965787335618,564,Building maintenance requests that you lay down newspaper before the Board meeting starts.
1351,2,6,46,54,1.1851851851851851,0.06515087083609597,564,"They're hiring me to find their dad, last seen in a beautiful pea-green boat."
1351,2,6,46,54,1.1851851851851851,0.06515087083609597,564,"Make that ten mice, Miss Cartwright."
1351,1,8,45,54,1.1851851851851851,0.05954682150320808,564,"When I asked for secretaries that would turn heads, this isn't what I meant."
1351,2,6,46,54,1.1851851851851851,0.06515087083609597,564,"We're replacing you with nine of them, you should be flattered."
1351,2,6,46,54,1.1851851851851851,0.06515087083609597,564,"One is full of vodka, the rest are just regular taxidermies."
1351,1,8,45,54,1.1851851851851851,0.05954682150320808,564,The real question is why aren't YOU at your desk.
1351,1,8,45,54,1.1851851851851851,0.05954682150320808,564,You've been turning a lot of heads around here lately.
1351,2,6,46,54,1.1851851851851851,0.06515087083609597,564,I have gathered our customer service representatives together to get a little sunlight.
1351,3,4,47,54,1.1851851851851851,0.07030965787335618,564,We ordered a secret air weapon to defeat ISIS but autocorrect changed it to MICE.
1351,2,6,46,54,1.1851851851851851,0.06515087083609597,564,What do you think? Too much clutter?
1351,1,8,45,54,1.1851851851851851,0.05954682150320808,564,"This is the Corporate Communications Office, Mr. Price, not the Ministry of Magic."
1351,1,8,45,54,1.1851851851851851,0.05954682150320808,564,"I'm sorry, ma'am. This is a taxidermy office. The plastic surgeons office is down the hall."
1351,1,8,45,54,1.1851851851851851,0.05954682150320808,564,Well we already have the night shift covered.
1351,2,6,46,54,1.1851851851851851,0.06515087083609597,564,"No, what I said was invite the best and the brightest from the Third Branch."
1351,2,6,46,54,1.1851851851851851,0.06515087083609597,564,"I know I said ""Hooters"" for lunch, but...."
1351,3,4,47,54,1.1851851851851851,0.07030965787335618,564,So how did the retreat go?
1470,3,4,48,55,1.1818181818181819,0.06910154091509929,564,"""They've been selling like hoot cakes""."
1470,2,6,47,55,1.1818181818181819,0.06404390902685803,564,I don't know. Let me consult my parliament.
1470,1,8,46,55,1.1818181818181819,0.05855101715632098,564,"Evidently the cafeteria is out of mince, quince, and runcible spoons."
1470,2,6,47,55,1.1818181818181819,0.06404390902685803,564,The night shift's a hoot.
1470,2,6,47,55,1.1818181818181819,0.06404390902685803,564,"It's a win-win. They're not only wise, but non-partisan."
1470,3,4,48,55,1.1818181818181819,0.06910154091509929,564,"I re-read my memo and realized that I left the ""b"" off when I requested 9 bowls for this afternoon's meeting."
1476,1,7,44,52,1.1730769230769231,0.05966948841558946,564,"With women, it's cats."
1476,1,7,44,52,1.1730769230769231,0.05966948841558946,564,"Yes sir, you look much wiser."
1476,1,7,44,52,1.1730769230769231,0.05966948841558946,564,I seek the wisdom to know the difference.
1476,1,7,44,52,1.1730769230769231,0.05966948841558946,564,They look wise. That's good enough for me.
1476,2,5,45,52,1.1730769230769231,0.06568558183307435,564,I thought you would not be in today!?
1476,1,7,44,52,1.1730769230769231,0.05966948841558946,564,Who or whom? Who gives a hoot.
1476,2,5,45,52,1.1730769230769231,0.06568558183307435,564,"So, tell me... why do you want to work at Who's Who?"
1476,2,5,45,52,1.1730769230769231,0.06568558183307435,564,"""Who's on first?"" 'Who said that?'"
1476,0,9,43,52,1.1730769230769231,0.052974522506642974,564,"Sorry, Athena, there's only room for 9."
1476,1,7,44,52,1.1730769230769231,0.05966948841558946,564,I was not hooting at you.
1476,0,9,43,52,1.1730769230769231,0.052974522506642974,564,"'Yes, order me an ambrosia salad with pumpernickel toast. Oh, and 9 mice."""
1476,1,7,44,52,1.1730769230769231,0.05966948841558946,564,Send in Mr. Radcliffe.
1476,2,5,45,52,1.1730769230769231,0.06568558183307435,564,Nice hooters.
1476,1,7,44,52,1.1730769230769231,0.05966948841558946,564,"Fenwick, wisdom is qualitative, not quantitative."
1476,2,5,45,52,1.1730769230769231,0.06568558183307435,564,What do you mean you are replacing us with a wiser staff?
1476,3,3,46,52,1.1730769230769231,0.07119510849574463,564,"""Give a hoot....take a hoot""!"
1476,2,5,45,52,1.1730769230769231,0.06568558183307435,564,I thought you were going to get all your DUCKS in a row.
1476,2,5,45,52,1.1730769230769231,0.06568558183307435,564,"Well, you can't expect me to watch everyone on my team."
1476,2,5,45,52,1.1730769230769231,0.06568558183307435,564,"Must be time to leave, the night owls have arrived"
1476,1,7,44,52,1.1730769230769231,0.05966948841558946,564,"Hey Pat, I'd like to buy an owl."
1476,2,5,45,52,1.1730769230769231,0.06568558183307435,564,The memo saying that we are allowed wildlife on our desk was referring to plants.
1476,2,5,45,52,1.1730769230769231,0.06568558183307435,564,"Ms. Jenkins, I think I speak for all of us when I say, we don't give a hoot."
1476,1,7,44,52,1.1730769230769231,0.05966948841558946,564,We could just buy some mousetraps.
1476,3,3,46,52,1.1730769230769231,0.07119510849574463,564,Night owls. I said we need night owls.
1476,1,7,44,52,1.1730769230769231,0.05966948841558946,564,"Joan, I meant I wanted a box of cigars!"
1476,2,5,45,52,1.1730769230769231,0.06568558183307435,564,"To attract younger software engineers, we've started sending Harry Potter-themed job offers."
1476,2,5,45,52,1.1730769230769231,0.06568558183307435,564,"By the time they shutter the EPA, I'll have cornered the market on spotted owls."
1476,2,5,45,52,1.1730769230769231,0.06568558183307435,564,Wizard battle last weekend. We need to notify some next of kin.
1476,0,9,43,52,1.1730769230769231,0.052974522506642974,564,Your first day at Who's Who?
1476,2,5,45,52,1.1730769230769231,0.06568558183307435,564,"I had asked for more outlets, but this will work fine."
1476,1,7,44,52,1.1730769230769231,0.05966948841558946,564,Remind me not to tell you next time we have a mouse problem.
1476,1,7,44,52,1.1730769230769231,0.05966948841558946,564,"Clear my schedule, Allison. Me and the boys are staying out all night."
1476,2,5,45,52,1.1730769230769231,0.06568558183307435,564,"Margaret, the night shift is threatening to strike unless something is done about the bright lighting"
1476,1,7,44,52,1.1730769230769231,0.05966948841558946,564,"Now, do I look Wiser?"
1476,2,5,45,52,1.1730769230769231,0.06568558183307435,564,I keep losing my mouse.
1476,0,9,43,52,1.1730769230769231,0.052974522506642974,564,"I thought it was a clear case of nepotism, too."
1476,1,7,44,52,1.1730769230769231,0.05966948841558946,564,At least no one can say you don't give a hoot.
1476,2,5,45,52,1.1730769230769231,0.06568558183307435,564,Ordinary Wizarding Levels.
1476,1,7,44,52,1.1730769230769231,0.05966948841558946,564,I would like you to notify the Accounting Department that they are all being replaced immediately.
1476,2,5,45,52,1.1730769230769231,0.06568558183307435,564,"Reservation for 10 at Hooters, Ms. Deming."
1476,2,5,45,52,1.1730769230769231,0.06568558183307435,564,I don't give a hoot if my helpers are too cute; they're also astute!
1476,2,5,45,52,1.1730769230769231,0.06568558183307435,564,They're not as wise as I thought.
1476,2,5,45,52,1.1730769230769231,0.06568558183307435,564,Rest assured; wiser heads will prevail!
1476,2,5,45,52,1.1730769230769231,0.06568558183307435,564,"For the tenth time, I'd like to speak with George."
1476,3,3,46,52,1.1730769230769231,0.07119510849574463,564,Third Base!
1476,2,5,45,52,1.1730769230769231,0.06568558183307435,564,Find me a book on parliamentary procedure.
1476,2,5,45,52,1.1730769230769231,0.06568558183307435,564,I've called a meeting of parliament. What do you think it looks like?
1476,1,7,44,52,1.1730769230769231,0.05966948841558946,564,"It's not that I don't give a hoot, Nancy. If anything, I give too many."
1476,3,3,46,52,1.1730769230769231,0.07119510849574463,564,"You don't hear them complaining about working nights, do you?"
1476,1,7,44,52,1.1730769230769231,0.05966948841558946,564,It's take your owl to work day.
1476,3,3,46,52,1.1730769230769231,0.07119510849574463,564,It's not sexist; these ARE my hooters.
1476,1,7,44,52,1.1730769230769231,0.05966948841558946,564,"Madam, it should be clear by now that we don't give a hoot."
1476,2,5,45,52,1.1730769230769231,0.06568558183307435,564,Who?
1476,0,9,43,52,1.1730769230769231,0.052974522506642974,564,"Okay, okay--""to WHOM it may concern."""
1476,2,5,45,52,1.1730769230769231,0.06568558183307435,564,Did you notice we no longer have a mouse problem
1476,2,5,45,52,1.1730769230769231,0.06568558183307435,564,"Another look-alike contest, Alfred?"
1476,1,7,44,52,1.1730769230769231,0.05966948841558946,564,How do I get Hogwarts to stop spamming me?
1476,1,7,44,52,1.1730769230769231,0.05966948841558946,564,It exudes the aura of wisdom.......your question?
1476,3,3,46,52,1.1730769230769231,0.07119510849574463,564,"Email all users, please: No borrowing birds without permission."
1476,1,7,44,52,1.1730769230769231,0.05966948841558946,564,"No, Mr. Butler, I don't know who took your computer. But I have an idea about the mouse."""
1476,1,7,44,52,1.1730769230769231,0.05966948841558946,564,"I found that with more owls, it takes fewer licks overall to get to the center."
1476,0,9,43,52,1.1730769230769231,0.052974522506642974,564,I see you've taken care of your pigeon problem.
1476,3,3,46,52,1.1730769230769231,0.07119510849574463,564,"When the consultants said to surround yourself with wise counsel, I am pretty sure they did not have this in mind."
1476,0,9,43,52,1.1730769230769231,0.052974522506642974,564,"If it's wisdom you seek, you've obviously come to the right place."
1476,1,7,44,52,1.1730769230769231,0.05966948841558946,564,"You said I should get to know the ""who's who"" in this town!"
1476,2,5,45,52,1.1730769230769231,0.06568558183307435,564,They're cheaper than security cameras.
1476,1,7,44,52,1.1730769230769231,0.05966948841558946,564,I see Temple University is hinting around for a donation.
1476,2,5,45,52,1.1730769230769231,0.06568558183307435,564,"I'm sorry ma'am, but the whats, whys, wheres, whens, and hows have already been taken."
1476,0,9,43,52,1.1730769230769231,0.052974522506642974,564,"They're a bit more difficult to care for than cats but if you have a real problem with mice, this is the way to go."
1476,3,3,46,52,1.1730769230769231,0.07119510849574463,564,Tell Harry Potter to just email me
1476,2,5,45,52,1.1730769230769231,0.06568558183307435,564,"Miss Peters, you disappoint me. I never would have taken you for an owl hater."
1476,1,7,44,52,1.1730769230769231,0.05966948841558946,564,I like owls.
1476,2,5,45,52,1.1730769230769231,0.06568558183307435,564,"I'm sorry, who?"
1476,2,5,45,52,1.1730769230769231,0.06568558183307435,564,You can't have too many owls on your desk.
1476,2,5,45,52,1.1730769230769231,0.06568558183307435,564,Parliament is now in session!
1476,1,7,44,52,1.1730769230769231,0.05966948841558946,564,"Don't look at me like that, I know signing up for that Hogwarts newsletter was a mistake."
1476,0,9,43,52,1.1730769230769231,0.052974522506642974,564,"Stan, I think you're forgetting our policy regarding personal items in the work space..."
1476,1,7,44,52,1.1730769230769231,0.05966948841558946,564,"For the tenth time, who is here to see me?"
1476,2,5,45,52,1.1730769230769231,0.06568558183307435,564,"I know there's nine of them, Ms Buckley. I can count."
1476,2,5,45,52,1.1730769230769231,0.06568558183307435,564,"Let me guess, you ordered 9 outlets using speech recognition software."
1476,1,7,44,52,1.1730769230769231,0.05966948841558946,564,"Some bosses don't give a hoot, but not me."
1476,3,3,46,52,1.1730769230769231,0.07119510849574463,564,"Frankly, I don't give a Hoot"
1476,2,5,45,52,1.1730769230769231,0.06568558183307435,564,Call Harry Potter and tell him to stop leaving messages.
1476,2,5,45,52,1.1730769230769231,0.06568558183307435,564,"You're the first applicant who understands the meaning of ""hootnanny."""
1476,1,7,44,52,1.1730769230769231,0.05966948841558946,564,Pick the real one and you get a raise and a pet.
1476,2,5,45,52,1.1730769230769231,0.06568558183307435,564,"I tied to stop them sir, but they said that they're all here for the Hooters interview."
1476,1,7,44,52,1.1730769230769231,0.05966948841558946,564,There's a Dr. Who to see you.
1476,1,7,44,52,1.1730769230769231,0.05966948841558946,564,Batman is here to see you.
1476,2,5,45,52,1.1730769230769231,0.06568558183307435,564,"Well, Cheryl, aren't you just a hoot?"
1476,1,7,44,52,1.1730769230769231,0.05966948841558946,564,I think it's safe to remove them from the endangered species list.
1476,2,5,45,52,1.1730769230769231,0.06568558183307435,564,"I've been advised that our new motto is: ""We don't give a hoot."""
1476,2,5,45,52,1.1730769230769231,0.06568558183307435,564,This is ridiculous! How is it possible that everybody's computer mouse could disappear at the same time?
1476,1,7,44,52,1.1730769230769231,0.05966948841558946,564,One of our owls is missing.
1476,1,7,44,52,1.1730769230769231,0.05966948841558946,564,Just tell him I don't give a hoot!
1476,2,5,45,52,1.1730769230769231,0.06568558183307435,564,"So far I have taught them to say, ""What? Where? and When?"""
1476,2,5,45,52,1.1730769230769231,0.06568558183307435,564,"Mildred,I need nine pussycats and nine pea green boats,stat!"
1476,2,5,45,52,1.1730769230769231,0.06568558183307435,564,"Well, think it was a wise investment."
1476,1,7,44,52,1.1730769230769231,0.05966948841558946,564,Our rodent and reptile issues are over.
1476,0,9,43,52,1.1730769230769231,0.052974522506642974,564,I just thought we needed fresh eyes on the case.
1476,2,5,45,52,1.1730769230769231,0.06568558183307435,564,"I said “love those hooters, baby,” not “love those baby hooter!"""
1476,3,3,46,52,1.1730769230769231,0.07119510849574463,564,"The board has voted, in their infinite wisdom, to increase their director's compensation by an extra three rats and one mole per month."
1476,2,5,45,52,1.1730769230769231,0.06568558183307435,564,The chinchillas are no longer a problem.
1476,1,7,44,52,1.1730769230769231,0.05966948841558946,564,There are a lot of mice
1476,2,5,45,52,1.1730769230769231,0.06568558183307435,564,"Wisdom, my ass. These are for catching mice."
1476,1,7,44,52,1.1730769230769231,0.05966948841558946,564,I prefer listening to A Flock of Seagulls.
1476,4,1,47,52,1.1730769230769231,0.07630787172167883,564,"As far as parliaments go, this one looks pretty good."
1476,1,7,44,52,1.1730769230769231,0.05966948841558946,564,Ok. I get it. No more Indian mascot.
1476,1,7,44,52,1.1730769230769231,0.05966948841558946,564,Let me know when you're done with your Hitchcock moment.
1476,2,5,45,52,1.1730769230769231,0.06568558183307435,564,Are those to scare the crows away or just me?
1476,1,7,44,52,1.1730769230769231,0.05966948841558946,564,Remember when they used to give us apples?
1476,1,7,44,52,1.1730769230769231,0.05966948841558946,564,"You'll be handling some new duties, now."
1476,2,5,45,52,1.1730769230769231,0.06568558183307435,564,"For Pete's sake, hire me some morning people."
1476,1,7,44,52,1.1730769230769231,0.05966948841558946,564,Today must be the tryouts for first base.
1476,2,5,45,52,1.1730769230769231,0.06568558183307435,564,"Did you hit ""reply all"" again?"
1476,1,7,44,52,1.1730769230769231,0.05966948841558946,564,Martha this is not what I meant when I said I love Hooters.
1476,0,9,43,52,1.1730769230769231,0.052974522506642974,564,"You're right, it's time we turn the lights on."
1476,3,3,46,52,1.1730769230769231,0.07119510849574463,564,I see you've received many applications from Hogwarts for the new position.
1476,3,3,46,52,1.1730769230769231,0.07119510849574463,564,"Reagan had jelly beans. I got owls. Please, help yourself."
1476,1,7,44,52,1.1730769230769231,0.05966948841558946,564,"Stop saying ""who?"", you know damn well I'm talking to you."
1476,0,9,43,52,1.1730769230769231,0.052974522506642974,564,"Well, but have you seen any rodents in the office, Ms. Adams?"
1476,2,5,45,52,1.1730769230769231,0.06568558183307435,564,I rely on the wisdom of the crowd.
1476,2,5,45,52,1.1730769230769231,0.06568558183307435,564,I just hired the new night shift. They will start Monday.
1476,0,9,43,52,1.1730769230769231,0.052974522506642974,564,This isn't what it seems.
1476,1,7,44,52,1.1730769230769231,0.05966948841558946,564,"For the LAST time, I'm not that kind of vet!"
1476,2,5,45,52,1.1730769230769231,0.06568558183307435,564,Owl have what he's having.
1476,3,3,46,52,1.1730769230769231,0.07119510849574463,564,I said we'd need nine HOURS to finish this project.
1476,2,5,45,52,1.1730769230769231,0.06568558183307435,564,They usually work nights.
1476,1,7,44,52,1.1730769230769231,0.05966948841558946,564,"Who's not only on first, he's got the other eight positions cover, too."
1476,1,7,44,52,1.1730769230769231,0.05966948841558946,564,I hate working nights.
1476,1,7,44,52,1.1730769230769231,0.05966948841558946,564,I have been nominated to the U.S. a pellet court.
1476,2,5,45,52,1.1730769230769231,0.06568558183307435,564,"I'm sorry, madam, you're looking for whom?"
1476,1,7,44,52,1.1730769230769231,0.05966948841558946,564,They're the new third shift.
1476,2,5,45,52,1.1730769230769231,0.06568558183307435,564,We keep late hours here. I hope that won't be a problem.
1476,0,9,43,52,1.1730769230769231,0.052974522506642974,564,"Customer service is two doors down on the left, this is the 'I don't give a hoot department'."
1476,2,5,45,52,1.1730769230769231,0.06568558183307435,564,Pidgeon problem solved.
1476,2,5,45,52,1.1730769230769231,0.06568558183307435,564,"Yes, this is the complaint desk...but we don't give a hoot"
1612,0,6,29,35,1.1714285714285715,0.0646349059597627,564,Who doesn't understand Parliamentary procedure?
1613,0,9,44,53,1.169811320754717,0.05206789873629057,564,Something's different. Wait. Don't tell me. New tie?
1613,2,5,46,53,1.169811320754717,0.06451701239736683,564,A couple days of this and you'll forget all about the mice.
1613,2,5,46,53,1.169811320754717,0.06451701239736683,564,Nine years at Hooters corporate and this is how they thank me?!?
1613,0,9,44,53,1.169811320754717,0.05206789873629057,564,"No Mr. Hopkins, they do not make you appear wiser."
1613,1,7,45,53,1.169811320754717,0.0586238473980282,564,You didn't say COMPUTER mouse problem. I'll call I-T...
1613,3,3,47,53,1.169811320754717,0.06991519358205821,564,"So now that I showed you my ""Hooters"" why don't you show me yours?"
1613,1,7,45,53,1.169811320754717,0.0586238473980282,564,You Never Can Be Too Wise
1613,2,5,46,53,1.169811320754717,0.06451701239736683,564,"Still working the night shift, Mr. Wise?"
1613,0,9,44,53,1.169811320754717,0.05206789873629057,564,I said I was a night owl. Not 'I want nine owls.'
1613,2,5,46,53,1.169811320754717,0.06451701239736683,564,"Let's see...that'll be one corned beef on rye, eight dead mice, and a dachshund."
1613,1,7,45,53,1.169811320754717,0.0586238473980282,564,Nine complaints from Hogwarts. What's going on there?
1613,1,7,45,53,1.169811320754717,0.0586238473980282,564,I could give a hoot.
1613,2,5,46,53,1.169811320754717,0.06451701239736683,564,You're either with the plastic owls or you're with the pigeons.
1613,3,3,47,53,1.169811320754717,0.06991519358205821,564,They won't leave until they've spoken to an intellectual equal.
1613,1,7,45,53,1.169811320754717,0.0586238473980282,564,Whose the wisest of them all?
1613,0,9,44,53,1.169811320754717,0.05206789873629057,564,"Whom, Whom, is our next applicant?"
1613,2,5,46,53,1.169811320754717,0.06451701239736683,564,New interns for the night shift huh?!
1613,1,7,45,53,1.169811320754717,0.0586238473980282,564,This seems unwise.
1613,1,7,45,53,1.169811320754717,0.0586238473980282,564,"They don't care why, all they want to know is who."
1613,1,7,45,53,1.169811320754717,0.0586238473980282,564,To Whom--are you going to give those owls?
1613,2,5,46,53,1.169811320754717,0.06451701239736683,564,"With regard to those types of complaints, it's this HR department's policy not to give a hoot."
1613,0,9,44,53,1.169811320754717,0.05206789873629057,564,"Miss Heath, meet the new pest control service. In a week there won't be a single mouse left in this building!"
1613,1,7,45,53,1.169811320754717,0.0586238473980282,564,"They catch rodents, snakes and tweets. Theses 9 owls sitting before you could Make America Great Again."
1613,0,9,44,53,1.169811320754717,0.05206789873629057,564,"Jane, when I asked you to install Hootsuite on my desktop, this is not exactly what I had in mind."
1613,1,7,45,53,1.169811320754717,0.0586238473980282,564,I ordered takeout from Hooter's.
1613,2,5,46,53,1.169811320754717,0.06451701239736683,564,"Sorry, I thought they said they were with 'Who's Who.'"
1613,2,5,46,53,1.169811320754717,0.06451701239736683,564,Who just called.
1613,2,5,46,53,1.169811320754717,0.06451701239736683,564,The president's latest brain trust just flew in.
1613,2,5,46,53,1.169811320754717,0.06451701239736683,564,Swivel your head if you want mice again for lunch.
1613,2,5,46,53,1.169811320754717,0.06451701239736683,564,"Tell the guys in Sales I know it was them, and I don't care if they don't like our Give A Hoot campaign."
1613,2,5,46,53,1.169811320754717,0.06451701239736683,564,"Madam, if you're accusing one of my owls, it's not a question of who, it's whom."
1613,2,5,46,53,1.169811320754717,0.06451701239736683,564,Convince them why you need equal pay!
1613,2,5,46,53,1.169811320754717,0.06451701239736683,564,Maybe if you shave your mustache.
1613,1,7,45,53,1.169811320754717,0.0586238473980282,564,"I'm more interested in the ""why."""
1613,2,5,46,53,1.169811320754717,0.06451701239736683,564,We're very active at night.
1613,2,5,46,53,1.169811320754717,0.06451701239736683,564,I just keep needing more to get the same high.
1613,2,5,46,53,1.169811320754717,0.06451701239736683,564,"Let's not point fingers, but instead focus on what and why."
1613,1,7,45,53,1.169811320754717,0.0586238473980282,564,"You don't see any pigeons in here, do you?"
1613,2,5,46,53,1.169811320754717,0.06451701239736683,564,I asked for nine matching bowls. Look what they sent!
1613,1,7,45,53,1.169811320754717,0.0586238473980282,564,"Take an owl, Doris."
1613,2,5,46,53,1.169811320754717,0.06451701239736683,564,What's the problem? Would you rather they were ducks??
1613,2,5,46,53,1.169811320754717,0.06451701239736683,564,My wife wanted you to see her hooters
1613,1,7,45,53,1.169811320754717,0.0586238473980282,564,they just have one question for you
1613,0,9,44,53,1.169811320754717,0.05206789873629057,564,I’m certain I ordered vultures. I’m trying to set a mood here!
1613,3,3,47,53,1.169811320754717,0.06991519358205821,564,"Yes, HR does give a hoot."
1613,3,3,47,53,1.169811320754717,0.06991519358205821,564,They're the only ones the Senate could agree to confirm for the Supreme Court.
1613,2,5,46,53,1.169811320754717,0.06451701239736683,564,I like to surround myself with those wiser than myself.
1613,1,7,45,53,1.169811320754717,0.0586238473980282,564,They're Wise Guys.
1613,2,5,46,53,1.169811320754717,0.06451701239736683,564,.. it was bring your child to work day and we just had the 3D Printer delivered...
1613,2,5,46,53,1.169811320754717,0.06451701239736683,564,I prefer smart aleck.
1613,2,5,46,53,1.169811320754717,0.06451701239736683,564,Won't Miss Sinclair be amused when you explain yesterday's 'hooter' remark!
1613,1,7,45,53,1.169811320754717,0.0586238473980282,564,I told the IT department I was having a mouse problem
1613,2,5,46,53,1.169811320754717,0.06451701239736683,564,I think I've figured out why the lab mice keep disappearing.
1613,2,5,46,53,1.169811320754717,0.06451701239736683,564,Computer Services said I could change my desktop.
1613,2,5,46,53,1.169811320754717,0.06451701239736683,564,"Miss Burke, I'm afraid it's going to take more than a pooper-scooper."
1613,2,5,46,53,1.169811320754717,0.06451701239736683,564,They're in case we ever need to look the other way.
1613,0,9,44,53,1.169811320754717,0.05206789873629057,564,"They're my eyes, now I have to find my ears."
1613,1,7,45,53,1.169811320754717,0.0586238473980282,564,"That's right, nine mice and a tuna salad sandwich."
1613,3,3,47,53,1.169811320754717,0.06991519358205821,564,"Endangered? No, not at all—we've cornered the market and control the supply."
1613,2,5,46,53,1.169811320754717,0.06451701239736683,564,"I stand by the owls. If they go Mr. Jennings, I go!"
1613,2,5,46,53,1.169811320754717,0.06451701239736683,564,Parliament. Not a flock. A parliament of owls.
1674,1,6,42,49,1.163265306122449,0.060797833101086655,564,I see that parliament has convened
1674,1,6,42,49,1.163265306122449,0.060797833101086655,564,What do you think you are? Some kind of wise guy?
1674,2,4,43,49,1.163265306122449,0.06742934558367009,564,Larry again tried to garner support for his decision by enlisting a parliament of owls.
1674,2,4,43,49,1.163265306122449,0.06742934558367009,564,Is this Mensa?
1674,1,6,42,49,1.163265306122449,0.060797833101086655,564,Do you really think I give a hoot ?
1674,2,4,43,49,1.163265306122449,0.06742934558367009,564,Are you the guy who gives a hoot?
1674,1,6,42,49,1.163265306122449,0.060797833101086655,564,"See? When I said that I love hooters, I meant owls. Please don't sue."
1674,1,6,42,49,1.163265306122449,0.060797833101086655,564,I thought we agreed on carrier pigeons.
1674,1,6,42,49,1.163265306122449,0.060797833101086655,564,I'd prefer my bonus.
1674,0,8,41,49,1.163265306122449,0.05334825558285075,564,"Well, the mice are gone."
1674,2,4,43,49,1.163265306122449,0.06742934558367009,564,We heard you were coming.
1674,2,4,43,49,1.163265306122449,0.06742934558367009,564,I could have sworn that I asked you to order nine awls.
1674,3,2,44,49,1.163265306122449,0.07346466349134413,564,Im here to clean the mirror.
1674,0,8,41,49,1.163265306122449,0.05334825558285075,564,You can't say I don't give a hoot.
1674,1,6,42,49,1.163265306122449,0.060797833101086655,564,"Still waiting on that Hogwarts acceptance letter, huh, Bernie?"
1674,1,6,42,49,1.163265306122449,0.060797833101086655,564,Nor does it make you look wiser that you didn't cover your desk with newspapers.
1674,1,6,42,49,1.163265306122449,0.060797833101086655,564,When I asked to write the who's who column this isn't what I meant.
1674,1,6,42,49,1.163265306122449,0.060797833101086655,564,I couldn't find a babysitter.
1674,2,4,43,49,1.163265306122449,0.06742934558367009,564,Sanctuary EPA desk.
1674,2,4,43,49,1.163265306122449,0.06742934558367009,564,I don't care if they're nocturnal - the interns are not allowed to work after 5.
1674,1,6,42,49,1.163265306122449,0.060797833101086655,564,Work's been a hoot lately.
1674,2,4,43,49,1.163265306122449,0.06742934558367009,564,Whooooo is the next salesman?
1674,1,6,42,49,1.163265306122449,0.060797833101086655,564,There use to be 10 but one wised up to what we do.
1674,1,6,42,49,1.163265306122449,0.060797833101086655,564,"It's the new morale-booster ""Give a Hoot!"" campaign."
1674,3,2,44,49,1.163265306122449,0.07346466349134413,564,"Night Owls!! Phyllis, I said this place could use some night owls!"
1674,1,6,42,49,1.163265306122449,0.060797833101086655,564,Does these desk make me look smarter?
1674,3,2,44,49,1.163265306122449,0.07346466349134413,564,"""Boys, this lady has never seen 'The Birds'."
1674,0,8,41,49,1.163265306122449,0.05334825558285075,564,"Not ideal, granted; but the mouse infestation is over."
1674,2,4,43,49,1.163265306122449,0.06742934558367009,564,You are a wise man Mr. Smith.
1674,2,4,43,49,1.163265306122449,0.06742934558367009,564,Who’s to say I can’t join parliament?
1674,0,8,41,49,1.163265306122449,0.05334825558285075,564,The guys at the club couldn't believe it when I told them I had nine birdies.
1674,1,6,42,49,1.163265306122449,0.060797833101086655,564,They just flew in for the Hooters convention.
1674,0,8,41,49,1.163265306122449,0.05334825558285075,564,This is my method of escaping the rat race.
1674,1,6,42,49,1.163265306122449,0.060797833101086655,564,"Mrs. Smith, I don’t give a hoot."
1674,2,4,43,49,1.163265306122449,0.06742934558367009,564,"Mrs. Thistlecrump, verily, am I not the penultimate hoot?"
1674,0,8,41,49,1.163265306122449,0.05334825558285075,564,I'm really not an 'email' person.
1674,2,4,43,49,1.163265306122449,0.06742934558367009,564,"Given you're no longer accepting of my advances, I've decided to get my own set of hooters."
1674,0,8,41,49,1.163265306122449,0.05334825558285075,564,The next IT guy we hire--make sure he doesn't wear wizard robes.
1674,1,6,42,49,1.163265306122449,0.060797833101086655,564,I suspected you were a night owl.
1674,1,6,42,49,1.163265306122449,0.060797833101086655,564,Who is who?
1674,1,6,42,49,1.163265306122449,0.060797833101086655,564,Francis is wondering which conference room for the sorting hat.
1674,2,4,43,49,1.163265306122449,0.06742934558367009,564,"I came here ten years ago with just two of them, and they called me crazy. Well, who's crazy now?"
1674,0,8,41,49,1.163265306122449,0.05334825558285075,564,Remember I have eyes everywhere
1674,2,4,43,49,1.163265306122449,0.06742934558367009,564,Yesterday I read 'The Art of the Deal' and today I'm surrounded by wise guys!
1674,2,4,43,49,1.163265306122449,0.06742934558367009,564,"Jane, get us a large cheese pizza, two dozen white mice and some coffee, it looks like an all-nighter."
1674,1,6,42,49,1.163265306122449,0.060797833101086655,564,You're fired
1674,1,6,42,49,1.163265306122449,0.060797833101086655,564,I heard your column is a virtual Who's Who of New York society.
1674,0,8,41,49,1.163265306122449,0.05334825558285075,564,I'd still rather have a computer.
1674,0,8,41,49,1.163265306122449,0.05334825558285075,564,"I may have left the window open last night, why?"
1674,3,2,44,49,1.163265306122449,0.07346466349134413,564,"Why are all these owls on my desk? Because this is all that's left of the EPA and these are all the owls that are left, period."
1674,2,4,43,49,1.163265306122449,0.06742934558367009,564,"Well, WE don't give a hoot!"
1674,2,4,43,49,1.163265306122449,0.06742934558367009,564,I'll ask the questions around here.
1674,3,2,44,49,1.163265306122449,0.07346466349134413,564,I don't like Yes Men. I like Who Men.
1674,2,4,43,49,1.163265306122449,0.06742934558367009,564,"That's what I said, Who's on my desk!"
1674,0,8,41,49,1.163265306122449,0.05334825558285075,564,I asked for wet towelettes.
1674,0,8,41,49,1.163265306122449,0.05334825558285075,564,I was promoted after getting all my ducks in a row.
1674,3,2,44,49,1.163265306122449,0.07346466349134413,564,"Well, you're not seeing my hooters"
1674,1,6,42,49,1.163265306122449,0.060797833101086655,564,You know who I am. Stop asking.
1674,2,4,43,49,1.163265306122449,0.06742934558367009,564,Who...are you talking too?
1674,2,4,43,49,1.163265306122449,0.06742934558367009,564,That's not exactly what I meant when I said show me your hooters.
1674,2,4,43,49,1.163265306122449,0.06742934558367009,564,Guess I should have read the fine print on that membership application to Hooters.
1674,2,4,43,49,1.163265306122449,0.06742934558367009,564,They've never heard of you.
1674,0,8,41,49,1.163265306122449,0.05334825558285075,564,Not the hostile takeover I had expected....
1674,1,6,42,49,1.163265306122449,0.060797833101086655,564,Me.
1674,2,4,43,49,1.163265306122449,0.06742934558367009,564,One thousand one hundred and thirty-three days without a squirrel-related accident.
1674,1,6,42,49,1.163265306122449,0.060797833101086655,564,"Parliament passed a vote of no confidence. You're out, Cheryl."
1674,2,4,43,49,1.163265306122449,0.06742934558367009,564,Prime Minister has her parliament and I have mine.
1674,1,6,42,49,1.163265306122449,0.060797833101086655,564,We'd like to file a class action suit against the pussycat.
1674,1,6,42,49,1.163265306122449,0.060797833101086655,564,Owl be right with you.
1674,1,6,42,49,1.163265306122449,0.060797833101086655,564,"Don't worry, they're all rescues"
1674,2,4,43,49,1.163265306122449,0.06742934558367009,564,"Ms. Jennings, we just don't give a hoot."
1674,2,4,43,49,1.163265306122449,0.06742934558367009,564,"This isn't bad, actually. I've had some 14-owl days."
1674,0,8,41,49,1.163265306122449,0.05334825558285075,564,"I'm sorry, Pam, but you're the only one to complain about the new hours."
1674,1,6,42,49,1.163265306122449,0.060797833101086655,564,I feel more comfortable among my equals.
1674,1,6,42,49,1.163265306122449,0.060797833101086655,564,"Oh, I'm a loyal Temple U. alumni."
1674,2,4,43,49,1.163265306122449,0.06742934558367009,564,"OK. OK. OK. But let's not forget the what, where and when."
1674,1,6,42,49,1.163265306122449,0.060797833101086655,564,"May I ask who, who, who, who, who, who, who, who, who, who you are?"
1674,2,4,43,49,1.163265306122449,0.06742934558367009,564,"OK Lucille, I do give a hoot about you."
1674,0,8,41,49,1.163265306122449,0.05334825558285075,564,I'll have the ham on rye and the rest of the board will hunt mice in the barn.
1674,0,8,41,49,1.163265306122449,0.05334825558285075,564,Who's the boss.
1674,2,4,43,49,1.163265306122449,0.06742934558367009,564,"We're a package deal Mrs. Ellis. If they go, I go."
1674,1,6,42,49,1.163265306122449,0.060797833101086655,564,What? When? Where? And why?
1674,1,6,42,49,1.163265306122449,0.060797833101086655,564,I've never even heard of a 270-degree performance review...whose idea was this?
1674,1,6,42,49,1.163265306122449,0.060797833101086655,564,"Janice, meet the new recruits. I hear they are a bunch of night owls."
1674,1,6,42,49,1.163265306122449,0.060797833101086655,564,"For the eighth time Mr. Clark, it is your wife on line 3."
1674,0,8,41,49,1.163265306122449,0.05334825558285075,564,Who versus whom; is that your question?
1674,1,6,42,49,1.163265306122449,0.060797833101086655,564,"Miss Adams, when I told the employees at the Monday meeting to give a hoot, this is not what I had in mind."
1761,0,9,47,56,1.1607142857142858,0.04952230059306297,564,"We're wise to your ways, Mrs. Oglethorpe."
1762,0,8,42,50,1.16,0.05237229365663817,564,Got the message - you don't give a hoot
1762,0,8,42,50,1.16,0.05237229365663817,564,Let's review the pellets from last week's meeting.
1762,1,6,43,50,1.16,0.05965889433663171,564,It's their bread time.
1762,2,4,44,50,1.16,0.06614763944451557,564,"I'm interested in the what, where, when, and why."
1762,2,4,44,50,1.16,0.06614763944451557,564,I'm going for the extreme wise look
1762,0,8,42,50,1.16,0.05237229365663817,564,Welcome to Hooters.
1762,1,6,43,50,1.16,0.05965889433663171,564,They're here to advise me on my nest egg.
1762,1,6,43,50,1.16,0.05965889433663171,564,What? Where? When?
1762,1,6,43,50,1.16,0.05965889433663171,564,Hoo da man?
1762,1,6,43,50,1.16,0.05965889433663171,564,Are you the wise guy?
1762,2,4,44,50,1.16,0.06614763944451557,564,"Nice hooters, sir."
1762,1,6,43,50,1.16,0.05965889433663171,564,First just tell me if you give a hoot.
1762,2,4,44,50,1.16,0.06614763944451557,564,"Miss Johnson, the executives at Hooters take a dim view of you practical jokes."
1762,1,6,43,50,1.16,0.05965889433663171,564,They insist on parliamentian procedure!
1762,1,6,43,50,1.16,0.05965889433663171,564,"Order ten large coffees, a turkey club and a bucket of squirrels. We're gonna be here all night."
1777,1,5,39,45,1.1555555555555554,0.06321005190772531,564,...and cancel my ten o'clock owl.
1777,0,7,38,45,1.1555555555555554,0.05463890236888291,564,"""I'll have a BLT and they'll have 9 mice""."
1777,1,5,39,45,1.1555555555555554,0.06321005190772531,564,"Please tell the other owls that our Parliament is full, Ms. Brown, but thank them for running."
1777,1,5,39,45,1.1555555555555554,0.06321005190772531,564,"Yes, they keep the birds away from the windows in my mind"
1777,1,5,39,45,1.1555555555555554,0.06321005190772531,564,I see Parliament is in session
1782,1,5,40,46,1.1521739130434783,0.061913070618242964,564,This isn't exactly what I had in mind when I said we need to weed out the corporate vermin.
1782,1,5,40,46,1.1521739130434783,0.061913070618242964,564,"Crazy? Yeah, crazy like an owl."
1782,2,3,41,46,1.1521739130434783,0.06927778784183837,564,I've told you nine times now: your wife called.
1782,1,5,40,46,1.1521739130434783,0.061913070618242964,564,Don't wanna be... owl by myself
1782,0,7,39,46,1.1521739130434783,0.05354479188959757,564,"Okay, but where's the funkadelic?"
1782,0,7,39,46,1.1521739130434783,0.05354479188959757,564,"Parliamentary, my dear."
1782,1,5,40,46,1.1521739130434783,0.061913070618242964,564,This isn't what I imagined when I asked you to organise a twitter account.
1782,0,7,39,46,1.1521739130434783,0.05354479188959757,564,We're out of stock on carrier pigeons.
1782,1,5,40,46,1.1521739130434783,0.061913070618242964,564,Did someone leave the window open.
1782,1,5,40,46,1.1521739130434783,0.061913070618242964,564,"Well, owl-be."
1782,1,5,40,46,1.1521739130434783,0.061913070618242964,564,Hooters called. They want you to keep the flock out of there.
1782,1,5,40,46,1.1521739130434783,0.061913070618242964,564,The 18 wing Hooter's delivery had not been what Mr. Nolan was expecting.
1782,2,3,41,46,1.1521739130434783,0.06927778784183837,564,Nice set of hooters you got there
1782,0,7,39,46,1.1521739130434783,0.05354479188959757,564,"As you can see, I give a hoot."
1782,1,5,40,46,1.1521739130434783,0.061913070618242964,564,"As I already explained, Alice. I don't give a hoot."
1782,1,5,40,46,1.1521739130434783,0.061913070618242964,564,Tell Hogwarts we aren't hiring.
1782,0,7,39,46,1.1521739130434783,0.05354479188959757,564,which one do you think is the wisest looking?
1782,1,5,40,46,1.1521739130434783,0.061913070618242964,564,"Frankly, I don't give a hoot what you think."
1782,0,7,39,46,1.1521739130434783,0.05354479188959757,564,Bring in the mice
1782,1,5,40,46,1.1521739130434783,0.061913070618242964,564,Good thing Hogwarts lets me pay Kevin's tuition on the installment plan.
1782,0,7,39,46,1.1521739130434783,0.05354479188959757,564,"For the last time, Gladys, its owl or nothing!"
1782,1,5,40,46,1.1521739130434783,0.061913070618242964,564,"As a matter of fact, Ms. Jones, I DO feel wiser."
1782,1,5,40,46,1.1521739130434783,0.061913070618242964,564,"It's a very good idea, Ms. Carswell. I'm just not sure it's a wise idea."
1782,1,5,40,46,1.1521739130434783,0.061913070618242964,564,The babysitter called in sick
1782,2,3,41,46,1.1521739130434783,0.06927778784183837,564,"So far, we have one pastrami on rye and the internal organ platter for your guests..."
1782,1,5,40,46,1.1521739130434783,0.061913070618242964,564,"So the ""owls"" have it?"
1782,0,7,39,46,1.1521739130434783,0.05354479188959757,564,The company's going down fast. Should we sell something other than owl statues?
1782,1,5,40,46,1.1521739130434783,0.061913070618242964,564,"For the last time, Doris, generic white-out just isn't as precise."
1782,2,3,41,46,1.1521739130434783,0.06927778784183837,564,As of today you need to address me as prime minister
1782,2,3,41,46,1.1521739130434783,0.06927778784183837,564,Be very careful not to ask me the name of the sender.
1782,0,7,39,46,1.1521739130434783,0.05354479188959757,564,They voted to remain.
1782,1,5,40,46,1.1521739130434783,0.061913070618242964,564,"You know, just in case there's a pigeon attack."
1782,1,5,40,46,1.1521739130434783,0.061913070618242964,564,They refuse to deliver messages to the White House.
1782,1,5,40,46,1.1521739130434783,0.061913070618242964,564,"Of course they're friendly, just don't reach for a book without asking"
1782,1,5,40,46,1.1521739130434783,0.061913070618242964,564,I'm afraid my job is endangered.
1782,1,5,40,46,1.1521739130434783,0.061913070618242964,564,Would you please tell them that the Parliament meets at the government's office!
1782,2,3,41,46,1.1521739130434783,0.06927778784183837,564,We lost the Hogwarts account.
1782,2,3,41,46,1.1521739130434783,0.06927778784183837,564,So the new girl in accounting is she weird or what?
1782,2,3,41,46,1.1521739130434783,0.06927778784183837,564,"You may be wise, but you are not good"
1782,1,5,40,46,1.1521739130434783,0.061913070618242964,564,Is this our new Mice Squad?
1782,1,5,40,46,1.1521739130434783,0.061913070618242964,564,The applicants for the night shift.
1782,1,5,40,46,1.1521739130434783,0.061913070618242964,564,"If you don't mind, I've invited some friends over. I didn't want to be owl by myself."
1782,1,5,40,46,1.1521739130434783,0.061913070618242964,564,"They keep the mice down, and no litter box."
1782,1,5,40,46,1.1521739130434783,0.061913070618242964,564,Once you tell people how much you like live owls every one gets you one.
1782,2,3,41,46,1.1521739130434783,0.06927778784183837,564,Tell them owl see them when I'm ready.
1782,2,3,41,46,1.1521739130434783,0.06927778784183837,564,Abigail. Abigail. Abigail. Abigail. Abigail. Abigail. Abigail. Abigail. Abigail.
1782,1,5,40,46,1.1521739130434783,0.061913070618242964,564,"Your ""Smart Desk"" will require extensive maintenance."
1782,2,3,41,46,1.1521739130434783,0.06927778784183837,564,I'm learning to Tweet
1782,1,5,40,46,1.1521739130434783,0.061913070618242964,564,"No one gives a hoot like you, Mr. Fleishman."
1782,1,5,40,46,1.1521739130434783,0.061913070618242964,564,People need to understand that I just don't give a hoot.
1782,1,5,40,46,1.1521739130434783,0.061913070618242964,564,"""And what do ""we"" say, when the men in the straight-jackets ask for me, Ms. Turnbaum""!?"
1782,1,5,40,46,1.1521739130434783,0.061913070618242964,564,What was your question?
1782,1,5,40,46,1.1521739130434783,0.061913070618242964,564,It's a real Who done it.
1782,0,7,39,46,1.1521739130434783,0.05354479188959757,564,The ministry of magic must really want to get ahold of you
1782,0,7,39,46,1.1521739130434783,0.05354479188959757,564,"They've come to discuss the potato chip account. We'd like one latte and nine mice, thanks."
1782,0,7,39,46,1.1521739130434783,0.05354479188959757,564,You asked to be in charge of the hooters account.
1782,2,3,41,46,1.1521739130434783,0.06927778784183837,564,"First the Glasses! Now the owls! I am telling you, you do not look any smarter."
1782,0,7,39,46,1.1521739130434783,0.05354479188959757,564,How many owls does it take to get a hoot out of you?
1782,0,7,39,46,1.1521739130434783,0.05354479188959757,564,Do you need a who or a whom?
1782,1,5,40,46,1.1521739130434783,0.061913070618242964,564,"... And with every new policy you sell, you get your pick of owls as a bonus!"
1782,1,5,40,46,1.1521739130434783,0.061913070618242964,564,Is this the last Hitchcock remake meeting?
1782,1,5,40,46,1.1521739130434783,0.061913070618242964,564,"You’re a Hoot, Mr. Johnson."
1782,0,7,39,46,1.1521739130434783,0.05354479188959757,564,"""I've officially been accepted to teach at the Hogwarts School of Medicine.''"
1782,1,5,40,46,1.1521739130434783,0.061913070618242964,564,We just picked up Hogwarts as a new client.
1782,0,7,39,46,1.1521739130434783,0.05354479188959757,564,One a day really keeps my wisdom top notch!
1782,1,5,40,46,1.1521739130434783,0.061913070618242964,564,Take a message.
1782,2,3,41,46,1.1521739130434783,0.06927778784183837,564,I have decided to convene a parliament.
1782,0,7,39,46,1.1521739130434783,0.05354479188959757,564,The teams says they will no longer work the day shift.
1782,1,5,40,46,1.1521739130434783,0.061913070618242964,564,I think I may have a problem.
1782,0,7,39,46,1.1521739130434783,0.05354479188959757,564,Here are the candidates for the night shift you requested.
1782,2,3,41,46,1.1521739130434783,0.06927778784183837,564,"Shipment to Athens, Ms Steinkauz."
1782,2,3,41,46,1.1521739130434783,0.06927778784183837,564,Everyone's a wise guy these days.
1782,1,5,40,46,1.1521739130434783,0.061913070618242964,564,"No, Martin, what I said was, ""the break room needs more towels"""
1782,1,5,40,46,1.1521739130434783,0.061913070618242964,564,But do you see any pigeons?
1782,0,7,39,46,1.1521739130434783,0.05354479188959757,564,There were 10 until he got wise with me.
1782,2,3,41,46,1.1521739130434783,0.06927778784183837,564,I want YOU to give a hoot.
1782,1,5,40,46,1.1521739130434783,0.061913070618242964,564,Whooh ? Me?
1782,0,7,39,46,1.1521739130434783,0.05354479188959757,564,"Why no, I'm not offended you like my hooters."
1782,1,5,40,46,1.1521739130434783,0.061913070618242964,564,"No, Ms. DeVos. Adding another owl to your Hogwarts Charter School does not demonstrate growth..... Or proficiency."
1782,1,5,40,46,1.1521739130434783,0.061913070618242964,564,I don't care what the wildlife people told you - this is not accruing wisdom.
1782,3,1,42,46,1.1521739130434783,0.07593151824596947,564,"Actually, I DO give a hoot."
1782,1,5,40,46,1.1521739130434783,0.061913070618242964,564,I imagine your staff likes to be kept in the dark
1782,3,1,42,46,1.1521739130434783,0.07593151824596947,564,"They're charging their boss with a hate crime for calling them ""hooters""."
1782,1,5,40,46,1.1521739130434783,0.061913070618242964,564,"Well, I'd say the lack of rodents around here means it IS working out, Phyllis."
1782,1,5,40,46,1.1521739130434783,0.061913070618242964,564,"Janet, call shipping. I ordered nine bar towels."
1782,0,7,39,46,1.1521739130434783,0.05354479188959757,564,Who do I talk to about the night shift position you have open?
1782,1,5,40,46,1.1521739130434783,0.061913070618242964,564,The owls of wisdom fly at 5:00.
1782,1,5,40,46,1.1521739130434783,0.061913070618242964,564,Interesting...but how can you tell whose who?
1782,2,3,41,46,1.1521739130434783,0.06927778784183837,564,"Not the parliament I meant, Sir."
1782,1,5,40,46,1.1521739130434783,0.061913070618242964,564,This explains the decapitated bobblehead on the floor of my office!
1782,0,7,39,46,1.1521739130434783,0.05354479188959757,564,"Ms. Bell, I am also guessing our lunch order with the Nine Als deli isn't on its way right?"
1782,2,3,41,46,1.1521739130434783,0.06927778784183837,564,I thought you said it would be a nine-owl job.
1782,1,5,40,46,1.1521739130434783,0.061913070618242964,564,I want nine pussycats delivered here first thing in the morning.
1782,0,7,39,46,1.1521739130434783,0.05354479188959757,564,You don't have to be such a wise-guy!
1782,1,5,40,46,1.1521739130434783,0.061913070618242964,564,Wisdom comes in many forms.
1782,0,7,39,46,1.1521739130434783,0.05354479188959757,564,"Pussycats, Miss Benson, not Pussyhats."
1782,1,5,40,46,1.1521739130434783,0.061913070618242964,564,"I know you said they're service owls, but I don't really give a hoot."
1782,0,7,39,46,1.1521739130434783,0.05354479188959757,564,Searching for Whoo???
1782,1,5,40,46,1.1521739130434783,0.061913070618242964,564,Well then she should leave her mice at home next Pet Day.
1782,1,5,40,46,1.1521739130434783,0.061913070618242964,564,I do give a hoot. Take one
1782,0,7,39,46,1.1521739130434783,0.05354479188959757,564,All I said was 'Who's on first?'
1782,1,5,40,46,1.1521739130434783,0.061913070618242964,564,So this is why you ordered 20 mice for lunch?
1782,0,7,39,46,1.1521739130434783,0.05354479188959757,564,Please regurgitate your lunch Janice.
1782,0,7,39,46,1.1521739130434783,0.05354479188959757,564,Whooooo indeed Ms. Buckley?
1782,1,5,40,46,1.1521739130434783,0.061913070618242964,564,"You can be too thin. You can have too much money. But never, Mrs. Reilly, can you have too many owls."
1782,1,5,40,46,1.1521739130434783,0.061913070618242964,564,So......WHO'S ON FIRST??
1782,3,1,42,46,1.1521739130434783,0.07593151824596947,564,"Yes, there are 10 pins in Duckpin Bowling, but in Owlpin Bowling we only use 9 pins."
1782,1,5,40,46,1.1521739130434783,0.061913070618242964,564,I'll be out once parliament adjourns.
1782,0,7,39,46,1.1521739130434783,0.05354479188959757,564,I told you to order TOWELS!!
1782,1,5,40,46,1.1521739130434783,0.061913070618242964,564,They're all here on H-1Tree Visa's.
1782,2,3,41,46,1.1521739130434783,0.06927778784183837,564,Who is who?
1782,2,3,41,46,1.1521739130434783,0.06927778784183837,564,Very wise selections for our Parliamentary caucus sir...but will they fly?
1782,1,5,40,46,1.1521739130434783,0.061913070618242964,564,They say they keep pigeons away We'll see.
1782,1,5,40,46,1.1521739130434783,0.061913070618242964,564,"I don't even know how this concerns you Henry, but I'm pretty sure I said *bowel* movement"
1782,1,5,40,46,1.1521739130434783,0.061913070618242964,564,I am haunted by my Greek past.
1782,2,3,41,46,1.1521739130434783,0.06927778784183837,564,"Mr. Babcock, I agreed to an eight owl workday. This is simply too much."
1782,2,3,41,46,1.1521739130434783,0.06927778784183837,564,"I keep telling them it's ""whom"", but they won't listen."
1782,1,5,40,46,1.1521739130434783,0.061913070618242964,564,"No Miss Jones, I said ""Bring me nine Towels"" not nine Owls"
1782,2,3,41,46,1.1521739130434783,0.06927778784183837,564,Working third shift has changed you.
1782,1,5,40,46,1.1521739130434783,0.061913070618242964,564,They don't give a hoot
1782,1,5,40,46,1.1521739130434783,0.061913070618242964,564,"Is there another desk for what, where, when and why questions?"
1782,1,5,40,46,1.1521739130434783,0.061913070618242964,564,We're waiting for map quest to provide directions for reaching Hogwarts.
1782,2,3,41,46,1.1521739130434783,0.06927778784183837,564,This is my neck rehab under Trumpcare.
1782,0,7,39,46,1.1521739130434783,0.05354479188959757,564,The deli screwed up my order again.
1782,2,3,41,46,1.1521739130434783,0.06927778784183837,564,"Diane, in the future, when I ask for a Parliament, I am referring to a brand of cigarettes."
1782,2,3,41,46,1.1521739130434783,0.06927778784183837,564,It's all about hoo you know
1782,2,3,41,46,1.1521739130434783,0.06927778784183837,564,I will be judged by the company I keep.
1782,1,5,40,46,1.1521739130434783,0.061913070618242964,564,"I don't care, Who!, I want to know Why!"
1782,1,5,40,46,1.1521739130434783,0.061913070618242964,564,I'm Doctor Who's agent.
1782,1,5,40,46,1.1521739130434783,0.061913070618242964,564,They demand a cease and desist from nine ladies dancing
1782,1,5,40,46,1.1521739130434783,0.061913070618242964,564,"More humane than glueboards, Ms. Ricketts."
1782,0,7,39,46,1.1521739130434783,0.05354479188959757,564,"I was told to join a support-group for my Harry Potter addiction, so I did."
1782,2,3,41,46,1.1521739130434783,0.06927778784183837,564,I said BIG hooters!
1782,1,5,40,46,1.1521739130434783,0.061913070618242964,564,New hires at The Inquirer
1782,1,5,40,46,1.1521739130434783,0.061913070618242964,564,"Before you ask, it's a parliament."
1782,0,7,39,46,1.1521739130434783,0.05354479188959757,564,"I know what you are thinking...... if I hoot with the owls tonight, I won't soar with the eagles tomorrow."
1782,1,5,40,46,1.1521739130434783,0.061913070618242964,564,It's the new wisdom app.
1782,2,3,41,46,1.1521739130434783,0.06927778784183837,564,You should know I really enjoy your hooters.
1782,2,3,41,46,1.1521739130434783,0.06927778784183837,564,"No, Sir, no orders today. But I hear hawks and buzzards and selling well in some markets."
1782,1,5,40,46,1.1521739130434783,0.061913070618242964,564,Do these owls make me look fat?
1782,1,5,40,46,1.1521739130434783,0.061913070618242964,564,They're a hoot.
1782,2,3,41,46,1.1521739130434783,0.06927778784183837,564,The prunes haven't helped with regular owl movements.
1782,2,3,41,46,1.1521739130434783,0.06927778784183837,564,"Miss Simmons, I asked to see hotels, not hoot owls."
1782,2,3,41,46,1.1521739130434783,0.06927778784183837,564,I thought you had a bowel problem.
1782,0,7,39,46,1.1521739130434783,0.05354479188959757,564,We respect your right to identify as an owl.
1782,0,7,39,46,1.1521739130434783,0.05354479188959757,564,It's the only way I could be a member of parliament.
1782,0,7,39,46,1.1521739130434783,0.05354479188959757,564,My inbox is full.
1782,0,7,39,46,1.1521739130434783,0.05354479188959757,564,I distincly said 'clean towels'are needed in the men's room.
1782,0,7,39,46,1.1521739130434783,0.05354479188959757,564,Look what I brought back from lunch at Hooters!
1782,1,5,40,46,1.1521739130434783,0.061913070618242964,564,Do I seem wiser to you since my promotion?
1782,1,5,40,46,1.1521739130434783,0.061913070618242964,564,"Frankly, Mrs. Crankshaw, we don't give a hoot!"
1782,1,5,40,46,1.1521739130434783,0.061913070618242964,564,Who indeed.
1782,2,3,41,46,1.1521739130434783,0.06927778784183837,564,But I saw the best minds of my generation destroyed by madness.
1782,2,3,41,46,1.1521739130434783,0.06927778784183837,564,Does this make you a wise guy?
1782,1,5,40,46,1.1521739130434783,0.061913070618242964,564,I'm hoping they'll help me with my night life.
1782,1,5,40,46,1.1521739130434783,0.061913070618242964,564,Do you think that's wise?
1782,2,3,41,46,1.1521739130434783,0.06927778784183837,564,"Yes, we have gone to the birds. Tell me something I don't know."
1782,2,3,41,46,1.1521739130434783,0.06927778784183837,564,"Your cats, my pea-green boat out back-- Shangri-La, Miss Davis!"
1782,2,3,41,46,1.1521739130434783,0.06927778784183837,564,I love working here. It's a hoot.
1782,2,3,41,46,1.1521739130434783,0.06927778784183837,564,"We can't afford drones, but then I thought of Harry Potter..."
1782,0,7,39,46,1.1521739130434783,0.05354479188959757,564,"Wisdom is not accrued easily, my dear."
1782,2,3,41,46,1.1521739130434783,0.06927778784183837,564,"Frankly, Edna, we don't give two hoots for your opinion."
1782,2,3,41,46,1.1521739130434783,0.06927778784183837,564,"Frankly, Miss Peterson, I don't give a hoot."
1782,2,3,41,46,1.1521739130434783,0.06927778784183837,564,They don't give a hoot about the clean desk policy.
1782,2,3,41,46,1.1521739130434783,0.06927778784183837,564,"Let me tell you, I speak from a place of wisdom."
1782,2,3,41,46,1.1521739130434783,0.06927778784183837,564,"Miss Haversham, here is your order for a dozen towels. No more Alexa for you."
1782,3,1,42,46,1.1521739130434783,0.07593151824596947,564,Be nice. They attack pests.
1782,0,7,39,46,1.1521739130434783,0.05354479188959757,564,I'm simply here to offer a word to the wise.
1782,1,5,40,46,1.1521739130434783,0.061913070618242964,564,"Sir, the next candidate for Who's Who in America is here for his interview."
1782,1,5,40,46,1.1521739130434783,0.061913070618242964,564,"Well, smarty pants, the President of the United States says we ARE being attacked by zombie rodents."
1782,1,5,40,46,1.1521739130434783,0.061913070618242964,564,"No, this does not officially make you a member of parliament."
1782,1,5,40,46,1.1521739130434783,0.061913070618242964,564,"Take a litter, Miss Jones."
1782,1,5,40,46,1.1521739130434783,0.061913070618242964,564,"Well, it seemed like a good idea in ""Harry Potter."""
1782,1,5,40,46,1.1521739130434783,0.061913070618242964,564,"New staff members, show them the room with very poor lighting."
1956,0,7,40,47,1.148936170212766,0.05249310253140096,564,"Now, for three dollars more per hour, which owl has the pea under it?"
1956,1,5,41,47,1.148936170212766,0.06066790909183939,564,They keep the birds off my desk.
1956,1,5,41,47,1.148936170212766,0.06066790909183939,564,"Ever since e-readers, there's been a shortage of work for the book owls."
1956,1,5,41,47,1.148936170212766,0.06066790909183939,564,Just need a little inspiration for some words of wisdom to give at the next meeting.
1956,1,5,41,47,1.148936170212766,0.06066790909183939,564,Are you Horton?
1956,1,5,41,47,1.148936170212766,0.06066790909183939,564,I've heard they're better than email.
1956,1,5,41,47,1.148936170212766,0.06066790909183939,564,There's another under the desk savaging my innards.
1956,2,3,42,47,1.148936170212766,0.06786504677504616,564,I just do not like trolls.
1956,1,5,41,47,1.148936170212766,0.06066790909183939,564,They do make me feel wiser.
1956,1,5,41,47,1.148936170212766,0.06066790909183939,564,A BLT on toast and nine mice please
1956,2,3,42,47,1.148936170212766,0.06786504677504616,564,You can also reach J. K. Rowling by email.
1956,1,5,41,47,1.148936170212766,0.06066790909183939,564,And there's more where they came from.
1956,0,7,40,47,1.148936170212766,0.05249310253140096,564,"Sir, you may have a parliament, but you are not the Prime Minister."
1956,3,1,43,47,1.148936170212766,0.07436890448287321,564,Send in the lawyers from Rodent & Rodent.
1956,1,5,41,47,1.148936170212766,0.06066790909183939,564,"Yes, we now give a hoot!"
1956,1,5,41,47,1.148936170212766,0.06066790909183939,564,"I'm not mad, I'm just disappointed."
1956,1,5,41,47,1.148936170212766,0.06066790909183939,564,Well it's about time that you start giving a hoot!
1956,1,5,41,47,1.148936170212766,0.06066790909183939,564,I think I left a window open.
1956,2,3,42,47,1.148936170212766,0.06786504677504616,564,"Do you have the damn Tootsie Roll pops or not, Karen?"
1956,1,5,41,47,1.148936170212766,0.06066790909183939,564,Reply Owl!
1956,0,7,40,47,1.148936170212766,0.05249310253140096,564,I really do give a hoot.
1956,1,5,41,47,1.148936170212766,0.06066790909183939,564,"Yes, I'll do anything to sign David Sedaris."
1956,0,7,40,47,1.148936170212766,0.05249310253140096,564,"Sorry, I meant 'to whom' do the owls belong?"
1956,1,5,41,47,1.148936170212766,0.06066790909183939,564,"You hooted, sir?"
1956,1,5,41,47,1.148936170212766,0.06066790909183939,564,"This isn't what I expected when I answered the ad for "" Hooters manager wanted"""
1956,1,5,41,47,1.148936170212766,0.06066790909183939,564,Ms Rogers when I said I was a lonely night owl this is not what I meant.
1956,1,5,41,47,1.148936170212766,0.06066790909183939,564,Owls are the new penguins
1956,1,5,41,47,1.148936170212766,0.06066790909183939,564,It's my birthday and my true love gave me nine owls a hooting
1956,1,5,41,47,1.148936170212766,0.06066790909183939,564,"Ms. Crenshaw, would you bring me the book on parliamentary procedure."
1956,0,7,40,47,1.148936170212766,0.05249310253140096,564,"Ask away, Ms. Perkins. That's what we're here for."
1956,1,5,41,47,1.148936170212766,0.06066790909183939,564,"Women's rights are now decided by Parliament, instead of Congress."
1956,1,5,41,47,1.148936170212766,0.06066790909183939,564,NOT TO WORRY. JUST CANCEL THE JOURNAL AND GET ME 9 DEAD MICE.
1956,2,3,42,47,1.148936170212766,0.06786504677504616,564,Tell them the intelligence committee meets at 10:00 A.M. today.
1956,0,7,40,47,1.148936170212766,0.05249310253140096,564,Which one of these owls do you think goes best with my tie?
1956,2,3,42,47,1.148936170212766,0.06786504677504616,564,I take it they were out of boobies.
1956,1,5,41,47,1.148936170212766,0.06066790909183939,564,I believe I ordered a dozen small towels.
1956,2,3,42,47,1.148936170212766,0.06786504677504616,564,"No, I did not have lunch at Hooters. Why do you ask?"
1956,1,5,41,47,1.148936170212766,0.06066790909183939,564,All I'd wanted was a towel rack.
1956,2,3,42,47,1.148936170212766,0.06786504677504616,564,"Spread them around, we need to appear much wiser than we really are."
1956,0,7,40,47,1.148936170212766,0.05249310253140096,564,"Your guess is as good as mine, Minerva. I guess we'll just have to wait till after the dusk."
1956,0,7,40,47,1.148936170212766,0.05249310253140096,564,Don't see a mouse on my desk; do you?
1956,0,7,40,47,1.148936170212766,0.05249310253140096,564,At first I hated it. Now I really hate it.
1956,1,5,41,47,1.148936170212766,0.06066790909183939,564,Can you please introduce them with rest of your class?
1999,1,6,47,54,1.1481481481481481,0.05549729066741694,564,We are taking Parliament in a different direction this year.
2000,1,3,30,34,1.1470588235294117,0.07472293375658888,564,We thought it was only camels
2000,1,3,30,34,1.1470588235294117,0.07472293375658888,564,"I pluck all the feathers, chop the head off and cook at 450 for 20 minutes...tastes like chicken!!"
2000,1,3,30,34,1.1470588235294117,0.07472293375658888,564,"OK, you want one. But who?"
2003,3,1,44,48,1.1458333333333333,0.07286915878889004,564,The mice are gone. In fact we need to order some.
2003,2,3,43,48,1.1458333333333333,0.06650856696625959,564,"Ok, we've solved the rodent problem. What's next?"
2005,1,4,37,42,1.1428571428571428,0.0644049739048166,564,I've been looking for greener pest control for some time.
2005,0,6,36,42,1.1428571428571428,0.05464943254828616,564,I'm going to need a bigger desk.
2005,0,6,36,42,1.1428571428571428,0.05464943254828616,564,They're a hoot.
2005,0,6,36,42,1.1428571428571428,0.05464943254828616,564,Owl Theraprey
2005,1,4,37,42,1.1428571428571428,0.0644049739048166,564,Hoot! There it is.
2010,0,7,43,50,1.14,0.04956957592256419,564,My wife wouldn't let me go to Hooters...
2011,1,4,39,44,1.1363636363636365,0.06161077006722115,564,"I need to know ""who's who!"""
2011,2,2,40,44,1.1363636363636365,0.06966325746551968,564,Welcome to the 3rd Shift
2011,0,6,38,44,1.1363636363636365,0.05233358898302985,564,The students are here to receive their 'wisdom awards.'
2011,0,6,38,44,1.1363636363636365,0.05233358898302985,564,Would you please escort the owls out of the building.
2011,1,4,39,44,1.1363636363636365,0.06161077006722115,564,"Yes, Miss Gribbins, I'll have a tuna on rye and twelve live mice."
2011,0,6,38,44,1.1363636363636365,0.05233358898302985,564,But on the bright side the mice are gone.
2011,0,6,38,44,1.1363636363636365,0.05233358898302985,564,Stare all you want. We really don't give a hoot!
2011,0,6,38,44,1.1363636363636365,0.05233358898302985,564,Welcome to the Harry Potter message center.
2011,0,6,38,44,1.1363636363636365,0.05233358898302985,564,Kindly alphabetize and file these. Miss Smith
2011,2,2,40,44,1.1363636363636365,0.06966325746551968,564,You will have to sit somewhere else that's Al's desk.
2011,1,4,39,44,1.1363636363636365,0.06161077006722115,564,Our leveraged buyout of Hooters didn't go as planned.
2011,2,2,40,44,1.1363636363636365,0.06966325746551968,564,"They're eating all the chicken nuggets en route, so I want you to do a market analysis for nocturnal vegan deliveries."
2011,0,6,38,44,1.1363636363636365,0.05233358898302985,564,I'm spamming Hogwarts.
2011,1,4,39,44,1.1363636363636365,0.06161077006722115,564,I'll have a bigger selection coming in tonight.
2011,1,4,39,44,1.1363636363636365,0.06161077006722115,564,Now I can talk about your hooters without breaking any laws.
2011,1,4,39,44,1.1363636363636365,0.06161077006722115,564,"Biblically speaking, this isn't the Raptor I was praying for."
2011,0,6,38,44,1.1363636363636365,0.05233358898302985,564,May I say whoo is asking?
2011,2,2,40,44,1.1363636363636365,0.06966325746551968,564,"Oh no, More Harry Potter Sequels?!"
2011,2,2,40,44,1.1363636363636365,0.06966325746551968,564,And why do you wish to work for Hooters?
2011,1,4,39,44,1.1363636363636365,0.06161077006722115,564,"I'm leaving you, James. It's been a hoot."
2011,0,6,38,44,1.1363636363636365,0.05233358898302985,564,We’re also replacing company softball with Quidditch.
2011,0,6,38,44,1.1363636363636365,0.05233358898302985,564,I guess the CEO said he wanted us in more 'stringent form' but I could've sworn he said he wanted 'strigiformes'.
2011,1,4,39,44,1.1363636363636365,0.06161077006722115,564,"So you see Mrs. Rumplemeyer, I do, in fact, give a hoot."
2011,1,4,39,44,1.1363636363636365,0.06161077006722115,564,"Tennyson said ""Knowledge comes, but wisdom lingers"". He didn't mention how that might affect English oak..."
2011,1,4,39,44,1.1363636363636365,0.06161077006722115,564,They usually work the night shift
2011,0,6,38,44,1.1363636363636365,0.05233358898302985,564,"Margaret, please make a reservation for ten at Hooters."
2011,0,6,38,44,1.1363636363636365,0.05233358898302985,564,How many owls does it take to get to the center of a Tootsie pop?
2011,0,6,38,44,1.1363636363636365,0.05233358898302985,564,This explains why you only work at night.
2011,2,2,40,44,1.1363636363636365,0.06966325746551968,564,"Better than donkeys or elephants, I hope."
2011,1,4,39,44,1.1363636363636365,0.06161077006722115,564,So who gives a hoot?
2011,0,6,38,44,1.1363636363636365,0.05233358898302985,564,"Just letting you know, I give a hoot."
2011,1,4,39,44,1.1363636363636365,0.06161077006722115,564,"Miss Jennings would you please remove these owls from my desk and send in the clowns."""
2011,1,4,39,44,1.1363636363636365,0.06161077006722115,564,"I said we need night owls for the late shift, not nine owls."
2011,1,4,39,44,1.1363636363636365,0.06161077006722115,564,You know...you still aren't getting any wiser.
2011,0,6,38,44,1.1363636363636365,0.05233358898302985,564,Just don't call them hooters.
2011,0,6,38,44,1.1363636363636365,0.05233358898302985,564,Your nine owl clock is here.
2011,2,2,40,44,1.1363636363636365,0.06966325746551968,564,Who needs Congress when I have a parliament?
2011,2,2,40,44,1.1363636363636365,0.06966325746551968,564,You must be the night shift manager.
2011,1,4,39,44,1.1363636363636365,0.06161077006722115,564,I was the first thing they saw!
2011,1,4,39,44,1.1363636363636365,0.06161077006722115,564,Review the Minister of Magic's tweets for the article.
2011,2,2,40,44,1.1363636363636365,0.06966325746551968,564,"Hey, what are you looking at?"
2011,1,4,39,44,1.1363636363636365,0.06161077006722115,564,Owls well. How are things with you?
2011,2,2,40,44,1.1363636363636365,0.06966325746551968,564,"Madam,do you think I'd still be sitting here if I gave a hoot?"
2011,2,2,40,44,1.1363636363636365,0.06966325746551968,564,That Harry Potter is very persistent.
2011,1,4,39,44,1.1363636363636365,0.06161077006722115,564,"Your husband wants a divorce, sir."
2011,0,6,38,44,1.1363636363636365,0.05233358898302985,564,My drawers are full of mice.
2011,0,6,38,44,1.1363636363636365,0.05233358898302985,564,"Roberta, I just can't have them here today."
2011,0,6,38,44,1.1363636363636365,0.05233358898302985,564,We need to get more desks for the new night shift staff.
2011,0,6,38,44,1.1363636363636365,0.05233358898302985,564,I'm scamming kids by sending them letters from Hogwarts asking for money.
2011,1,4,39,44,1.1363636363636365,0.06161077006722115,564,We've been getting a lot of mail from Hogwarts lately.
2011,0,6,38,44,1.1363636363636365,0.05233358898302985,564,We're gonna need more worms. It's gonna be a late night.
2011,0,6,38,44,1.1363636363636365,0.05233358898302985,564,"They may be wise, Sir, but they're never objective."
2011,1,4,39,44,1.1363636363636365,0.06161077006722115,564,Another A-Pellet Court Case ?
2011,1,4,39,44,1.1363636363636365,0.06161077006722115,564,"Rick Perry Syndrome, for the presently-intellectual.."
2011,1,4,39,44,1.1363636363636365,0.06161077006722115,564,"In this organization we refer to them as a parliament of owls. Please don't embarrass yourself by calling them a ""hoot""."
2011,2,2,40,44,1.1363636363636365,0.06966325746551968,564,"Congratulations, Sir. You've finally cornered the market."
2011,2,2,40,44,1.1363636363636365,0.06966325746551968,564,"So it's official, nine out of ten of you give a hoot."
2011,0,6,38,44,1.1363636363636365,0.05233358898302985,564,I'm here for the Hooters interview.
2011,1,4,39,44,1.1363636363636365,0.06161077006722115,564,"Hoo are you, hoo hoo, hoo hoo? I really wanna know...."
2011,2,2,40,44,1.1363636363636365,0.06966325746551968,564,I'm expecting great things now that we have a full flock again.
2011,1,4,39,44,1.1363636363636365,0.06161077006722115,564,We think there's a niche opportunity in the wisdom space.
2011,1,4,39,44,1.1363636363636365,0.06161077006722115,564,Which one of you hooted?
2011,0,6,38,44,1.1363636363636365,0.05233358898302985,564,You should have come at night that's when I'm really productive.
2011,1,4,39,44,1.1363636363636365,0.06161077006722115,564,"I heard you on the phone sir, thought you said you'd love a nice pair of Hooters in your face, so I thought I'd surprise you with a parliament."
2011,1,4,39,44,1.1363636363636365,0.06161077006722115,564,"Frankly, I don't give a hoot what you think."
2011,0,6,38,44,1.1363636363636365,0.05233358898302985,564,"So that's nine field-mice paninis and one BLT club, hold the mayo."
2011,1,4,39,44,1.1363636363636365,0.06161077006722115,564,Let me give you a quick who's hoo of our accounting department.
2011,1,4,39,44,1.1363636363636365,0.06161077006722115,564,"Well, you asked for all the mail from from J.K. Rowlng."
2011,1,4,39,44,1.1363636363636365,0.06161077006722115,564,Please get your wand for some dictation.
2011,1,4,39,44,1.1363636363636365,0.06161077006722115,564,Do they hold lifetime appointments?
2011,0,6,38,44,1.1363636363636365,0.05233358898302985,564,"Yeah, but what where when and why?"
2011,2,2,40,44,1.1363636363636365,0.06966325746551968,564,"Yes, are you the Hootin' Nanny?"
2011,0,6,38,44,1.1363636363636365,0.05233358898302985,564,There just aren't enough owls in the day.
2011,2,2,40,44,1.1363636363636365,0.06966325746551968,564,"If they bother you, you may have irritable owl syndrome."
2011,1,4,39,44,1.1363636363636365,0.06161077006722115,564,"Contrary to what people think, Miss Davis, I do give a hoot!"
2011,1,4,39,44,1.1363636363636365,0.06161077006722115,564,Owls see in the dark. Now we'll know what goes on here.
2011,1,4,39,44,1.1363636363636365,0.06161077006722115,564,"Didn't we learned from the ""Barrel of Monkeys"" Incident?"
2011,0,6,38,44,1.1363636363636365,0.05233358898302985,564,"Solar panels, composting, organic snacks - fine. I'm drawing the line at mouse traps."
2011,2,2,40,44,1.1363636363636365,0.06966325746551968,564,"Okay John, I get your point, it's late. You can go home now."
2011,1,4,39,44,1.1363636363636365,0.06161077006722115,564,"Go on, say it. ""Who let the dogs out..."""
2011,1,4,39,44,1.1363636363636365,0.06161077006722115,564,"If you're even thinking of starting a sentence with ""Who...,"" spare me."
2011,1,4,39,44,1.1363636363636365,0.06161077006722115,564,Which one handles unnecessary bullshit?
2011,1,4,39,44,1.1363636363636365,0.06161077006722115,564,I can't remember the last tine I moved my owls.
2011,2,2,40,44,1.1363636363636365,0.06966325746551968,564,"Mr.Pussycat is here again sir, he says it's urgent."
2011,2,2,40,44,1.1363636363636365,0.06966325746551968,564,"Harry, I really think email is more efficient."
2011,0,6,38,44,1.1363636363636365,0.05233358898302985,564,I showed you my hooters.
2011,0,6,38,44,1.1363636363636365,0.05233358898302985,564,Whom is the object form.
2011,1,4,39,44,1.1363636363636365,0.06161077006722115,564,"Frankly, Marsha, I don't give a hoot."
2011,1,4,39,44,1.1363636363636365,0.06161077006722115,564,It will be a few minutes more. Would you like an owl while you wait?
2011,1,4,39,44,1.1363636363636365,0.06161077006722115,564,"No, you can't claim them as dependents."
2011,1,4,39,44,1.1363636363636365,0.06161077006722115,564,I love casual Friday.
2011,2,2,40,44,1.1363636363636365,0.06966325746551968,564,Make that one cappuccino and nine mice.
2011,2,2,40,44,1.1363636363636365,0.06966325746551968,564,Great news Miss Jones! Our research team is finally going to get to the bottom of 'how many licks does it take to get to the center of a Tootsie Pop'.
2011,0,6,38,44,1.1363636363636365,0.05233358898302985,564,Because my kids said we couldn't be hacked.
2011,1,4,39,44,1.1363636363636365,0.06161077006722115,564,I don't think the pigeons will come inside.
2011,1,4,39,44,1.1363636363636365,0.06161077006722115,564,I'm gonna need a bigger desk.
2011,1,4,39,44,1.1363636363636365,0.06161077006722115,564,"If you're so smart, why did you vote for Trump?"
2011,1,4,39,44,1.1363636363636365,0.06161077006722115,564,The Internet of Things is far more complicated than I realized.
2011,0,6,38,44,1.1363636363636365,0.05233358898302985,564,Well the rest of the staff give a hoot about their jobs.
2011,1,4,39,44,1.1363636363636365,0.06161077006722115,564,Whom are you here to see?
2011,1,4,39,44,1.1363636363636365,0.06161077006722115,564,Could you place a delivery order for one Cobb Salad and nine voles?
2011,1,4,39,44,1.1363636363636365,0.06161077006722115,564,What's up with the flocking owls?
2011,1,4,39,44,1.1363636363636365,0.06161077006722115,564,"And after this I'll teach them what, where, when, why, and how"
2011,1,4,39,44,1.1363636363636365,0.06161077006722115,564,What's the count on the swimming pool statuary shipped to Mar-a-Lago?
2011,0,6,38,44,1.1363636363636365,0.05233358898302985,564,"Hey Olga, i bought these night-vision cameras, can we have them installed?"
2011,2,2,40,44,1.1363636363636365,0.06966325746551968,564,"Mrs. Spinalzo, I've solved our rodent problem."
2011,1,4,39,44,1.1363636363636365,0.06161077006722115,564,The new one swung the vote against your raise.
2011,1,4,39,44,1.1363636363636365,0.06161077006722115,564,I assure you the office is vermin-free.
2011,1,4,39,44,1.1363636363636365,0.06161077006722115,564,I see you've surrounded yourself with the whose who of banking
2011,1,4,39,44,1.1363636363636365,0.06161077006722115,564,Because ten wouldn't leave me room for my laptop.
2011,2,2,40,44,1.1363636363636365,0.06966325746551968,564,"I'm sorry, Marge. We don't have enough for a quorum. Your vacation request has been denied."
2011,2,2,40,44,1.1363636363636365,0.06966325746551968,564,Whoville. Where else?
2011,2,2,40,44,1.1363636363636365,0.06966325746551968,564,They're seeking asylum from the late-night twittersphere.
2011,1,4,39,44,1.1363636363636365,0.06161077006722115,564,Can I have the potted plant please?
2011,1,4,39,44,1.1363636363636365,0.06161077006722115,564,"Garbled message. I said, ""Buy low. No more than nine."""
2011,1,4,39,44,1.1363636363636365,0.06161077006722115,564,We have a record crowd lined up outside for the hootenanny.
2011,0,6,38,44,1.1363636363636365,0.05233358898302985,564,Owl betcha can't eat just one!
2011,0,6,38,44,1.1363636363636365,0.05233358898302985,564,Those are the best hooters I've ever seen.
2011,0,6,38,44,1.1363636363636365,0.05233358898302985,564,Owl get right on that.
2011,0,6,38,44,1.1363636363636365,0.05233358898302985,564,So I thought the hell with it I'm bringing all my owls with me to work today
2011,2,2,40,44,1.1363636363636365,0.06966325746551968,564,Owl-righty-then
2011,0,6,38,44,1.1363636363636365,0.05233358898302985,564,Box'em and send them to J. K. This is the last time.
2011,2,2,40,44,1.1363636363636365,0.06966325746551968,564,Trying to keep the stool pigeons away eh?
2011,1,4,39,44,1.1363636363636365,0.06161077006722115,564,All hell broke loose when they discovered the third from the left is really a cat.
2011,1,4,39,44,1.1363636363636365,0.06161077006722115,564,I like to go beyond the conventional wisdom. They give me stock tips.
2011,1,4,39,44,1.1363636363636365,0.06161077006722115,564,"Oh good, you're here. They're here to talk about Brexit."
2011,1,4,39,44,1.1363636363636365,0.06161077006722115,564,"FYI Dennis, the Mouse Department has made a formal complaint again."
2011,0,6,38,44,1.1363636363636365,0.05233358898302985,564,"Why? Because we give a hoot!"""
2011,0,6,38,44,1.1363636363636365,0.05233358898302985,564,"Miss Abernathy, would you tell me if you heard gossiping about my jowls?"
2011,1,4,39,44,1.1363636363636365,0.06161077006722115,564,Wanna' see 'em go crazy?...Ask me 'Who let the owls out?'
2011,1,4,39,44,1.1363636363636365,0.06161077006722115,564,"Well, aren't you a hoot."
2011,0,6,38,44,1.1363636363636365,0.05233358898302985,564,"No, I asked for towels."
2011,0,6,38,44,1.1363636363636365,0.05233358898302985,564,We're loaning these out until the mainframe is back on line.
2011,2,2,40,44,1.1363636363636365,0.06966325746551968,564,I'm afraid the company has no further need for your wisdom and perspicacity.
2011,3,0,41,44,1.1363636363636365,0.07687686188404527,564,They’ve solved my rodent problem but replaced it with an existential crisis.
2011,0,6,38,44,1.1363636363636365,0.05233358898302985,564,"Athena, it's called a parliament. Not a gaggle nor a bevy but a parliament."
2011,1,4,39,44,1.1363636363636365,0.06161077006722115,564,"Ah, Mrs. Jones, it gets lonely at the top."
2011,0,6,38,44,1.1363636363636365,0.05233358898302985,564,"They are symbols of wisdom, but they have reached the limits of my desktop."
2011,0,6,38,44,1.1363636363636365,0.05233358898302985,564,they can't say I don't give a hoot around here any more............
2011,2,2,40,44,1.1363636363636365,0.06966325746551968,564,"Your idea for owl bobblehead day, Miss Wertz, was rather unsuccessful."
2011,1,4,39,44,1.1363636363636365,0.06161077006722115,564,"Sorry, my desk is a little fluttered"
2011,0,6,38,44,1.1363636363636365,0.05233358898302985,564,"Mr. Jackson, you've been hired. The correct answer was 'whom'."
2011,2,2,40,44,1.1363636363636365,0.06966325746551968,564,I wish you'd stop staring at my hooters!
2011,0,6,38,44,1.1363636363636365,0.05233358898302985,564,Find out whoo did this.
2011,0,6,38,44,1.1363636363636365,0.05233358898302985,564,What should I tell the pidgeons in reception?
2011,1,4,39,44,1.1363636363636365,0.06161077006722115,564,You're replacing me with hoo?
2011,0,6,38,44,1.1363636363636365,0.05233358898302985,564,There are a lot of teams with no first baseman.
2011,1,4,39,44,1.1363636363636365,0.06161077006722115,564,"Pastrami on rye, a Dr. Brown soda and nine mice as usual Miss. Screech."
2011,0,6,38,44,1.1363636363636365,0.05233358898302985,564,I think there are still a few in the file cabinet.
2011,1,4,39,44,1.1363636363636365,0.06161077006722115,564,Still trying to solve the mice problem in the office?
2011,0,6,38,44,1.1363636363636365,0.05233358898302985,564,"We got rid of the pigeons and rats, now how do we get rid of the wise guys?"
2011,1,4,39,44,1.1363636363636365,0.06161077006722115,564,You say these are library drones?
2011,0,6,38,44,1.1363636363636365,0.05233358898302985,564,Go ahead and complain...see if anyone gives a hoot!
2011,0,6,38,44,1.1363636363636365,0.05233358898302985,564,I don't give a hoot which one you choose.
2011,2,2,40,44,1.1363636363636365,0.06966325746551968,564,"Those guys at the genius bar are so smug, this is the wisdom desk"
2011,0,6,38,44,1.1363636363636365,0.05233358898302985,564,"A grilled Reuben with pickles, a root beer, and nine live mice."
2011,0,6,38,44,1.1363636363636365,0.05233358898302985,564,The next step in my quest for wisdom is to synchronize our sleep schedules.
2011,1,4,39,44,1.1363636363636365,0.06161077006722115,564,I've been working nine owl days and still can't anything done.
2011,2,2,40,44,1.1363636363636365,0.06966325746551968,564,"Oh, Darrell, you're a hoot."
2011,1,4,39,44,1.1363636363636365,0.06161077006722115,564,Listen Ethel. There's nine good reason why I'm the hoo's hoo of Acme accounting department.
2011,1,4,39,44,1.1363636363636365,0.06161077006722115,564,Who told you that? Who? Who?
2011,1,4,39,44,1.1363636363636365,0.06161077006722115,564,I wanted to show you all that I am capable of giving two hoots!
2011,2,2,40,44,1.1363636363636365,0.06966325746551968,564,MEET YOUR NEW TRUMP UNIVERSITY PROFESSORS.
2011,0,6,38,44,1.1363636363636365,0.05233358898302985,564,I understand your grievances but you can't beat the working owls
2011,1,4,39,44,1.1363636363636365,0.06161077006722115,564,They ask the right questions.
2011,1,4,39,44,1.1363636363636365,0.06161077006722115,564,I seem to be missing an owl.
2011,1,4,39,44,1.1363636363636365,0.06161077006722115,564,They get the chicks.
2011,1,4,39,44,1.1363636363636365,0.06161077006722115,564,It's about who?
2011,0,6,38,44,1.1363636363636365,0.05233358898302985,564,I can see you don't give a hoot.
2011,2,2,40,44,1.1363636363636365,0.06966325746551968,564,"Sir, the staff would like to meet your Transition Team."
2011,2,2,40,44,1.1363636363636365,0.06966325746551968,564,"When I requested a meeting to appeal my termination notice, I didn't know I'd have to appear before the entire Executive Committee."
2011,2,2,40,44,1.1363636363636365,0.06966325746551968,564,"Who, who did you say again was here to see me?"
2011,2,2,40,44,1.1363636363636365,0.06966325746551968,564,The feng shui consultant is here. She has come up with a slightly revised positioning plan
2011,0,6,38,44,1.1363636363636365,0.05233358898302985,564,These all night sessions of Parliament are killing me!
2011,2,2,40,44,1.1363636363636365,0.06966325746551968,564,"Yes, my name is Horton. Why?"
2011,1,4,39,44,1.1363636363636365,0.06161077006722115,564,Why would I ask you to order more owls for the restrooms?
2011,1,4,39,44,1.1363636363636365,0.06161077006722115,564,Thanks for sharing Miss Wilson but those are not the hooters we are looking for.
2011,2,2,40,44,1.1363636363636365,0.06966325746551968,564,Well owl be darned...
2011,0,6,38,44,1.1363636363636365,0.05233358898302985,564,Can I get you 10 cups of coffee?
2011,1,4,39,44,1.1363636363636365,0.06161077006722115,564,We're forming a committee to revise Who's Hoo.
2011,2,2,40,44,1.1363636363636365,0.06966325746551968,564,You really need to stop acting so mousy.
2011,1,4,39,44,1.1363636363636365,0.06161077006722115,564,They're hiring us to help them bring Harry Potter jobs back.
2011,1,4,39,44,1.1363636363636365,0.06161077006722115,564,"Sorry madam, but 'owl be seeing you' violates the strict no-pun rule of our caption contest."
2011,1,4,39,44,1.1363636363636365,0.06161077006722115,564,"You said 'have something that'll turn heads on your desk by Tuesday'. Well guess what kinda, it's Tuesday."
2011,3,0,41,44,1.1363636363636365,0.07687686188404527,564,"Yes Ms. Horne, the owls are not what they seem."
2011,1,4,39,44,1.1363636363636365,0.06161077006722115,564,I need your help. I seem to be missing one.
2011,2,2,40,44,1.1363636363636365,0.06966325746551968,564,"I'm sorry, I don't know if any of these is wise or old."
2011,2,2,40,44,1.1363636363636365,0.06966325746551968,564,"Frankly, Mrs. Jenkins, we don't give a hoot!"
2011,2,2,40,44,1.1363636363636365,0.06966325746551968,564,"Miss Carlson, I need someone to take care of this situation immediately. Please call the hootenanny agency."
2011,0,6,38,44,1.1363636363636365,0.05233358898302985,564,They've decided that they want to be called a 'funkadelic of owls' instead.
2011,2,2,40,44,1.1363636363636365,0.06966325746551968,564,"I don't care what you read in that book, owls are not the answer to the rising postal rates."
2011,2,2,40,44,1.1363636363636365,0.06966325746551968,564,"Sir, that's the ninth time you said you didn't give a hoot!"
2011,0,6,38,44,1.1363636363636365,0.05233358898302985,564,Wisdom likes company!
2011,0,6,38,44,1.1363636363636365,0.05233358898302985,564,"Madam, why on earth would you think I give a hoot?"
2011,1,4,39,44,1.1363636363636365,0.06161077006722115,564,"Laugh if you will, but I've saved a fortune on my exterminator expenses."
2011,1,4,39,44,1.1363636363636365,0.06161077006722115,564,Wisdom is overrated.
2011,2,2,40,44,1.1363636363636365,0.06966325746551968,564,What's wrong with the night shift?
2011,1,4,39,44,1.1363636363636365,0.06161077006722115,564,They keep me company.
2011,0,6,38,44,1.1363636363636365,0.05233358898302985,564,"The storks went on strike, so we're trying something new."
2011,0,6,38,44,1.1363636363636365,0.05233358898302985,564,Please don't use the W Word.
2011,1,4,39,44,1.1363636363636365,0.06161077006722115,564,"The office needed more towels, Judith, not owls."
2011,2,2,40,44,1.1363636363636365,0.06966325746551968,564,Anyone who can say more than Hoot ?
2011,1,4,39,44,1.1363636363636365,0.06161077006722115,564,This way no birds will fly onto my desk.
2011,0,6,38,44,1.1363636363636365,0.05233358898302985,564,"See Margie, they all think I'm a hoot."
2011,1,4,39,44,1.1363636363636365,0.06161077006722115,564,"Do they all want coffee, sir?"
2011,2,2,40,44,1.1363636363636365,0.06966325746551968,564,There are nine owls on my desk.
2011,2,2,40,44,1.1363636363636365,0.06966325746551968,564,They flew early in for Sid's 10:00.
2011,0,6,38,44,1.1363636363636365,0.05233358898302985,564,This desk is owlfully full.
2011,1,4,39,44,1.1363636363636365,0.06161077006722115,564,"Ms. Jones, I believe we have the answer to our small rodent infestation problem."
2011,1,4,39,44,1.1363636363636365,0.06161077006722115,564,"I don't give a hoot what your excuse is, it is unwise to be late."
2011,2,2,40,44,1.1363636363636365,0.06966325746551968,564,"Yes, we are still running our promotion: Buy one, get eight free."
2011,0,6,38,44,1.1363636363636365,0.05233358898302985,564,"It's subtle, but you do seem wiser."
2011,1,4,39,44,1.1363636363636365,0.06161077006722115,564,"""MS. KLUTZ, I ORDERED TOWELS NOT OWLS FOR THE BATHROOM!"
2011,1,4,39,44,1.1363636363636365,0.06161077006722115,564,And I guarantee they won't watch you in the shower or peck out your eyes while you sleep.
2011,0,6,38,44,1.1363636363636365,0.05233358898302985,564,"I'll need a pea-green boat, some honey, plenty of money, and 9 cats."
2011,1,4,39,44,1.1363636363636365,0.06161077006722115,564,Yes sir. You said you wanted nice hooters around the office so there you are.
2011,1,4,39,44,1.1363636363636365,0.06161077006722115,564,"Why, no, I haven't seen your field mice."
2011,1,4,39,44,1.1363636363636365,0.06161077006722115,564,Whom are you here to see?
2011,2,2,40,44,1.1363636363636365,0.06966325746551968,564,"Sure I could've googled 'how does a parliament work?', but where's the fun in that?"
2011,1,4,39,44,1.1363636363636365,0.06161077006722115,564,"I'm more a Blue Breasted Boobie Gal, myself."
2011,1,4,39,44,1.1363636363636365,0.06161077006722115,564,Said hoo?
2011,0,6,38,44,1.1363636363636365,0.05233358898302985,564,It's five for 'who' and four for 'whom'.
2011,1,4,39,44,1.1363636363636365,0.06161077006722115,564,"I suppose ""what a hoot!"" would be redundant....."
2011,1,4,39,44,1.1363636363636365,0.06161077006722115,564,They can tweet sixty-words-per-minute and also do security.
2011,1,4,39,44,1.1363636363636365,0.06161077006722115,564,I just got elected Prime Minister!
2011,1,4,39,44,1.1363636363636365,0.06161077006722115,564,This does not change the basic optics. It will still appear to be an unwise decision.
2011,0,6,38,44,1.1363636363636365,0.05233358898302985,564,"Either I've been accepted to Hogwarts, or you misunderstood me when I asked for a Parliament."
2011,1,4,39,44,1.1363636363636365,0.06161077006722115,564,"Coffee please, Miss Jones, and a cookie. And nine plump mice."
2011,1,4,39,44,1.1363636363636365,0.06161077006722115,564,It seems I'm needed at Hogwarts.
2011,1,4,39,44,1.1363636363636365,0.06161077006722115,564,The boss preferred to be surrounded by night owls.
2011,1,4,39,44,1.1363636363636365,0.06161077006722115,564,Where's the pussycat?
2011,1,4,39,44,1.1363636363636365,0.06161077006722115,564,"They seem bright, but really, as conversations go, very one-sided!"
2011,1,4,39,44,1.1363636363636365,0.06161077006722115,564,"Well, we solved the mouse problem."
2011,1,4,39,44,1.1363636363636365,0.06161077006722115,564,Hootenanny for the day.
2011,0,6,38,44,1.1363636363636365,0.05233358898302985,564,What do you mean 'It's a bird brained idea?'
2011,2,2,40,44,1.1363636363636365,0.06966325746551968,564,Hoo should I say is calling?
2011,1,4,39,44,1.1363636363636365,0.06161077006722115,564,"This is what happens when you continually ask, ""Who? Who? Who?"""
2011,0,6,38,44,1.1363636363636365,0.05233358898302985,564,"You'd like to speak to, who?"
2011,2,2,40,44,1.1363636363636365,0.06966325746551968,564,I thought I was ordering a bottle of Nine Owl Scotch
2011,1,4,39,44,1.1363636363636365,0.06161077006722115,564,Someone has to give a hoot.
2011,1,4,39,44,1.1363636363636365,0.06161077006722115,564,I'm sorry Mrs. Hopkins. I'm really not a morning person.
2011,2,2,40,44,1.1363636363636365,0.06966325746551968,564,"That's it, Vivian - you're nine owls late!"
2011,0,6,38,44,1.1363636363636365,0.05233358898302985,564,Your wife called. She wants the frozen mice out of the freezer too.
2011,1,4,39,44,1.1363636363636365,0.06161077006722115,564,"We've already filled the job openings in third shift, Margaret. Please stop sending in all these night owls."
2011,1,4,39,44,1.1363636363636365,0.06161077006722115,564,My doctor told me I needed to have more owl movements...
2011,0,6,38,44,1.1363636363636365,0.05233358898302985,564,Owl get right on that.
2011,0,6,38,44,1.1363636363636365,0.05233358898302985,564,Parliamentary procedure dictates we should consult Robert's Rules of Order not animal control.
2011,1,4,39,44,1.1363636363636365,0.06161077006722115,564,They think they're the smartest in the room.
2011,0,6,38,44,1.1363636363636365,0.05233358898302985,564,There's a mole in the company.
2011,1,4,39,44,1.1363636363636365,0.06161077006722115,564,"As of today, I am a wise ass."
2011,2,2,40,44,1.1363636363636365,0.06966325746551968,564,What makes you think I don't give a hoot?
2011,1,4,39,44,1.1363636363636365,0.06161077006722115,564,I have always strived to seek wise counsel.
2011,2,2,40,44,1.1363636363636365,0.06966325746551968,564,I don't think those are the hooters the President ordered.
2011,1,4,39,44,1.1363636363636365,0.06161077006722115,564,"One dopio, please Doris. Oh, and 9 infant mice, wild caught locally, organic alfalfa or wheat fields if possible but corn is ok if that's all you can get. Let's say 4 grey, 2 white, and 3 any color, shall we?"
2011,2,2,40,44,1.1363636363636365,0.06966325746551968,564,"Miss Jenkins, this is a modelling agency. When I said that I wanted to see hooters lined up from one end of my desk to the other this morning, this is not at all what I had in mind."
2011,0,6,38,44,1.1363636363636365,0.05233358898302985,564,The 3rd shift won't leave until we agree to an increase in mice.
2011,1,4,39,44,1.1363636363636365,0.06161077006722115,564,"Not what, my dear, but hoo."
2011,1,4,39,44,1.1363636363636365,0.06161077006722115,564,Fire the exterminator!
2011,0,6,38,44,1.1363636363636365,0.05233358898302985,564,"Pick an owl, any owl."
2011,1,4,39,44,1.1363636363636365,0.06161077006722115,564,There used to be ten . What did you do with one of them.
2011,1,4,39,44,1.1363636363636365,0.06161077006722115,564,"Sorry, Diane. I know they're all great candidates, but I still can't figure out hoo is the most qualified."
2011,0,6,38,44,1.1363636363636365,0.05233358898302985,564,Stop hiring anyone whose head is screwed on backwards!
2011,0,6,38,44,1.1363636363636365,0.05233358898302985,564,"So, you some kind of wise guy?"
2011,1,4,39,44,1.1363636363636365,0.06161077006722115,564,To whom are you referring?
2011,1,4,39,44,1.1363636363636365,0.06161077006722115,564,Auditions....The What and When have already been chosen.
2011,0,6,38,44,1.1363636363636365,0.05233358898302985,564,Meet the AI staff.
2011,1,4,39,44,1.1363636363636365,0.06161077006722115,564,"Who do you think will blink first, me or them?"
2011,0,6,38,44,1.1363636363636365,0.05233358898302985,564,"My analyst said I should surround myself with friends. I said, 'But who?' Then it occurred to me."
2011,1,4,39,44,1.1363636363636365,0.06161077006722115,564,"Mr Potter, I need a word about your in tray"
2011,1,4,39,44,1.1363636363636365,0.06161077006722115,564,"From now on, I'm only hiring real head-turners."
2011,1,4,39,44,1.1363636363636365,0.06161077006722115,564,"I'm changing the infield. Who's at first. Wait, uh, second. What's, uh, shortstop. And Where is third."
2011,1,4,39,44,1.1363636363636365,0.06161077006722115,564,"So this is the idea of the ""environmentally friendly"" exterminator!!"
2011,1,4,39,44,1.1363636363636365,0.06161077006722115,564,This is your solution to the mice in the break room?
2011,0,6,38,44,1.1363636363636365,0.05233358898302985,564,I take it this is your first graveyard shift?
2011,1,4,39,44,1.1363636363636365,0.06161077006722115,564,It's important to show that you give a hoot.
2011,0,6,38,44,1.1363636363636365,0.05233358898302985,564,You can stuff 'em all but you'll never get your toupée back!
2011,1,4,39,44,1.1363636363636365,0.06161077006722115,564,New night shift workers
2011,1,4,39,44,1.1363636363636365,0.06161077006722115,564,I have a better mouse trap.
2011,1,4,39,44,1.1363636363636365,0.06161077006722115,564,I usually pick the wisest consultants.
2011,0,6,38,44,1.1363636363636365,0.05233358898302985,564,"Wisdom or not, they cannot be our Supreme Court."
2011,1,4,39,44,1.1363636363636365,0.06161077006722115,564,I assume you haven't sent out the memos yet?
2292,0,7,45,52,1.1346153846153846,0.04779328093727965,564,I brought in some assistants to help you burn the midnight oil.
2293,1,5,47,53,1.1320754716981132,0.05413078722488102,564,"Very well, the eyes have it."
2294,0,6,40,46,1.1304347826086956,0.05020437123388051,564,"I'm receiving messages, but I can't seem to send any."
2295,0,5,36,41,1.1219512195121952,0.051739520574625435,564,"I thought they would give me wisdom, but all I got was potato chips."
2295,1,3,37,41,1.1219512195121952,0.06242187264424257,564,I thought this was an 8 owl a day job.
2295,1,3,37,41,1.1219512195121952,0.06242187264424257,564,The owls are not what they seem.
2295,1,3,37,41,1.1219512195121952,0.06242187264424257,564,"Yes, they do seem well behaved, Miss Farnsworth, ... but I distinctly asked you to arrange a meeting with the Howells."
2295,1,3,37,41,1.1219512195121952,0.06242187264424257,564,They demand an increase in the owly wage.
2295,1,3,37,41,1.1219512195121952,0.06242187264424257,564,Didn't you get your Hogwarts letter?
2295,0,5,36,41,1.1219512195121952,0.051739520574625435,564,"We'll have a tuna salad, a bowl of pine nuts, a vanilla smoothie, and nine live mice."
2295,1,3,37,41,1.1219512195121952,0.06242187264424257,564,"Yes, I know it's a cluttered desk, but I don't give a hoot."
2295,1,3,37,41,1.1219512195121952,0.06242187264424257,564,I'm tired of being all about spontaneity. I'm opting for wisdom by osmosis.
2295,1,3,37,41,1.1219512195121952,0.06242187264424257,564,Just so you know your head stands out.
2295,0,5,36,41,1.1219512195121952,0.051739520574625435,564,It's a security issue Ms Jones. Figure out how to take care of them. We will be using owls instead of emails from now on.
2295,0,5,36,41,1.1219512195121952,0.051739520574625435,564,"The PR department's ""Give a Hoot"" campaign is getting out of hand."
2295,0,5,36,41,1.1219512195121952,0.051739520574625435,564,"No wise remarks, please."
2295,0,5,36,41,1.1219512195121952,0.051739520574625435,564,"I thought he said ""do you want to take in 9 holes...?"""
2295,0,5,36,41,1.1219512195121952,0.051739520574625435,564,... and the greatest part is not one of them has complained about working the night shift.
2295,0,5,36,41,1.1219512195121952,0.051739520574625435,564,I meant the restaurant!
2295,1,3,37,41,1.1219512195121952,0.06242187264424257,564,On the other hand...we no longer have a mouse problem.
2295,1,3,37,41,1.1219512195121952,0.06242187264424257,564,Which one of us is the wizard?
2295,0,5,36,41,1.1219512195121952,0.051739520574625435,564,"Owlementary, my dear Ms. Watson."
2295,0,5,36,41,1.1219512195121952,0.051739520574625435,564,Please bring me the Wise Potato Chip royalty litigation file
2295,0,5,36,41,1.1219512195121952,0.051739520574625435,564,Are you ready to receive the pigeon delegation now?
2295,1,3,37,41,1.1219512195121952,0.06242187264424257,564,"Sir,wouldn't a traditional paperweight be more appealing?"
2295,1,3,37,41,1.1219512195121952,0.06242187264424257,564,Another promo from the Audubon Society.
2295,1,3,37,41,1.1219512195121952,0.06242187264424257,564,No ... I really don't think they make you seem more intelligent.
2295,1,3,37,41,1.1219512195121952,0.06242187264424257,564,Now we have our think tank. Let's get to work.
2295,1,3,37,41,1.1219512195121952,0.06242187264424257,564,"Yes, I'd like to get rid of them but they're an endangered species."
2295,0,5,36,41,1.1219512195121952,0.051739520574625435,564,"Ms. Jenkins, we need to store the hoots. I'm expecting two gross of hollers later today"
2295,0,5,36,41,1.1219512195121952,0.051739520574625435,564,"I need to approve these tweets before you post them, Mr. Potter."
2295,1,3,37,41,1.1219512195121952,0.06242187264424257,564,Where would you like those filed sir?
2295,1,3,37,41,1.1219512195121952,0.06242187264424257,564,"I'm sorry, Parliament has decided your position is no longer a position."
2295,2,1,38,41,1.1219512195121952,0.07152623560300088,564,"Based on your last report, I don't think they have rubbed off on you yet."
2295,1,3,37,41,1.1219512195121952,0.06242187264424257,564,How do you tell who's hoo?
2295,0,5,36,41,1.1219512195121952,0.051739520574625435,564,You're obsessed with hooters.
2295,0,5,36,41,1.1219512195121952,0.051739520574625435,564,I'll give you that -- the pigeon population seems under control on your desk.
2295,0,5,36,41,1.1219512195121952,0.051739520574625435,564,Numbers are down? Owl see about that.
2295,1,3,37,41,1.1219512195121952,0.06242187264424257,564,As I get older I'm dispensing with some of my accumulated wisdom
2295,0,5,36,41,1.1219512195121952,0.051739520574625435,564,Do I seem wiser?
2295,0,5,36,41,1.1219512195121952,0.051739520574625435,564,"The staff wanted to thank you for solving the rat problem, Sir."
2295,0,5,36,41,1.1219512195121952,0.051739520574625435,564,What do you think of my new candidates for the Supreme Court?
2295,1,3,37,41,1.1219512195121952,0.06242187264424257,564,"Yes, this is Whose Whoo"
2295,0,5,36,41,1.1219512195121952,0.051739520574625435,564,"Originally, it was cute bunnies, and the owls, well, just showed up."
2295,0,5,36,41,1.1219512195121952,0.051739520574625435,564,You have to be able to work nights.
2295,0,5,36,41,1.1219512195121952,0.051739520574625435,564,This is not what I expected when I agreed to work in the Hogwarts admissions department.
2295,0,5,36,41,1.1219512195121952,0.051739520574625435,564,We could use a little wisdom around here
2295,1,3,37,41,1.1219512195121952,0.06242187264424257,564,"Sorry, they will stop putting the dead mice in your office."
2295,1,3,37,41,1.1219512195121952,0.06242187264424257,564,"Nothing Boss, just working late again"
2295,2,1,38,41,1.1219512195121952,0.07152623560300088,564,"You've been a solid employee, but owls are just more efficient."
2295,0,5,36,41,1.1219512195121952,0.051739520574625435,564,"Trust me, owl always be here for you."
2295,2,1,38,41,1.1219512195121952,0.07152623560300088,564,Could you please get us some more coffee?
2295,1,3,37,41,1.1219512195121952,0.06242187264424257,564,"Jenny, don't you know how to knock?!?"
2295,0,5,36,41,1.1219512195121952,0.051739520574625435,564,"I know why the caged bird sings, but I really don't give a hoot."
2295,2,1,38,41,1.1219512195121952,0.07152623560300088,564,May I approach the bench?
2295,0,5,36,41,1.1219512195121952,0.051739520574625435,564,I misunderstood when you said we would be sitting with parliament.
2295,0,5,36,41,1.1219512195121952,0.051739520574625435,564,"You know me Helen, I'm not one to take advice."
2295,2,1,38,41,1.1219512195121952,0.07152623560300088,564,"They said they don't give a hoot who you are, you didn't order towels and your pups are on the way."
2295,0,5,36,41,1.1219512195121952,0.051739520574625435,564,"So, you don't give a hoot about Bring-Your-Pets-To-Work day."
2295,1,3,37,41,1.1219512195121952,0.06242187264424257,564,"Okay, I'll keep the pussy cats in my office."
2295,0,5,36,41,1.1219512195121952,0.051739520574625435,564,Please don't scowl.
2295,0,5,36,41,1.1219512195121952,0.051739520574625435,564,I thought they'd help me look more wise
2295,2,1,38,41,1.1219512195121952,0.07152623560300088,564,These fake owls are supposed to scare off HR.
2295,2,1,38,41,1.1219512195121952,0.07152623560300088,564,"They were going to be released around the city for our new ""Give a hoot"" campaign until the PETA people made a big stink about it and some potato chip company sued us."
2295,2,1,38,41,1.1219512195121952,0.07152623560300088,564,Who do these wise guys think they are?
2295,1,3,37,41,1.1219512195121952,0.06242187264424257,564,Do you want a clean desk or a display of my accumulated business wisdom?
2295,1,3,37,41,1.1219512195121952,0.06242187264424257,564,You need to be a night owl to work these hours.
2295,0,5,36,41,1.1219512195121952,0.051739520574625435,564,"""No, he's on first""!"
2295,0,5,36,41,1.1219512195121952,0.051739520574625435,564,"Unlike the corporate brass, this group truly gives a hoot about what I do around here...."
2295,1,3,37,41,1.1219512195121952,0.06242187264424257,564,"Frankly Thelma, I couldn't give a hoot about the clean desk policy."
2295,1,3,37,41,1.1219512195121952,0.06242187264424257,564,"Nine owls, Miss Fenwick...NINE OWLS?! I distinctly said TEN."
2295,1,3,37,41,1.1219512195121952,0.06242187264424257,564,I hope you're having a hoot right now.
2295,0,5,36,41,1.1219512195121952,0.051739520574625435,564,Who are you? who! who! who! who!. I really wanna know.
2295,1,3,37,41,1.1219512195121952,0.06242187264424257,564,"Mrs. Knapp, I said. It's Mrs. Knapp! Enough with the question!"
2295,0,5,36,41,1.1219512195121952,0.051739520574625435,564,You can tell him I haven't given a hoot for quite some time.
2295,1,3,37,41,1.1219512195121952,0.06242187264424257,564,"No! I said, 'Get me at table at Hooters.'"
2295,0,5,36,41,1.1219512195121952,0.051739520574625435,564,"'I'd like you to meet the night shift."""
2295,2,1,38,41,1.1219512195121952,0.07152623560300088,564,"Mr. Fox, the exterminator has taken care of our rodent problems."
2295,0,5,36,41,1.1219512195121952,0.051739520574625435,564,We know what I'm doing.
2295,0,5,36,41,1.1219512195121952,0.051739520574625435,564,Do you think this's wise for our Wisdom Awards?
2295,0,5,36,41,1.1219512195121952,0.051739520574625435,564,We're expanding the night shift!
2295,1,3,37,41,1.1219512195121952,0.06242187264424257,564,I think Maggie got confused when you asked for Hooters for your birthday lunch
2295,0,5,36,41,1.1219512195121952,0.051739520574625435,564,I like your hooters.
2295,1,3,37,41,1.1219512195121952,0.06242187264424257,564,It's a cybernetic organism robot prototype with enhanced binocular sight and exceptional clairvoyance. CORP for short.
2295,0,5,36,41,1.1219512195121952,0.051739520574625435,564,"Now that the night crew has arrived, what say we go grab a drink?"
2295,2,1,38,41,1.1219512195121952,0.07152623560300088,564,Tell Harry Potter that I prefer emails
2295,0,5,36,41,1.1219512195121952,0.051739520574625435,564,The Pussycats? Send 'em in.
2295,0,5,36,41,1.1219512195121952,0.051739520574625435,564,"The Pet store said that, in fact, Owls are NOT cheaper by the dozen. You only get that discount with Goldfish and Guppies."
2295,1,3,37,41,1.1219512195121952,0.06242187264424257,564,"Forget my clients, I'm waging a full-scale war on the pigeons."
2295,0,5,36,41,1.1219512195121952,0.051739520574625435,564,We have a few questions.
2295,1,3,37,41,1.1219512195121952,0.06242187264424257,564,"... and thus, HR suggested this would be the only appropriate environment in which I could say 'Hooters' in the work place."
2295,0,5,36,41,1.1219512195121952,0.051739520574625435,564,You haven't given a hoot for a long time!
2295,2,1,38,41,1.1219512195121952,0.07152623560300088,564,How can you possibly say that I don't give a hoot?
2295,0,5,36,41,1.1219512195121952,0.051739520574625435,564,Wearing glasses alone does not get you into the Wise Old Owls club.
2295,1,3,37,41,1.1219512195121952,0.06242187264424257,564,One wise-ass around here was already enough.....
2295,0,5,36,41,1.1219512195121952,0.051739520574625435,564,So who are you expecting to clean up?
2295,0,5,36,41,1.1219512195121952,0.051739520574625435,564,It's so I don't have to give a hoot
2295,0,5,36,41,1.1219512195121952,0.051739520574625435,564,If you mention my hooters one last time I'll have to speak with H.R.
2295,1,3,37,41,1.1219512195121952,0.06242187264424257,564,"Can grave and formal pass for wise, When Women the solemn Owl despise?"
2295,0,5,36,41,1.1219512195121952,0.051739520574625435,564,Who's who around here?
2295,1,3,37,41,1.1219512195121952,0.06242187264424257,564,Can I get you anything else?
2295,2,1,38,41,1.1219512195121952,0.07152623560300088,564,"When I gave the team a birthday gift hint, I should have said, ""I love Hoosters, the restaurant""!"
2295,0,5,36,41,1.1219512195121952,0.051739520574625435,564,I don't think this is what they meant by parliamentary procedure.
2295,1,3,37,41,1.1219512195121952,0.06242187264424257,564,"We're the committee for ""Who's Who in America."""
2295,1,3,37,41,1.1219512195121952,0.06242187264424257,564,"Is it so weird to want my office free of mice, Miss Perkins?"
2295,0,5,36,41,1.1219512195121952,0.051739520574625435,564,"""Do you think this will help me get into ""Who's Who""?"
2295,0,5,36,41,1.1219512195121952,0.051739520574625435,564,They're the who's who of the legal community.
2295,0,5,36,41,1.1219512195121952,0.051739520574625435,564,We think you are overreacting … You saw one mouse last week….
2295,1,3,37,41,1.1219512195121952,0.06242187264424257,564,I'll leave immediately; I think I just needed the push to pursue taxidermy full time.
2295,1,3,37,41,1.1219512195121952,0.06242187264424257,564,"Oh, Hooters. Now I get it, Mr. Ailes."
2295,1,3,37,41,1.1219512195121952,0.06242187264424257,564,They help me find the stapler.
2295,2,1,38,41,1.1219512195121952,0.07152623560300088,564,They keep the pigeons away.
2295,1,3,37,41,1.1219512195121952,0.06242187264424257,564,"Barn owls brought peace in Isreal, let's see if it does it again between Republicans and Democrats here."
2295,0,5,36,41,1.1219512195121952,0.051739520574625435,564,You still need to wise-up.
2295,1,3,37,41,1.1219512195121952,0.06242187264424257,564,I'm supposed to give a hoot?
2295,0,5,36,41,1.1219512195121952,0.051739520574625435,564,Meet the new night shift.
2295,0,5,36,41,1.1219512195121952,0.051739520574625435,564,"They're Parliament, and I'm Funkadelic."
2295,0,5,36,41,1.1219512195121952,0.051739520574625435,564,"OK, I've got the wise. Now I just need the wherefores."
2295,0,5,36,41,1.1219512195121952,0.051739520574625435,564,"No, they don't make you look any wiser."
2295,0,5,36,41,1.1219512195121952,0.051739520574625435,564,Should I come back after your Parliament meeting is over?
2295,1,3,37,41,1.1219512195121952,0.06242187264424257,564,We need all eyes on desk!
2295,0,5,36,41,1.1219512195121952,0.051739520574625435,564,"Wisdom, miss brooks, lots of wisdom."
2295,1,3,37,41,1.1219512195121952,0.06242187264424257,564,"Hold all calls—Parliament is in session."""
2295,1,3,37,41,1.1219512195121952,0.06242187264424257,564,"Despite popular misconception, it's actually WHOM do you think you are...."
2295,1,3,37,41,1.1219512195121952,0.06242187264424257,564,Take an owl. Worshiping Athena is now the company religion.
2295,1,3,37,41,1.1219512195121952,0.06242187264424257,564,I love owls. woman- I can tell!
2295,1,3,37,41,1.1219512195121952,0.06242187264424257,564,"You should see my mnemonics for WHAT, WHEN, and WHERE."
2295,1,3,37,41,1.1219512195121952,0.06242187264424257,564,This isn't what I meant when I said I needed to speak to parliament
2295,0,5,36,41,1.1219512195121952,0.051739520574625435,564,Our auditors see everything.
2295,1,3,37,41,1.1219512195121952,0.06242187264424257,564,I assume these are the candidates for the night watchman position.
2295,2,1,38,41,1.1219512195121952,0.07152623560300088,564,"What, where, why and how ?"
2295,2,1,38,41,1.1219512195121952,0.07152623560300088,564,Whoooose in charge now?
2295,0,5,36,41,1.1219512195121952,0.051739520574625435,564,We use to have a mice problem.
2295,0,5,36,41,1.1219512195121952,0.051739520574625435,564,Better than twitter? Really.
2295,0,5,36,41,1.1219512195121952,0.051739520574625435,564,Yesterday it was five and four pussycats. What happened?
2295,1,3,37,41,1.1219512195121952,0.06242187264424257,564,Please tell accounting that I have the backup for the Hooters charges on my expense account.
2295,0,5,36,41,1.1219512195121952,0.051739520574625435,564,"I don't have time to look for your pussycat Miss Jones, one of my owls is missing."
2295,2,1,38,41,1.1219512195121952,0.07152623560300088,564,"Yes I see the difference, but I shall continue to think of you as ""owlish""."
2295,0,5,36,41,1.1219512195121952,0.051739520574625435,564,They voted 5-4. You're fired.
2295,0,5,36,41,1.1219512195121952,0.051739520574625435,564,"Hearing Aids! I said 'night owls', not 'NINE owls'!"
2295,1,3,37,41,1.1219512195121952,0.06242187264424257,564,"Margaret, make sure we tell the staff not to take my pep talks so literally in the future."
2295,1,3,37,41,1.1219512195121952,0.06242187264424257,564,What is your wife going to think when she sees all the hooter chicks in here.
2295,2,1,38,41,1.1219512195121952,0.07152623560300088,564,"One of our board members is asking about a vegetarian option. Otherwise, it's coffee and live mice for everyone."
2295,1,3,37,41,1.1219512195121952,0.06242187264424257,564,Just like Wise potato chips I couldn't have just one!
2295,1,3,37,41,1.1219512195121952,0.06242187264424257,564,I bet you're wondering who's who.
2295,1,3,37,41,1.1219512195121952,0.06242187264424257,564,"No, Delores, I said I need nite owls for the job."
2295,1,3,37,41,1.1219512195121952,0.06242187264424257,564,I am trying to find the leak of our corporate secrets. Who? Who? Who?
2295,1,3,37,41,1.1219512195121952,0.06242187264424257,564,I can't understand why people accuse me of not giving a hoot.
2295,2,1,38,41,1.1219512195121952,0.07152623560300088,564,I got a great deal on one size nesting dolls.
2295,1,3,37,41,1.1219512195121952,0.06242187264424257,564,Meet 3rd shift.
2295,1,3,37,41,1.1219512195121952,0.06242187264424257,564,Meet our new night-time employees.
2295,1,3,37,41,1.1219512195121952,0.06242187264424257,564,You report directly to Parliament.
2295,1,3,37,41,1.1219512195121952,0.06242187264424257,564,I had asked for some towels!
2295,1,3,37,41,1.1219512195121952,0.06242187264424257,564,They were the cheapest temps we could find to answer phones for the World Health Organization.
2295,1,3,37,41,1.1219512195121952,0.06242187264424257,564,I apologize for all the hootenanny.
2295,1,3,37,41,1.1219512195121952,0.06242187264424257,564,Is it too much to ask for a little eye contact?
2295,0,5,36,41,1.1219512195121952,0.051739520574625435,564,"Believe me, it's much more effective than drones."
2295,0,5,36,41,1.1219512195121952,0.051739520574625435,564,I'm here for the hootnanny.
2295,1,3,37,41,1.1219512195121952,0.06242187264424257,564,"Sorry, I think you misheard me--I said I need 10 HOURS to get the project done."
2295,0,5,36,41,1.1219512195121952,0.051739520574625435,564,Don't you think it would be wise to have the owls running the country rather than Trump???
2295,1,3,37,41,1.1219512195121952,0.06242187264424257,564,We need nine H1B visas.
2295,1,3,37,41,1.1219512195121952,0.06242187264424257,564,So now you're a night owl by day.
2295,1,3,37,41,1.1219512195121952,0.06242187264424257,564,"These Early Decisions need to be out by end of day, please."
2295,1,3,37,41,1.1219512195121952,0.06242187264424257,564,"As you can see, working here is quite a hoot."
2295,1,3,37,41,1.1219512195121952,0.06242187264424257,564,"Ms. Carlyle, where's the nearest Hooters?"
2295,0,5,36,41,1.1219512195121952,0.051739520574625435,564,"It's ""To whom, to whom"". Now you know why."
2295,1,3,37,41,1.1219512195121952,0.06242187264424257,564,"Well, that's a hoot"
2295,0,5,36,41,1.1219512195121952,0.051739520574625435,564,There are the applicants for the new night shift position.
2295,0,5,36,41,1.1219512195121952,0.051739520574625435,564,They took care of the mice. Now we have to wait for the wisdom to kick in.
2295,1,3,37,41,1.1219512195121952,0.06242187264424257,564,Hoot hoot! Find which one of us is human and the job is yours!
2295,1,3,37,41,1.1219512195121952,0.06242187264424257,564,I just get apples from my students.
2295,0,5,36,41,1.1219512195121952,0.051739520574625435,564,Tell them I'll give them an answer after I consult with my advisors.
2295,1,3,37,41,1.1219512195121952,0.06242187264424257,564,"Courtesy of our collective wisdom, you're being terminated."
2295,0,5,36,41,1.1219512195121952,0.051739520574625435,564,"If I've told you once, I've told you 10 times; I don't give a hoot."
2295,1,3,37,41,1.1219512195121952,0.06242187264424257,564,"When I agreed to appear in the ""Who's Who"", this wasn't what I had in mind!"
2295,1,3,37,41,1.1219512195121952,0.06242187264424257,564,"""Who""wants to know?"
2295,0,5,36,41,1.1219512195121952,0.051739520574625435,564,And I thought you didn't give a hoot
2295,0,5,36,41,1.1219512195121952,0.051739520574625435,564,"Trust me, you wouldn't want to sit if hadn't removed the chairs."
2295,0,5,36,41,1.1219512195121952,0.051739520574625435,564,I'm afraid the Hogwarts transfers have been passing notes in class again.
2295,1,3,37,41,1.1219512195121952,0.06242187264424257,564,They're specially designed to deflect criticism.
2295,2,1,38,41,1.1219512195121952,0.07152623560300088,564,I'll be working late tonight.
2295,1,3,37,41,1.1219512195121952,0.06242187264424257,564,They're neater than the pigeons.
2295,1,3,37,41,1.1219512195121952,0.06242187264424257,564,"There is another way to catch that mouse, you know."
2295,1,3,37,41,1.1219512195121952,0.06242187264424257,564,The consultant said I should surround myself with the most intelligence I can find.
2295,0,5,36,41,1.1219512195121952,0.051739520574625435,564,Don't get wise with me.
2295,1,3,37,41,1.1219512195121952,0.06242187264424257,564,"So, I have nine owls. A cat has nine lives."
2295,0,5,36,41,1.1219512195121952,0.051739520574625435,564,"Mr. Jones, your wise cracks are getting on my nerves!"
2295,1,3,37,41,1.1219512195121952,0.06242187264424257,564,I don't think this is what employees had in mind for their 360 degree review.
2295,0,5,36,41,1.1219512195121952,0.051739520574625435,564,Mouse problem?
2295,0,5,36,41,1.1219512195121952,0.051739520574625435,564,Just don't ask...'you know.'
2295,0,5,36,41,1.1219512195121952,0.051739520574625435,564,They told me you were a hoot
2295,2,1,38,41,1.1219512195121952,0.07152623560300088,564,"Ms. Hopkins, please order nine tiny mortar boards and gross of field mice for our new concept development team."
2295,1,3,37,41,1.1219512195121952,0.06242187264424257,564,It looks like the Ministry of Magic is unhappy with my position on postal reform.
2295,1,3,37,41,1.1219512195121952,0.06242187264424257,564,An owl for your thoughts Miss Smith...
2295,0,5,36,41,1.1219512195121952,0.051739520574625435,564,"Professor Smith, in the future we request you teach that the 5 W's of journalism are who, who, who, who, and who."
2295,0,5,36,41,1.1219512195121952,0.051739520574625435,564,The new job's been a real hoot.
2295,1,3,37,41,1.1219512195121952,0.06242187264424257,564,On Tuesdays I meet with our branch managers.
2295,1,3,37,41,1.1219512195121952,0.06242187264424257,564,I really hate Bring Your Owl to Work Day.
2295,1,3,37,41,1.1219512195121952,0.06242187264424257,564,"Martha, I can never be owl by myself."
2295,1,3,37,41,1.1219512195121952,0.06242187264424257,564,"If these new sales managers don't motivate the deliverymice, I don't know what will."
2295,1,3,37,41,1.1219512195121952,0.06242187264424257,564,"Yet again, Lockwood had misunderstood Casual Friday."
2295,1,3,37,41,1.1219512195121952,0.06242187264424257,564,"None of us give a hoot about what you want, Ms. Jones."
2295,1,3,37,41,1.1219512195121952,0.06242187264424257,564,I've given up on people--I'm surrounding myself with wise creatures.
2295,2,1,38,41,1.1219512195121952,0.07152623560300088,564,Where are the other three?
2295,1,3,37,41,1.1219512195121952,0.06242187264424257,564,"I don't pollute because, obviously, I give a hoot."
2295,1,3,37,41,1.1219512195121952,0.06242187264424257,564,I couldn't afford the doves.
2295,1,3,37,41,1.1219512195121952,0.06242187264424257,564,Hogwarts first principal.
2295,0,5,36,41,1.1219512195121952,0.051739520574625435,564,I'm tired of people saying I don't give a hoot
2295,1,3,37,41,1.1219512195121952,0.06242187264424257,564,"I need an answer Ted. When I left for the bathroom there were ten owls, now there's nine."
2295,0,5,36,41,1.1219512195121952,0.051739520574625435,564,"Oh, these are my friend's pet owls. Wait, who's gonna clean all the pellets?"
2295,0,5,36,41,1.1219512195121952,0.051739520574625435,564,"Is there anything I can hoot for you, Mrs. Wilson?"
2295,1,3,37,41,1.1219512195121952,0.06242187264424257,564,I'm not driving you anywhere...I'm a taxidermist.
2295,1,3,37,41,1.1219512195121952,0.06242187264424257,564,"Well, you can tell HR I don't give a hoot!"
2295,0,5,36,41,1.1219512195121952,0.051739520574625435,564,This is why you don't see any mice in here!
2295,1,3,37,41,1.1219512195121952,0.06242187264424257,564,"A word to the wise, Ms. Hedwig."
2295,0,5,36,41,1.1219512195121952,0.051739520574625435,564,"Now, about your pigeons Ms. Brittlebottom."
2295,1,3,37,41,1.1219512195121952,0.06242187264424257,564,"...and what birds do you flock to, Mrs. Blaine?"
2295,1,3,37,41,1.1219512195121952,0.06242187264424257,564,We're just consulting.
2295,1,3,37,41,1.1219512195121952,0.06242187264424257,564,They're helping me find my mouse.
2295,1,3,37,41,1.1219512195121952,0.06242187264424257,564,"Ms. Farruggia, I said we needed ""nine hours."""
2295,0,5,36,41,1.1219512195121952,0.051739520574625435,564,"The question is not what, but who...?"
2295,2,1,38,41,1.1219512195121952,0.07152623560300088,564,"No sandwiches, we're getting some tasty field mice for lunch today."
2295,0,5,36,41,1.1219512195121952,0.051739520574625435,564,You are safe here from all the lemmings.
2295,1,3,37,41,1.1219512195121952,0.06242187264424257,564,"Thanks for the invite, but I brought lunch."
2295,2,1,38,41,1.1219512195121952,0.07152623560300088,564,Your flight to Athens leaves this afternoon
2295,1,3,37,41,1.1219512195121952,0.06242187264424257,564,We now have enough votes for a quorum - set up the meeting for 3:00 a.m.
2295,0,5,36,41,1.1219512195121952,0.051739520574625435,564,I see you're ready for the rat race.
2295,2,1,38,41,1.1219512195121952,0.07152623560300088,564,Miss Moneypenny. Tell James Bond we have a unique new spying device.
2295,0,5,36,41,1.1219512195121952,0.051739520574625435,564,A classic case of who done it.
2295,1,3,37,41,1.1219512195121952,0.06242187264424257,564,2 more owls and we move to phase 2 Alice!
2295,0,5,36,41,1.1219512195121952,0.051739520574625435,564,"When you said the ""wise guys"" had taken over, this is not what I imagined."
2295,0,5,36,41,1.1219512195121952,0.051739520574625435,564,"Now then, I'm going to shuffle the owls, then correctly pick the one you were thinking of."
2295,1,3,37,41,1.1219512195121952,0.06242187264424257,564,"Great news Ms Frobisher, we finally have nine wise Justices."
2295,2,1,38,41,1.1219512195121952,0.07152623560300088,564,My son's school is having a fundraiser...
2295,0,5,36,41,1.1219512195121952,0.051739520574625435,564,Ask IT when I'm getting my computer back.
2295,0,5,36,41,1.1219512195121952,0.051739520574625435,564,I meant Twitter.
2295,1,3,37,41,1.1219512195121952,0.06242187264424257,564,"Yet again, Lockwood had misunderstood Casual Friday."
2295,0,5,36,41,1.1219512195121952,0.051739520574625435,564,"Computer's out for repair and by the way, whooooo do you think you're talking to?"
2295,1,3,37,41,1.1219512195121952,0.06242187264424257,564,I have a question old wise ones...and Herb.
2295,1,3,37,41,1.1219512195121952,0.06242187264424257,564,"No worries Mrs. Rectumwald, They do not have irritable owl syndrome."
2295,0,5,36,41,1.1219512195121952,0.051739520574625435,564,I still don't feel wise.
2295,1,3,37,41,1.1219512195121952,0.06242187264424257,564,"That's too bad. Ironically, we don't give a hoot."
2295,0,5,36,41,1.1219512195121952,0.051739520574625435,564,"Yes, we now give a hoot!"
2295,0,5,36,41,1.1219512195121952,0.051739520574625435,564,They call us the ten wise guys.
2295,0,5,36,41,1.1219512195121952,0.051739520574625435,564,Choose one: it might be the wisest of them all.
2295,1,3,37,41,1.1219512195121952,0.06242187264424257,564,They all seem to be under the misconception that my desk is full of Tootsie Pops.
2295,1,3,37,41,1.1219512195121952,0.06242187264424257,564,I'm not really sure that this will help you to appear wiser.
2295,1,3,37,41,1.1219512195121952,0.06242187264424257,564,Does this make me look wiser?
2295,1,3,37,41,1.1219512195121952,0.06242187264424257,564,I've never met a carrier pigeon with good news.
2295,0,5,36,41,1.1219512195121952,0.051739520574625435,564,Who may I say is calling?
2295,0,5,36,41,1.1219512195121952,0.051739520574625435,564,"Don't worry, they're not what they seem."
2295,1,3,37,41,1.1219512195121952,0.06242187264424257,564,"Your husband’s not here, and this isn’t Hooters."
2295,0,5,36,41,1.1219512195121952,0.051739520574625435,564,"They're advising me about the mouse problem right now, actually."
2295,1,3,37,41,1.1219512195121952,0.06242187264424257,564,Please thank the students in shop class for the desk made of endangered wood.
2295,0,5,36,41,1.1219512195121952,0.051739520574625435,564,"Like I always say, ‘If I’m the smartest person in the room, we’re in big trouble.’"
2295,1,3,37,41,1.1219512195121952,0.06242187264424257,564,What did you think I meant when I suggested we meet at the hooters?
2295,1,3,37,41,1.1219512195121952,0.06242187264424257,564,IT's concerned about your mouse usage.
2295,0,5,36,41,1.1219512195121952,0.051739520574625435,564,"""Meet our new mentors""."
2295,0,5,36,41,1.1219512195121952,0.051739520574625435,564,"I said ""Alexa, order nine white towels"""
2295,0,5,36,41,1.1219512195121952,0.051739520574625435,564,"MAYBE I DIDNT MAKE MYSELF CLEAR, THE WHITE OWLS I WANTED ARE CIGARS."
2295,0,5,36,41,1.1219512195121952,0.051739520574625435,564,I told you those owl banks wouldn't sell.
2295,0,5,36,41,1.1219512195121952,0.051739520574625435,564,"Great news, Helen, I've hired some excellent new candidates to join you on the night shift."
2295,1,3,37,41,1.1219512195121952,0.06242187264424257,564,"A coffee please, Miss Hayes, and nine live mice for my friends."
2295,1,3,37,41,1.1219512195121952,0.06242187264424257,564,It was buy one get eight free at the rescue shelter.
2295,0,5,36,41,1.1219512195121952,0.051739520574625435,564,"Owl get right on it... Do you get it?... these are owls and I said 'owl' instead of 'I will'... Ok fine Doris, you just don't give a hoot about my work... Anything that time? No? Well hoo do you have to screw..."
2295,1,3,37,41,1.1219512195121952,0.06242187264424257,564,"I'm sorry, this office is Wisdom. Argument is down the hall, room 304."
2295,1,3,37,41,1.1219512195121952,0.06242187264424257,564,Only 9 Tweets today!
2295,0,5,36,41,1.1219512195121952,0.051739520574625435,564,They want tickets to Groundhog Day.
2295,0,5,36,41,1.1219512195121952,0.051739520574625435,564,Why? Not used to that question.
2295,2,1,38,41,1.1219512195121952,0.07152623560300088,564,"Tell Claus they're cheaper, nocturnal and more aerodynamic."
2295,1,3,37,41,1.1219512195121952,0.06242187264424257,564,Yesterday I couldn't give two hoots for this job. Today I upped it to nine.
2295,1,3,37,41,1.1219512195121952,0.06242187264424257,564,"Um, yeah, they want you down in HR...yeah, no, idea why..."
2295,1,3,37,41,1.1219512195121952,0.06242187264424257,564,"Turns out, getting your ducks in a row is a terrible idea."
2295,1,3,37,41,1.1219512195121952,0.06242187264424257,564,They need me for the minyan.
2295,0,5,36,41,1.1219512195121952,0.051739520574625435,564,"There was one more, but he didn't give a hoot"
2295,0,5,36,41,1.1219512195121952,0.051739520574625435,564,"""I said, Want to go by Hooters? Not, go buy hooters!"
2295,1,3,37,41,1.1219512195121952,0.06242187264424257,564,"Whoo, Whoo, Whoo, Whoo, Whoo, left this on my desk?!"
2295,2,1,38,41,1.1219512195121952,0.07152623560300088,564,"The Trump Administration may not give a hoot about them, but I do."
2295,1,3,37,41,1.1219512195121952,0.06242187264424257,564,"No, I can't tell which one is stuffed."
2295,1,3,37,41,1.1219512195121952,0.06242187264424257,564,"I think this rendition of ""Teenage Wasteland"" will speak for itself."
2295,1,3,37,41,1.1219512195121952,0.06242187264424257,564,I am not a tax attorney.
2295,0,5,36,41,1.1219512195121952,0.051739520574625435,564,"Pardon me Mrs. Cranwell, but have you seen my mouse?"
2295,0,5,36,41,1.1219512195121952,0.051739520574625435,564,"Yes, we discussed your concerns. Frankly my dear we don't give a hoot."
2295,1,3,37,41,1.1219512195121952,0.06242187264424257,564,Are they cheaper by the dozen? What do you feed them?
2295,1,3,37,41,1.1219512195121952,0.06242187264424257,564,"Oh yeah? Well, my hooters are bigger than yours!"
2295,0,5,36,41,1.1219512195121952,0.051739520574625435,564,"We know your SAT score, Bob. Ditch the owls."
2295,1,3,37,41,1.1219512195121952,0.06242187264424257,564,"Wise, shmise. If they crap on my report you're retyping it."
2295,0,5,36,41,1.1219512195121952,0.051739520574625435,564,All future directives will be an Act of Parliament.
2295,2,1,38,41,1.1219512195121952,0.07152623560300088,564,"I don't care what species you identify with, Gabe, you have to use the regular bathroom like everyone else."
2295,2,1,38,41,1.1219512195121952,0.07152623560300088,564,I'm sure you'll soon learn whose hoo.
2295,1,3,37,41,1.1219512195121952,0.06242187264424257,564,Our committee sees nothing wrong with the hunt and peck method.
2295,2,1,38,41,1.1219512195121952,0.07152623560300088,564,You don't look any wiser.
2295,0,5,36,41,1.1219512195121952,0.051739520574625435,564,Nine out of ten owls prefer desk jobs
2295,0,5,36,41,1.1219512195121952,0.051739520574625435,564,The budget cuts really hit us hard. This was the best we could do in terms of security.
2295,1,3,37,41,1.1219512195121952,0.06242187264424257,564,"You can really have a ""hoot"" with these."
2295,0,5,36,41,1.1219512195121952,0.051739520574625435,564,"Parliament is in session, Carol."
2295,1,3,37,41,1.1219512195121952,0.06242187264424257,564,How do you feel about working nights?
2295,0,5,36,41,1.1219512195121952,0.051739520574625435,564,And yet not one of them has my Hogwarts letter.
2295,1,3,37,41,1.1219512195121952,0.06242187264424257,564,They said they'd be a hoot.
2295,0,5,36,41,1.1219512195121952,0.051739520574625435,564,And what wisdom could you provide that I don't already have on my desk?
2295,0,5,36,41,1.1219512195121952,0.051739520574625435,564,"The finalists in our ""Give a Hoot"" contest just flew in."
2295,1,3,37,41,1.1219512195121952,0.06242187264424257,564,Good news! My octuplets have all been accepted to Hogwarts.
2295,0,5,36,41,1.1219512195121952,0.051739520574625435,564,Alice...I'am gonna need a stack of old newspapers and 3 dozen live mice.
2295,1,3,37,41,1.1219512195121952,0.06242187264424257,564,Your paranoia has to be addressed Mr. Williams.
2295,0,5,36,41,1.1219512195121952,0.051739520574625435,564,"This the owl information desk. For other questions, go to General Information Desk."
2295,0,5,36,41,1.1219512195121952,0.051739520574625435,564,I'm told the nesting habits of owls vary considerably.
2295,0,5,36,41,1.1219512195121952,0.051739520574625435,564,I'll give you my answer after I confer with the parliament.
2295,1,3,37,41,1.1219512195121952,0.06242187264424257,564,They keep away the hawks.
2295,1,3,37,41,1.1219512195121952,0.06242187264424257,564,I like the nightlife baby.
2295,0,5,36,41,1.1219512195121952,0.051739520574625435,564,"They say after I fly into that pane of glass, I'm in the club."
2295,1,3,37,41,1.1219512195121952,0.06242187264424257,564,"I give a hoot, ma'am."
2295,2,1,38,41,1.1219512195121952,0.07152623560300088,564,"It's called a 'parliament', Christine. Can we stop playing this game now?"
2295,1,3,37,41,1.1219512195121952,0.06242187264424257,564,Wise decision on the new hires.
2295,1,3,37,41,1.1219512195121952,0.06242187264424257,564,They'll be asking to the questions.
2295,0,5,36,41,1.1219512195121952,0.051739520574625435,564,"Yes, it's clearly a predatory takeover."
2295,1,3,37,41,1.1219512195121952,0.06242187264424257,564,My favorite Hitchcock film? Surely you jest.
2295,0,5,36,41,1.1219512195121952,0.051739520574625435,564,Tawny owls? I said Brawny towels. Now I am really going to need some.
2295,1,3,37,41,1.1219512195121952,0.06242187264424257,564,They usually work nights.
2295,1,3,37,41,1.1219512195121952,0.06242187264424257,564,Our new funding limits their habitat to my desktop.
2295,0,5,36,41,1.1219512195121952,0.051739520574625435,564,Tell Hogwarts to send me a larger inbox.
2295,1,3,37,41,1.1219512195121952,0.06242187264424257,564,But when and why?
2295,1,3,37,41,1.1219512195121952,0.06242187264424257,564,Grab your banjo - we've been waiting on a hootenanny!
2295,1,3,37,41,1.1219512195121952,0.06242187264424257,564,Who is my favorite.
2295,1,3,37,41,1.1219512195121952,0.06242187264424257,564,Owl be damned.
2295,0,5,36,41,1.1219512195121952,0.051739520574625435,564,I'll give you a raise if you can make them stop blinking.
2295,0,5,36,41,1.1219512195121952,0.051739520574625435,564,"Yes, a parliament of owls, that's right."
2295,0,5,36,41,1.1219512195121952,0.051739520574625435,564,I have a mouse problem.
2295,0,5,36,41,1.1219512195121952,0.051739520574625435,564,It's called an Accountant's Dozen.
2295,1,3,37,41,1.1219512195121952,0.06242187264424257,564,Because it makes me look wiser.
2295,0,5,36,41,1.1219512195121952,0.051739520574625435,564,"Before you come closer, do you have any rodents on your person?"
2295,1,3,37,41,1.1219512195121952,0.06242187264424257,564,I've always been a big fan of hooters.
2295,1,3,37,41,1.1219512195121952,0.06242187264424257,564,"I wanted to tell you how much we appreciate your work for the company, but we have to cut some budgets. Also, these are for you, i know you're not a roses person."
2295,1,3,37,41,1.1219512195121952,0.06242187264424257,564,My earlier comment was not harassment; these are what I meant by saying I like hooters.
2295,0,5,36,41,1.1219512195121952,0.051739520574625435,564,Wise guys. They'll fix the mole problem.
2295,1,3,37,41,1.1219512195121952,0.06242187264424257,564,"I said ""buy me nine hours"" not ""buy me nine owls."""
2295,1,3,37,41,1.1219512195121952,0.06242187264424257,564,"I said, I needed towels, not owls"
2295,1,3,37,41,1.1219512195121952,0.06242187264424257,564,"""Who's"" in charge here?"
2295,0,5,36,41,1.1219512195121952,0.051739520574625435,564,Frankly Mr. Audubon I find your interest in owls a fowl obsession.
2295,1,3,37,41,1.1219512195121952,0.06242187264424257,564,"Now we just need to know ""when"" and ""where""."
2295,0,5,36,41,1.1219512195121952,0.051739520574625435,564,I dare you to go to HR.
2295,0,5,36,41,1.1219512195121952,0.051739520574625435,564,I'd like you to do a mass mailing for the library's upcoming Harry Potter event.
2295,1,3,37,41,1.1219512195121952,0.06242187264424257,564,They're my 'who' men.
2295,1,3,37,41,1.1219512195121952,0.06242187264424257,564,Another meeting of the W.H.O.
2295,0,5,36,41,1.1219512195121952,0.051739520574625435,564,"Correction: it's called a ""parliament,"" not a ""flock"" of owls."
2295,0,5,36,41,1.1219512195121952,0.051739520574625435,564,"Yes, I've solved that mouse problem."
2295,0,5,36,41,1.1219512195121952,0.051739520574625435,564,Harry Potter is on the phone and would like to know how Harry Jr. ended up on the wait list exactly.
2295,1,3,37,41,1.1219512195121952,0.06242187264424257,564,"No, Miss Climson, not ""owls""; I asked for more ""v-owels""."
2295,1,3,37,41,1.1219512195121952,0.06242187264424257,564,"I switched from email to omail, and my inbox is still full."
2295,0,5,36,41,1.1219512195121952,0.051739520574625435,564,You don't give a hoot about your 3:30?
2295,1,3,37,41,1.1219512195121952,0.06242187264424257,564,"No Sir, I don't believe there is a shortcut to wisdom."
2295,0,5,36,41,1.1219512195121952,0.051739520574625435,564,Tell him my team says we don't give a hoot what the president thinks.
2295,0,5,36,41,1.1219512195121952,0.051739520574625435,564,They are going to be handling the night shift
2295,0,5,36,41,1.1219512195121952,0.051739520574625435,564,"Then, madam, I suggest you keep your mice in their cages."
2295,0,5,36,41,1.1219512195121952,0.051739520574625435,564,Must be a hoot around here at feeding time.
2295,1,3,37,41,1.1219512195121952,0.06242187264424257,564,You're fired. My new staff doesn't complain when they have to pull an all nighter.
2295,1,3,37,41,1.1219512195121952,0.06242187264424257,564,"Ma'am, this is a library. You can't return owls here."
2295,0,5,36,41,1.1219512195121952,0.051739520574625435,564,"Really Erma... Was nine ""hours"" too much to ask?"
2295,1,3,37,41,1.1219512195121952,0.06242187264424257,564,Their neck rotation wont give a wider range to your perspective
2295,1,3,37,41,1.1219512195121952,0.06242187264424257,564,Yes and who would you like to see today?
2295,0,5,36,41,1.1219512195121952,0.051739520574625435,564,Who do you think they are?
2295,1,3,37,41,1.1219512195121952,0.06242187264424257,564,We're hoping these guys can help the White House's tweets sound a little wiser.
2295,1,3,37,41,1.1219512195121952,0.06242187264424257,564,"Point taken, Janice. It is possible give a hoot."
2295,2,1,38,41,1.1219512195121952,0.07152623560300088,564,They help me with my low self-esteem.
2295,0,5,36,41,1.1219512195121952,0.051739520574625435,564,"Beth, it's working! The owls have scared all the people away!"
2295,1,3,37,41,1.1219512195121952,0.06242187264424257,564,"No sir, I do not think ten would be cuter."
2295,2,1,38,41,1.1219512195121952,0.07152623560300088,564,Is it another story of mice and man ?
2295,1,3,37,41,1.1219512195121952,0.06242187264424257,564,It's 5 to 4. You're fired!
2295,0,5,36,41,1.1219512195121952,0.051739520574625435,564,Who knew the Hogwarts graduates would be so interested in an entry level accountant job?
2295,1,3,37,41,1.1219512195121952,0.06242187264424257,564,Would please have our corporate ornithologists see me as soon as possible?
2295,0,5,36,41,1.1219512195121952,0.051739520574625435,564,Bill knows one of them ate his lunch.
2295,1,3,37,41,1.1219512195121952,0.06242187264424257,564,Who sent you?
2295,0,5,36,41,1.1219512195121952,0.051739520574625435,564,You're late.
2295,0,5,36,41,1.1219512195121952,0.051739520574625435,564,Who let the owls out? Who? Who? Who? Who? Who?
2295,1,3,37,41,1.1219512195121952,0.06242187264424257,564,They're the best brains I could find.
2295,1,3,37,41,1.1219512195121952,0.06242187264424257,564,I find myself missing the mice.
2295,1,3,37,41,1.1219512195121952,0.06242187264424257,564,Who said that?
2295,0,5,36,41,1.1219512195121952,0.051739520574625435,564,"So I say, ""Who are you?"" And they say, ""Who?"" Then I say, ""You."" Then they say, ""Who?"" Then I say, wait for it, ""Third base!"""
2295,2,1,38,41,1.1219512195121952,0.07152623560300088,564,"I'll take two Southern-fried to go, please."
2295,2,1,38,41,1.1219512195121952,0.07152623560300088,564,The gift card says they're from some environmental group.
2295,1,3,37,41,1.1219512195121952,0.06242187264424257,564,"When I said 'this job is for the birds,' they all swooped in to take it."
2295,0,5,36,41,1.1219512195121952,0.051739520574625435,564,"Frankly Mr. Butler, I don't give a hoot either."
2295,0,5,36,41,1.1219512195121952,0.051739520574625435,564,"We know when you're lying, Jan."
2295,1,3,37,41,1.1219512195121952,0.06242187264424257,564,I've acumulated more wisdom in every one of the nine years I've worked here.
2295,2,1,38,41,1.1219512195121952,0.07152623560300088,564,"Nein owls, Frau Heller. Nein owls..."
2295,0,5,36,41,1.1219512195121952,0.051739520574625435,564,"Ms. Frakenbach, take a memo: My associates and I don't give a hoot."
2295,1,3,37,41,1.1219512195121952,0.06242187264424257,564,I.T. needs sign off on a supply order. All the mice have gone missing.
2295,2,1,38,41,1.1219512195121952,0.07152623560300088,564,We did it! We now know how many licks.
2295,0,5,36,41,1.1219512195121952,0.051739520574625435,564,I just finished briefing the night shift.
2295,0,5,36,41,1.1219512195121952,0.051739520574625435,564,"Sir, our man in Athens suggests Newcastle."
2295,0,5,36,41,1.1219512195121952,0.051739520574625435,564,Batman was already taken
2295,2,1,38,41,1.1219512195121952,0.07152623560300088,564,"Can you point out which of my advisors sexually harassed you, Mrs. Hu?"
2295,0,5,36,41,1.1219512195121952,0.051739520574625435,564,The wisdoms of crowds
2295,0,5,36,41,1.1219512195121952,0.051739520574625435,564,Point made Ms. Pritchett. Nothing inauspicious here.
2685,0,4,29,33,1.121212121212121,0.05769525080199931,564,Said hoo?
2685,0,4,29,33,1.121212121212121,0.05769525080199931,564,You will be responsible for the what-why-when-and-wheres.
2685,0,4,29,33,1.121212121212121,0.05769525080199931,564,They're training for Hogwarts.
2685,0,4,29,33,1.121212121212121,0.05769525080199931,564,Make sure you choose wisely.
2685,0,4,29,33,1.121212121212121,0.05769525080199931,564,Did you find out how many licks it takes sir?
2690,2,1,39,42,1.119047619047619,0.06986282354917808,564,"I've asked you what, why, when, where and how. But they may have one more question."
2691,1,3,39,43,1.1162790697674418,0.059615808787130756,564,"We all have problems, but don’t tell me don't give a hoot!"
2692,0,4,33,37,1.1081081081081081,0.05175281663547772,564,"I said I was into Dr Who, not Nine Owls From the Midnight Inning."
2692,1,2,34,37,1.1081081081081081,0.06465180222706,564,"Headquarters, Marquis Who’s Who."
2692,0,4,33,37,1.1081081081081081,0.05175281663547772,564,"Miss Jenkins, a memo to Hogwarts please: ""We are not accepting transfer applications at this time."""
2692,0,4,33,37,1.1081081081081081,0.05175281663547772,564,It's the new FAQ division.
2692,1,2,34,37,1.1081081081081081,0.06465180222706,564,"Well, Owl be damned, Francine. Hoo'd a thunk most people hate puns?"
2692,1,2,34,37,1.1081081081081081,0.06465180222706,564,Do you think that's wise?
2692,0,4,33,37,1.1081081081081081,0.05175281663547772,564,He's asking for the 'Wise One'.
2692,0,4,33,37,1.1081081081081081,0.05175281663547772,564,Hoo's Hoo?
2692,0,4,33,37,1.1081081081081081,0.05175281663547772,564,"An owl for every desk, Mrs. Smith. Let's see if we get smarter memos."
2692,0,4,33,37,1.1081081081081081,0.05175281663547772,564,"Don't listen to them, I know who that is."
2692,0,4,33,37,1.1081081081081081,0.05175281663547772,564,"I understand that you like my new file cabinet, Ms. Jones."
2692,0,4,33,37,1.1081081081081081,0.05175281663547772,564,"With all the government budget cuts, we had to hire some new assistants."
2692,1,2,34,37,1.1081081081081081,0.06465180222706,564,"Is it ok now to set appointment for your wisdom teeth removal, sir?"
2692,0,4,33,37,1.1081081081081081,0.05175281663547772,564,"OK George, but this is the last time...""who let the dogs out?"""
2692,1,2,34,37,1.1081081081081081,0.06465180222706,564,Trust me! It's a hoot!
2692,0,4,33,37,1.1081081081081081,0.05175281663547772,564,"OK, I get it. You don't want me to focus on 'what, when, where, and how,"" but on who!"
2692,0,4,33,37,1.1081081081081081,0.05175281663547772,564,They are my most trusted advisors.
2692,0,4,33,37,1.1081081081081081,0.05175281663547772,564,'you left the windows open again.'
2692,1,2,34,37,1.1081081081081081,0.06465180222706,564,President Trump mandated this wowl.
2692,1,2,34,37,1.1081081081081081,0.06465180222706,564,"Well, I do give a hoot!"
2692,0,4,33,37,1.1081081081081081,0.05175281663547772,564,"They want the ninth day of Christmas changed to ""nine owls a-hooting."""
2692,1,2,34,37,1.1081081081081081,0.06465180222706,564,We thought it would be wiser if you no longer worked here.
2692,1,2,34,37,1.1081081081081081,0.06465180222706,564,"Frankly, Madam, I don't give a hoot."
2692,0,4,33,37,1.1081081081081081,0.05175281663547772,564,"Miss Penny, I specifically asked that 9 dowels be installed under my desktop"
2692,1,2,34,37,1.1081081081081081,0.06465180222706,564,"We're not so different, you an I."
2692,1,2,34,37,1.1081081081081081,0.06465180222706,564,Is it me? Is it you? Who gives a hoot?
2692,0,4,33,37,1.1081081081081081,0.05175281663547772,564,Fly with your own flock.
2692,1,2,34,37,1.1081081081081081,0.06465180222706,564,"Clearly, I DO give a hoot about your problem."
2692,0,4,33,37,1.1081081081081081,0.05175281663547772,564,"When you asked about ways to relieve stress, I meant Hooters."
2692,1,2,34,37,1.1081081081081081,0.06465180222706,564,"No wisdom from these stupid birds, I get all my information from the Internet."
2692,1,2,34,37,1.1081081081081081,0.06465180222706,564,"You always go above and beyond, Oscar, but 'bring your pet to work day' means ONE, not a parliament!"
2692,0,4,33,37,1.1081081081081081,0.05175281663547772,564,"Sandra, I believe you've met the new legal team..."
2692,0,4,33,37,1.1081081081081081,0.05175281663547772,564,"I'm happy your side business is going well Ted, but your 'Authentic Harry Potter Mail Owl' business must be run from home."
2692,1,2,34,37,1.1081081081081081,0.06465180222706,564,"Trademarked? Well, what about Hooties?"
2692,0,4,33,37,1.1081081081081081,0.05175281663547772,564,"Send them back. I ordered a ""Who's Who"" for my desk."
2692,0,4,33,37,1.1081081081081081,0.05175281663547772,564,What makes you think I give a hoot!
2692,1,2,34,37,1.1081081081081081,0.06465180222706,564,'They're the desktop version'
2692,0,4,33,37,1.1081081081081081,0.05175281663547772,564,"I know Tuesdays are half-price wings at Hooter's, but this is ridiculous."
2692,0,4,33,37,1.1081081081081081,0.05175281663547772,564,"Sorry, they ran out of pipers piping."
2692,1,2,34,37,1.1081081081081081,0.06465180222706,564,Didn't anybody telly you? Mr. Jenkins hates owls.
2692,1,2,34,37,1.1081081081081081,0.06465180222706,564,There's this cat that I don't ever want to see again!
2692,0,4,33,37,1.1081081081081081,0.05175281663547772,564,Don't get nervous ... It's not as if they're chickens ...
2692,1,2,34,37,1.1081081081081081,0.06465180222706,564,I'm missing one...can you bring me my binoculars?
2692,0,4,33,37,1.1081081081081081,0.05175281663547772,564,I told you the Ornithologists Writers' League would make a lousy acro
2692,0,4,33,37,1.1081081081081081,0.05175281663547772,564,"Frankly, Sylvia, I don't give nine hoots."
2692,0,4,33,37,1.1081081081081081,0.05175281663547772,564,I ordered a DOZEN owls Ms Smith.
2692,1,2,34,37,1.1081081081081081,0.06465180222706,564,Care for a Parliament?
2692,0,4,33,37,1.1081081081081081,0.05175281663547772,564,"We've got who, all we need now is the what and where."
2692,1,2,34,37,1.1081081081081081,0.06465180222706,564,"Good morning, sir, are we any closer to giving a hoot today?"
2692,0,4,33,37,1.1081081081081081,0.05175281663547772,564,I see you've been ignoring your Hogwarts letters.
2692,1,2,34,37,1.1081081081081081,0.06465180222706,564,Would you like to buy a owl?
2692,0,4,33,37,1.1081081081081081,0.05175281663547772,564,I've figured out how to win the rat race.
2692,0,4,33,37,1.1081081081081081,0.05175281663547772,564,"You said I should get all my ducks in a row, so what if I can't find any ducks?"
2692,0,4,33,37,1.1081081081081081,0.05175281663547772,564,Have I made it clear I don't give a hoot?
2692,1,2,34,37,1.1081081081081081,0.06465180222706,564,"ITS MY BIRTHDAY, EVER ONE KNOWS I LIKE HOOTERS."
2692,0,4,33,37,1.1081081081081081,0.05175281663547772,564,"When I asked for a Parliament, I meant a cigarette."
2692,0,4,33,37,1.1081081081081081,0.05175281663547772,564,At least the rats are gone.
2692,0,4,33,37,1.1081081081081081,0.05175281663547772,564,This will take care of the mouse problem.
2692,1,2,34,37,1.1081081081081081,0.06465180222706,564,Who knows?
2692,0,4,33,37,1.1081081081081081,0.05175281663547772,564,The Tootsie Pop focus group is here.
2692,0,4,33,37,1.1081081081081081,0.05175281663547772,564,I still don't give a hoot!
2692,0,4,33,37,1.1081081081081081,0.05175281663547772,564,"9 lollipops please, Janice"
2692,0,4,33,37,1.1081081081081081,0.05175281663547772,564,"Personally, I don't give a hoot, but I'm clearly outnumbered."
2692,0,4,33,37,1.1081081081081081,0.05175281663547772,564,"Well, they’re not turning out to be as wise as we’d hoped but they’re keeping the field mice down."
2692,1,2,34,37,1.1081081081081081,0.06465180222706,564,It would be wise of you not to say anything about my friends!
2692,1,2,34,37,1.1081081081081081,0.06465180222706,564,Parliament is in session!
2692,0,4,33,37,1.1081081081081081,0.05175281663547772,564,It's the Audubon Society on line one.
2692,0,4,33,37,1.1081081081081081,0.05175281663547772,564,"Doctor, Mr. Sedaris is here to discuss diabetes."
2692,1,2,34,37,1.1081081081081081,0.06465180222706,564,"I'm sorry, we're short two Pussy-cats for the Dance By The Light Of the Moon."
2692,1,2,34,37,1.1081081081081081,0.06465180222706,564,E-mail? Does Dumbledore use e-mail?
2692,0,4,33,37,1.1081081081081081,0.05175281663547772,564,"No, Stan, I did not know it is 'Take Your Owls to Work Day'."
2692,1,2,34,37,1.1081081081081081,0.06465180222706,564,"You're fired, Mrs. Johnson. Please get the flock out of here."
2692,1,2,34,37,1.1081081081081081,0.06465180222706,564,"When they said I was to ""speak to the parliament..."""
2692,0,4,33,37,1.1081081081081081,0.05175281663547772,564,I'm here to see Mr. Who.
2692,1,2,34,37,1.1081081081081081,0.06465180222706,564,These owls will help fight illiteracy!
2692,0,4,33,37,1.1081081081081081,0.05175281663547772,564,FYI we use computers to send messages here.
2692,1,2,34,37,1.1081081081081081,0.06465180222706,564,"No, I said I wanted to see Al's son, Dex!"
2692,0,4,33,37,1.1081081081081081,0.05175281663547772,564,Whooo's on first?
2692,0,4,33,37,1.1081081081081081,0.05175281663547772,564,Whoooo's missing?
2692,0,4,33,37,1.1081081081081081,0.05175281663547772,564,It's a sit-in - they want us to rename Twitter to Hooter.
2692,0,4,33,37,1.1081081081081081,0.05175281663547772,564,They told me this job was a hoot. They didn't say why.
2692,1,2,34,37,1.1081081081081081,0.06465180222706,564,"Well, you're no pussycat."
2692,1,2,34,37,1.1081081081081081,0.06465180222706,564,"Really Jones, when I said I'm looking for branch manager material this is not what I meant."
2692,1,2,34,37,1.1081081081081081,0.06465180222706,564,Neither the Cardinals nor the Blue Jays are interested in the Whoo's on first joke.
2692,0,4,33,37,1.1081081081081081,0.05175281663547772,564,"WHO, WHO, WHO are you?"
2692,2,0,35,37,1.1081081081081081,0.07537477716523201,564,"Yes, this is what happens when you don't give a hoot."
2692,1,2,34,37,1.1081081081081081,0.06465180222706,564,I'm sick of being called four eyes.
2692,1,2,34,37,1.1081081081081081,0.06465180222706,564,"You're kidding, Mr. Hootwell, I don't care what your mother said."
2692,0,4,33,37,1.1081081081081081,0.05175281663547772,564,"Taking this ""night owl"" thing seriously."
2692,0,4,33,37,1.1081081081081081,0.05175281663547772,564,They are my eyes!
2692,1,2,34,37,1.1081081081081081,0.06465180222706,564,"Very humorous, Ms. Fogerty. Gee, I don't think I've ever heard the comment, ""Oh, what a hoot!"" about my owl collection before. Hilarious."
2692,1,2,34,37,1.1081081081081081,0.06465180222706,564,"All I want to know now is: ""Who?"""
2692,0,4,33,37,1.1081081081081081,0.05175281663547772,564,"Harold, wisdom comes from experience. Nice try!"
2692,0,4,33,37,1.1081081081081081,0.05175281663547772,564,"We'll be having a working lunch. After the deli, could you stop by the pet store and pick up nine mice?"
2692,0,4,33,37,1.1081081081081081,0.05175281663547772,564,"100,000 steps this week and it's only Wednesday."
2692,1,2,34,37,1.1081081081081081,0.06465180222706,564,My friends here fill in when I don't have all the answers.
2692,1,2,34,37,1.1081081081081081,0.06465180222706,564,"We're sending this year's acceptance letters Hogwarts-style. Take that, Yale."
2692,1,2,34,37,1.1081081081081081,0.06465180222706,564,Now will you stop resisting the wisdom of my decisions?
2692,1,2,34,37,1.1081081081081081,0.06465180222706,564,"I hope you don't mind, Miss Fieldmouse, but I've invited a few of my colleagues to sit in on this next part of the interview."
2692,0,4,33,37,1.1081081081081081,0.05175281663547772,564,I thought it would be a hoot.
2692,0,4,33,37,1.1081081081081081,0.05175281663547772,564,Inform my wife that the staff and I shall be working late again tonight
2692,1,2,34,37,1.1081081081081081,0.06465180222706,564,Call Hogwarts and tell them we will no longer be accepting returns by airmail
2692,0,4,33,37,1.1081081081081081,0.05175281663547772,564,At least make an effort to know who is who.
2692,0,4,33,37,1.1081081081081081,0.05175281663547772,564,That's the last time you go to Hooters!
2692,1,2,34,37,1.1081081081081081,0.06465180222706,564,Let me guess; you're headed to a hootenanny.
2692,0,4,33,37,1.1081081081081081,0.05175281663547772,564,Henry I said the outlet store. Not the owlet store.
2692,0,4,33,37,1.1081081081081081,0.05175281663547772,564,Not one of them. Good night!
2692,1,2,34,37,1.1081081081081081,0.06465180222706,564,Thought I'd get a few more eyes on the annual report.
2692,1,2,34,37,1.1081081081081081,0.06465180222706,564,We need to discuss your obsession with Hooters
2692,0,4,33,37,1.1081081081081081,0.05175281663547772,564,Whooo did you say the author was?
2692,0,4,33,37,1.1081081081081081,0.05175281663547772,564,"Their to support the ""wiretapping"" claim."
2692,1,2,34,37,1.1081081081081081,0.06465180222706,564,Who did you say you were?
2692,0,4,33,37,1.1081081081081081,0.05175281663547772,564,You'll have to admit it has cut down on the field mice.
2692,0,4,33,37,1.1081081081081081,0.05175281663547772,564,Only they ask the questions around here.
2692,0,4,33,37,1.1081081081081081,0.05175281663547772,564,"Thank you, Ms. Mudd, but I asked for some TOWELETTES to clean the window."
2692,0,4,33,37,1.1081081081081081,0.05175281663547772,564,Your petition for equal pay was rejected by parliament.
2692,1,2,34,37,1.1081081081081081,0.06465180222706,564,I've displayed my doppelgänger in its various moods.
2692,1,2,34,37,1.1081081081081081,0.06465180222706,564,"This isn't what I meant when I asked you to give a hoot, Harold. That being said, I am glad I censored myself."
2692,0,4,33,37,1.1081081081081081,0.05175281663547772,564,They'll keep an eye on things while I'm gone.
2692,0,4,33,37,1.1081081081081081,0.05175281663547772,564,Your wife called. She says she doesn't give a hoot.
2692,0,4,33,37,1.1081081081081081,0.05175281663547772,564,Maybe it's time to cut back on night shifts.
2692,0,4,33,37,1.1081081081081081,0.05175281663547772,564,"Well, you did ask for the Who's Who on your desk, sir."
2692,1,2,34,37,1.1081081081081081,0.06465180222706,564,I don't like working late nights either.
2692,1,2,34,37,1.1081081081081081,0.06465180222706,564,"Sorry, but I don't give a hoot."
2692,0,4,33,37,1.1081081081081081,0.05175281663547772,564,And I say it's 'To Who It May Concern'.
2692,1,2,34,37,1.1081081081081081,0.06465180222706,564,"This way, I'm never alone with a woman."
2692,1,2,34,37,1.1081081081081081,0.06465180222706,564,I solved the mouse problem.
2692,0,4,33,37,1.1081081081081081,0.05175281663547772,564,"Who,Who,Who,Who wants to see me?"
2692,0,4,33,37,1.1081081081081081,0.05175281663547772,564,"No, Liz, I said I needed ten HOURS to get this project done."
2692,0,4,33,37,1.1081081081081081,0.05175281663547772,564,"Is it ""Who"" or ""Whom"" am I talking to?"
2692,0,4,33,37,1.1081081081081081,0.05175281663547772,564,J.K. Rowling is sending Tweets to the President again.
2692,0,4,33,37,1.1081081081081081,0.05175281663547772,564,What else would I be doing in the middle of the night?
2692,1,2,34,37,1.1081081081081081,0.06465180222706,564,Great hooters you got there!
2692,1,2,34,37,1.1081081081081081,0.06465180222706,564,Truth in advertising demands accuracy. Bring in the Tootsie Pops.
2692,1,2,34,37,1.1081081081081081,0.06465180222706,564,This does NOT make you a Member of Parliament!
2692,1,2,34,37,1.1081081081081081,0.06465180222706,564,We need to reword the help wanted ad for that new Hooters franchise.
2692,0,4,33,37,1.1081081081081081,0.05175281663547772,564,It's a Jeopardy question.
2692,1,2,34,37,1.1081081081081081,0.06465180222706,564,"What is it this time, groomer or the vet?"
2692,0,4,33,37,1.1081081081081081,0.05175281663547772,564,"I wouldn't call this building a better mousetrap, no."
2692,1,2,34,37,1.1081081081081081,0.06465180222706,564,I met them at Hooters.
2692,1,2,34,37,1.1081081081081081,0.06465180222706,564,For one mouse?
2692,0,4,33,37,1.1081081081081081,0.05175281663547772,564,"Sorry, I'm fresh out of mice."
2692,0,4,33,37,1.1081081081081081,0.05175281663547772,564,Who's here to see me?
2692,0,4,33,37,1.1081081081081081,0.05175281663547772,564,"I caught them prowling around, Ms. Hedwig. It's obvious they're in cahoots, but with who?"
2692,1,2,34,37,1.1081081081081081,0.06465180222706,564,"Frankly, I prefer to seem wise by stealing my grad students' papers..."
2692,0,4,33,37,1.1081081081081081,0.05175281663547772,564,"I know they're cluttering my desk, but I don't give a hoot."
2692,1,2,34,37,1.1081081081081081,0.06465180222706,564,"Yeah, but whoooooooooo's counting?"
2692,1,2,34,37,1.1081081081081081,0.06465180222706,564,Tell the Potter fans that emails are just fine.
2692,1,2,34,37,1.1081081081081081,0.06465180222706,564,"But you haven't seen any mice around, have you?"
2692,0,4,33,37,1.1081081081081081,0.05175281663547772,564,Apparently they mistook Harvard for Hogwarts.
2692,0,4,33,37,1.1081081081081081,0.05175281663547772,564,I don't give a hoot who's here to see me. I am working on the reorganization plan with my consultants!
2692,0,4,33,37,1.1081081081081081,0.05175281663547772,564,The ruling is not in your favor. You're fired.
2692,1,2,34,37,1.1081081081081081,0.06465180222706,564,My ex-place or yours?
2692,1,2,34,37,1.1081081081081081,0.06465180222706,564,"It's ""I give a hoot at work day""."
2692,0,4,33,37,1.1081081081081081,0.05175281663547772,564,They're here for a consultation on how to build a better nest egg.
2692,0,4,33,37,1.1081081081081081,0.05175281663547772,564,As a matter of fact I was raised in a barn.
2692,1,2,34,37,1.1081081081081081,0.06465180222706,564,Owl cappella.
2692,1,2,34,37,1.1081081081081081,0.06465180222706,564,They came with the desk
2692,1,2,34,37,1.1081081081081081,0.06465180222706,564,"So, bringing wisdom to the office is not figuratively, eh?"
2692,0,4,33,37,1.1081081081081081,0.05175281663547772,564,Let her go to Hogwarts already!
2692,1,2,34,37,1.1081081081081081,0.06465180222706,564,Don't screech. It is a parliament meeting.
2692,0,4,33,37,1.1081081081081081,0.05175281663547772,564,"Contrary to what you may have heard, this office does actually give a hoot."
2692,0,4,33,37,1.1081081081081081,0.05175281663547772,564,Are you F!#@ing kidding me Ellen?!? I said towels!
2692,1,2,34,37,1.1081081081081081,0.06465180222706,564,Get me the quinoa salad and nine rats.
2692,0,4,33,37,1.1081081081081081,0.05175281663547772,564,Now bring 2 mice and a documentary filmmaker.
2692,1,2,34,37,1.1081081081081081,0.06465180222706,564,I don't give a hoot about all your collected wisdom...
2692,0,4,33,37,1.1081081081081081,0.05175281663547772,564,Just because my name is Harry Z. Potter!
2692,0,4,33,37,1.1081081081081081,0.05175281663547772,564,"It's parliamentary, my dear Ms. Henderson."
2692,0,4,33,37,1.1081081081081081,0.05175281663547772,564,We shared an Uber Pool.
2692,0,4,33,37,1.1081081081081081,0.05175281663547772,564,The employment agency sent them over. Nobody else wants to work the night shift.
2692,0,4,33,37,1.1081081081081081,0.05175281663547772,564,I've just been appointed Prime Minister.
2692,0,4,33,37,1.1081081081081081,0.05175281663547772,564,Have one that gives a hoot?
2692,0,4,33,37,1.1081081081081081,0.05175281663547772,564,Maybe next time we should specify that replies from Hogwarts should be sent by email.
2692,1,2,34,37,1.1081081081081081,0.06465180222706,564,"Sir, there's an owl in the outer office applying for the vacancy."
2692,1,2,34,37,1.1081081081081081,0.06465180222706,564,"Because you are a genius, we will tolerate your obsession with owls."
2692,2,0,35,37,1.1081081081081081,0.07537477716523201,564,"Jane, I would like you to meet your new night staff. Upper management decided to make budget cuts."
2692,0,4,33,37,1.1081081081081081,0.05175281663547772,564,We've contracted with them to write 'The Who's Who of the National Audubon Society'.
2692,0,4,33,37,1.1081081081081081,0.05175281663547772,564,I bet you carry a lot of books on prophecy and wisdom.
2692,1,2,34,37,1.1081081081081081,0.06465180222706,564,Our Tootsie Roll client is going to love this new ad campaign!
2692,0,4,33,37,1.1081081081081081,0.05175281663547772,564,"Who, indeed! Who cares?"
2692,0,4,33,37,1.1081081081081081,0.05175281663547772,564,"Janice, I'm the only guy around here who gives a hoot."
2692,1,2,34,37,1.1081081081081081,0.06465180222706,564,"Oh, so those are the hooters? I'm still reporting you to HR."
2692,0,4,33,37,1.1081081081081081,0.05175281663547772,564,"Uh-huh,"" says I, ""a couple of freshman philosophy courses and you're ready to perch there pontifying like god's gift to perspicacity. Now how 'bout you striplings come see how the real world works?"
2692,0,4,33,37,1.1081081081081081,0.05175281663547772,564,"""I am trying to figure out 'whodunnit'!""."
2692,1,2,34,37,1.1081081081081081,0.06465180222706,564,Our company email has been hacked.
2692,0,4,33,37,1.1081081081081081,0.05175281663547772,564,"Well, owl-be."
2692,1,2,34,37,1.1081081081081081,0.06465180222706,564,"How many owls does it take to get the center of an HR investigation?"" ""One was enough, John."
2692,1,2,34,37,1.1081081081081081,0.06465180222706,564,the one on the left sings bass
2692,1,2,34,37,1.1081081081081081,0.06465180222706,564,Say hello to our Board of Directors.
2692,1,2,34,37,1.1081081081081081,0.06465180222706,564,"Evelyn, I'd like you to meet our night crew."
2692,1,2,34,37,1.1081081081081081,0.06465180222706,564,"I'll call it in now, nine rats and one BLT, with blah, extra mayo."
2692,1,2,34,37,1.1081081081081081,0.06465180222706,564,"Shall I show them the temple, or will you?"
2692,0,4,33,37,1.1081081081081081,0.05175281663547772,564,"Honestly, I don't give HOOT."
2692,0,4,33,37,1.1081081081081081,0.05175281663547772,564,"I'd ask 'Why?', yet, 'Who?' seems more appropriate."
2692,0,4,33,37,1.1081081081081081,0.05175281663547772,564,"Sorry, Ms. Higgins. The committee just doesn't give a hoot."
2692,0,4,33,37,1.1081081081081081,0.05175281663547772,564,"To Athens, not from."
2692,1,2,34,37,1.1081081081081081,0.06465180222706,564,"10 cups of black coffee, please."
2692,1,2,34,37,1.1081081081081081,0.06465180222706,564,Guess whoooo's been granted power of attorney?
2692,0,4,33,37,1.1081081081081081,0.05175281663547772,564,"Yes, I agree. Your office is the most rodent-free office in the building."
2692,1,2,34,37,1.1081081081081081,0.06465180222706,564,We'd like you to join our Parliament.
2692,0,4,33,37,1.1081081081081081,0.05175281663547772,564,"Towels, Johnson; towels."
2692,1,2,34,37,1.1081081081081081,0.06465180222706,564,"No, Sir. I don't think it makes you look smarter and your desk is a mess."
2692,0,4,33,37,1.1081081081081081,0.05175281663547772,564,I don't care if you don't give a hoot.
2692,0,4,33,37,1.1081081081081081,0.05175281663547772,564,"No, Mrs. Smith, I need towelettes."
2692,1,2,34,37,1.1081081081081081,0.06465180222706,564,"Tell him that ""Owl be happy to join the meeting."""
2692,0,4,33,37,1.1081081081081081,0.05175281663547772,564,Do you know whooo you're talking to?
2692,0,4,33,37,1.1081081081081081,0.05175281663547772,564,But I never had a bird problem on my desk before you got the owls.
2692,0,4,33,37,1.1081081081081081,0.05175281663547772,564,"Ms. Jones, I asked for nine towels!"
2692,0,4,33,37,1.1081081081081081,0.05175281663547772,564,"My inbox is insane, our server is down."
2692,0,4,33,37,1.1081081081081081,0.05175281663547772,564,"I don't care if they're 100% organic, Miss Hurd, I asked for towels."
2692,1,2,34,37,1.1081081081081081,0.06465180222706,564,"Well, who are you? Who, who, who, who ?? I really wanna know who are you? Hoo, hoo, hoo, hoo?? Tell me, who are you. Hoo, hoo, hoo, hoo ?? 'Cause I really wanna know. Hoo, hoo, hoo, hoo??"
2692,1,2,34,37,1.1081081081081081,0.06465180222706,564,"Mr. Bezos, if people were afraid of Amazon Drones..."
2692,1,2,34,37,1.1081081081081081,0.06465180222706,564,A bird in the hand is worth nine on the desk.
2692,0,4,33,37,1.1081081081081081,0.05175281663547772,564,We don't give a hoot about your problem.
2692,1,2,34,37,1.1081081081081081,0.06465180222706,564,"From today on, our corporation’s work time is from dusk to dawn."
2692,0,4,33,37,1.1081081081081081,0.05175281663547772,564,Hooo's the boss now?
2692,1,2,34,37,1.1081081081081081,0.06465180222706,564,"You've made it clear that you don't give a hoot. But, nine; really?"
2692,0,4,33,37,1.1081081081081081,0.05175281663547772,564,So hoo's first?
2692,0,4,33,37,1.1081081081081081,0.05175281663547772,564,"I thought wisdom came from experience, not from icons"
2692,0,4,33,37,1.1081081081081081,0.05175281663547772,564,"Actually, I DO give a hoot."
2692,0,4,33,37,1.1081081081081081,0.05175281663547772,564,Implausible deniability.
2692,1,2,34,37,1.1081081081081081,0.06465180222706,564,Turns out kids prefer pussycats.
2692,0,4,33,37,1.1081081081081081,0.05175281663547772,564,Who said I have a problem? Who? Who?
2692,0,4,33,37,1.1081081081081081,0.05175281663547772,564,"I know what you're going to say...""why nine?"""
2692,0,4,33,37,1.1081081081081081,0.05175281663547772,564,"HRs new strategy. ""We really, really, do give a hoot."""
2692,1,2,34,37,1.1081081081081081,0.06465180222706,564,"When I asked you to do something about the mice, I meant call an exterminator."
2692,1,2,34,37,1.1081081081081081,0.06465180222706,564,I think that is a wise move.
2692,1,2,34,37,1.1081081081081081,0.06465180222706,564,The EPA was having a sale.
2692,1,2,34,37,1.1081081081081081,0.06465180222706,564,"Just a thought, Miss Primby,~do you know any nice pussycats?"
2692,1,2,34,37,1.1081081081081081,0.06465180222706,564,"Wise? No, I'd say subtle."
2692,0,4,33,37,1.1081081081081081,0.05175281663547772,564,You think this is bad? Every day I have to wake up to that old hen.
2692,0,4,33,37,1.1081081081081081,0.05175281663547772,564,It was a split decision. You're fired.
2692,0,4,33,37,1.1081081081081081,0.05175281663547772,564,"I don't care if you give a hoot, I am not doing that"
2692,1,2,34,37,1.1081081081081081,0.06465180222706,564,"Oh, Cathy - you're a hoot."
2692,2,0,35,37,1.1081081081081081,0.07537477716523201,564,"Is there a problem,?"
2692,2,0,35,37,1.1081081081081081,0.07537477716523201,564,"""The Audabon folks aren't interested;they think they're wise enough!'"
2692,1,2,34,37,1.1081081081081081,0.06465180222706,564,Welcome to OWL FINANCIAL SERVICES where we give a hoot.
2692,1,2,34,37,1.1081081081081081,0.06465180222706,564,But who's counting?
2692,1,2,34,37,1.1081081081081081,0.06465180222706,564,Owl ask you later.
2692,1,2,34,37,1.1081081081081081,0.06465180222706,564,"Bring me a coffee, paper towels and some mice."
2692,0,4,33,37,1.1081081081081081,0.05175281663547772,564,I wish people would wise up and stop giving me the bird.
2692,0,4,33,37,1.1081081081081081,0.05175281663547772,564,"Why yes, I have been feeling a bit owly lately."
2692,1,2,34,37,1.1081081081081081,0.06465180222706,564,"I don't give a hoot, either, Ed. I still need your timesheets."
2692,0,4,33,37,1.1081081081081081,0.05175281663547772,564,My therapist says nine owls a day will cure my fear of rodents.
2692,0,4,33,37,1.1081081081081081,0.05175281663547772,564,Also where? what? and why?n
2692,1,2,34,37,1.1081081081081081,0.06465180222706,564,It's a new Parliamentary procedure
2692,1,2,34,37,1.1081081081081081,0.06465180222706,564,You must be the wisest person I know!
2692,0,4,33,37,1.1081081081081081,0.05175281663547772,564,"You can laugh, but there hasn't been a pidgeon on my desk all day."
2692,0,4,33,37,1.1081081081081081,0.05175281663547772,564,Looks to me like you can afford to give a hoot now and then.
2692,0,4,33,37,1.1081081081081081,0.05175281663547772,564,Mr. Finley I think you have mice in your desk
2692,1,2,34,37,1.1081081081081081,0.06465180222706,564,"No, I wanted some towels, with a ""T."""
2692,0,4,33,37,1.1081081081081081,0.05175281663547772,564,Proof we actually give a hoot!
2692,0,4,33,37,1.1081081081081081,0.05175281663547772,564,"It's not the Hoo, it's the Why?"
2692,1,2,34,37,1.1081081081081081,0.06465180222706,564,I thought these might soften Hooters image!
2692,1,2,34,37,1.1081081081081081,0.06465180222706,564,They're mad that rodents get all the good roles in cartoons.
2692,1,2,34,37,1.1081081081081081,0.06465180222706,564,You said I didn't give a hoot so I gave a hoot.
2692,0,4,33,37,1.1081081081081081,0.05175281663547772,564,"Frankly, I could give a hoot."
2692,1,2,34,37,1.1081081081081081,0.06465180222706,564,I'm researching a who-done-it
2692,0,4,33,37,1.1081081081081081,0.05175281663547772,564,"Yes, Hazel, I am now a member of Parliament."
2692,0,4,33,37,1.1081081081081081,0.05175281663547772,564,I still say an exterminator would have been able to look after our mouse problem.
2692,1,2,34,37,1.1081081081081081,0.06465180222706,564,"They're calling it a ""Hoteninenny!"""
2692,1,2,34,37,1.1081081081081081,0.06465180222706,564,"We've been up all night working on this project, so please bring us nine mouse sandwiches and one sticky bun."
2692,0,4,33,37,1.1081081081081081,0.05175281663547772,564,Was it too much to ask for the Nine Ladies Dancing?
2692,1,2,34,37,1.1081081081081081,0.06465180222706,564,I couldn't resist.
2692,1,2,34,37,1.1081081081081081,0.06465180222706,564,"Feeling owly this morning, are we, sir?"
2692,0,4,33,37,1.1081081081081081,0.05175281663547772,564,"Yeah, I work with a bunch of wise guys."
2692,1,2,34,37,1.1081081081081081,0.06465180222706,564,"They don't give a hoot, Miss Ledbetter, and I no longer care to holler."
2692,1,2,34,37,1.1081081081081081,0.06465180222706,564,"From now on, Ms. Beasley, they'll be asking all the questions."
2692,1,2,34,37,1.1081081081081081,0.06465180222706,564,I'm a believer in collective wisdom.
2692,0,4,33,37,1.1081081081081081,0.05175281663547772,564,Tell the boss I don't give nine hoots.
2692,1,2,34,37,1.1081081081081081,0.06465180222706,564,I misunderstood when the board told me to acquire Hooter's.
2692,0,4,33,37,1.1081081081081081,0.05175281663547772,564,How about Weird 'Owl' Yankovic?
2692,0,4,33,37,1.1081081081081081,0.05175281663547772,564,I have all these eyes to observe you.
2692,0,4,33,37,1.1081081081081081,0.05175281663547772,564,"I don't give a hoot what you say, I'm not calling an exterminator!"
2692,0,4,33,37,1.1081081081081081,0.05175281663547772,564,"Did you say whose, who's or whos?"
2692,0,4,33,37,1.1081081081081081,0.05175281663547772,564,I wish I gave a hoot.
2692,0,4,33,37,1.1081081081081081,0.05175281663547772,564,Any luck keeping the pigeons off your head?
2692,0,4,33,37,1.1081081081081081,0.05175281663547772,564,"I'll need expense reports, the merger proposal and three dozen field mice."
2692,1,2,34,37,1.1081081081081081,0.06465180222706,564,"Historically, I've been more inclined to take a hoot."
2692,1,2,34,37,1.1081081081081081,0.06465180222706,564,"Before I sack Jenkins, tell him to reorder the towelettes."
2692,1,2,34,37,1.1081081081081081,0.06465180222706,564,"Actually, I could give a hoot."
2692,0,4,33,37,1.1081081081081081,0.05175281663547772,564,Looks like the internship applications from Hogwarts have arrived early this year.
2692,0,4,33,37,1.1081081081081081,0.05175281663547772,564,Our board is a veritable who's-who.
2692,1,2,34,37,1.1081081081081081,0.06465180222706,564,"Don't ever call me pussycat again, Mr. Wise!"
2692,0,4,33,37,1.1081081081081081,0.05175281663547772,564,"Yes sir, I found a tailor who can make suits for them."
2692,2,0,35,37,1.1081081081081081,0.07537477716523201,564,"Who's the wise guy, in charge of this place?"
2692,0,4,33,37,1.1081081081081081,0.05175281663547772,564,"I get it, you don't give a hoot"
2692,2,0,35,37,1.1081081081081081,0.07537477716523201,564,Whooo did you say called?
2692,0,4,33,37,1.1081081081081081,0.05175281663547772,564,My fax machine is on the fritz.
2692,0,4,33,37,1.1081081081081081,0.05175281663547772,564,The library owl had babies.
2692,1,2,34,37,1.1081081081081081,0.06465180222706,564,I did find it rather an odd request Madam Prime Minister.
2692,0,4,33,37,1.1081081081081081,0.05175281663547772,564,"As you can see, sometimes I do give a hoot."
2692,1,2,34,37,1.1081081081081081,0.06465180222706,564,So you're not a Muggle after all.
2692,1,2,34,37,1.1081081081081081,0.06465180222706,564,At least the mice are gone.
2692,1,2,34,37,1.1081081081081081,0.06465180222706,564,"I am a woman and I am underpaid"" --- ""I am a Republican and I don't give a hoot."
2692,1,2,34,37,1.1081081081081081,0.06465180222706,564,It is such a hoot to work here.
2692,0,4,33,37,1.1081081081081081,0.05175281663547772,564,"The question is 'why?', not 'who?'"
2692,1,2,34,37,1.1081081081081081,0.06465180222706,564,Who sent you?
2692,1,2,34,37,1.1081081081081081,0.06465180222706,564,Can't you see I don't give a Hoot!
2692,0,4,33,37,1.1081081081081081,0.05175281663547772,564,"Sorry, Margaret, I no longer give a hoot."
2692,0,4,33,37,1.1081081081081081,0.05175281663547772,564,More spam from Hogwarts?
2692,1,2,34,37,1.1081081081081081,0.06465180222706,564,"My secretary quit, but one of my carrier owls can get us lunch. How do you feel about rabbit?"
2692,0,4,33,37,1.1081081081081081,0.05175281663547772,564,They remind me that I'm not a mouse.
2692,0,4,33,37,1.1081081081081081,0.05175281663547772,564,Hoo done it?
2692,1,2,34,37,1.1081081081081081,0.06465180222706,564,May I have the Potter file?
2692,1,2,34,37,1.1081081081081081,0.06465180222706,564,"I have to go to the bathroom, would you watch my owls?"
2692,1,2,34,37,1.1081081081081081,0.06465180222706,564,I just don't give a hoot!
2692,0,4,33,37,1.1081081081081081,0.05175281663547772,564,"Ms Sanders, this is not what I meant when I said schedule 'Hooters' for lunch."
2692,0,4,33,37,1.1081081081081081,0.05175281663547772,564,Can you have the zoo department take a look at our outgoing mail problem?
2692,0,4,33,37,1.1081081081081081,0.05175281663547772,564,"For the last time, Mr. Jennings, we didn't have any mice even BEFORE you got them."
2692,0,4,33,37,1.1081081081081081,0.05175281663547772,564,"Sorry, we can’t seem to keep the whodunnits on the shelves."
2692,0,4,33,37,1.1081081081081081,0.05175281663547772,564,Your assignment is to teach them to fly.
2692,0,4,33,37,1.1081081081081081,0.05175281663547772,564,You can't have too much wisdom.
2692,0,4,33,37,1.1081081081081081,0.05175281663547772,564,"There'll be no hootin' and hollerin' around here, thank you."
2692,0,4,33,37,1.1081081081081081,0.05175281663547772,564,"Thank you, that will be owl, Ms. Perkins."
2692,0,4,33,37,1.1081081081081081,0.05175281663547772,564,Because there are a lot of rats working in this office.
2692,1,2,34,37,1.1081081081081081,0.06465180222706,564,Who is the wisest boss of all?
2692,0,4,33,37,1.1081081081081081,0.05175281663547772,564,Looks like you've made The Who's Who
2692,1,2,34,37,1.1081081081081081,0.06465180222706,564,You call them owls. I call them emotional support animals.
2692,1,2,34,37,1.1081081081081081,0.06465180222706,564,We could give a hoot about monthly sales reports.
2692,0,4,33,37,1.1081081081081081,0.05175281663547772,564,It's no coincidence the new mailroom guy is someone by the name of Potter.
2692,0,4,33,37,1.1081081081081081,0.05175281663547772,564,I never should have branched out.
2692,1,2,34,37,1.1081081081081081,0.06465180222706,564,Who's your daddy?
2692,0,4,33,37,1.1081081081081081,0.05175281663547772,564,My fear now is we'll run out of mice.
2692,1,2,34,37,1.1081081081081081,0.06465180222706,564,Is this where parliament meets?
2692,1,2,34,37,1.1081081081081081,0.06465180222706,564,Please file there alphabetically and by political preferences.
2692,0,4,33,37,1.1081081081081081,0.05175281663547772,564,You don't look any wiser.
2692,1,2,34,37,1.1081081081081081,0.06465180222706,564,"Once again, thank you for your gift of a membership in the 'Owl of the Month Club.'"
2692,0,4,33,37,1.1081081081081081,0.05175281663547772,564,"This is the client I was telling you about, they're a real hoot!"
2692,0,4,33,37,1.1081081081081081,0.05175281663547772,564,My wife made me move my owl collection out of the house.
2692,1,2,34,37,1.1081081081081081,0.06465180222706,564,I find I'm more productive if I check my messages only twice a day.
2692,1,2,34,37,1.1081081081081081,0.06465180222706,564,You said it would be wise to consult the Who's Who.
2692,0,4,33,37,1.1081081081081081,0.05175281663547772,564,Who ordered these?
2692,0,4,33,37,1.1081081081081081,0.05175281663547772,564,"How many times do I have to tell you, it's not ""who,"" it's ""whom."""
2692,0,4,33,37,1.1081081081081081,0.05175281663547772,564,All addressed to me: see 'Mr. Barry Potter.'
2692,1,2,34,37,1.1081081081081081,0.06465180222706,564,"Wise up, Moneypenny"
2692,1,2,34,37,1.1081081081081081,0.06465180222706,564,I won a drawing at Hooters
2692,0,4,33,37,1.1081081081081081,0.05175281663547772,564,"Professor Dumbledore, I see you shaved your beard and remodeled your office."
2692,0,4,33,37,1.1081081081081081,0.05175281663547772,564,If a bird in the hand is worth more than one in one in the bush than a bushel of owls is worth a fortune.
2692,1,2,34,37,1.1081081081081081,0.06465180222706,564,"I'm all out of hoots to give, Karen."
2692,1,2,34,37,1.1081081081081081,0.06465180222706,564,Whose the wisest of them all?
2692,1,2,34,37,1.1081081081081081,0.06465180222706,564,You can't hide behind your knowledge if you don't know how to apply it.
2692,0,4,33,37,1.1081081081081081,0.05175281663547772,564,But you're a Muggle!!!
2692,0,4,33,37,1.1081081081081081,0.05175281663547772,564,I'm glad you're here. I'm having the hardest time finding out the name of the first baseman from them.
2692,0,4,33,37,1.1081081081081081,0.05175281663547772,564,"Sure, I like them, but today I was expecting nine ladies dancing."
2692,0,4,33,37,1.1081081081081081,0.05175281663547772,564,"They've replaced our national intelligence agents."" or ""The adminstration has replaced all of the other national intelligence agents."
2692,0,4,33,37,1.1081081081081081,0.05175281663547772,564,Should I file them under 'wise' or 'wisdom' and #hoot?
2692,0,4,33,37,1.1081081081081081,0.05175281663547772,564,Apparently it's what happens when you tell maintenance their mousetraps don't work
2692,1,2,34,37,1.1081081081081081,0.06465180222706,564,"This is not what I meant by getting ""eyes in the sky""."
2692,0,4,33,37,1.1081081081081081,0.05175281663547772,564,They help me make wise managerial decisions.
2692,0,4,33,37,1.1081081081081081,0.05175281663547772,564,"Yes, I'm proud of what I did. Hasn't been a mouse in my office for weeks!"
2692,0,4,33,37,1.1081081081081081,0.05175281663547772,564,—Tell my wife I am in the middle of a meeting.
2692,1,2,34,37,1.1081081081081081,0.06465180222706,564,"Ms. Dawson, prepare to short the timber industry."
2692,1,2,34,37,1.1081081081081081,0.06465180222706,564,Who's in charge? Your guess is as good as ours.
2692,0,4,33,37,1.1081081081081081,0.05175281663547772,564,Now you show me yours!
2692,1,2,34,37,1.1081081081081081,0.06465180222706,564,Is the fax machine broken again?
2692,0,4,33,37,1.1081081081081081,0.05175281663547772,564,""" I do 'who', not 'what', 'where', ' when', and 'why'."
2692,1,2,34,37,1.1081081081081081,0.06465180222706,564,Can't we just use Fed-Ex this week?
2692,2,0,35,37,1.1081081081081081,0.07537477716523201,564,"OK, I admit it, I have a thing for hooters."
2692,0,4,33,37,1.1081081081081081,0.05175281663547772,564,I have raptor-phobia.
2692,1,2,34,37,1.1081081081081081,0.06465180222706,564,"Sally, find out how these owls got in my office. I suspect fowl play."
2692,0,4,33,37,1.1081081081081081,0.05175281663547772,564,"Is Hogwarts still trying to invite you back, Mr. Potter?"
2692,1,2,34,37,1.1081081081081081,0.06465180222706,564,Welcome to my sanctuary.
2692,0,4,33,37,1.1081081081081081,0.05175281663547772,564,Be sure to keep the males and females separated.
2692,1,2,34,37,1.1081081081081081,0.06465180222706,564,Pigeons.
2692,0,4,33,37,1.1081081081081081,0.05175281663547772,564,"Mr. Yew, I am not here for your amusement."
2692,1,2,34,37,1.1081081081081081,0.06465180222706,564,Who wants miced cream?
2692,1,2,34,37,1.1081081081081081,0.06465180222706,564,"No, Miss Smith, I don't give a hoot about you."
2692,0,4,33,37,1.1081081081081081,0.05175281663547772,564,Who gives a whoot where is my pay check !
2692,0,4,33,37,1.1081081081081081,0.05175281663547772,564,Tell Athena I want to see her immediately!!
2692,0,4,33,37,1.1081081081081081,0.05175281663547772,564,"Tell them it's ""Whom is inquiring?"
2692,0,4,33,37,1.1081081081081081,0.05175281663547772,564,It isn't Bring Your Owls to Work Day? I've been punked!
2692,1,2,34,37,1.1081081081081081,0.06465180222706,564,They're moving out of the White House. I'm trying to find them new homes.
2692,1,2,34,37,1.1081081081081081,0.06465180222706,564,The Hoots are here for a pre-adoption interview.
2692,0,4,33,37,1.1081081081081081,0.05175281663547772,564,Who left several messages?
2692,1,2,34,37,1.1081081081081081,0.06465180222706,564,"I swear, Ginny, these are just friendly texts."
2692,0,4,33,37,1.1081081081081081,0.05175281663547772,564,"I don't give a hoot, but they do."
2692,0,4,33,37,1.1081081081081081,0.05175281663547772,564,It's not hoarding if they want to be with me.
2692,0,4,33,37,1.1081081081081081,0.05175281663547772,564,I'm an owl person.
2692,1,2,34,37,1.1081081081081081,0.06465180222706,564,I could give nine hoots about what you think you're entitled to Delores.
2692,1,2,34,37,1.1081081081081081,0.06465180222706,564,Is this your way of saying you don't give a hoot about my problem?
2692,0,4,33,37,1.1081081081081081,0.05175281663547772,564,"Well, Miss Clark, I retire tomorrow and owl sure miss all the laughs we shared over the last 40 years. You, too?"
2692,0,4,33,37,1.1081081081081081,0.05175281663547772,564,But they're platform agnostic.
2692,0,4,33,37,1.1081081081081081,0.05175281663547772,564,They help convince my patients that I really am a wise doctor.
2692,0,4,33,37,1.1081081081081081,0.05175281663547772,564,Please make a lunch reservation for 10 at Hooters.
2692,1,2,34,37,1.1081081081081081,0.06465180222706,564,Meet the President's new fly by night advisory team.
2692,0,4,33,37,1.1081081081081081,0.05175281663547772,564,I work the night shift...
2692,1,2,34,37,1.1081081081081081,0.06465180222706,564,Hoot you talk'n to?
2692,1,2,34,37,1.1081081081081081,0.06465180222706,564,"Yeah, but he said in his address that America needs a Parliament."
2692,1,2,34,37,1.1081081081081081,0.06465180222706,564,She felt his tweets were unprofessional.
2692,0,4,33,37,1.1081081081081081,0.05175281663547772,564,Don't you think that you're pushing that Pigeon phobia of yours a little too far?
2692,1,2,34,37,1.1081081081081081,0.06465180222706,564,"I said, 'Hourly.'""  ""I said, 'Hourly."
2692,0,4,33,37,1.1081081081081081,0.05175281663547772,564,Terrific new band. The Whos'.
2692,1,2,34,37,1.1081081081081081,0.06465180222706,564,"Remember, you told me to wise up!"
2692,1,2,34,37,1.1081081081081081,0.06465180222706,564,Why? Because the penguins were busy.
2692,1,2,34,37,1.1081081081081081,0.06465180222706,564,This is not what I had in mind when I said you needed to follow parliamentary procedure.
2692,0,4,33,37,1.1081081081081081,0.05175281663547772,564,"A chicken salad on whole wheat, chips, a Diet Dr. Pepper and nine live mice."
2692,1,2,34,37,1.1081081081081081,0.06465180222706,564,"Mr Wise, that annoying CaptionContest guy is here again and he insists that you comment."
2692,1,2,34,37,1.1081081081081081,0.06465180222706,564,"Will That be all, Sir?"
2692,0,4,33,37,1.1081081081081081,0.05175281663547772,564,"No, I haven't replied to all the messages yet"
2692,1,2,34,37,1.1081081081081081,0.06465180222706,564,Frankly Miss Jenkins ... I don't give a hoot!
2692,1,2,34,37,1.1081081081081081,0.06465180222706,564,"What? It's ""Bring Your Kids to Work Day."""
2692,1,2,34,37,1.1081081081081081,0.06465180222706,564,"That mouse can never scare you again, Caroline."
2692,0,4,33,37,1.1081081081081081,0.05175281663547772,564,You wanted to see me about a 9-owl work day?
2692,1,2,34,37,1.1081081081081081,0.06465180222706,564,Pete Townshend called. He needs his back-up singers for a comeback tour.
2692,0,4,33,37,1.1081081081081081,0.05175281663547772,564,"Dowels, Mrs Johnson.W we make furniture. We need a case of dowels."
2692,0,4,33,37,1.1081081081081081,0.05175281663547772,564,This board meeting is going to be a real hoot!
2692,1,2,34,37,1.1081081081081081,0.06465180222706,564,Many sets of eyes are watching you.
2692,0,4,33,37,1.1081081081081081,0.05175281663547772,564,The mouse problem isn't that bad.
2692,1,2,34,37,1.1081081081081081,0.06465180222706,564,I told you I was a night owl.
2692,0,4,33,37,1.1081081081081081,0.05175281663547772,564,"I'll take that one."" ""Who?"
2692,0,4,33,37,1.1081081081081081,0.05175281663547772,564,I warned you not to schedule your own parliament meetings.
2692,0,4,33,37,1.1081081081081081,0.05175281663547772,564,Please bring me the Wise files.
2692,0,4,33,37,1.1081081081081081,0.05175281663547772,564,I don't give a hoot what you think.
2692,0,4,33,37,1.1081081081081081,0.05175281663547772,564,I'm looking for the person who is in charge of owls.
2692,0,4,33,37,1.1081081081081081,0.05175281663547772,564,I'm here about the parliamentarian position you advertised.
2692,0,4,33,37,1.1081081081081081,0.05175281663547772,564,"Wisdom Baker, they are for wisdom"
2692,0,4,33,37,1.1081081081081081,0.05175281663547772,564,"Who says, that's who."
2692,0,4,33,37,1.1081081081081081,0.05175281663547772,564,I can't figure what's behind my urge for potato chips.
2692,1,2,34,37,1.1081081081081081,0.06465180222706,564,"Mr. Potter, you've got mail!"
2692,0,4,33,37,1.1081081081081081,0.05175281663547772,564,Ok so who's the wise guy.
2692,0,4,33,37,1.1081081081081081,0.05175281663547772,564,"Are you planning to clone Harry Potter as well, sir?"
2692,0,4,33,37,1.1081081081081081,0.05175281663547772,564,"Helen, help me out here. I can't keep track of whose who is who!"
3115,0,4,34,38,1.105263157894737,0.050452767712569575,564,Not only will they be better protection for you than the Secret Service but no mice will be found for miles!
3115,0,4,34,38,1.105263157894737,0.050452767712569575,564,So your favorite band is The Who?
3115,0,4,34,38,1.105263157894737,0.050452767712569575,564,I'm guessing JK did not like my most recent edits
3115,1,2,35,38,1.105263157894737,0.06299172069839128,564,"Actually, they're referred to as a 'parliament' of owls."
3115,0,4,34,38,1.105263157894737,0.050452767712569575,564,Guess who called while you were out?
3115,0,4,34,38,1.105263157894737,0.050452767712569575,564,I'm learning to give a hoot.
3115,0,4,34,38,1.105263157894737,0.050452767712569575,564,"President Trump asked me to submit a list of potential cabinet members but, whenever I suggest a name, all they say is - WHO? ."
3115,0,4,34,38,1.105263157894737,0.050452767712569575,564,"Well, the pigeons don't bother me anymore."
3115,1,2,35,38,1.105263157894737,0.06299172069839128,564,They were here all night.
3115,1,2,35,38,1.105263157894737,0.06299172069839128,564,The Three Blind Mice are here for their 10:00 o'clock Appointment Sir.
3115,0,4,34,38,1.105263157894737,0.050452767712569575,564,"When I said I liked hooters, I was talking about my owls."
3115,1,2,35,38,1.105263157894737,0.06299172069839128,564,The convention has been moved. Didn't the pigeon send the memo?
3115,0,4,34,38,1.105263157894737,0.050452767712569575,564,The wise have it.
3115,0,4,34,38,1.105263157894737,0.050452767712569575,564,Hoot twice for assistance
3115,0,4,34,38,1.105263157894737,0.050452767712569575,564,"Apparently, my review of the latest Harry Potter film was not sufficiently positive."
3115,1,2,35,38,1.105263157894737,0.06299172069839128,564,now that your new pets food is mice-count me out.
3115,0,4,34,38,1.105263157894737,0.050452767712569575,564,Welcome to the night shift!
3115,1,2,35,38,1.105263157894737,0.06299172069839128,564,One of our accountants will be with you shortly.
3115,2,0,36,38,1.105263157894737,0.07341956131188587,564,Says who? who? who? who? who? who? who? who? who?
3115,1,2,35,38,1.105263157894737,0.06299172069839128,564,Owl bet your are looking for whoo's in charge.
3115,1,2,35,38,1.105263157894737,0.06299172069839128,564,The company will not be giving out Christmas bonuses this year. But you can pick an owl to take home with you along with the Starbucks gift certificate.
3115,1,2,35,38,1.105263157894737,0.06299172069839128,564,They're for the new awards ceremony.
3115,0,4,34,38,1.105263157894737,0.050452767712569575,564,Is this what you meant by 'a little help from my friends'?
3115,1,2,35,38,1.105263157894737,0.06299172069839128,564,Nine times out of ten no one gives a hoot.
3115,0,4,34,38,1.105263157894737,0.050452767712569575,564,"Owl Gore to see you, sir."
3115,0,4,34,38,1.105263157894737,0.050452767712569575,564,"No, Mrs. Worthington, I think it MOST unlikely someone did it for a lark."
3115,0,4,34,38,1.105263157894737,0.050452767712569575,564,Wise choice! Soon you'll be able to get rid of those glasses forever.
3115,0,4,34,38,1.105263157894737,0.050452767712569575,564,I said ten
3115,0,4,34,38,1.105263157894737,0.050452767712569575,564,I will consult with the 9 most wise.
3115,0,4,34,38,1.105263157894737,0.050452767712569575,564,"Tell him I will go four owls, but not a single owl more."
3115,0,4,34,38,1.105263157894737,0.050452767712569575,564,Pick one. Any one.
3115,1,2,35,38,1.105263157894737,0.06299172069839128,564,Different kind of hooters.
3115,0,4,34,38,1.105263157894737,0.050452767712569575,564,"I don't care how many you give me, I'm not reading Atlas Shrugged."
3115,1,2,35,38,1.105263157894737,0.06299172069839128,564,"Nine owls would make a fine baseball team, but I need ten to open my computer."
3115,1,2,35,38,1.105263157894737,0.06299172069839128,564,"I said towels Beth, towels."
3115,0,4,34,38,1.105263157894737,0.050452767712569575,564,I'm delighted to report that you've been reappointed as secretary of the parliament.
3115,0,4,34,38,1.105263157894737,0.050452767712569575,564,"You're such a pussycat, Mr. Clyde."
3115,0,4,34,38,1.105263157894737,0.050452767712569575,564,"""I finally got an environmental consensus""."
3115,1,2,35,38,1.105263157894737,0.06299172069839128,564,Let's show the staff that I do give a hoot.
3115,0,4,34,38,1.105263157894737,0.050452767712569575,564,These are not the hooters I asked for Brenda.
3155,1,2,36,39,1.1025641025641026,0.06141463024552095,564,"I asked you to show me candidates that were a real hoot, but I'm beginning to think you're willfully misunderstanding me."
3155,0,4,35,39,1.1025641025641026,0.04921614717627658,564,Abbott always said I sounded like Hoo.
3155,1,2,36,39,1.1025641025641026,0.06141463024552095,564,"Yes, WHO indeed?"
3155,0,4,35,39,1.1025641025641026,0.04921614717627658,564,Did you check their references? The 'mouse' was seen in our Data Security Room.
3159,1,2,37,40,1.1,0.05991446895152781,564,Pull up the Hogwarts account.
3159,1,2,37,40,1.1,0.05991446895152781,564,I'm over the Girl Scout cookies
3161,1,2,38,41,1.0975609756097562,0.05848575028430145,564,Take one-they're our new low budget smart phones.
3161,1,2,38,41,1.0975609756097562,0.05848575028430145,564,"Ms Simpkins, I said please get me Warren Howells not barn owls."
3161,2,0,39,41,1.0975609756097562,0.06811824411594605,564,I'm collecting scat for the annual report
3164,0,3,28,31,1.096774193548387,0.053978066228004884,564,"They say owls bring wisdom. So, I'll take one for each cabinet member...and rwio or three for their boss."
3165,1,2,39,42,1.0952380952380953,0.057123496526633864,564,"I ordered a dozen ""towels"", and where's the other three?"
3166,0,3,29,32,1.09375,0.052351460373382196,564,You know I hate being interrupted while I'm in roosting sessions.
3166,0,3,29,32,1.09375,0.052351460373382196,564,"As you can plainly see, our Investment Advisors are a wise lot indeed."
3166,0,3,29,32,1.09375,0.052351460373382196,564,"What I said was, a good secretary needs a nice set of vowels."
3166,0,3,29,32,1.09375,0.052351460373382196,564,"I believe it's actually, 'To whom are you referring?', Mary."
3166,0,3,29,32,1.09375,0.052351460373382196,564,"Gerald! For the ninth time, I said I'm asking for Gerald!"
3166,0,3,29,32,1.09375,0.052351460373382196,564,It doesn't matter. Nobody is going to think you're a hoot.
3166,0,3,29,32,1.09375,0.052351460373382196,564,Hogwarts will just have to find another accountant.
3166,0,3,29,32,1.09375,0.052351460373382196,564,"Well, at least these new hires actually give a hoot."
3166,0,3,29,32,1.09375,0.052351460373382196,564,I'll need a conference room and a bag of Tootsie Pops.
3166,0,3,29,32,1.09375,0.052351460373382196,564,So I see we're finally replacing the original Cabinet
3166,0,3,29,32,1.09375,0.052351460373382196,564,You don't have to work nights anymore.
3166,0,3,29,32,1.09375,0.052351460373382196,564,This isn't what I meant when I asked for alpine furniture.
3166,0,3,29,32,1.09375,0.052351460373382196,564,Marketing predicts an onslaught of wood peckers.
3166,1,1,30,32,1.09375,0.0689695906576505,564,"Ok, bring in the Tootsie Roll Pops."
3166,0,3,29,32,1.09375,0.052351460373382196,564,My subscription to the Owl of the Month Club was ill-considered.
3166,0,3,29,32,1.09375,0.052351460373382196,564,Ginsberg's Owl?
3166,0,3,29,32,1.09375,0.052351460373382196,564,I see you are not familiar with thecommon New England Desk Owl! It's a native species.
3166,0,3,29,32,1.09375,0.052351460373382196,564,My desk job is for the birds. Flight school is down the hall. I only handle roosting.
3166,0,3,29,32,1.09375,0.052351460373382196,564,They are a perfect fit for the department that will be interrogated by police.
3166,0,3,29,32,1.09375,0.052351460373382196,564,"I will not be intimidated by a desk full of wise guys, you're fired!"
3166,0,3,29,32,1.09375,0.052351460373382196,564,Was this in the business plan?
3166,1,1,30,32,1.09375,0.0689695906576505,564,"Your wife, dammit, not 'Who?'"
3166,0,3,29,32,1.09375,0.052351460373382196,564,Owls about we save sex 'til after we're married.
3189,0,3,30,33,1.0909090909090908,0.05081972676135885,564,O.k. o.k. So you DO give a hoot.
3189,0,3,30,33,1.0909090909090908,0.05081972676135885,564,"I understand corporate's happy they'll work for bird seed, but are you sure they can file?"
3189,0,3,30,33,1.0909090909090908,0.05081972676135885,564,The work has been a bit more difficult since taking the night shift.
3189,0,3,30,33,1.0909090909090908,0.05081972676135885,564,"Obviously, I don't give a hoot!"
3189,0,3,30,33,1.0909090909090908,0.05081972676135885,564,"I said I needed nine copies of ""Howl""."
3189,0,3,30,33,1.0909090909090908,0.05081972676135885,564,I say we wait here until one of these mannequins opens the window.
3189,0,3,30,33,1.0909090909090908,0.05081972676135885,564,"1. """"Eat, Prey, Love"" - Our new motto!"""" 2. ""what a hoot! Love the new team."" 3. O ""Owl be back in a moment with mice for your guests."""
3189,0,3,30,33,1.0909090909090908,0.05081972676135885,564,The board has spoken. We don't give a hoot.
3189,0,3,30,33,1.0909090909090908,0.05081972676135885,564,"Yes, Miss Codswallop, I said ""Whoooo's a member of parliament now?"""
3189,0,3,30,33,1.0909090909090908,0.05081972676135885,564,"They threw me out of Congress, so I joined a Parliament."
3189,0,3,30,33,1.0909090909090908,0.05081972676135885,564,"Trust me, you wouldn't want to sit if hadn't removed the chairs."
3189,0,3,30,33,1.0909090909090908,0.05081972676135885,564,"Mine has her name, Mildred, tattooed under her left wing."
3189,0,3,30,33,1.0909090909090908,0.05081972676135885,564,Owl be watching you.
3189,0,3,30,33,1.0909090909090908,0.05081972676135885,564,I would get some work done if I could only get these damn owls off my desk.
3189,0,3,30,33,1.0909090909090908,0.05081972676135885,564,Doesn't make you any smarter.
3189,0,3,30,33,1.0909090909090908,0.05081972676135885,564,"Yes, you misheard me! And who'd ever say, 'I'll see you in nine owls' anyway?"
3189,1,1,31,33,1.0909090909090908,0.06690727929036247,564,"""Find he mice,, Miss Hansen"
3189,0,3,30,33,1.0909090909090908,0.05081972676135885,564,Of course there's room for more school vouchers.
3189,0,3,30,33,1.0909090909090908,0.05081972676135885,564,I told you not to work at night.
3189,0,3,30,33,1.0909090909090908,0.05081972676135885,564,"While I can empathize, we simply do not abate figurative rats."
3189,1,1,31,33,1.0909090909090908,0.06690727929036247,564,"These won't do, Miss Bennis. We need a spokesowl who gives a hoot."
3189,0,3,30,33,1.0909090909090908,0.05081972676135885,564,"Put together, they're wiser than you are."
3189,0,3,30,33,1.0909090909090908,0.05081972676135885,564,Mr. Oswald! I'm only orating on an obvious observation.
3189,0,3,30,33,1.0909090909090908,0.05081972676135885,564,"So, who was here first?"
3189,0,3,30,33,1.0909090909090908,0.05081972676135885,564,"They're not from "" funny and cute owls compilation""."
3189,0,3,30,33,1.0909090909090908,0.05081972676135885,564,"No, Miss Jones, these are wise young owls."
3189,0,3,30,33,1.0909090909090908,0.05081972676135885,564,"...After careful consulting with the board of directors on bonuses this year, everyone agrees it's more of an issue of ""who"" is deserving exactly."
3189,0,3,30,33,1.0909090909090908,0.05081972676135885,564,"Okay, whooo is the wise one?"
3189,0,3,30,33,1.0909090909090908,0.05081972676135885,564,"Owlivia, per your request, here's the new night shift."
3189,0,3,30,33,1.0909090909090908,0.05081972676135885,564,"Not only do I give a hoot, I may sell the rest on eBay."
3189,0,3,30,33,1.0909090909090908,0.05081972676135885,564,They're my research assistants.
3189,0,3,30,33,1.0909090909090908,0.05081972676135885,564,At least there are finally 9 of them again.
3189,0,3,30,33,1.0909090909090908,0.05081972676135885,564,"No, a romp is for otters. I wanted a parliament."
3189,0,3,30,33,1.0909090909090908,0.05081972676135885,564,Is Horton back from his therapist?
3189,0,3,30,33,1.0909090909090908,0.05081972676135885,564,No one gives more hoots than me.
3189,0,3,30,33,1.0909090909090908,0.05081972676135885,564,I put potato chips in our bird feeder
3189,0,3,30,33,1.0909090909090908,0.05081972676135885,564,Hoo is here?
3189,0,3,30,33,1.0909090909090908,0.05081972676135885,564,And they've also been trained to 'who' at alternative facts.
3189,0,3,30,33,1.0909090909090908,0.05081972676135885,564,"Who, who knows."
3189,0,3,30,33,1.0909090909090908,0.05081972676135885,564,Performance review be damned-I give a hoot .
3189,0,3,30,33,1.0909090909090908,0.05081972676135885,564,Are you trying to be a wise guy?
3189,0,3,30,33,1.0909090909090908,0.05081972676135885,564,It won't make up for the fact that you've been acting like an Eeyore.
3189,0,3,30,33,1.0909090909090908,0.05081972676135885,564,They're the control group for the Irritable Owl Syndrome testing.
3189,0,3,30,33,1.0909090909090908,0.05081972676135885,564,Mr. Popper's Owls?
3189,0,3,30,33,1.0909090909090908,0.05081972676135885,564,"I don't give a hoot, I get a hoot."
3189,0,3,30,33,1.0909090909090908,0.05081972676135885,564,"Marcy, can you get us a table for ten at Hooters?"
3189,0,3,30,33,1.0909090909090908,0.05081972676135885,564,I'm finishing up tax returns for all the Hogwarts clients
3189,0,3,30,33,1.0909090909090908,0.05081972676135885,564,"No Miss Jenkins, I do not give a hoot about the company picnic!"
3189,0,3,30,33,1.0909090909090908,0.05081972676135885,564,Their work visas have expired - but no country will accept them back.
3189,0,3,30,33,1.0909090909090908,0.05081972676135885,564,I think I gave one too many hoots.
3189,0,3,30,33,1.0909090909090908,0.05081972676135885,564,Seems my office feng shui is out of balance.
3189,0,3,30,33,1.0909090909090908,0.05081972676135885,564,"Owly maybe, mousy no."
3189,0,3,30,33,1.0909090909090908,0.05081972676135885,564,"Nonplussed Margaret waited for one of them to blink as Mr. Carmine remained mute, in the morning there had been only 5"
3189,0,3,30,33,1.0909090909090908,0.05081972676135885,564,Henry your owl collection tells me you’re not the smartest one in the room.
3189,0,3,30,33,1.0909090909090908,0.05081972676135885,564,The board has voted to switch to a parliamentary model.
3189,0,3,30,33,1.0909090909090908,0.05081972676135885,564,"Yes, these are owls."
3189,0,3,30,33,1.0909090909090908,0.05081972676135885,564,"I usually don't give a hoot. But for you, please take one."
3189,0,3,30,33,1.0909090909090908,0.05081972676135885,564,Yes. Superb Owl. I get the joke.
3189,0,3,30,33,1.0909090909090908,0.05081972676135885,564,I needed a secure server.
3189,0,3,30,33,1.0909090909090908,0.05081972676135885,564,Please tell Mr. Bailey I don't give a hoot.
3189,0,3,30,33,1.0909090909090908,0.05081972676135885,564,The publisher of Woo's Woo of Owl Collecting wants to see you. Do you give a hoot?
3189,0,3,30,33,1.0909090909090908,0.05081972676135885,564,We are closely monitoring the mice index.
3189,0,3,30,33,1.0909090909090908,0.05081972676135885,564,I'd like to confer with the parliament.
3189,0,3,30,33,1.0909090909090908,0.05081972676135885,564,I've decided that our new brain trust is really for the birds.
3189,0,3,30,33,1.0909090909090908,0.05081972676135885,564,"Wisdom of the crowd, Janet."
3189,0,3,30,33,1.0909090909090908,0.05081972676135885,564,I'm selling them to raise funds for the Boy Scouts.
3189,0,3,30,33,1.0909090909090908,0.05081972676135885,564,This is an organized hoot against The Predatorocrat.
3189,0,3,30,33,1.0909090909090908,0.05081972676135885,564,"That’s correct, Ms. Jones, we’ll be seeing no more candidates for the overnight shift."
3189,0,3,30,33,1.0909090909090908,0.05081972676135885,564,What makes you think that I give a hoot?
3258,0,3,31,34,1.088235294117647,0.04937482703908927,564,Tell me why I should give a hoot.
3258,0,3,31,34,1.088235294117647,0.04937482703908927,564,It was the wise thing to do.
3258,0,3,31,34,1.088235294117647,0.04937482703908927,564,"No, Mr. O'Reilly. Even with the Groucho disguise and the cute birds, I don't want to get drinks with you after the show."
3258,0,3,31,34,1.088235294117647,0.04937482703908927,564,"Harry tries to convince the head of HR that this was what he meant when he said ""I love hooters!"""
3258,0,3,31,34,1.088235294117647,0.04937482703908927,564,Say it again but this time: 'With whom am I visiting?'
3258,0,3,31,34,1.088235294117647,0.04937482703908927,564,"Who,Who,Who,Who,Who,Who,Who,Who Who...What?"
3258,0,3,31,34,1.088235294117647,0.04937482703908927,564,Who sent those?
3258,1,1,32,34,1.088235294117647,0.06496464222510488,564,Wise men seek wise counsel.
3258,0,3,31,34,1.088235294117647,0.04937482703908927,564,Your resume was a real head-turner.
3258,0,3,31,34,1.088235294117647,0.04937482703908927,564,Owl let you know when you get a pay raise.
3258,0,3,31,34,1.088235294117647,0.04937482703908927,564,"Gladys, our night shift team here lodged a complaint with HR, saying your called them a, ""Bunch of hoots."""
3258,0,3,31,34,1.088235294117647,0.04937482703908927,564,Maybe now you can give a hoot.
3258,1,1,32,34,1.088235294117647,0.06496464222510488,564,"Speaking for all of us, ""We don't give a hoot!"""
3258,0,3,31,34,1.088235294117647,0.04937482703908927,564,I would suggest filing them under ‘O’.
3258,1,1,32,34,1.088235294117647,0.06496464222510488,564,"So the boss wants to have a serious talk with me? Well, tell him I don't give a hoot"
3258,0,3,31,34,1.088235294117647,0.04937482703908927,564,I don't give a hoot. I receive them.
3258,0,3,31,34,1.088235294117647,0.04937482703908927,564,Who needs a computer when you have nine owls?
3258,1,1,32,34,1.088235294117647,0.06496464222510488,564,"Wise Decision, Miss Havishaw, but where are the Potato Chips?"
3258,1,1,32,34,1.088235294117647,0.06496464222510488,564,"Thanks for the bonus this year, but do you remember that last year's bonus was a snake?"
3258,0,3,31,34,1.088235294117647,0.04937482703908927,564,Our mouse problem has become an owl problem.
3258,0,3,31,34,1.088235294117647,0.04937482703908927,564,"Personally, I don't give a hoot. However ..."
3258,0,3,31,34,1.088235294117647,0.04937482703908927,564,"They're called ""Tribble Owls"". I don't know why..."
3258,0,3,31,34,1.088235294117647,0.04937482703908927,564,"If anyone mentions ""hooters,""now it's not sexual harassment. Next to hire a couple of ""boobs."""
3258,0,3,31,34,1.088235294117647,0.04937482703908927,564,"Welcome to the Trump appointed House of Parliament."" ""...I'm not sure that's how this works."" ""Try telling him that."
3258,0,3,31,34,1.088235294117647,0.04937482703908927,564,"Hoo hoo, messed up the order for 9 awls?"
3258,1,1,32,34,1.088235294117647,0.06496464222510488,564,"Outpatient forms, Merideth! OUTpatient!"
3258,1,1,32,34,1.088235294117647,0.06496464222510488,564,Not what I meant by I think you are a hoot.
3258,0,3,31,34,1.088235294117647,0.04937482703908927,564,We look forward to having you on our team.
3258,0,3,31,34,1.088235294117647,0.04937482703908927,564,We're diversifying.
3258,0,3,31,34,1.088235294117647,0.04937482703908927,564,Get me a list of the funkier Catksills venues and then get George Clinton's people on the line to see if he's interested in summer tour.
3258,1,1,32,34,1.088235294117647,0.06496464222510488,564,"What makes you think I give a hoot, Miss Jensen?"
3258,0,3,31,34,1.088235294117647,0.04937482703908927,564,"No, no vole infestation here."
3258,0,3,31,34,1.088235294117647,0.04937482703908927,564,I thought you wanted hooters for lunch.
3258,0,3,31,34,1.088235294117647,0.04937482703908927,564,I'm finally at the top of the pecking order.
3258,0,3,31,34,1.088235294117647,0.04937482703908927,564,Look at all the hoots I give.
3258,1,1,32,34,1.088235294117647,0.06496464222510488,564,these are my nine owls . that's right. nine fine fuckin owls. count 'em donna you wet-brained clod. how many owls do you have
3258,0,3,31,34,1.088235294117647,0.04937482703908927,564,Whooooooo are you?
3258,0,3,31,34,1.088235294117647,0.04937482703908927,564,What do you think of my hooter desktop?
3258,0,3,31,34,1.088235294117647,0.04937482703908927,564,"What ever you have to say to me, you can say in front of the parliament."
3258,0,3,31,34,1.088235294117647,0.04937482703908927,564,"The meek and the quiet don't last in this business, Ms. Frump."
3258,0,3,31,34,1.088235294117647,0.04937482703908927,564,"I don't get it. Our new team of reporters never asks What, Why, Where and How...only Who."
3258,0,3,31,34,1.088235294117647,0.04937482703908927,564,Which Who is in first?
3258,1,1,32,34,1.088235294117647,0.06496464222510488,564,This won't make the guys in the C-suite think you're a hoot.
3258,0,3,31,34,1.088235294117647,0.04937482703908927,564,The night shift wants a raise.
3258,0,3,31,34,1.088235294117647,0.04937482703908927,564,Not exactly the parliament I envisioned.
3258,0,3,31,34,1.088235294117647,0.04937482703908927,564,"I know I suggested Hooters for my birthday, Miss Jones."
3258,0,3,31,34,1.088235294117647,0.04937482703908927,564,"And all I said was,""I really don't give a hoot."""
3258,1,1,32,34,1.088235294117647,0.06496464222510488,564,"Ms. Reynolds, I assure you the corporation DOES give a hoot about you."
3258,1,1,32,34,1.088235294117647,0.06496464222510488,564,I require a dozen fresh voles for my friends
3258,0,3,31,34,1.088235294117647,0.04937482703908927,564,Like I give a hoot.
3258,0,3,31,34,1.088235294117647,0.04937482703908927,564,These are the wisest night-shift employees we have.
3258,1,1,32,34,1.088235294117647,0.06496464222510488,564,"We had to cancel our broadband as a result of budget cuts, but I think these guys are up to the task."
3258,1,1,32,34,1.088235294117647,0.06496464222510488,564,I wasn't lying when I said I'm out working.
3258,1,1,32,34,1.088235294117647,0.06496464222510488,564,Do you think Hooters would be interested?
3258,0,3,31,34,1.088235294117647,0.04937482703908927,564,What makes you think you have what it takes to work at Hooters?
3258,1,1,32,34,1.088235294117647,0.06496464222510488,564,"Let me guess, you were looking for a secretary with a couple of hooters?"
3258,0,3,31,34,1.088235294117647,0.04937482703908927,564,"Personally, Mrs. Jones, I don't give a hoot!"
3258,0,3,31,34,1.088235294117647,0.04937482703908927,564,Not another one of your attempts to outsmart the system?
3258,0,3,31,34,1.088235294117647,0.04937482703908927,564,I recommend your son hang out with this gang instead of one he is in.
3258,0,3,31,34,1.088235294117647,0.04937482703908927,564,"Sorry, I don't give a hoot."
3258,0,3,31,34,1.088235294117647,0.04937482703908927,564,"What do you mean, you 'don't give a hoot' about my new office decorations?"
3258,0,3,31,34,1.088235294117647,0.04937482703908927,564,"Hooters called, they're taking it in a different direction."
3258,0,3,31,34,1.088235294117647,0.04937482703908927,564,They want to know who who who who who who who who who is calling.
3258,1,1,32,34,1.088235294117647,0.06496464222510488,564,The 401k owl is on lunch break right now.
3258,1,1,32,34,1.088235294117647,0.06496464222510488,564,"Forgive me for saying this, but you look pretty unwise by comparison."
3258,0,3,31,34,1.088235294117647,0.04937482703908927,564,Yeah I guess I could give a hoot.
3258,0,3,31,34,1.088235294117647,0.04937482703908927,564,"Human Resources: The Hoot Nanny As you can see, it was all a misunderstanding. He meant these hooters."
3258,0,3,31,34,1.088235294117647,0.04937482703908927,564,They help with my anxiety.
3258,1,1,32,34,1.088235294117647,0.06496464222510488,564,"Now we just need the what, where and why..."
3258,0,3,31,34,1.088235294117647,0.04937482703908927,564,"Edna, I'd like you to meet the new government appointed Department of Field Mouse Safety & Health."
3258,0,3,31,34,1.088235294117647,0.04937482703908927,564,Surround yourself with wisdom. Surround yourself.
3258,0,3,31,34,1.088235294117647,0.04937482703908927,564,Maybe the Church will take them; they ARE birds of prey.
3258,0,3,31,34,1.088235294117647,0.04937482703908927,564,"They were three short of a dozen, so I got them very cheaply."
3258,0,3,31,34,1.088235294117647,0.04937482703908927,564,My Mixtape Gets All The Chicks...Yes Melanie It Is Fire
3258,1,1,32,34,1.088235294117647,0.06496464222510488,564,Why do you have a bunch of owls on your desk?
3258,0,3,31,34,1.088235294117647,0.04937482703908927,564,"Pamela, thanks for coming in. One question: Who is the wisest of them all?"
3258,0,3,31,34,1.088235294117647,0.04937482703908927,564,This year's company party should be a hoot.
3258,0,3,31,34,1.088235294117647,0.04937482703908927,564,Cancel all my meetings. I've just learned that I'm a wizard.
3258,0,3,31,34,1.088235294117647,0.04937482703908927,564,Exactly hooo do you think you are asking me about my business?
3258,0,3,31,34,1.088235294117647,0.04937482703908927,564,"I like the ad campaign, but in the office giving a hoot does pollute."
3258,0,3,31,34,1.088235294117647,0.04937482703908927,564,Today is Bring Your Hooters to Work Day! Care to show me yours?
3258,0,3,31,34,1.088235294117647,0.04937482703908927,564,The blowfish are on the way.
3258,0,3,31,34,1.088235294117647,0.04937482703908927,564,Never speak of this.
3258,0,3,31,34,1.088235294117647,0.04937482703908927,564,"Must I really respond to, ""Knock, knock""?"
3258,0,3,31,34,1.088235294117647,0.04937482703908927,564,"If you didn't know me, could you tell?"
3258,0,3,31,34,1.088235294117647,0.04937482703908927,564,Here are the original copies.
3258,1,1,32,34,1.088235294117647,0.06496464222510488,564,The Hooters board says lose the jacket.
3258,1,1,32,34,1.088235294117647,0.06496464222510488,564,I asked to be connected to Parliament House not a Parliament of Owls.
3258,0,3,31,34,1.088235294117647,0.04937482703908927,564,Enough already! Block Hogwarts.
3258,0,3,31,34,1.088235294117647,0.04937482703908927,564,You wanted to see me about hoo?
3258,1,1,32,34,1.088235294117647,0.06496464222510488,564,"I don't care what day of Christmas it is, Stan"
3258,1,1,32,34,1.088235294117647,0.06496464222510488,564,I just took it for a joke as someone asked me weather Hogwarts students a eligible for this MOOC or not....
3258,0,3,31,34,1.088235294117647,0.04937482703908927,564,"oy vey, this is even worse than i suspected when you said you had to stay out late and ""work with colleagues"" every night,,,"
3258,0,3,31,34,1.088235294117647,0.04937482703908927,564,"Sir, Mr. Jones is here to see you. Whoooo?"
3258,0,3,31,34,1.088235294117647,0.04937482703908927,564,"Good news, we're making you partner here at Owl, Owl, Owl, Owl, Owl, Owl, Owl, Owl, Owl and Jones."
3258,1,1,32,34,1.088235294117647,0.06496464222510488,564,"Ask as much as you want, I don't know who!"
3258,0,3,31,34,1.088235294117647,0.04937482703908927,564,"""Mrs. West, I can't do my work."" ""Why not?"" ""Because I'm stupid."" ""No, you're not stupid. You're my gentleman lover."" Also, owls."
3258,0,3,31,34,1.088235294117647,0.04937482703908927,564,"The parliament and I have voted to secede from the corporate union. We will, of course, continue to receive our salaries while we negotiate future trading agreements."
3258,0,3,31,34,1.088235294117647,0.04937482703908927,564,Whose first
3258,1,1,32,34,1.088235294117647,0.06496464222510488,564,"Janet, we have received quite a few complaints from HR."
3258,1,1,32,34,1.088235294117647,0.06496464222510488,564,"When you said we needed more plants in the office is this ""who"" they were for?"
3258,0,3,31,34,1.088235294117647,0.04937482703908927,564,"Not, I repeat, not funny. Heads will spin."
3258,1,1,32,34,1.088235294117647,0.06496464222510488,564,Is there another meeting of the Harry Potter Book Club today Ms. Steinman?
3258,0,3,31,34,1.088235294117647,0.04937482703908927,564,"Bob Geldof, John Mellencamp and Lady GaGa are collaborating on a new benefit rock concert. Guess what its for?"
3258,0,3,31,34,1.088235294117647,0.04937482703908927,564,"I didn't say who, I said what."
3258,0,3,31,34,1.088235294117647,0.04937482703908927,564,"My colleagues inform me Dr Who videos can be found in the most watched section, top shelf."
3258,0,3,31,34,1.088235294117647,0.04937482703908927,564,Is it necessary that the entire Board to be present?
3258,0,3,31,34,1.088235294117647,0.04937482703908927,564,I'm listed in Hoo's Hoo.
3258,0,3,31,34,1.088235294117647,0.04937482703908927,564,"Miss Wilson, it's not what's that on my desk, it's whoos that on my desk."
3258,0,3,31,34,1.088235294117647,0.04937482703908927,564,There's one for each member of the Senate Intelligence Committee. They should help during the questioning of witnesses.
3258,0,3,31,34,1.088235294117647,0.04937482703908927,564,"So, you're firing me because I said you remind me of Norman Bates?"
3258,0,3,31,34,1.088235294117647,0.04937482703908927,564,"All chicks? No, I won't work late with any of them either."
3258,0,3,31,34,1.088235294117647,0.04937482703908927,564,"Because Google only provides the most popular answers, Mrs. Fitch."
3258,0,3,31,34,1.088235294117647,0.04937482703908927,564,GUESS THE NUMBERS OF OWLS AND KITTENS.
3258,0,3,31,34,1.088235294117647,0.04937482703908927,564,I clicked on the subscription option by mistake.
3258,0,3,31,34,1.088235294117647,0.04937482703908927,564,how do you like me nowl?
3258,0,3,31,34,1.088235294117647,0.04937482703908927,564,"It's not Whom Ms. Clark, but Who!"
3258,0,3,31,34,1.088235294117647,0.04937482703908927,564,You will find we in HR give more than two hoots about staff welfare Miss Clinton.
3258,0,3,31,34,1.088235294117647,0.04937482703908927,564,Who's next?
3258,1,1,32,34,1.088235294117647,0.06496464222510488,564,"They are on strike, they demand hooters matter."
3258,0,3,31,34,1.088235294117647,0.04937482703908927,564,We need all eyes on desk!
3258,0,3,31,34,1.088235294117647,0.04937482703908927,564,"I'm sorry, who?"
3258,0,3,31,34,1.088235294117647,0.04937482703908927,564,Tell Petersen I don't give a hoot.
3258,0,3,31,34,1.088235294117647,0.04937482703908927,564,They'll stay put until my mouse is returned.
3258,0,3,31,34,1.088235294117647,0.04937482703908927,564,The other board members are very against changing the waitress uniforms too.
3258,1,1,32,34,1.088235294117647,0.06496464222510488,564,"I don't give a hoot what y'owl think, they're for the birds and they have to go."
3258,1,1,32,34,1.088235294117647,0.06496464222510488,564,"They're a hoot, aren't they?"
3258,0,3,31,34,1.088235294117647,0.04937482703908927,564,10 brains are better than 1.
3258,0,3,31,34,1.088235294117647,0.04937482703908927,564,"Unfortunately, owl therapy to reinforce 'who' you are is not covered by the company's health plan."
3258,1,1,32,34,1.088235294117647,0.06496464222510488,564,"I'm afraid you've just got to let me go, Miss Belfiore. I'm one of them now."
3258,0,3,31,34,1.088235294117647,0.04937482703908927,564,What owls?
3258,1,1,32,34,1.088235294117647,0.06496464222510488,564,"They'll caw , coo and even cock-a-doodle-doo, but they just don't give a hoot."
3258,0,3,31,34,1.088235294117647,0.04937482703908927,564,Ho did it?
3258,0,3,31,34,1.088235294117647,0.04937482703908927,564,I really wish the Ministry of Magic would use FedEx
3258,0,3,31,34,1.088235294117647,0.04937482703908927,564,If I stop the lights will go out.
3258,0,3,31,34,1.088235294117647,0.04937482703908927,564,"Madame Prime Minister, meet your post Brexit parliament."
3258,0,3,31,34,1.088235294117647,0.04937482703908927,564,"I am shocked Dolores! What do you mean ""which one is Woodsy""?"
3258,1,1,32,34,1.088235294117647,0.06496464222510488,564,"The answer is parliamentary, Dr. Watson."
3258,1,1,32,34,1.088235294117647,0.06496464222510488,564,It's not working out. I'm still getting the same 5-4 decisions.
3258,0,3,31,34,1.088235294117647,0.04937482703908927,564,"Well, well, Mr. Potter. It seems your inbox is full again."
3258,1,1,32,34,1.088235294117647,0.06496464222510488,564,"Dang it Cheryl, what about Where, What, When and How?"
3258,0,3,31,34,1.088235294117647,0.04937482703908927,564,"It all started when I didn't give a hoot. But as you can see, I changed my mind."
3258,1,1,32,34,1.088235294117647,0.06496464222510488,564,"I said ""I don't give a hoot."" What's not to get?"
3258,0,3,31,34,1.088235294117647,0.04937482703908927,564,"Sir, there's a delivery, they said it's from the zoo, did you order another owl?"
3258,0,3,31,34,1.088235294117647,0.04937482703908927,564,They're wise behind their ears.
3258,1,1,32,34,1.088235294117647,0.06496464222510488,564,"Sir, Who did it."
3258,0,3,31,34,1.088235294117647,0.04937482703908927,564,The mice were out of control.
3258,0,3,31,34,1.088235294117647,0.04937482703908927,564,Whoooo were you here to see?
3258,0,3,31,34,1.088235294117647,0.04937482703908927,564,"If you can tell me ""Who's on First"" you'll finally get your raise, Doris."
3258,0,3,31,34,1.088235294117647,0.04937482703908927,564,Please open the window it's hoot in here.
3258,0,3,31,34,1.088235294117647,0.04937482703908927,564,Aren't they a hoot?
3258,0,3,31,34,1.088235294117647,0.04937482703908927,564,Our building's persistent rodent problem howls for an alternative solution.
3258,0,3,31,34,1.088235294117647,0.04937482703908927,564,"From now on, work will be a hoot!"
3258,0,3,31,34,1.088235294117647,0.04937482703908927,564,Owls. They're like rabbits!
3258,1,1,32,34,1.088235294117647,0.06496464222510488,564,That's 'Night Owl.'
3258,1,1,32,34,1.088235294117647,0.06496464222510488,564,My broker said it was a good investment in today's climate.
3258,0,3,31,34,1.088235294117647,0.04937482703908927,564,I really have to stop shopping on Ebay.
3258,1,1,32,34,1.088235294117647,0.06496464222510488,564,"Linda, I said I needed some 'warmed towels' for the conference, not nine Horned Owls."
3258,0,3,31,34,1.088235294117647,0.04937482703908927,564,Whooooo are you looking for?
3258,0,3,31,34,1.088235294117647,0.04937482703908927,564,Who's everyone?
3258,0,3,31,34,1.088235294117647,0.04937482703908927,564,"""If you ask me once more who am I talking to I 'll get real mad""!"
3258,0,3,31,34,1.088235294117647,0.04937482703908927,564,I DO give a hoot. Help yourself!
3258,0,3,31,34,1.088235294117647,0.04937482703908927,564,YOU'RE LIVING IN AN OWLIGARCHY!
3258,1,1,32,34,1.088235294117647,0.06496464222510488,564,I'm so tired of all this busy-work.
3258,0,3,31,34,1.088235294117647,0.04937482703908927,564,Those are not Pokemon.
3258,0,3,31,34,1.088235294117647,0.04937482703908927,564,"Okay, which one of you wants a transfer to Hogwarts?"
3258,1,1,32,34,1.088235294117647,0.06496464222510488,564,Get me my copy of Atlas Shrugged...and a wet sponge
3258,0,3,31,34,1.088235294117647,0.04937482703908927,564,You called for a Hootenanny?
3258,1,1,32,34,1.088235294117647,0.06496464222510488,564,The unread messenger birds were starting to pile up.
3258,0,3,31,34,1.088235294117647,0.04937482703908927,564,"Ok, Bob, I get it. You don't give a hoot."
3258,0,3,31,34,1.088235294117647,0.04937482703908927,564,"No, Madame Prime Minister, Parliament does not meet on my desk."
3258,0,3,31,34,1.088235294117647,0.04937482703908927,564,Owl expect your resignation by tomorrow.
3258,0,3,31,34,1.088235294117647,0.04937482703908927,564,"Miss Brown, fetch me two more, please. The wise one says a quorum for a parliament of owls is 11."
3258,1,1,32,34,1.088235294117647,0.06496464222510488,564,"Despite what Potter says, pigeons are more reliable"
3258,0,3,31,34,1.088235294117647,0.04937482703908927,564,Now who's the wise guy?
3258,0,3,31,34,1.088235294117647,0.04937482703908927,564,"WHO ? "" "" WHO ?"
3258,0,3,31,34,1.088235294117647,0.04937482703908927,564,Do you want coffee with those dozen dead mice?
3258,0,3,31,34,1.088235294117647,0.04937482703908927,564,The sitter couldn't make it.
3258,0,3,31,34,1.088235294117647,0.04937482703908927,564,"When in doubt, go with the wisdom of the crowd."
3258,0,3,31,34,1.088235294117647,0.04937482703908927,564,Who called?
3258,0,3,31,34,1.088235294117647,0.04937482703908927,564,Hoo do you do?
3258,0,3,31,34,1.088235294117647,0.04937482703908927,564,These Hedwigs are weaning the President off tweeting.
3258,0,3,31,34,1.088235294117647,0.04937482703908927,564,"Oh, so that's how you became so wise."
3258,1,1,32,34,1.088235294117647,0.06496464222510488,564,"Take them out for a walk, feed them, and then bring me coffee!"
3258,0,3,31,34,1.088235294117647,0.04937482703908927,564,Now that we've solved the mice problem....
3258,0,3,31,34,1.088235294117647,0.04937482703908927,564,I manage the Hogwarts account.
3258,1,1,32,34,1.088235294117647,0.06496464222510488,564,Others have owls thrust upon 'em.
3258,0,3,31,34,1.088235294117647,0.04937482703908927,564,What the fuck
3258,1,1,32,34,1.088235294117647,0.06496464222510488,564,You can't go anywhere without running into a sit-in.
3258,0,3,31,34,1.088235294117647,0.04937482703908927,564,"Madam, we don't give a hoot about your genealogy."
3258,0,3,31,34,1.088235294117647,0.04937482703908927,564,"NO!' 'Alls I want..."" I said!"
3258,0,3,31,34,1.088235294117647,0.04937482703908927,564,"It's about time you gave a hoot, Miss Brooks!"
3258,1,1,32,34,1.088235294117647,0.06496464222510488,564,"You just can't find good protection, these days. I had to get creative."
3258,1,1,32,34,1.088235294117647,0.06496464222510488,564,Give one to every employee to be reminded daily to make wise decisions or else!
3258,0,3,31,34,1.088235294117647,0.04937482703908927,564,"Why do you have owls on your desk?"" ""Hoo cares."
3258,1,1,32,34,1.088235294117647,0.06496464222510488,564,Hoo do you prefer..?
3258,0,3,31,34,1.088235294117647,0.04937482703908927,564,That’s the last time I interview applicants from Hogwarts.
3258,0,3,31,34,1.088235294117647,0.04937482703908927,564,"yes, i do think this will make our agency memorable in the eyes of the Wise Snacks marketing team"
3258,0,3,31,34,1.088235294117647,0.04937482703908927,564,"I find flying with the eagles tiresome, Ms. Bailey."
3258,0,3,31,34,1.088235294117647,0.04937482703908927,564,This is harder than a Chinese arithmetic problem.
3258,0,3,31,34,1.088235294117647,0.04937482703908927,564,Is it hoot in here or is it just me?
3258,0,3,31,34,1.088235294117647,0.04937482703908927,564,"No miss Jones, I said 'book me for nine HOLES.'"
3258,0,3,31,34,1.088235294117647,0.04937482703908927,564,"They aren't real but they are impressive, existentially, don't you think?"
3258,0,3,31,34,1.088235294117647,0.04937482703908927,564,"They say owls brung wisdom So I'll take one for each of the Cabinet members,...and two or three for their boss,"
3258,0,3,31,34,1.088235294117647,0.04937482703908927,564,We give a hoot about your grievances.
3258,0,3,31,34,1.088235294117647,0.04937482703908927,564,"""It's me, Ms. Cooper. "" ""It's me, Ms. Cooper."" ""It's me....."
3258,1,1,32,34,1.088235294117647,0.06496464222510488,564,Management of Hooters
3258,0,3,31,34,1.088235294117647,0.04937482703908927,564,"I don't think this is what the Prime Minister meant by ""a smarter parliament."""
3258,0,3,31,34,1.088235294117647,0.04937482703908927,564,"you're right, this definitely doesn't make you look stupid."
3258,1,1,32,34,1.088235294117647,0.06496464222510488,564,Are you getting ready for The Who concert this weekend
3258,0,3,31,34,1.088235294117647,0.04937482703908927,564,Figurines are for amateurs.
3258,0,3,31,34,1.088235294117647,0.04937482703908927,564,I just don't give a hoot anymore.
3258,0,3,31,34,1.088235294117647,0.04937482703908927,564,"Dr. Who, I presume?"
3258,0,3,31,34,1.088235294117647,0.04937482703908927,564,I see you didn't specify 'Purdue'.
3258,0,3,31,34,1.088235294117647,0.04937482703908927,564,"This *is* the Editorial Board of ""Whoo's Whoo"" and not a murder of crows ... though the two are not dissimilar."
3258,0,3,31,34,1.088235294117647,0.04937482703908927,564,Owls are the new Rolodex.
3258,0,3,31,34,1.088235294117647,0.04937482703908927,564,Who?
3258,1,1,32,34,1.088235294117647,0.06496464222510488,564,The shipment of pussycats is scheduled for next week.
3258,0,3,31,34,1.088235294117647,0.04937482703908927,564,"Betcha don't know what a bunch of owls are called, Miss Jones."
3258,0,3,31,34,1.088235294117647,0.04937482703908927,564,Are you telling me that you don't give a Hoot about my feelings?
3258,0,3,31,34,1.088235294117647,0.04937482703908927,564,"Ms. Wilson, I do give a hoot!"
3258,0,3,31,34,1.088235294117647,0.04937482703908927,564,Are you willing to work nights?
3258,0,3,31,34,1.088235294117647,0.04937482703908927,564,Is USPS on strike?
3258,0,3,31,34,1.088235294117647,0.04937482703908927,564,"Have you heard of our downsizing plan, Miss Fieldmouse?"
3258,0,3,31,34,1.088235294117647,0.04937482703908927,564,Oh Wise One... The delivery guys are here. Where should we put the other desk?
3258,0,3,31,34,1.088235294117647,0.04937482703908927,564,This does NOT make you a Member of Parliament!
3258,0,3,31,34,1.088235294117647,0.04937482703908927,564,"Martha, this ""equal work for equal pay business"" is just a hoot."
3258,0,3,31,34,1.088235294117647,0.04937482703908927,564,Hold all my calls - parliament is in session.
3258,1,1,32,34,1.088235294117647,0.06496464222510488,564,You don't know what hooters is do you?
3258,0,3,31,34,1.088235294117647,0.04937482703908927,564,I had to use the nuclear option to get the last one on board.
3258,0,3,31,34,1.088235294117647,0.04937482703908927,564,"No, I didn't say your hooters were fine, I said they're were nine!"
3258,0,3,31,34,1.088235294117647,0.04937482703908927,564,Because they give a hoot.
3258,1,1,32,34,1.088235294117647,0.06496464222510488,564,"I have everything you asked for - eight more owls, nine pussycats, nine pea green boats, nine bags of money wrapped in Five Pound Notes"
3258,1,1,32,34,1.088235294117647,0.06496464222510488,564,Owl see what I can do ma'am.
3258,0,3,31,34,1.088235294117647,0.04937482703908927,564,Don't you criticize my tchotchkes.
3258,0,3,31,34,1.088235294117647,0.04937482703908927,564,"Edna, make sure they get an office with a view."
3258,0,3,31,34,1.088235294117647,0.04937482703908927,564,Don't look at me like that.
3258,0,3,31,34,1.088235294117647,0.04937482703908927,564,This job's a hoot!
3258,0,3,31,34,1.088235294117647,0.04937482703908927,564,That'll be owl Ms. Elanius. Owl let you know hoo owl need for the meeting.
3258,0,3,31,34,1.088235294117647,0.04937482703908927,564,those are some nice statues.
3258,0,3,31,34,1.088235294117647,0.04937482703908927,564,You did ask people to give a hoot.
3258,0,3,31,34,1.088235294117647,0.04937482703908927,564,They all respond to 'Who'.
3258,0,3,31,34,1.088235294117647,0.04937482703908927,564,Now let them say we don't give a hoot.
3258,1,1,32,34,1.088235294117647,0.06496464222510488,564,I'm addressing the parliament right now
3258,0,3,31,34,1.088235294117647,0.04937482703908927,564,I'm training them to work a switchboard.
3258,0,3,31,34,1.088235294117647,0.04937482703908927,564,"Move away from the desk, Cat Woman."
3258,1,1,32,34,1.088235294117647,0.06496464222510488,564,I told you not to complain about the I.T. department.
3258,0,3,31,34,1.088235294117647,0.04937482703908927,564,"You want a wise resolution of your problem, don't you?"
3258,0,3,31,34,1.088235294117647,0.04937482703908927,564,"Your keyboard will be fine, but you should definitely hide your mouse."
3258,0,3,31,34,1.088235294117647,0.04937482703908927,564,"Sorry mary,the night shift is just wrapping up"
3258,1,1,32,34,1.088235294117647,0.06496464222510488,564,I've been assured that they know all the best words.
3258,0,3,31,34,1.088235294117647,0.04937482703908927,564,I came to work with 10 of them.
3258,1,1,32,34,1.088235294117647,0.06496464222510488,564,"Sir, it's become apparent you just don't give a hoot."
3258,0,3,31,34,1.088235294117647,0.04937482703908927,564,Whooh ? Me?
3258,0,3,31,34,1.088235294117647,0.04937482703908927,564,Clean up that desk. Were you raised in a barn?
3258,1,1,32,34,1.088235294117647,0.06496464222510488,564,"(Sigh)...Yes, 'Owl see you later' too."
3258,1,1,32,34,1.088235294117647,0.06496464222510488,564,"No, I mean like, we have a pretty open ""arrangement"" or whatever but I'm not fucking ALL of them, I mean not actively"
3258,1,1,32,34,1.088235294117647,0.06496464222510488,564,"In your revised memo regarding shelter donations, please remember the 'B' in BOWLS..."
3258,0,3,31,34,1.088235294117647,0.04937482703908927,564,"I do give a hoot. Hell, we all give a hoot."
3258,1,1,32,34,1.088235294117647,0.06496464222510488,564,Who-who-who-who-who-who-who-who-who are you ?
3258,0,3,31,34,1.088235294117647,0.04937482703908927,564,They've been up all night.
3258,0,3,31,34,1.088235294117647,0.04937482703908927,564,It's a lot cheaper than Macs.
3258,0,3,31,34,1.088235294117647,0.04937482703908927,564,If you wouldn't leave food at your desk we wouldn't have mice.
3258,0,3,31,34,1.088235294117647,0.04937482703908927,564,It's our new Knowledge Management team.
3258,0,3,31,34,1.088235294117647,0.04937482703908927,564,I'm not sure if they should be filed alphabetically or numerically.
3258,0,3,31,34,1.088235294117647,0.04937482703908927,564,I don't give a hoot about your issues
3258,0,3,31,34,1.088235294117647,0.04937482703908927,564,"I'll need these filed under ""O""."
3258,0,3,31,34,1.088235294117647,0.04937482703908927,564,Does it look like I give a hoot?
3258,1,1,32,34,1.088235294117647,0.06496464222510488,564,"I came with two captions >> ""Is that wise?"" or ""Which one is Jared?"" :)"
3258,0,3,31,34,1.088235294117647,0.04937482703908927,564,"Gotta pass on leaving early for drinks, Patty. Higher-ups have been perching out for me to screw up."
3258,0,3,31,34,1.088235294117647,0.04937482703908927,564,Rabbi...I see you have a minyan.
3258,0,3,31,34,1.088235294117647,0.04937482703908927,564,"Mice for nine, and a turkey on Rye for me!"
3258,0,3,31,34,1.088235294117647,0.04937482703908927,564,I never give a hoot
3258,0,3,31,34,1.088235294117647,0.04937482703908927,564,"As I don't agree with our current parliament, I thought I'd assemble one of my own."
3258,0,3,31,34,1.088235294117647,0.04937482703908927,564,"Mary, don't buy pens this week. I think I have a better idea..."
3258,0,3,31,34,1.088235294117647,0.04937482703908927,564,"Some water, please, with lots of mice."
3258,0,3,31,34,1.088235294117647,0.04937482703908927,564,Better cancel my 10 o'clock with the Hare family.
3258,0,3,31,34,1.088235294117647,0.04937482703908927,564,Hoo should I say is in charge?
3258,0,3,31,34,1.088235294117647,0.04937482703908927,564,"If he says 'guess WHO is here?' again, I'm going to scream."
3258,0,3,31,34,1.088235294117647,0.04937482703908927,564,They called our bluff.
3258,0,3,31,34,1.088235294117647,0.04937482703908927,564,"I'm not sure, Minerva."
3258,0,3,31,34,1.088235294117647,0.04937482703908927,564,Do they keep you up at night ?
3258,0,3,31,34,1.088235294117647,0.04937482703908927,564,Who says so?
3258,1,1,32,34,1.088235294117647,0.06496464222510488,564,I don't give a hoot--I just take 'em.
3258,0,3,31,34,1.088235294117647,0.04937482703908927,564,"I don't care how well their band sings. ""The Who"" is already taken."
3258,1,1,32,34,1.088235294117647,0.06496464222510488,564,I'd like a little coffee with my hazel nuts.
3258,0,3,31,34,1.088235294117647,0.04937482703908927,564,"They can't hit or run, and they all play first base."
3258,1,1,32,34,1.088235294117647,0.06496464222510488,564,I just don't want to be owl by myself.
3258,0,3,31,34,1.088235294117647,0.04937482703908927,564,"Naturally, they sought out wisdom."
3258,1,1,32,34,1.088235294117647,0.06496464222510488,564,I think you said your pussy cat has nine lives.
3258,1,1,32,34,1.088235294117647,0.06496464222510488,564,I don't like conventional paper shredders.
3258,0,3,31,34,1.088235294117647,0.04937482703908927,564,I was told I needed to give a hoot.
3258,0,3,31,34,1.088235294117647,0.04937482703908927,564,"I said it would be nice if we had night-owls here, not nine owls!"
3258,0,3,31,34,1.088235294117647,0.04937482703908927,564,I have this idea to start a restaurant chain called Hooters
3258,1,1,32,34,1.088235294117647,0.06496464222510488,564,Now I can give a hoot!
3258,0,3,31,34,1.088235294117647,0.04937482703908927,564,How is my morning? I'm having a hoot...
3258,0,3,31,34,1.088235294117647,0.04937482703908927,564,"These are the current nominees for the president's committee on rodent health. Please bring your gerbil ""Fluffy"" to them for examination."
3258,0,3,31,34,1.088235294117647,0.04937482703908927,564,It's the night shift.
3258,1,1,32,34,1.088235294117647,0.06496464222510488,564,"""There's a problem with the mail server again."" (First wizarding-world problems)"
3258,0,3,31,34,1.088235294117647,0.04937482703908927,564,I asked for towels for my desk.
3258,0,3,31,34,1.088235294117647,0.04937482703908927,564,"Yes, finding them jobs has been difficult since Hogwarts switched to FedEx."
3258,0,3,31,34,1.088235294117647,0.04937482703908927,564,"I have decided to embark on a matrimonial quest … to wit, to woo"
3258,0,3,31,34,1.088235294117647,0.04937482703908927,564,They convinced me irrefutably that we are all in this together.
3258,0,3,31,34,1.088235294117647,0.04937482703908927,564,Go ahead and Tweet I'll Hoot.
3258,0,3,31,34,1.088235294117647,0.04937482703908927,564,"Frankly Miss Kronk, I give a hoot!"
3258,0,3,31,34,1.088235294117647,0.04937482703908927,564,They keep the crows and ravens away.
3258,0,3,31,34,1.088235294117647,0.04937482703908927,564,They're not nearly as wise as we've been told.
3258,0,3,31,34,1.088235294117647,0.04937482703908927,564,No more mice
3258,0,3,31,34,1.088235294117647,0.04937482703908927,564,I'm a hooter man myself.
3258,1,1,32,34,1.088235294117647,0.06496464222510488,564,"Hoo, me?"
3258,0,3,31,34,1.088235294117647,0.04937482703908927,564,Who did you say was on the phone? Who? Who? Who?
3258,0,3,31,34,1.088235294117647,0.04937482703908927,564,This should take care of the mouse problem in the ladies' room.
3258,0,3,31,34,1.088235294117647,0.04937482703908927,564,Pigeons need not apply.
3258,0,3,31,34,1.088235294117647,0.04937482703908927,564,"I'm sorry. I don't know who you are looking for, try the next desk."
3258,0,3,31,34,1.088235294117647,0.04937482703908927,564,"Next time you say, ""wisest parliament members,"" you may want to be more species specific, sir."
3258,0,3,31,34,1.088235294117647,0.04937482703908927,564,At least the pigeons used to leave again.
3258,0,3,31,34,1.088235294117647,0.04937482703908927,564,"We don't give a hoot about your excuses, Nancy. The way you've been treating your coworkers lately has been positively fowl!"
3258,1,1,32,34,1.088235294117647,0.06496464222510488,564,"Yes, Ms. Linn, I finally purchased a 'HOOTERS' franchise."
3258,0,3,31,34,1.088235294117647,0.04937482703908927,564,Whoooo really knew?
3258,0,3,31,34,1.088235294117647,0.04937482703908927,564,"Miss Pennywinkle, Your inane questions must now pass through my nine owl gauntlet before I attempt to answer it."
3258,0,3,31,34,1.088235294117647,0.04937482703908927,564,Something went wrong when I was trying to open a social media account on Twitter. Get me someone from I.T.
3258,0,3,31,34,1.088235294117647,0.04937482703908927,564,After 7 P.M. we'll be going out on the rodent project.
3258,0,3,31,34,1.088235294117647,0.04937482703908927,564,Any suggestions?
3258,1,1,32,34,1.088235294117647,0.06496464222510488,564,Call that exterminator again. His method isn't working.
3258,0,3,31,34,1.088235294117647,0.04937482703908927,564,"Whatever, I think it's a big hoot."
3258,0,3,31,34,1.088235294117647,0.04937482703908927,564,"Now I really need the nine ""towels"" I originally asked you for"
3258,0,3,31,34,1.088235294117647,0.04937482703908927,564,"Who, who, who, who, who, who, who, who, who are you?"
3258,1,1,32,34,1.088235294117647,0.06496464222510488,564,It's a class action lawsuit.
3258,0,3,31,34,1.088235294117647,0.04937482703908927,564,"Did you hear a screech, Miss Armstrong?"
3258,0,3,31,34,1.088235294117647,0.04937482703908927,564,"Unaccustomed to sexual harassment, the new secretary completely misunderstood the comment about fake hooters."
3258,0,3,31,34,1.088235294117647,0.04937482703908927,564,"All these reminders have my head spinning, Marsha."
3258,0,3,31,34,1.088235294117647,0.04937482703908927,564,"Now this is Harry, Larry, Gerry, Terry, Mary, etc."
3258,0,3,31,34,1.088235294117647,0.04937482703908927,564,What time is it? Who knows?
3258,0,3,31,34,1.088235294117647,0.04937482703908927,564,"If I give them an owl, they can't say I don't give a hoot."
3258,0,3,31,34,1.088235294117647,0.04937482703908927,564,"Marge, you don't understand Twitter."
3258,0,3,31,34,1.088235294117647,0.04937482703908927,564,You're thinking of the restaurant—we don't sell wings here.
3258,1,1,32,34,1.088235294117647,0.06496464222510488,564,Can you please identify the one who screeched at you inappropriately?
3258,0,3,31,34,1.088235294117647,0.04937482703908927,564,No need to explain. I don't give a hoot!
3258,0,3,31,34,1.088235294117647,0.04937482703908927,564,This is not my idea of nine wise guys.
3258,1,1,32,34,1.088235294117647,0.06496464222510488,564,Everyone that comes here gives a hoot.
3258,0,3,31,34,1.088235294117647,0.04937482703908927,564,I just don't give a hoot!
3258,0,3,31,34,1.088235294117647,0.04937482703908927,564,I said I wanted them NONE the wiser.
3258,0,3,31,34,1.088235294117647,0.04937482703908927,564,I'm always told everyone's full name.
3258,1,1,32,34,1.088235294117647,0.06496464222510488,564,Sam finally found out how many licks it took to get to the center of a tootsie pop.
3258,0,3,31,34,1.088235294117647,0.04937482703908927,564,"Just what we need, nine more bird brains."
3258,1,1,32,34,1.088235294117647,0.06496464222510488,564,And then after work we're going to a night club!
3258,0,3,31,34,1.088235294117647,0.04937482703908927,564,Who's asking?
3258,0,3,31,34,1.088235294117647,0.04937482703908927,564,The Babe Magnets were working.
3258,0,3,31,34,1.088235294117647,0.04937482703908927,564,So you formed your own parliament
3258,0,3,31,34,1.088235294117647,0.04937482703908927,564,"*They* didn't make fun of my glasses, Carol."
3258,1,1,32,34,1.088235294117647,0.06496464222510488,564,I've come to the realization this company can't afford to give a hoot.
3258,1,1,32,34,1.088235294117647,0.06496464222510488,564,"TOO MANY PIGEONS, MISS GOLLIDAY"
3258,1,1,32,34,1.088235294117647,0.06496464222510488,564,My life coach said I should cultivate wisdom
3258,0,3,31,34,1.088235294117647,0.04937482703908927,564,"Ahh, regretfully, no. We do, however, have owls."
3258,0,3,31,34,1.088235294117647,0.04937482703908927,564,"We're in the owl protection racket now, Effie."
3258,0,3,31,34,1.088235294117647,0.04937482703908927,564,Just show me how to turn off Autocorrect.
3258,0,3,31,34,1.088235294117647,0.04937482703908927,564,"Well, Linda and I decided not to have kids."
3258,1,1,32,34,1.088235294117647,0.06496464222510488,564,"Marry me Miss Hastings, owl love you forever."
3258,0,3,31,34,1.088235294117647,0.04937482703908927,564,Isn't this a hoot? One more of these guys and I'll have the wisest minyan in town!
3258,0,3,31,34,1.088235294117647,0.04937482703908927,564,"Have you finished playing with my hooters, Mr. Johnson?"
3258,0,3,31,34,1.088235294117647,0.04937482703908927,564,"Yes, sir, very funny, sir. Yes, we can do it again: Who is my boss?"
3258,0,3,31,34,1.088235294117647,0.04937482703908927,564,"Yes, I'm the Bill in parliament."
3258,1,1,32,34,1.088235294117647,0.06496464222510488,564,"Owl (I'll) take the call. Who's next, Miss Byrd?"
3258,0,3,31,34,1.088235294117647,0.04937482703908927,564,"Karen, hold my 3 o'clock. I've been radicalized."
3258,0,3,31,34,1.088235294117647,0.04937482703908927,564,"I guess this is the price I have to pay for underreporting $150,000."
3258,0,3,31,34,1.088235294117647,0.04937482703908927,564,"Out of all the people who work here, only nine really give a hoot."
3258,1,1,32,34,1.088235294117647,0.06496464222510488,564,"And if you need anything else, just give me a hoot"
3258,0,3,31,34,1.088235294117647,0.04937482703908927,564,With who would you like to speak?
3258,1,1,32,34,1.088235294117647,0.06496464222510488,564,"I don't give a ""hoot"" anymore."
3258,0,3,31,34,1.088235294117647,0.04937482703908927,564,I will need the complete file for the Wise account.
3258,0,3,31,34,1.088235294117647,0.04937482703908927,564,Okay. But how?
3258,1,1,32,34,1.088235294117647,0.06496464222510488,564,So that's nine RSVPs from Hogwarts.
3258,0,3,31,34,1.088235294117647,0.04937482703908927,564,"It's a parliament of interns, actually. But, yeah, they're replacing you."
3258,0,3,31,34,1.088235294117647,0.04937482703908927,564,Hooters?
3258,0,3,31,34,1.088235294117647,0.04937482703908927,564,"I don't give a hoot what you think, nine of them won't work either."
3258,1,1,32,34,1.088235294117647,0.06496464222510488,564,You can call me owl
3258,0,3,31,34,1.088235294117647,0.04937482703908927,564,Welcome to parliament!
3258,0,3,31,34,1.088235294117647,0.04937482703908927,564,"Owl be fine, if you could just help them to the front door."
3258,0,3,31,34,1.088235294117647,0.04937482703908927,564,Kevin in marketing stole one of your owls.
3258,0,3,31,34,1.088235294117647,0.04937482703908927,564,I thought managing the Hogwarts account would be more fun.
3258,0,3,31,34,1.088235294117647,0.04937482703908927,564,I won them at a hootenanny.
3258,0,3,31,34,1.088235294117647,0.04937482703908927,564,"To 'whom' do I owe my thanks, for this impromptu grammar lesson ?"
3258,0,3,31,34,1.088235294117647,0.04937482703908927,564,I said a 9 HOUR workday
3258,0,3,31,34,1.088235294117647,0.04937482703908927,564,Corporate sent them over to evaluate our rodent control plan
3258,0,3,31,34,1.088235294117647,0.04937482703908927,564,"Just remember, Miss Pelly, business is not a basket of puppies."
3258,0,3,31,34,1.088235294117647,0.04937482703908927,564,Sir! It's ducks in a row not owls!
3258,0,3,31,34,1.088235294117647,0.04937482703908927,564,"Very good sir, nine mice, and will you be having your usual corned beef?"
3258,0,3,31,34,1.088235294117647,0.04937482703908927,564,"And so, your field mouse duties have been made redundant."
3258,1,1,32,34,1.088235294117647,0.06496464222510488,564,"No, I will not call you 'Mr. Speaker.'"
3258,1,1,32,34,1.088235294117647,0.06496464222510488,564,How many owls does it take ?
3258,0,3,31,34,1.088235294117647,0.04937482703908927,564,"Miss Smith, take these to our owlet store."
3258,1,1,32,34,1.088235294117647,0.06496464222510488,564,Not sure you hired from the right Hooters
3258,1,1,32,34,1.088235294117647,0.06496464222510488,564,"Nice hooters, sir."
3258,0,3,31,34,1.088235294117647,0.04937482703908927,564,Is it who or whom?
3258,1,1,32,34,1.088235294117647,0.06496464222510488,564,I don't give a hoot what you thought I requested.
3258,0,3,31,34,1.088235294117647,0.04937482703908927,564,"Doctor Who, I presume."
3258,0,3,31,34,1.088235294117647,0.04937482703908927,564,"Frankly, my dear, I don't give a hoot!"
3258,0,3,31,34,1.088235294117647,0.04937482703908927,564,"Well Janice, you can inform Mr. Hoskins that I do not, in fact, give a hoot."
3258,0,3,31,34,1.088235294117647,0.04937482703908927,564,It's my own fault for telling them my name is Horton.
3258,1,1,32,34,1.088235294117647,0.06496464222510488,564,Welcome to Hooters.
3258,0,3,31,34,1.088235294117647,0.04937482703908927,564,"Go ahead, take one."
3258,0,3,31,34,1.088235294117647,0.04937482703908927,564,In an effort to manage rising corporate shipping rates...
3258,1,1,32,34,1.088235294117647,0.06496464222510488,564,"The what, when and why of the case will have to wait. Right now, I'm looking for the ""hoo?"""
3258,1,1,32,34,1.088235294117647,0.06496464222510488,564,They saw my mouse.
3258,0,3,31,34,1.088235294117647,0.04937482703908927,564,"I'd have already SENT the email, Larry, but I can't find my mouse anywhere."
3258,0,3,31,34,1.088235294117647,0.04937482703908927,564,Hooo Dat?
3258,1,1,32,34,1.088235294117647,0.06496464222510488,564,Hoo is here?
3258,0,3,31,34,1.088235294117647,0.04937482703908927,564,"We're not so different, you an I."
3258,0,3,31,34,1.088235294117647,0.04937482703908927,564,"Trust me, they're a hoot."
3258,0,3,31,34,1.088235294117647,0.04937482703908927,564,"Frankly Harold, this does not make you look any wiser."
3258,0,3,31,34,1.088235294117647,0.04937482703908927,564,I don't give a hoot. Owl talk to you later.
3258,0,3,31,34,1.088235294117647,0.04937482703908927,564,"Now all you're missing is the lightening bolt, Harold."
3258,0,3,31,34,1.088235294117647,0.04937482703908927,564,Aren't you a bit old for your Hogwarts letter?
3258,0,3,31,34,1.088235294117647,0.04937482703908927,564,"Sorry, they ran out of pigeons!"
3258,1,1,32,34,1.088235294117647,0.06496464222510488,564,Ask away. Inside their pellets will be the answers to any and all your HR questions.
3258,1,1,32,34,1.088235294117647,0.06496464222510488,564,So now you think that you're nine times wiser?
3258,0,3,31,34,1.088235294117647,0.04937482703908927,564,You asked for “authentic reclaimed barn wood” and that’s *exactly* what I ordered.
3258,0,3,31,34,1.088235294117647,0.04937482703908927,564,Should I cancel your two o'clock?
3258,1,1,32,34,1.088235294117647,0.06496464222510488,564,"Sorry for the ruckus, but everything's OWL right in here."
3258,1,1,32,34,1.088235294117647,0.06496464222510488,564,"My grandfather always told me,'it's not what you know..it's whoooo'!"
3258,0,3,31,34,1.088235294117647,0.04937482703908927,564,"Well, I'm sorry MY live owl collection interferes with HIS profits."
3258,0,3,31,34,1.088235294117647,0.04937482703908927,564,Looks like you've solved our problem of filling the night shift
3258,1,1,32,34,1.088235294117647,0.06496464222510488,564,"Linda, I've just accidentally turned the board of directors into owls. Run out and get me the latest Harry Potter book, a dozen live mice, my dictaphone, and please post this on Facebook with the heading ""owl right, owl right, owl right."""
3258,0,3,31,34,1.088235294117647,0.04937482703908927,564,But I ordered 10!
3258,0,3,31,34,1.088235294117647,0.04937482703908927,564,"Who, who, who, who, who, who, who, who, who are you and what do you want?"
3258,0,3,31,34,1.088235294117647,0.04937482703908927,564,I attended a seminar on how to acquire wisdom
3258,0,3,31,34,1.088235294117647,0.04937482703908927,564,I don't give a hoot about the cat world. You're looking at evidence that owls can have nine lives too.
3258,0,3,31,34,1.088235294117647,0.04937482703908927,564,"The kids named them Who, Who's, Whose, Who'd, Who'll, Whom, Who Dunit, Whoo Hoo, and Whoot Whoot......I thought it would help them with contractions by being a bit creative...."
3258,0,3,31,34,1.088235294117647,0.04937482703908927,564,"You sling one of your wise remarks, one of these guys slips me a rejoinder."
3258,1,1,32,34,1.088235294117647,0.06496464222510488,564,"-""What?"" -""Nothing."""
3258,1,1,32,34,1.088235294117647,0.06496464222510488,564,The remains of Larry's failed wireless 360° security company.
3258,0,3,31,34,1.088235294117647,0.04937482703908927,564,I’ve accumulated a lot of wisdom during my years in this office.
3258,1,1,32,34,1.088235294117647,0.06496464222510488,564,Look at me all you want but I'm through with pigeon duty with these phony wise guys.
3258,1,1,32,34,1.088235294117647,0.06496464222510488,564,Really; owls? There are no pigeons around here!
3258,0,3,31,34,1.088235294117647,0.04937482703908927,564,They're excellent typists.
3258,0,3,31,34,1.088235294117647,0.04937482703908927,564,I thought I had mentioned this during my interview.
3258,1,1,32,34,1.088235294117647,0.06496464222510488,564,I'm letting you go because you clearly don't give a hoot.
3258,1,1,32,34,1.088235294117647,0.06496464222510488,564,I just didn't want you to think I couldn't afford to give a hoot.
3258,0,3,31,34,1.088235294117647,0.04937482703908927,564,You stand out -- lose the tie.
3258,0,3,31,34,1.088235294117647,0.04937482703908927,564,"We were trying to get smarter rabbits, but we ended up with randier owls."
3258,0,3,31,34,1.088235294117647,0.04937482703908927,564,"I am going to work for a boss that also cares about the ""what"", ""when"", ""where"", and ""how""."
3258,0,3,31,34,1.088235294117647,0.04937482703908927,564,"They're not for sale. They're free. You see, I give a hoot."
3258,1,1,32,34,1.088235294117647,0.06496464222510488,564,I know it's their breeding season but the weather keeps them indoors. It's too wet to woo.
3258,0,3,31,34,1.088235294117647,0.04937482703908927,564,"I said get wings from Hooters, not get hooters with wings!"
3258,1,1,32,34,1.088235294117647,0.06496464222510488,564,"Whooo,whooo, who let the birds out?"
3258,1,1,32,34,1.088235294117647,0.06496464222510488,564,"Well, who are you? (hoot, hoot, hoot, hoot?) I really wanna know (who are you? hoot, hoot, hoot, hoot?)"
3258,0,3,31,34,1.088235294117647,0.04937482703908927,564,"Instead of lives, I was given owls"
3258,0,3,31,34,1.088235294117647,0.04937482703908927,564,Just tell 'em . . . 'We don't give a hoot!'
3258,0,3,31,34,1.088235294117647,0.04937482703908927,564,Owl be out for a while....
3258,0,3,31,34,1.088235294117647,0.04937482703908927,564,Speak up. I can't hear you.
3258,1,1,32,34,1.088235294117647,0.06496464222510488,564,You're suggesting I'm hungover?
3258,0,3,31,34,1.088235294117647,0.04937482703908927,564,"The question is not what, but who...?"
3258,0,3,31,34,1.088235294117647,0.04937482703908927,564,The President is on the line. He said he is looking for some collective wisdom.
3258,0,3,31,34,1.088235294117647,0.04937482703908927,564,"oh, I know hoo."
3258,0,3,31,34,1.088235294117647,0.04937482703908927,564,"Well, you denied my request to hire more staff, so I got some free owls. Whoooooo's laughing now?"
3258,0,3,31,34,1.088235294117647,0.04937482703908927,564,it was a hoot
3258,0,3,31,34,1.088235294117647,0.04937482703908927,564,"Yes, I'm the executive in charge of the company wisdom!"
3258,0,3,31,34,1.088235294117647,0.04937482703908927,564,"... and as a result, Horton heard more than one who."
3258,0,3,31,34,1.088235294117647,0.04937482703908927,564,I need to clear my mouser history.
3258,0,3,31,34,1.088235294117647,0.04937482703908927,564,"Miss Wiggins, take my Brain trust and then come back and clean up the desk."
3258,1,1,32,34,1.088235294117647,0.06496464222510488,564,"My name is Al. You can call me Wise Old Al, but if you do you owe me another one of these."
3258,0,3,31,34,1.088235294117647,0.04937482703908927,564,"Mr. Perdue, no sir, I don't think your father would approve, even if we call them free range owls!"
3258,0,3,31,34,1.088235294117647,0.04937482703908927,564,"Sue Biggs, from marketing. Sue Biggs, from marketing. Sue Biggs, from marketing."
3258,0,3,31,34,1.088235294117647,0.04937482703908927,564,We could use some wisdom right now. Can I ship one of those to the White House?
3258,0,3,31,34,1.088235294117647,0.04937482703908927,564,"Why yes my new desk is mahogany, thank you."
3258,1,1,32,34,1.088235294117647,0.06496464222510488,564,I thought this way someone around here might give a hoot.
3258,0,3,31,34,1.088235294117647,0.04937482703908927,564,There was a 9 for 1 sale at Petco.
3258,1,1,32,34,1.088235294117647,0.06496464222510488,564,"get these fucking owls out of my office, alice, i hate birds and dont understand why they are here"
3258,0,3,31,34,1.088235294117647,0.04937482703908927,564,They've really helped me cut down on book theft.
3258,0,3,31,34,1.088235294117647,0.04937482703908927,564,Missing Owl Department
3258,0,3,31,34,1.088235294117647,0.04937482703908927,564,"Grow up, Harry. Get an iPhone like everyone else."
3258,0,3,31,34,1.088235294117647,0.04937482703908927,564,When did you become such a Wise guy?
3258,1,1,32,34,1.088235294117647,0.06496464222510488,564,I do not think you can sell this outsourcing option to the management.
3258,0,3,31,34,1.088235294117647,0.04937482703908927,564,Hedwig is out taking a message to Harry
3258,0,3,31,34,1.088235294117647,0.04937482703908927,564,It appears you never learned to use the internet . . .
3258,0,3,31,34,1.088235294117647,0.04937482703908927,564,"What Whig are you going to wear, today? They all look the same!"
3258,0,3,31,34,1.088235294117647,0.04937482703908927,564,I only have knowledge here. Wise guys are down the hall.
3258,0,3,31,34,1.088235294117647,0.04937482703908927,564,Who said who? Or was it whom?
3258,0,3,31,34,1.088235294117647,0.04937482703908927,564,Where are you in your search for wisdom?
3258,0,3,31,34,1.088235294117647,0.04937482703908927,564,"No, Ms. Sims, I said we need night-owls for the late shift."
3258,0,3,31,34,1.088235294117647,0.04937482703908927,564,The parliament refuses to dissolve.
3258,0,3,31,34,1.088235294117647,0.04937482703908927,564,So you made it in to the wisest school. Let's discuss it tonight over drinks!
3258,0,3,31,34,1.088235294117647,0.04937482703908927,564,"Frankly, Mrs. O'Dowd, I don't give a hoot..."
3258,0,3,31,34,1.088235294117647,0.04937482703908927,564,I wasn't wise enough
3258,0,3,31,34,1.088235294117647,0.04937482703908927,564,Edith can you please stop my subscription to the owl of the month club
3258,1,1,32,34,1.088235294117647,0.06496464222510488,564,"As I am sure you are aware, Mr. Henkshire, some changes are anticipated in the intra-office mail system."
3258,0,3,31,34,1.088235294117647,0.04937482703908927,564,"One of them is a wise-guy Ms. Appledorn, and I aim to find out who."
3258,0,3,31,34,1.088235294117647,0.04937482703908927,564,"I'm sorry Ms. Jergens but as you can see, I only have only 9 more hoots to give before I retire."
3258,0,3,31,34,1.088235294117647,0.04937482703908927,564,"1.) Hooters, again, for lunch?! 2.) The restrooms are out of...towels, Miss Finkler."
3258,0,3,31,34,1.088235294117647,0.04937482703908927,564,Who did you say is here?
3258,0,3,31,34,1.088235294117647,0.04937482703908927,564,"Yes, yes, yes. Harry sent you."
3258,0,3,31,34,1.088235294117647,0.04937482703908927,564,Owls have it!
3258,0,3,31,34,1.088235294117647,0.04937482703908927,564,I'll take owl of them please.
3258,1,1,32,34,1.088235294117647,0.06496464222510488,564,'Just whooooo do you think you I am? Now isn't that original.'
3258,0,3,31,34,1.088235294117647,0.04937482703908927,564,"Well, No birds have flown in since I put these out"
3258,1,1,32,34,1.088235294117647,0.06496464222510488,564,You know your wife doesn't like it when you go to Hooters
3258,0,3,31,34,1.088235294117647,0.04937482703908927,564,Why do you want a raise?
3258,0,3,31,34,1.088235294117647,0.04937482703908927,564,"It's known as a ""parliament"", not a ""bunch of owls"" you dumb bitch!"
3258,0,3,31,34,1.088235294117647,0.04937482703908927,564,All these whos when all we need is a them.
3258,0,3,31,34,1.088235294117647,0.04937482703908927,564,Is this the Who's Who editorial department?
3258,0,3,31,34,1.088235294117647,0.04937482703908927,564,Owl be with you in a minute.
3258,0,3,31,34,1.088235294117647,0.04937482703908927,564,It's easier than the Senate confirmation process.
3258,0,3,31,34,1.088235294117647,0.04937482703908927,564,"I just looked up their diet. How are your trapping skills, Ms. Jenkins?"
3258,0,3,31,34,1.088235294117647,0.04937482703908927,564,Does the nine-owl day include a lunch break?
3258,1,1,32,34,1.088235294117647,0.06496464222510488,564,I can't help but think that this is retaliation for saying that no one around here gives a hoot.
3258,0,3,31,34,1.088235294117647,0.04937482703908927,564,"Moles and mice, Mrs Roberts. The Board wants production figures."
3258,1,1,32,34,1.088235294117647,0.06496464222510488,564,Bark let the owls out? Bark. Bark.
3258,0,3,31,34,1.088235294117647,0.04937482703908927,564,"Well, it worked for Twitter…"
3258,0,3,31,34,1.088235294117647,0.04937482703908927,564,"MY, WE CERTAINLY ARE FEELING OWLY TODAY!"
3258,0,3,31,34,1.088235294117647,0.04937482703908927,564,"Miss Swanson, when I said I don't give a hoot, I meant it!"
3258,1,1,32,34,1.088235294117647,0.06496464222510488,564,It's my way of being interesting.
3258,0,3,31,34,1.088235294117647,0.04937482703908927,564,We just received a complaint from Hooters!
3258,0,3,31,34,1.088235294117647,0.04937482703908927,564,"No,no,,,I asked for more towles!!"
3258,0,3,31,34,1.088235294117647,0.04937482703908927,564,You just had to have the oak...
3258,0,3,31,34,1.088235294117647,0.04937482703908927,564,These are all the hoots I have left to give.
3258,0,3,31,34,1.088235294117647,0.04937482703908927,564,"Yeah, right, our new email program."
3258,0,3,31,34,1.088235294117647,0.04937482703908927,564,I've worked nine owls and still can't get anything done.
3258,0,3,31,34,1.088235294117647,0.04937482703908927,564,Who? I keep telling you me.
3258,0,3,31,34,1.088235294117647,0.04937482703908927,564,They're for the office hootenanny.
3258,1,1,32,34,1.088235294117647,0.06496464222510488,564,And by YOLO I mean You Obviously Love Owls.
3258,0,3,31,34,1.088235294117647,0.04937482703908927,564,What can I say? I'm no early bird.
3258,0,3,31,34,1.088235294117647,0.04937482703908927,564,"In this department we really do give a hoot, Ms. Baker."
3258,0,3,31,34,1.088235294117647,0.04937482703908927,564,So you're sure it isn't a migratory species.
3258,1,1,32,34,1.088235294117647,0.06496464222510488,564,'Are these all the applicants for the Hooters job?'
3258,0,3,31,34,1.088235294117647,0.04937482703908927,564,"By the way, did you order those horn dowels I requested?"
3258,0,3,31,34,1.088235294117647,0.04937482703908927,564,So you're telling me you asked for a consignment of towels?
3258,0,3,31,34,1.088235294117647,0.04937482703908927,564,"Sorry, who did you say you're looking for?"
3258,0,3,31,34,1.088235294117647,0.04937482703908927,564,They're sticklers for Parliamentary procedure.
3258,1,1,32,34,1.088235294117647,0.06496464222510488,564,Owl late will you be working tonight?
3258,0,3,31,34,1.088235294117647,0.04937482703908927,564,"You told my wife I needed more wisdom at work, didn't you?"
3258,0,3,31,34,1.088235294117647,0.04937482703908927,564,I ordered wings from Hooters.
3258,0,3,31,34,1.088235294117647,0.04937482703908927,564,"""I see the boss is still dropping his h's when he's unhappy with me""."
3258,0,3,31,34,1.088235294117647,0.04937482703908927,564,Hold my calls. I'm experimenting with giving a hoot.
3258,0,3,31,34,1.088235294117647,0.04937482703908927,564,Why can't this Harry Potter just send me emails like everybody else?
3258,0,3,31,34,1.088235294117647,0.04937482703908927,564,Your computer mouse is a liar.
3258,0,3,31,34,1.088235294117647,0.04937482703908927,564,"Save a life, adopt an owl."
3258,1,1,32,34,1.088235294117647,0.06496464222510488,564,"These? Oh, the PR department is worried we're not reaching the wizard demographic."
3258,0,3,31,34,1.088235294117647,0.04937482703908927,564,"I'm sorry, I assumed your sign was missing a letter. Do you know where the nearest bowl shop is?"
3258,0,3,31,34,1.088235294117647,0.04937482703908927,564,"Honestly, no one else in the office gives a hoot."
3258,1,1,32,34,1.088235294117647,0.06496464222510488,564,I don't really give a damn if tbey are endangered Mrs. Morrison!
3258,1,1,32,34,1.088235294117647,0.06496464222510488,564,"No, no, we require ten, gotta have one little mousie for me."
3258,0,3,31,34,1.088235294117647,0.04937482703908927,564,I think we need to put Harry Potter in the Spam filter
3258,1,1,32,34,1.088235294117647,0.06496464222510488,564,"First we had a cricket problem, then a mice problem. Where does it end, Carl!?"
3258,1,1,32,34,1.088235294117647,0.06496464222510488,564,Where do they go? Hoo knows.
3258,0,3,31,34,1.088235294117647,0.04937482703908927,564,"If you'll let me shoo them off, none will be the wiser."
3258,1,1,32,34,1.088235294117647,0.06496464222510488,564,Owl be with you shortly.
3258,0,3,31,34,1.088235294117647,0.04937482703908927,564,"Who,who,who,who,who,who,who,who,who...are you?"
3258,0,3,31,34,1.088235294117647,0.04937482703908927,564,Ask me if I give a hoot.
3258,0,3,31,34,1.088235294117647,0.04937482703908927,564,I don't recall asking to see your hooters at last night's office party.
3258,1,1,32,34,1.088235294117647,0.06496464222510488,564,"Would you like to go to a ""Who down?"""
3258,0,3,31,34,1.088235294117647,0.04937482703908927,564,You'd give a hoot if you knew what this is doing to your career.
3258,0,3,31,34,1.088235294117647,0.04937482703908927,564,I think I'm going to need a bigger desk
3258,0,3,31,34,1.088235294117647,0.04937482703908927,564,"Helicopter parenting, Hogwart's edition."
3258,1,1,32,34,1.088235294117647,0.06496464222510488,564,"No. I said 'how are you?' They said 'whoo...' (underline ""how,"" ""They"" and ""Whoo"")"
3258,0,3,31,34,1.088235294117647,0.04937482703908927,564,It would be a real hoot to let them all loose in the cafeteria!
3258,0,3,31,34,1.088235294117647,0.04937482703908927,564,My therapist suggested this to overcome my fear of owls.
3258,0,3,31,34,1.088235294117647,0.04937482703908927,564,"I've always been a nine-owl, Ms. Jones. This is when I get my most inspired ideas."
3258,0,3,31,34,1.088235294117647,0.04937482703908927,564,I don't give a hoot what you think is between us...
3258,0,3,31,34,1.088235294117647,0.04937482703908927,564,"Sorry, Minerva. The category 'endangered species' has been discontinued."
3258,0,3,31,34,1.088235294117647,0.04937482703908927,564,I keep them around in case an angry client asks for me by name.
3258,0,3,31,34,1.088235294117647,0.04937482703908927,564,"I said I wanted lunch FROM Hooters, not OF Hooters."
3258,0,3,31,34,1.088235294117647,0.04937482703908927,564,They were all out of mouse traps
3258,1,1,32,34,1.088235294117647,0.06496464222510488,564,This is your way of telling me you don't give a hoot?
3258,0,3,31,34,1.088235294117647,0.04937482703908927,564,"For f's sake, Margaret...I said ""Towels"""
3258,0,3,31,34,1.088235294117647,0.04937482703908927,564,"Good night, owl."" ""Good night, owlless."
3258,0,3,31,34,1.088235294117647,0.04937482703908927,564,OK. So now you know where my wise ideas come from!
3258,1,1,32,34,1.088235294117647,0.06496464222510488,564,"For an adequate monetary incentive, I will replace these with your canaries."
3258,0,3,31,34,1.088235294117647,0.04937482703908927,564,"I don'y know if they're old, but for what I paid for them, they better be wise."
3258,0,3,31,34,1.088235294117647,0.04937482703908927,564,"We all miss Hogwarts, Harry."
3258,0,3,31,34,1.088235294117647,0.04937482703908927,564,Pick the one who best embodies my wisdom.
3258,0,3,31,34,1.088235294117647,0.04937482703908927,564,"If they're the parliament, You must be the funkadelic"
3258,1,1,32,34,1.088235294117647,0.06496464222510488,564,We're all out of mice.
3258,0,3,31,34,1.088235294117647,0.04937482703908927,564,"Yes,but can they type and intimidate?"
3258,0,3,31,34,1.088235294117647,0.04937482703908927,564,A computer mouse. I wanted you to get rid of my computer mouse!
3258,1,1,32,34,1.088235294117647,0.06496464222510488,564,There's a Mr. Smith to see you. He says it'll be a hoot.
3258,0,3,31,34,1.088235294117647,0.04937482703908927,564,I thought I ordered Girl Scout cookies.
3258,1,1,32,34,1.088235294117647,0.06496464222510488,564,Now we won't need security cameras.
3258,0,3,31,34,1.088235294117647,0.04937482703908927,564,Tell the team we're owl in.
3258,0,3,31,34,1.088235294117647,0.04937482703908927,564,"Miss Jones, my colleagues from Hooters."
3258,1,1,32,34,1.088235294117647,0.06496464222510488,564,They refuse to go until we replace the servers with actual owls.
3258,0,3,31,34,1.088235294117647,0.04937482703908927,564,Ow'l I get anything done?
3258,0,3,31,34,1.088235294117647,0.04937482703908927,564,Please file these under 'O'.
3258,0,3,31,34,1.088235294117647,0.04937482703908927,564,This won't increase your wisdom one hoot!
3258,0,3,31,34,1.088235294117647,0.04937482703908927,564,I still think we need another set of eyes to look at this
3258,0,3,31,34,1.088235294117647,0.04937482703908927,564,You being a night owl is no longer an excuse for coming in late.
3258,0,3,31,34,1.088235294117647,0.04937482703908927,564,Our nine new employees starting today are a real hoot!
3258,0,3,31,34,1.088235294117647,0.04937482703908927,564,"Miss Simms, we need all the wisdom we can get."
3258,0,3,31,34,1.088235294117647,0.04937482703908927,564,"Jane, you know I supported the firm's desk-sharing initiative, but it's starting to get in the way of my work."
3258,0,3,31,34,1.088235294117647,0.04937482703908927,564,You know how everyone complains about our email system? Problem solved.
3258,0,3,31,34,1.088235294117647,0.04937482703908927,564,I thought you could use a little incentive to work on your mousiness.
3258,0,3,31,34,1.088235294117647,0.04937482703908927,564,"I'll see your nine, and raise you ten blowfish."
3258,1,1,32,34,1.088235294117647,0.06496464222510488,564,"Several hours after eating, the indigestible parts like fur, bones, teeth & feathers that are still in the gizzard are compressed into a pellet and regurgitated. Why?"
3258,0,3,31,34,1.088235294117647,0.04937482703908927,564,The Internet put them out of business?
3258,0,3,31,34,1.088235294117647,0.04937482703908927,564,Is this the head office of Wise Guys Inc.?
3258,0,3,31,34,1.088235294117647,0.04937482703908927,564,Could you check the break room for donuts or vermin?
3258,0,3,31,34,1.088235294117647,0.04937482703908927,564,"You can't subcontract ""wise"", Larry."
3258,1,1,32,34,1.088235294117647,0.06496464222510488,564,Our new board of directors is a real hoot.
3258,1,1,32,34,1.088235294117647,0.06496464222510488,564,The oversight committee is reviewing your proposal now.
3258,0,3,31,34,1.088235294117647,0.04937482703908927,564,What makes you think I've been avoiding your messages?
3258,0,3,31,34,1.088235294117647,0.04937482703908927,564,"Believe it or not, I'm a HUGE fan of The Who."
3258,0,3,31,34,1.088235294117647,0.04937482703908927,564,"Whoo-hooo am I? The head of parliament, of course!"
3258,0,3,31,34,1.088235294117647,0.04937482703908927,564,1. I know.... but Day Owls were cheaper 2. We got another wrong delivery. This was for number 9 Dowling Street
3258,0,3,31,34,1.088235294117647,0.04937482703908927,564,Hoos on top of things more than you.
3258,0,3,31,34,1.088235294117647,0.04937482703908927,564,"I said, ""Whose?"" ""Whose!"""
3258,1,1,32,34,1.088235294117647,0.06496464222510488,564,They have just been showing up since we fired that Potter fellow.
3258,1,1,32,34,1.088235294117647,0.06496464222510488,564,Roger Daltrey just called. He was hoping you could squeeze him in.
3258,1,1,32,34,1.088235294117647,0.06496464222510488,564,I'm the company's new parliamentarian.
3258,0,3,31,34,1.088235294117647,0.04937482703908927,564,I believe in the wisdom of the crowd
3258,0,3,31,34,1.088235294117647,0.04937482703908927,564,"See you later, Dawn."
3258,0,3,31,34,1.088235294117647,0.04937482703908927,564,Well you're the one who keeps calling me Mr. Wisenheimer.
3258,0,3,31,34,1.088235294117647,0.04937482703908927,564,"I didn't mean to imply that I know it all, I just meant I know how to find out."
3258,0,3,31,34,1.088235294117647,0.04937482703908927,564,"I won't say ""who"" but ""why"">"
3258,0,3,31,34,1.088235294117647,0.04937482703908927,564,"I assume you're ok with cheese on your burger today, correct?"
3258,0,3,31,34,1.088235294117647,0.04937482703908927,564,Return them to Who it May Concern.
3258,0,3,31,34,1.088235294117647,0.04937482703908927,564,Who would nyou like to talk with?
3258,1,1,32,34,1.088235294117647,0.06496464222510488,564,"My computer's down, but fire away."
3258,0,3,31,34,1.088235294117647,0.04937482703908927,564,Don't even ask. You couldn't handle the truth.
3258,0,3,31,34,1.088235294117647,0.04937482703908927,564,You have to stop working late!
3258,0,3,31,34,1.088235294117647,0.04937482703908927,564,"I am a night owl myself Mr. Piccolo, and I can handle all night security pronto, capische?!"
3258,0,3,31,34,1.088235294117647,0.04937482703908927,564,It seems we just cut down the last tree.
3258,1,1,32,34,1.088235294117647,0.06496464222510488,564,Just who do you think your are talking to?
3258,0,3,31,34,1.088235294117647,0.04937482703908927,564,April Foowl!
3258,1,1,32,34,1.088235294117647,0.06496464222510488,564,Welcome. You're here for who?
3258,1,1,32,34,1.088235294117647,0.06496464222510488,564,"No, I don't think this will decrease your stupidity."
3258,1,1,32,34,1.088235294117647,0.06496464222510488,564,Put owls on it.
3258,0,3,31,34,1.088235294117647,0.04937482703908927,564,My wife said they have to keep an eye on the new gorgeous intern.
3258,1,1,32,34,1.088235294117647,0.06496464222510488,564,I didn't realize you gave a hoot.
3258,0,3,31,34,1.088235294117647,0.04937482703908927,564,Fancy meeting you here.
3258,0,3,31,34,1.088235294117647,0.04937482703908927,564,I'm just going to keep interviewing until I find the right one.
3258,1,1,32,34,1.088235294117647,0.06496464222510488,564,I love Hooters.
3258,0,3,31,34,1.088235294117647,0.04937482703908927,564,Parliament is now in session!
3258,0,3,31,34,1.088235294117647,0.04937482703908927,564,But who can tell whose woot is who . . . or is it whom?
3258,0,3,31,34,1.088235294117647,0.04937482703908927,564,"We don't care so much about what, where and why Mrs Smarty pants...Around here what we want to know is..Who!"
3258,0,3,31,34,1.088235294117647,0.04937482703908927,564,Owl be needing you to stay late tonight.
3258,1,1,32,34,1.088235294117647,0.06496464222510488,564,Have you heard the one about not being able to find the sucker at the table?
3258,0,3,31,34,1.088235294117647,0.04937482703908927,564,This is our brood of directors.
3258,0,3,31,34,1.088235294117647,0.04937482703908927,564,One for each Branch.
3258,1,1,32,34,1.088235294117647,0.06496464222510488,564,I bet they're a hoot.
3258,0,3,31,34,1.088235294117647,0.04937482703908927,564,Just one more and I'll have the whole set!
3258,0,3,31,34,1.088235294117647,0.04937482703908927,564,"Saying ""See my Hooters"" was not sexist!"
3258,0,3,31,34,1.088235294117647,0.04937482703908927,564,Let's get the intern to come activate the HootSuite.
3258,1,1,32,34,1.088235294117647,0.06496464222510488,564,I'm not as dumb as I look. Just ask them!
3258,0,3,31,34,1.088235294117647,0.04937482703908927,564,I'm showing the public how much we give a hoot.
3258,0,3,31,34,1.088235294117647,0.04937482703908927,564,Who is on line three.
3258,0,3,31,34,1.088235294117647,0.04937482703908927,564,Who says a wise man is not clutter-free?
3258,0,3,31,34,1.088235294117647,0.04937482703908927,564,"But I ordered wise, old owls. These are all under age!"
3258,0,3,31,34,1.088235294117647,0.04937482703908927,564,With who would you like to speak?
3258,1,1,32,34,1.088235294117647,0.06496464222510488,564,One will accompany you in your future endeavors.
3258,0,3,31,34,1.088235294117647,0.04937482703908927,564,Tell congress that the executive and judiciary are of one mind!
3258,0,3,31,34,1.088235294117647,0.04937482703908927,564,The union might not be happy with our overnight security changes.
3258,0,3,31,34,1.088235294117647,0.04937482703908927,564,Owl look into it
3258,0,3,31,34,1.088235294117647,0.04937482703908927,564,"But Mr. Smith, I don't think this is what the chief had in mind when he told you to ""wisen up."""
3258,0,3,31,34,1.088235294117647,0.04937482703908927,564,"For the last time, I was referring to a computer mouse on your desk."
3258,0,3,31,34,1.088235294117647,0.04937482703908927,564,I need to work late.
3258,0,3,31,34,1.088235294117647,0.04937482703908927,564,"You have messages—one maternal, one paternal and a bunch nocturnal."
3258,0,3,31,34,1.088235294117647,0.04937482703908927,564,"No, 'Who' is the only thing they say and it's annoying."
3258,0,3,31,34,1.088235294117647,0.04937482703908927,564,It's the president on line one. He wants to talk to a wise owl.
3258,1,1,32,34,1.088235294117647,0.06496464222510488,564,Prepare the letter for scratchings.
3258,1,1,32,34,1.088235294117647,0.06496464222510488,564,"If you did ask, which I get you haven't, I wouldn't know who stole your pen."
3258,1,1,32,34,1.088235294117647,0.06496464222510488,564,Hoo do you think you are? This is a workplace not a Hootenanny. Frankly my dear I couldn't give nine hoots.
3258,1,1,32,34,1.088235294117647,0.06496464222510488,564,Please bring in the mice.
3258,0,3,31,34,1.088235294117647,0.04937482703908927,564,"The advisory board meeting is adjourned, please show them the window."
3258,0,3,31,34,1.088235294117647,0.04937482703908927,564,THIS is your solution to losing your seat in Parliament?
3258,1,1,32,34,1.088235294117647,0.06496464222510488,564,I selected my own Congress.
3258,1,1,32,34,1.088235294117647,0.06496464222510488,564,It's 5:30. Let's run over and have a drink together.
3258,0,3,31,34,1.088235294117647,0.04937482703908927,564,All of those owls won't make you wise!
3258,0,3,31,34,1.088235294117647,0.04937482703908927,564,"Your responsibilities will include answering the phone, typing and filing, and some light housekeeping."
3258,0,3,31,34,1.088235294117647,0.04937482703908927,564,"I already know 'what,' 'where,' 'when,' and 'why,' Miss Thompson. Can you tell me what I don't know?"
3258,0,3,31,34,1.088235294117647,0.04937482703908927,564,Larry you're a hoot
3258,0,3,31,34,1.088235294117647,0.04937482703908927,564,You heard right. We don't give a hoot.
3258,0,3,31,34,1.088235294117647,0.04937482703908927,564,I ordered nine yarn towels using my cell phone and received nine barn owls. Darn autocorrect!
3258,0,3,31,34,1.088235294117647,0.04937482703908927,564,"I think it is more a question of ""why"" than ""who?"""
3258,0,3,31,34,1.088235294117647,0.04937482703908927,564,BOG8
3258,0,3,31,34,1.088235294117647,0.04937482703908927,564,"Just let me know which J.K. Rowling title you want, and one of the owls will take you there."
3258,0,3,31,34,1.088235294117647,0.04937482703908927,564,"I certainly do, Miss Pettifrogge. In fact, I give nine hoots."
3258,0,3,31,34,1.088235294117647,0.04937482703908927,564,Who may I say is calling?
3258,1,1,32,34,1.088235294117647,0.06496464222510488,564,Nice hooters Mr. Higgins.
3258,0,3,31,34,1.088235294117647,0.04937482703908927,564,"I don't care if you don't give a hoot, decisions are final."
3258,0,3,31,34,1.088235294117647,0.04937482703908927,564,"I know birds of a feather flock together, but why here?"
3258,0,3,31,34,1.088235294117647,0.04937482703908927,564,They're not so smart. Get me a good consultant.
3258,0,3,31,34,1.088235294117647,0.04937482703908927,564,I don't give a hoot how many you think will fit.
3258,0,3,31,34,1.088235294117647,0.04937482703908927,564,"Margaret, please tell them I am currently unavailable and owl get back to them ASAP."
3258,0,3,31,34,1.088235294117647,0.04937482703908927,564,"Sorry, ma'am, but these are the only owls on stock."
3258,0,3,31,34,1.088235294117647,0.04937482703908927,564,"It's what, why and when. Not just who, Bob."
3258,0,3,31,34,1.088235294117647,0.04937482703908927,564,It IS possible to have too much wisdom at hand!
3258,0,3,31,34,1.088235294117647,0.04937482703908927,564,"You can ask me when, where or what, but please stop asking me who!"
3258,0,3,31,34,1.088235294117647,0.04937482703908927,564,"Maybe you misheard the voicemail, I think I asked for a new set of ""towels""!"
3258,0,3,31,34,1.088235294117647,0.04937482703908927,564,The boss says I need to give more of a hoot around here.
3258,0,3,31,34,1.088235294117647,0.04937482703908927,564,Talk about having a hootin time at work.
3258,0,3,31,34,1.088235294117647,0.04937482703908927,564,"More than anything, Ted longed for a life unfeathered"
3258,0,3,31,34,1.088235294117647,0.04937482703908927,564,"Towels, Mrs. Farnsworth. I asked you to bring me some towels."
3258,0,3,31,34,1.088235294117647,0.04937482703908927,564,"Welcome back from vacation, Kevin. I see you made the most of Harry Potter World."
3258,0,3,31,34,1.088235294117647,0.04937482703908927,564,And Who Will I report to?
3258,0,3,31,34,1.088235294117647,0.04937482703908927,564,Owl be the judge of that.
3258,0,3,31,34,1.088235294117647,0.04937482703908927,564,"Is this the ""Occupy the Wizenheimer"" headquarters desk?"
3258,0,3,31,34,1.088235294117647,0.04937482703908927,564,It's a bit intimidating-all of this wisdom in one place.
3258,0,3,31,34,1.088235294117647,0.04937482703908927,564,"No, I'm sorry you can't take one, I'm using them all right now."
3258,0,3,31,34,1.088235294117647,0.04937482703908927,564,...but which one looks the most like me Miss Match?
3258,0,3,31,34,1.088235294117647,0.04937482703908927,564,The mice haven't been delivered yet.
3258,0,3,31,34,1.088235294117647,0.04937482703908927,564,"Please, take a seat."
3258,1,1,32,34,1.088235294117647,0.06496464222510488,564,"Ms Smith, place an order for more mice."
3258,0,3,31,34,1.088235294117647,0.04937482703908927,564,"I always get this part confused. Is it ""who"" or ""whom""?"
3258,0,3,31,34,1.088235294117647,0.04937482703908927,564,Spam from Hogwarts.
3258,1,1,32,34,1.088235294117647,0.06496464222510488,564,"They chose me as the wisest and oldest owl! By the way, you're fired."
3258,0,3,31,34,1.088235294117647,0.04937482703908927,564,This team will be a real Who's Who of baseball.
3258,0,3,31,34,1.088235294117647,0.04937482703908927,564,"Slower than Watson, but I'm told they are wise"
3258,0,3,31,34,1.088235294117647,0.04937482703908927,564,"As I said, I really do not give a hoot."
3258,1,1,32,34,1.088235294117647,0.06496464222510488,564,"Seriously?…You asked me if I am a NIGHT OWL?????” “Oh Mister Rosenthorp, I’m so sorry! I thought you told me to get NINE OWLS."" ""But I was able to get a very good deal on them!"
3258,0,3,31,34,1.088235294117647,0.04937482703908927,564,"Buy them all, and I'll throw in a lifetime supply of mice."
3258,0,3,31,34,1.088235294117647,0.04937482703908927,564,Whooo's there?
3258,0,3,31,34,1.088235294117647,0.04937482703908927,564,I want to project an image of wisdom.
3258,0,3,31,34,1.088235294117647,0.04937482703908927,564,Seemed like a hoot at the time.'
3258,1,1,32,34,1.088235294117647,0.06496464222510488,564,"The real question, Phyllis, is not 'why?' but 'whooooo?'"
3258,0,3,31,34,1.088235294117647,0.04937482703908927,564,"Sorry, Marge. These are the only ""night shift"" workers that could make it over the wall."
3258,0,3,31,34,1.088235294117647,0.04937482703908927,564,It's official...we have owls.
3258,1,1,32,34,1.088235294117647,0.06496464222510488,564,Pick the right one and you'll understand why we can't give you a raise.
3258,0,3,31,34,1.088235294117647,0.04937482703908927,564,There was a slight error in my model.
3258,1,1,32,34,1.088235294117647,0.06496464222510488,564,That's it! No more anti-wizard editorials.
3258,1,1,32,34,1.088235294117647,0.06496464222510488,564,"Technology is not killing the bird messenger industry Marsha, it's trade deals!"
3258,0,3,31,34,1.088235294117647,0.04937482703908927,564,What's new pussycat?
3258,0,3,31,34,1.088235294117647,0.04937482703908927,564,"So...you've got your ""ducks"" in a row"
3258,0,3,31,34,1.088235294117647,0.04937482703908927,564,I love birds. Have these stuffed and mounted in a humane manner.
3258,0,3,31,34,1.088235294117647,0.04937482703908927,564,It's a real hoo's hoo around here.
3258,1,1,32,34,1.088235294117647,0.06496464222510488,564,You notice there are no elephants in the room.
3258,0,3,31,34,1.088235294117647,0.04937482703908927,564,"No, I said I wanted to address Parliament some day."
3258,1,1,32,34,1.088235294117647,0.06496464222510488,564,Tell our Colombian connection to start using some other figurines for shipments. We don't want Customs getting wise.
3258,0,3,31,34,1.088235294117647,0.04937482703908927,564,Let's see a robot try taking this job.
3258,0,3,31,34,1.088235294117647,0.04937482703908927,564,"Hello, pussycat!"
3258,0,3,31,34,1.088235294117647,0.04937482703908927,564,"Baby goats won the internet, please return these"
3258,1,1,32,34,1.088235294117647,0.06496464222510488,564,What's owling you?
3258,0,3,31,34,1.088235294117647,0.04937482703908927,564,"My role, as I see it, is more to ask the 'what, where, when and why' questions."
3258,0,3,31,34,1.088235294117647,0.04937482703908927,564,With all due respect I suggest you stop working into the night hours.
3258,0,3,31,34,1.088235294117647,0.04937482703908927,564,"Oh, God. It never occurred to me that they look like the boss."
3258,0,3,31,34,1.088235294117647,0.04937482703908927,564,"You can call me whatever you want, Mr. Babcock, but those fake owls aren't going to scare me away."
3258,0,3,31,34,1.088235294117647,0.04937482703908927,564,All together they're a hoot.
3258,0,3,31,34,1.088235294117647,0.04937482703908927,564,"""This is a nice liter, but they're cheaper by the dozen."" Joe Pitts Washington, DC"
3258,1,1,32,34,1.088235294117647,0.06496464222510488,564,I don't give a hooter.
3258,0,3,31,34,1.088235294117647,0.04937482703908927,564,Replacements for that WISE OLD OWL desk sign?
3258,0,3,31,34,1.088235294117647,0.04937482703908927,564,The couturier said fieldmice sportcoats were going to blow up this Winter.
3258,0,3,31,34,1.088235294117647,0.04937482703908927,564,I'm still not sure how 'Hooters' are supposed to help the sales team.
3258,0,3,31,34,1.088235294117647,0.04937482703908927,564,"Just a reminder to use ""who"" rather than ""whom"" when appropriate."
3258,0,3,31,34,1.088235294117647,0.04937482703908927,564,It's a hoot-in.
3258,0,3,31,34,1.088235294117647,0.04937482703908927,564,The President wants you to see that he gets into 'Who's Who'.
3258,0,3,31,34,1.088235294117647,0.04937482703908927,564,I meant get Parliament on the phone
3258,0,3,31,34,1.088235294117647,0.04937482703908927,564,"It's chemical free rat control. By the way, have you seen my red stapler?"
3258,0,3,31,34,1.088235294117647,0.04937482703908927,564,Wisdom is next door. This is the owl dcpartment.
3258,0,3,31,34,1.088235294117647,0.04937482703908927,564,"Florence, book a table for 10 at hooters."
3258,0,3,31,34,1.088235294117647,0.04937482703908927,564,What predatory marketing practices?
3258,0,3,31,34,1.088235294117647,0.04937482703908927,564,"Margaret, for the last time, will you please stop referring to me as the company's ""owl-countant"""
3258,0,3,31,34,1.088235294117647,0.04937482703908927,564,I can help you send fan mail to J. K. Rowling.
3258,0,3,31,34,1.088235294117647,0.04937482703908927,564,At least I give a hoot.
3258,0,3,31,34,1.088235294117647,0.04937482703908927,564,"This is the new Board of Directors, but they only work at night."
3258,1,1,32,34,1.088235294117647,0.06496464222510488,564,"When I said that I wanted to listen to The Who, I didn't mean this!"
3258,0,3,31,34,1.088235294117647,0.04937482703908927,564,I thought you said no one would give a hoot about it.
3258,0,3,31,34,1.088235294117647,0.04937482703908927,564,I thought I was ordering nine awls. The website was very misleading.
3258,0,3,31,34,1.088235294117647,0.04937482703908927,564,This isn't what I meant when I told you to give him the bird!
3258,1,1,32,34,1.088235294117647,0.06496464222510488,564,They're a new British group called The Who.
3258,0,3,31,34,1.088235294117647,0.04937482703908927,564,"Gertrude, we'll be watching your performance."
3258,0,3,31,34,1.088235294117647,0.04937482703908927,564,They're here to keep an eye on things.
3258,0,3,31,34,1.088235294117647,0.04937482703908927,564,"Yes sir, I see the wisdom, but how should I word the memo?"
3258,0,3,31,34,1.088235294117647,0.04937482703908927,564,The Hogwarts mailshot is ready.
3258,1,1,32,34,1.088235294117647,0.06496464222510488,564,They're the only employees left who give a hoot.
3258,0,3,31,34,1.088235294117647,0.04937482703908927,564,"Finally, Ms. Owl, I was asking for you all morning!"
3258,1,1,32,34,1.088235294117647,0.06496464222510488,564,"You're quite right, Miss Hopkins, I did ask to see your hooters."
3258,0,3,31,34,1.088235294117647,0.04937482703908927,564,"Wise, sir? They've never said an objective thing."
3258,0,3,31,34,1.088235294117647,0.04937482703908927,564,Displaying your hooters is a prerequisite of the job.
3258,1,1,32,34,1.088235294117647,0.06496464222510488,564,Tell them that Dr. Who will see them now.
3258,0,3,31,34,1.088235294117647,0.04937482703908927,564,They've reached a unanimous decision.
3258,0,3,31,34,1.088235294117647,0.04937482703908927,564,I was tired of no one giving a hoot around here.
3258,0,3,31,34,1.088235294117647,0.04937482703908927,564,I have one for each of my cat's lives.
3258,0,3,31,34,1.088235294117647,0.04937482703908927,564,What do you mean Marge? Haven't you ever seen a hootenanny?
3258,0,3,31,34,1.088235294117647,0.04937482703908927,564,Ask the consultants if it's who or whom.
3258,0,3,31,34,1.088235294117647,0.04937482703908927,564,"I hear what you are saying, Mrs. Jones, but I don't really give a hoot."
3258,0,3,31,34,1.088235294117647,0.04937482703908927,564,"These nine wise owls are a gift from Harry potter, but a quick peek of your hooters would make my day much hotter!"
3258,1,1,32,34,1.088235294117647,0.06496464222510488,564,Meet the who's who of the graduating class.
3258,1,1,32,34,1.088235294117647,0.06496464222510488,564,"Do you give even a single hoot, Miss Pym?"
3258,0,3,31,34,1.088235294117647,0.04937482703908927,564,I've been accepted at Hogwarts.
3258,0,3,31,34,1.088235294117647,0.04937482703908927,564,"Please take one. See, I give a hoot after all!"
3258,0,3,31,34,1.088235294117647,0.04937482703908927,564,"Martha, the advisory board meeting is going into lunch - please pick up 4 organic wood mice, 3 free-range shrews, 2 clover-fed voles...and a steak sandwich."
3258,0,3,31,34,1.088235294117647,0.04937482703908927,564,"""Please file 3 in each drawer""."
3258,1,1,32,34,1.088235294117647,0.06496464222510488,564,Owl assume that the board meeting was a hoot...
3258,1,1,32,34,1.088235294117647,0.06496464222510488,564,They're Washington refugees. Trump doesn't give a hoot for wisdom.
3258,1,1,32,34,1.088235294117647,0.06496464222510488,564,"Acutally, I said: I don't give a hoot."
3258,0,3,31,34,1.088235294117647,0.04937482703908927,564,"When I took this job, they told me it would be a real hoot. Who knew 9 owls on a desk could be this much fun?"
3258,0,3,31,34,1.088235294117647,0.04937482703908927,564,I should never have given them the first mouse.
3258,0,3,31,34,1.088235294117647,0.04937482703908927,564,"Oh! A 'spot ad, Daryl.' That's not what a I heard."
3258,1,1,32,34,1.088235294117647,0.06496464222510488,564,"Clearly, they're not a metaphor for Congress."
3258,0,3,31,34,1.088235294117647,0.04937482703908927,564,Whooo told you about that?
3258,0,3,31,34,1.088235294117647,0.04937482703908927,564,"Tell me exactly, whose line are we repping?"
3258,0,3,31,34,1.088235294117647,0.04937482703908927,564,Where are my other owls?
3258,0,3,31,34,1.088235294117647,0.04937482703908927,564,Dew we work nights
3258,1,1,32,34,1.088235294117647,0.06496464222510488,564,"Mr. Jones, you are a wise man."
3258,0,3,31,34,1.088235294117647,0.04937482703908927,564,"Who said that, when and where?"
3258,0,3,31,34,1.088235294117647,0.04937482703908927,564,I don't give a hoot. Nor do they.
3258,0,3,31,34,1.088235294117647,0.04937482703908927,564,"Well, Sandra, if you've got a better idea of how to increase wisdom company-wide by 900%, I'd certainly like to hear it."
3258,0,3,31,34,1.088235294117647,0.04937482703908927,564,So you're interested in working for Hooters!
3258,0,3,31,34,1.088235294117647,0.04937482703908927,564,I told the boss I needed nine hours to finish the job ...
3258,0,3,31,34,1.088235294117647,0.04937482703908927,564,Tell the mail room boys I want to see them. Pronto.
3258,0,3,31,34,1.088235294117647,0.04937482703908927,564,I'm told you have a plan to deal with the overdue Harry Potter books.
3258,0,3,31,34,1.088235294117647,0.04937482703908927,564,I'm in a meeting. Owl get back to you.
3258,0,3,31,34,1.088235294117647,0.04937482703908927,564,Welcome to Hooters Corporate...
3258,1,1,32,34,1.088235294117647,0.06496464222510488,564,"They said they wanted a ""Hooters"" display. No?"
3258,0,3,31,34,1.088235294117647,0.04937482703908927,564,But I asked for nine parrots
3258,0,3,31,34,1.088235294117647,0.04937482703908927,564,Please inform my previous advisors
3258,0,3,31,34,1.088235294117647,0.04937482703908927,564,"WHO PUT THESE OWLS ON MY DESK,WHO,WHO,WHO!"
3258,0,3,31,34,1.088235294117647,0.04937482703908927,564,"Librarian, can you point me towards the ""Who Done It?"" Section?"
3258,0,3,31,34,1.088235294117647,0.04937482703908927,564,"The next time a package comes from the 9 Owl society Millie, please return it unopened."
3258,1,1,32,34,1.088235294117647,0.06496464222510488,564,"""I miss the days, when it was just about the owls!"" -Hooters CEO"
3258,0,3,31,34,1.088235294117647,0.04937482703908927,564,"Please tell Mrs. Pidgeon I can't see her now, tomorrow, or ever."
3258,0,3,31,34,1.088235294117647,0.04937482703908927,564,Welcome to your first day. Owl be watching you.
3258,0,3,31,34,1.088235294117647,0.04937482703908927,564,Great. Now they only want to work nights.
3258,0,3,31,34,1.088235294117647,0.04937482703908927,564,These are for all those parents who claim I don't give a hoot.
3258,0,3,31,34,1.088235294117647,0.04937482703908927,564,Don't mistake me for someone who gives a hoot.
3258,1,1,32,34,1.088235294117647,0.06496464222510488,564,Office of Sinead Hunt.
3258,1,1,32,34,1.088235294117647,0.06496464222510488,564,It's their moment of Zen.
3258,0,3,31,34,1.088235294117647,0.04937482703908927,564,"And this comes under class action, right?"
3258,0,3,31,34,1.088235294117647,0.04937482703908927,564,"Excuse me Mr. Jones, I am happy to report that we no longer have a mouse problem."
3258,0,3,31,34,1.088235294117647,0.04937482703908927,564,We will make another wise decision.
3258,0,3,31,34,1.088235294117647,0.04937482703908927,564,You're a hoot. Nine owls won't make you wise!
3258,0,3,31,34,1.088235294117647,0.04937482703908927,564,"Mrs. Benson, please bring me a large tree."
3258,0,3,31,34,1.088235294117647,0.04937482703908927,564,"Not Again, Gerald!"
3258,0,3,31,34,1.088235294117647,0.04937482703908927,564,"The question, Miss Peregrine, is not ""How?"", but ""Who, who, who, who, who, who, who, who, who?"""
3258,0,3,31,34,1.088235294117647,0.04937482703908927,564,"Seems I, ""GAVE A HOOT,"" too many times."
3258,0,3,31,34,1.088235294117647,0.04937482703908927,564,Until we replace the roof these should scare away the pigeons.
4082,0,3,32,35,1.0857142857142856,0.04800960288096031,564,We’ve lined up enough pussy-cats but we’re short on pea-green boats.
4082,1,1,33,35,1.0857142857142856,0.06313156292770737,564,How and Why are you here?
4082,0,3,32,35,1.0857142857142856,0.04800960288096031,564,I'm sorry I can't - I've got owl this work to do.
4082,0,3,32,35,1.0857142857142856,0.04800960288096031,564,The animal rights activist is here to see you
4082,0,3,32,35,1.0857142857142856,0.04800960288096031,564,Look at all my owls
4082,0,3,32,35,1.0857142857142856,0.04800960288096031,564,"They were downsizing at Hogwarts, and I got a great deal!"
4082,0,3,32,35,1.0857142857142856,0.04800960288096031,564,"OK, so I DO give a hoot!"
4082,1,1,33,35,1.0857142857142856,0.06313156292770737,564,"And I repeat ""Can you please order a paper towels for the office"""
4082,0,3,32,35,1.0857142857142856,0.04800960288096031,564,"Paper towels, Pam. I said we needed paper towels."
4082,1,1,33,35,1.0857142857142856,0.06313156292770737,564,Who could be leaving preditors that hunt at night? We are a law firm.
4082,0,3,32,35,1.0857142857142856,0.04800960288096031,564,They overheard that 'The Who' is touring this summer...anyway do you think we could book them?
4082,0,3,32,35,1.0857142857142856,0.04800960288096031,564,"You never know when you will need one, I put them on payroll."
4082,0,3,32,35,1.0857142857142856,0.04800960288096031,564,"I know it's not exactly a tree full of owls, but...!"
4082,0,3,32,35,1.0857142857142856,0.04800960288096031,564,"Sir, this is a 9 to 5. Having nocturnal birds will not get you overtime pay."
4082,0,3,32,35,1.0857142857142856,0.04800960288096031,564,"On the contrary, I actually do give a hoot."
4082,1,1,33,35,1.0857142857142856,0.06313156292770737,564,"He said, ""grab them by the pussy."" I say, ""grab them by the hooters."""
4082,0,3,32,35,1.0857142857142856,0.04800960288096031,564,I hope only they do that neck thing.
4082,0,3,32,35,1.0857142857142856,0.04800960288096031,564,I don't give......I take!
4082,1,1,33,35,1.0857142857142856,0.06313156292770737,564,Now we just need some early birds for the day shift.
4082,1,1,33,35,1.0857142857142856,0.06313156292770737,564,"They just legalized dope, not wisdom."
4082,0,3,32,35,1.0857142857142856,0.04800960288096031,564,"No, I don't think that will help us compete with Twitter."
4082,0,3,32,35,1.0857142857142856,0.04800960288096031,564,I don't give 9 hoots why you and Joanne are having difficulty working together. I need the report by Monday.
4082,1,1,33,35,1.0857142857142856,0.06313156292770737,564,Phooey ! Birds of a feather does not apply to you Quimby!
4082,0,3,32,35,1.0857142857142856,0.04800960288096031,564,Why should I give a hoot about what you are saying?
4082,0,3,32,35,1.0857142857142856,0.04800960288096031,564,"So, just why do you want to work here at ""Who's Who?"""
4082,1,1,33,35,1.0857142857142856,0.06313156292770737,564,Help me out here!
4082,0,3,32,35,1.0857142857142856,0.04800960288096031,564,We don't have names on any of these files.
4082,0,3,32,35,1.0857142857142856,0.04800960288096031,564,The EPA said these were all that's left for the photo op with DeVos
4082,0,3,32,35,1.0857142857142856,0.04800960288096031,564,I've seen this movie.
4082,0,3,32,35,1.0857142857142856,0.04800960288096031,564,"To wit, to woo, this gift, for you."
4082,0,3,32,35,1.0857142857142856,0.04800960288096031,564,They're bonuses for the night shift.
4082,1,1,33,35,1.0857142857142856,0.06313156292770737,564,Filing cabinet was full.
4082,0,3,32,35,1.0857142857142856,0.04800960288096031,564,"No, thanks. I already have nine."
4082,1,1,33,35,1.0857142857142856,0.06313156292770737,564,we WILL get an answer to 'how many licks does it take to get to the center of a lollipop'
4082,0,3,32,35,1.0857142857142856,0.04800960288096031,564,Can you send out for more mice..and tell my wife I will be working late?
4082,1,1,33,35,1.0857142857142856,0.06313156292770737,564,"Tell that Old Owl, I don't give a Hoot!"
4082,0,3,32,35,1.0857142857142856,0.04800960288096031,564,It looks like we in for a real hootenanny!
4082,0,3,32,35,1.0857142857142856,0.04800960288096031,564,"I really don't give a hoot, Nanny!"
4082,0,3,32,35,1.0857142857142856,0.04800960288096031,564,We're going to attract a bunch of those voucher students by converting to a Hogwarts format.
4082,0,3,32,35,1.0857142857142856,0.04800960288096031,564,"Marge, can you call the deli back? They delivered the wrong order again."
4082,0,3,32,35,1.0857142857142856,0.04800960288096031,564,None of us gives a hoot what you think about it.
4082,1,1,33,35,1.0857142857142856,0.06313156292770737,564,We've got a flight risk on our hands.
4082,0,3,32,35,1.0857142857142856,0.04800960288096031,564,Is this enough to make me look smart?
4082,0,3,32,35,1.0857142857142856,0.04800960288096031,564,"Owl be busy today, please hoo-eld my calls."
4082,0,3,32,35,1.0857142857142856,0.04800960288096031,564,"Well, at first I didn't give a hoot... but my view is evolving!"
4082,1,1,33,35,1.0857142857142856,0.06313156292770737,564,$10 each. It’s a Mensa fundraiser. Or do you want to discuss your pay request first?
4082,0,3,32,35,1.0857142857142856,0.04800960288096031,564,"I no longer give a hoot, Miss Brown."
4082,1,1,33,35,1.0857142857142856,0.06313156292770737,564,There are easier ways to tell me that you don't give a hoot about my weekend plans.
4082,0,3,32,35,1.0857142857142856,0.04800960288096031,564,"Miss Brooks, I'm not sure you give a hoot about our company. Please take one of my owls for a mentor."
4082,0,3,32,35,1.0857142857142856,0.04800960288096031,564,"Welcome to Hooters, may I take your order?"
4082,0,3,32,35,1.0857142857142856,0.04800960288096031,564,Hoo should I talk to about opening an account? See how I did that?
4082,1,1,33,35,1.0857142857142856,0.06313156292770737,564,"You can try, but I don't think the ""Hooters"" you actually meant to apply to will hire you."
4082,1,1,33,35,1.0857142857142856,0.06313156292770737,564,"Frankly, Scarlet, I don't give a hoot!"
4082,0,3,32,35,1.0857142857142856,0.04800960288096031,564,"Reading ""The Art of the Wheel"" has changed my life."
4082,0,3,32,35,1.0857142857142856,0.04800960288096031,564,Impromptu board of advisors meeting?
4082,0,3,32,35,1.0857142857142856,0.04800960288096031,564,I thought it was nine ladies dancing?
4082,0,3,32,35,1.0857142857142856,0.04800960288096031,564,They heard I like Hooters.
4082,1,1,33,35,1.0857142857142856,0.06313156292770737,564,"The Hogwarts' parliament has arrived, Prime Minister."
4082,0,3,32,35,1.0857142857142856,0.04800960288096031,564,'The eyes have it.'
4082,0,3,32,35,1.0857142857142856,0.04800960288096031,564,Have you seen my pet mouse anywhere?
4082,0,3,32,35,1.0857142857142856,0.04800960288096031,564,Boss I want a raise *who* come on boss *who* ok i'm done *thank you*
4082,1,1,33,35,1.0857142857142856,0.06313156292770737,564,Please tell Mr. Koons he can come in now.
4082,0,3,32,35,1.0857142857142856,0.04800960288096031,564,Wise choice
4082,0,3,32,35,1.0857142857142856,0.04800960288096031,564,Tell me owl about it.
4082,1,1,33,35,1.0857142857142856,0.06313156292770737,564,"Horton, I really think it's time you finally got that hearing aid."
4082,0,3,32,35,1.0857142857142856,0.04800960288096031,564,I'm replacing the watch dog with these guard owls from Who's There Inc.
4082,0,3,32,35,1.0857142857142856,0.04800960288096031,564,Owl see him now
4082,1,1,33,35,1.0857142857142856,0.06313156292770737,564,"Mickey Mouse called and asked, “Is it safe?”"
4082,0,3,32,35,1.0857142857142856,0.04800960288096031,564,I wasn't lying when I said it was a hoot up here
4082,0,3,32,35,1.0857142857142856,0.04800960288096031,564,Whooo? Are you talikn tooo?
4082,0,3,32,35,1.0857142857142856,0.04800960288096031,564,"They’re young, aggressive, and they pellet out more ideas a day than anyone in the biz!"
4082,0,3,32,35,1.0857142857142856,0.04800960288096031,564,"Although you didn't get the raise, the board of directors did appalud your efforts to appear more intelligent."
4082,0,3,32,35,1.0857142857142856,0.04800960288096031,564,Yes. The Hoot Nanny position is still open.
4082,0,3,32,35,1.0857142857142856,0.04800960288096031,564,Did you get this idea from the bisness channel?
4082,0,3,32,35,1.0857142857142856,0.04800960288096031,564,"Despite your best efforts, we've reached the point where we no longer give a hoot."
4082,0,3,32,35,1.0857142857142856,0.04800960288096031,564,No--surround yourself with wise PEOPLE!
4082,0,3,32,35,1.0857142857142856,0.04800960288096031,564,I ' m wiling the Owls away.
4082,0,3,32,35,1.0857142857142856,0.04800960288096031,564,I thought it's forbidden to bring pets to the office.
4082,0,3,32,35,1.0857142857142856,0.04800960288096031,564,Can you tell Hogwarts to stop sending me junk owls?
4082,1,1,33,35,1.0857142857142856,0.06313156292770737,564,"Owens, your's is the only parlaiment I don't find nausiating."
4082,1,1,33,35,1.0857142857142856,0.06313156292770737,564,I keep hearing them call my name.
4082,1,1,33,35,1.0857142857142856,0.06313156292770737,564,I said I didn't give a hoot.
4082,0,3,32,35,1.0857142857142856,0.04800960288096031,564,Mice kept eating all the beans
4082,0,3,32,35,1.0857142857142856,0.04800960288096031,564,Our tests indicate it takes more than 3 licks to get to the center of a tootsie-pop.
4082,0,3,32,35,1.0857142857142856,0.04800960288096031,564,I take it you still haven't heard anything from Hogwarts?
4082,0,3,32,35,1.0857142857142856,0.04800960288096031,564,"Get me the latest edition of ”Wh's Who."""
4082,0,3,32,35,1.0857142857142856,0.04800960288096031,564,"See, I told you they gave a hoot!"
4082,0,3,32,35,1.0857142857142856,0.04800960288096031,564,"Yes, I can see you give a hoot."
4082,0,3,32,35,1.0857142857142856,0.04800960288096031,564,I don't give a hoot what you think.
4082,0,3,32,35,1.0857142857142856,0.04800960288096031,564,I'm trying desperately to raise my IQ
4082,0,3,32,35,1.0857142857142856,0.04800960288096031,564,Who do you think?
4082,0,3,32,35,1.0857142857142856,0.04800960288096031,564,We never break up sets.
4082,0,3,32,35,1.0857142857142856,0.04800960288096031,564,"The Whitehouse wants wise, but cheap, advisers. Ship 'em !"
4082,1,1,33,35,1.0857142857142856,0.06313156292770737,564,Whooo did you say that you were?
4082,0,3,32,35,1.0857142857142856,0.04800960288096031,564,Whooo's in charge?
4082,0,3,32,35,1.0857142857142856,0.04800960288096031,564,"After seeing Harry Potter, George opted for a new form of interoffice communication."
4082,0,3,32,35,1.0857142857142856,0.04800960288096031,564,"They're very cute, but the poop-scooping must be hideous."
4082,0,3,32,35,1.0857142857142856,0.04800960288096031,564,"Hi, I'm the Hootenanny."
4082,1,1,33,35,1.0857142857142856,0.06313156292770737,564,Would you please tell them that it's my wife who cooks for me!
4082,1,1,33,35,1.0857142857142856,0.06313156292770737,564,I couldn't afford the doves.
4082,0,3,32,35,1.0857142857142856,0.04800960288096031,564,"As they say: ""It's not what you know. It's hoo you know."""
4082,0,3,32,35,1.0857142857142856,0.04800960288096031,564,THIS YEAR'S BONUS IS AN OWL.
4082,0,3,32,35,1.0857142857142856,0.04800960288096031,564,Didn't I tell you that I joined a parliament?
4082,0,3,32,35,1.0857142857142856,0.04800960288096031,564,So we'll maintain our competitive advantage if they cut Saturday deliveries.
4082,1,1,33,35,1.0857142857142856,0.06313156292770737,564,It's like I told them; one says 'whom' if it's the object of a sentence.
4082,0,3,32,35,1.0857142857142856,0.04800960288096031,564,"Yeah, my wife left me, saying ""Owl be seeing you"". That's her kind of a hoot."
4082,0,3,32,35,1.0857142857142856,0.04800960288096031,564,"I believe wisdom is acquired, not innate."
4082,1,1,33,35,1.0857142857142856,0.06313156292770737,564,You're the tenth one today who doesn't give a hoot.
4082,1,1,33,35,1.0857142857142856,0.06313156292770737,564,"All right already, tell Mr. Potter I get the message."
4082,0,3,32,35,1.0857142857142856,0.04800960288096031,564,I don't give a hoot about your book club.
4082,0,3,32,35,1.0857142857142856,0.04800960288096031,564,"WHO, WHO, WHO IS RESPONSIBLE FOR THIS, MISS DALRYMPLE?"
4082,0,3,32,35,1.0857142857142856,0.04800960288096031,564,"Well obviously, but what KIND of owls?"
4082,0,3,32,35,1.0857142857142856,0.04800960288096031,564,"That's right, nine. I filled the vacancy by executive order."
4082,0,3,32,35,1.0857142857142856,0.04800960288096031,564,Do you want me to stall the investigator while you get rid of all of those owls from the Ministry of Russian Magic?
4082,0,3,32,35,1.0857142857142856,0.04800960288096031,564,They're demanding seats on the board!
4082,0,3,32,35,1.0857142857142856,0.04800960288096031,564,When is this fucking acid going to wear off?
4082,1,1,33,35,1.0857142857142856,0.06313156292770737,564,Owl in the family?
4082,0,3,32,35,1.0857142857142856,0.04800960288096031,564,The good news is we're under budget.
4082,0,3,32,35,1.0857142857142856,0.04800960288096031,564,You're fired. I surround myself with only those who can truly turn heads.
4082,0,3,32,35,1.0857142857142856,0.04800960288096031,564,Did you hear? There's a new pet-friendly policy.
4082,0,3,32,35,1.0857142857142856,0.04800960288096031,564,How is this supposed to help with our social media?
4082,1,1,33,35,1.0857142857142856,0.06313156292770737,564,Who who who who who who who who who who are you here to see?
4082,0,3,32,35,1.0857142857142856,0.04800960288096031,564,Your son called. He's wondering if you know where his Furby's are.
4082,1,1,33,35,1.0857142857142856,0.06313156292770737,564,A Mensa of owls.
4082,0,3,32,35,1.0857142857142856,0.04800960288096031,564,Really? Hooters? Is that the message you want to send?
4082,0,3,32,35,1.0857142857142856,0.04800960288096031,564,You're always saying how much you love hooters for lunch.
4082,0,3,32,35,1.0857142857142856,0.04800960288096031,564,There just isn't room in that bookcase for all of my Penguins.
4082,0,3,32,35,1.0857142857142856,0.04800960288096031,564,Whooooo are you looking for?
4082,1,1,33,35,1.0857142857142856,0.06313156292770737,564,I've convened a warren commission.
4082,1,1,33,35,1.0857142857142856,0.06313156292770737,564,They all here to audition for the role of the falcon in the Maltese falcon remake
4082,0,3,32,35,1.0857142857142856,0.04800960288096031,564,I finally asked my boss for a few days off to go birding
4082,0,3,32,35,1.0857142857142856,0.04800960288096031,564,"I have no idea who left them here, but that seems to be the question on everyone’s mind."
4082,1,1,33,35,1.0857142857142856,0.06313156292770737,564,They're territorial by nature but litigious by choice.
4082,1,1,33,35,1.0857142857142856,0.06313156292770737,564,Bring me an owl.
4082,1,1,33,35,1.0857142857142856,0.06313156292770737,564,Yes! The resemblance is remarkable. But nobody will ever accuse you of being wise
4082,0,3,32,35,1.0857142857142856,0.04800960288096031,564,Turns out they're just a bunch of wise guys.
4082,0,3,32,35,1.0857142857142856,0.04800960288096031,564,Meet the new evening shift.
4082,0,3,32,35,1.0857142857142856,0.04800960288096031,564,"Sorry, but this is owl I have."
4082,0,3,32,35,1.0857142857142856,0.04800960288096031,564,These are messages from your wizard constituents.
4082,0,3,32,35,1.0857142857142856,0.04800960288096031,564,"Get me the latest edition of ”Wh's Who."""
4082,0,3,32,35,1.0857142857142856,0.04800960288096031,564,Whoooo asked your opinion?
4082,1,1,33,35,1.0857142857142856,0.06313156292770737,564,Has anyone mentioned the resolution of the mouse problem?
4082,0,3,32,35,1.0857142857142856,0.04800960288096031,564,"Janet, hold my calls... I have an impending owl movement"
4082,0,3,32,35,1.0857142857142856,0.04800960288096031,564,"Bob, your Harry Potter obsession is getting out of control."
4082,0,3,32,35,1.0857142857142856,0.04800960288096031,564,No 'WISE'cracks!!!
4082,0,3,32,35,1.0857142857142856,0.04800960288096031,564,Who let the owls out? Hoot! Hoot! Hoot! Hoot!
4082,1,1,33,35,1.0857142857142856,0.06313156292770737,564,Owl's your typing?
4082,0,3,32,35,1.0857142857142856,0.04800960288096031,564,And stop insisting that I call you Hermione.
4082,0,3,32,35,1.0857142857142856,0.04800960288096031,564,"Mr. Wiseman, I presume?"
4082,0,3,32,35,1.0857142857142856,0.04800960288096031,564,"It's hard to tell who's who, but these new interns are a hoot!"
4082,0,3,32,35,1.0857142857142856,0.04800960288096031,564,"hoo, hoo did you say was calling?"
4082,0,3,32,35,1.0857142857142856,0.04800960288096031,564,The salesman guaranteed this would get me noticed at work.
4082,1,1,33,35,1.0857142857142856,0.06313156292770737,564,"The ""five whys"" weren't working, so we're gonna try the ""nine whos."""
4082,0,3,32,35,1.0857142857142856,0.04800960288096031,564,Really? I thought they said our new product would ease 'owl' movements.
4082,0,3,32,35,1.0857142857142856,0.04800960288096031,564,Who's Whoo? I don't give a hoot!
4082,0,3,32,35,1.0857142857142856,0.04800960288096031,564,This isn't going to end well.
4082,0,3,32,35,1.0857142857142856,0.04800960288096031,564,Could you put in a call to corporate governance?
4082,0,3,32,35,1.0857142857142856,0.04800960288096031,564,Why do you want to work at Hooters?
4082,0,3,32,35,1.0857142857142856,0.04800960288096031,564,I really don't give a hoot about your problems.
4082,0,3,32,35,1.0857142857142856,0.04800960288096031,564,Whooo do you think you're talkong to?
4082,0,3,32,35,1.0857142857142856,0.04800960288096031,564,I'll call HR if you compliment my hooters again.
4082,1,1,33,35,1.0857142857142856,0.06313156292770737,564,"Alice, bring me some candied mice, hoot sweet!"
4082,1,1,33,35,1.0857142857142856,0.06313156292770737,564,"Welcome tot he ""Who's Who"" library."
4082,0,3,32,35,1.0857142857142856,0.04800960288096031,564,"No, I said I wanted a secretary with horn-rimmed GLASSES."
4082,0,3,32,35,1.0857142857142856,0.04800960288096031,564,I don't sell you these until I find out what you did with the four-and-twenty blackbirds.
4082,0,3,32,35,1.0857142857142856,0.04800960288096031,564,Apparently someone over in the Ornithology Department actually gives a hoot.
4082,0,3,32,35,1.0857142857142856,0.04800960288096031,564,Do I have to repeat myself? I don't give a hoot
4082,0,3,32,35,1.0857142857142856,0.04800960288096031,564,We employ all of the hoo's hoo's
4082,0,3,32,35,1.0857142857142856,0.04800960288096031,564,"...and you won't see anymore of them, either!"
4251,0,3,33,36,1.0833333333333333,0.04671765921511568,564,"When MY kid gets into Hogwarts, everyone is going to know!"
4251,0,3,33,36,1.0833333333333333,0.04671765921511568,564,"You say ""Who"", I say ""Dat"". Who Dat. Who Dat. Go Saints."
4251,1,1,34,36,1.0833333333333333,0.06139903313441727,564,Now it's my turn! Nice hooters.
4251,0,3,33,36,1.0833333333333333,0.04671765921511568,564,And who would you like to see?
4255,0,3,34,37,1.0810810810810811,0.045493265488117475,564,"Yes I was calling ""youhoohoohoohooyou..."""
4256,0,3,36,39,1.0769230769230769,0.04322703745761662,564,"I know they're wise, but maybe account should review too."
4257,0,3,37,40,1.075,0.04217636961434866,564,"OK, wiseguy...counting you, it makes 10............"
4257,0,3,37,40,1.075,0.04217636961434866,564,We expect our employees to demonstrate some wisdom.
4259,0,2,28,30,1.0666666666666667,0.046320555585310084,564,"Two things, Wheeler... first, here are the extra owls you requested... second, have you seen my hearing aids?"
4259,0,2,28,30,1.0666666666666667,0.046320555585310084,564,can't you see? I am wiser than many owls.
4259,0,2,28,30,1.0666666666666667,0.046320555585310084,564,"Who’s on your desk, no, second base."
4259,0,2,28,30,1.0666666666666667,0.046320555585310084,564,"Mr. Smyth to see you, sir. Who?"
4259,0,2,28,30,1.0666666666666667,0.046320555585310084,564,"Lesson learned: don't keep repeating ""owl be back."""
4259,0,2,28,30,1.0666666666666667,0.046320555585310084,564,Hiring for a hootenanny
4259,0,2,28,30,1.0666666666666667,0.046320555585310084,564,"I do give hoot. Hell, we all give hoot!"
4259,0,2,28,30,1.0666666666666667,0.046320555585310084,564,But knowledge is power.
4259,0,2,28,30,1.0666666666666667,0.046320555585310084,564,the last thing...you'd be caring for the rat farm...
4259,0,2,28,30,1.0666666666666667,0.046320555585310084,564,"Yes, but they are only solitary at at night time."
4259,0,2,28,30,1.0666666666666667,0.046320555585310084,564,You must be Doctor Hoo.
4259,0,2,28,30,1.0666666666666667,0.046320555585310084,564,They're cheaper than a reference librarian.
4259,0,2,28,30,1.0666666666666667,0.046320555585310084,564,They're Buy One Get One Free!
4259,0,2,28,30,1.0666666666666667,0.046320555585310084,564,"Yes, Mr. Arless, your 'Give A Hoot or Get The Boot' campaign is very popular with all your employees at the Owl Figurine Gift Shop."
4259,0,2,28,30,1.0666666666666667,0.046320555585310084,564,"'More Bard!'"" I said, meaning Shakespeare, not Barred, as in owls."
4259,0,2,28,30,1.0666666666666667,0.046320555585310084,564,Aren't they a hoot?
4259,0,2,28,30,1.0666666666666667,0.046320555585310084,564,Oh wise one: What the hell is wrong with you?
4259,0,2,28,30,1.0666666666666667,0.046320555585310084,564,"Working for you has been a hoot, but I quit."
4259,0,2,28,30,1.0666666666666667,0.046320555585310084,564,I don't give a hoot who buys them.
4259,0,2,28,30,1.0666666666666667,0.046320555585310084,564,Aren't I a hoot?
4259,0,2,28,30,1.0666666666666667,0.046320555585310084,564,Talk to those that give a hoot.
4259,0,2,28,30,1.0666666666666667,0.046320555585310084,564,"A little hint. ""They can sense fear."
4259,0,2,28,30,1.0666666666666667,0.046320555585310084,564,We're gonna have to rethink the 'Small Pets for Sale' department.
4259,0,2,28,30,1.0666666666666667,0.046320555585310084,564,"What, why, where and how? Two doors down."
4259,1,0,29,30,1.0666666666666667,0.06666666666666668,564,"I just wanted a cigarette, Doris."
4259,0,2,28,30,1.0666666666666667,0.046320555585310084,564,The invoice came from Athens. But I cannot find anyone who ordered them.
4259,0,2,28,30,1.0666666666666667,0.046320555585310084,564,They are cheaper than a night watchman.
4259,0,2,28,30,1.0666666666666667,0.046320555585310084,564,I can see you're a real who's who.
4259,0,2,28,30,1.0666666666666667,0.046320555585310084,564,"Just so you know, I really do give a hoot."
4259,0,2,28,30,1.0666666666666667,0.046320555585310084,564,"Miss Johnson, this is the team reviewing our personnel office."
4259,0,2,28,30,1.0666666666666667,0.046320555585310084,564,Who who who were you talking to?
4259,0,2,28,30,1.0666666666666667,0.046320555585310084,564,I was told it was bring your pet to work day.
4259,0,2,28,30,1.0666666666666667,0.046320555585310084,564,"Ms. George, I had asked you to order a set of towels for the staff gym."
4259,0,2,28,30,1.0666666666666667,0.046320555585310084,564,A call from whom?
4259,0,2,28,30,1.0666666666666667,0.046320555585310084,564,"Too much, perhaps? And yet the pigeons have been routed."
4259,0,2,28,30,1.0666666666666667,0.046320555585310084,564,File them by age
4259,0,2,28,30,1.0666666666666667,0.046320555585310084,564,The President watched Harry Potter last night and now I have to figure out this new way to get our secrets to the Russians.
4259,0,2,28,30,1.0666666666666667,0.046320555585310084,564,You didn't mention this at the job interview.
4259,0,2,28,30,1.0666666666666667,0.046320555585310084,564,It would have been better if you had just gone on wiseowl.c
4259,0,2,28,30,1.0666666666666667,0.046320555585310084,564,So you say you don't pollute?
4259,0,2,28,30,1.0666666666666667,0.046320555585310084,564,"Sir, it's really a hoot to work here"
4259,0,2,28,30,1.0666666666666667,0.046320555585310084,564,"This is going to be a difficult day, I'm afraid. The consultants are advising us to make some fire most of marketing and bring in some field mice to temp."
4259,0,2,28,30,1.0666666666666667,0.046320555585310084,564,We have just acquired Hooters
4259,0,2,28,30,1.0666666666666667,0.046320555585310084,564,Your order from amazon is quite a hoot!
4259,0,2,28,30,1.0666666666666667,0.046320555585310084,564,They symbolize executive wisdom.
4259,0,2,28,30,1.0666666666666667,0.046320555585310084,564,Didn't I tell you to stop barking up the wrong tree?
4259,0,2,28,30,1.0666666666666667,0.046320555585310084,564,"Whooo, whooo, whooo are you?"
4259,0,2,28,30,1.0666666666666667,0.046320555585310084,564,"You see Gladys, I do give a hoot."
4259,0,2,28,30,1.0666666666666667,0.046320555585310084,564,Maybe we should stop asking for read receipts
4259,0,2,28,30,1.0666666666666667,0.046320555585310084,564,What part of 'who' don't you understand?
4259,0,2,28,30,1.0666666666666667,0.046320555585310084,564,You must be wondering why I've gathered you all here.
4259,0,2,28,30,1.0666666666666667,0.046320555585310084,564,I'm thinking of a change in strategy.
4259,0,2,28,30,1.0666666666666667,0.046320555585310084,564,they kept flying into the window.
4259,0,2,28,30,1.0666666666666667,0.046320555585310084,564,The doctor said I needed an owl prep kit.
4259,0,2,28,30,1.0666666666666667,0.046320555585310084,564,"Instead of being a cat lady, how about an owl lady?"
4259,0,2,28,30,1.0666666666666667,0.046320555585310084,564,Hoo did you say you were again?
4259,0,2,28,30,1.0666666666666667,0.046320555585310084,564,"No, Harold, homing-owls are not 'the new email'."
4259,0,2,28,30,1.0666666666666667,0.046320555585310084,564,"No, I don't give a hoot...."
4259,0,2,28,30,1.0666666666666667,0.046320555585310084,564,Yeah... owl explain.
4259,0,2,28,30,1.0666666666666667,0.046320555585310084,564,The pigeons have left the building.
4259,0,2,28,30,1.0666666666666667,0.046320555585310084,564,"So, you wanted me to give a hoot."
4259,0,2,28,30,1.0666666666666667,0.046320555585310084,564,"The tenth ""Owl"" nears!"
4321,0,2,29,31,1.064516129032258,0.04485301852605202,564,"Sir, Mr. Horton and I thought we heard a who."
4321,0,2,29,31,1.064516129032258,0.04485301852605202,564,"Why nine of them, Mr. Quigley?"
4321,0,2,29,31,1.064516129032258,0.04485301852605202,564,"John, just because you give a hoot, it doesn't make you one of them."
4321,0,2,29,31,1.064516129032258,0.04485301852605202,564,"See, Sarah, I really give a hoot about your problem."
4321,0,2,29,31,1.064516129032258,0.04485301852605202,564,"Well, ""name your favorite rock band"" didn't help to narrow down the pool of applicants."
4321,0,2,29,31,1.064516129032258,0.04485301852605202,564,"No, Stacey, I asked for a dozen packs of paper towels, not a dozen paper owls!"
4321,0,2,29,31,1.064516129032258,0.04485301852605202,564,Three more and we'll have a jury.
4321,0,2,29,31,1.064516129032258,0.04485301852605202,564,"Oh my god, Strigiformeses"
4321,0,2,29,31,1.064516129032258,0.04485301852605202,564,"No, I'm afraid your size still hasn't come in"
4321,0,2,29,31,1.064516129032258,0.04485301852605202,564,"That's funny, I always saw you more as a sheep."
4321,0,2,29,31,1.064516129032258,0.04485301852605202,564,Are you Wiseman?
4321,0,2,29,31,1.064516129032258,0.04485301852605202,564,They'll be singing 'Hoo Are You' on America's Got Talent.
4321,0,2,29,31,1.064516129032258,0.04485301852605202,564,I'll have to consult hoo's hoo.
4321,0,2,29,31,1.064516129032258,0.04485301852605202,564,"You ordered ""hooters"", right?"
4321,0,2,29,31,1.064516129032258,0.04485301852605202,564,"Ow! Actually, stupidity is the only first impression you give."
4321,0,2,29,31,1.064516129032258,0.04485301852605202,564,"So, this is your first time on the night shift?"
4321,0,2,29,31,1.064516129032258,0.04485301852605202,564,"The pussycats have shipped, but the pea green boats are still backordered."
4321,0,2,29,31,1.064516129032258,0.04485301852605202,564,I know that you see everything and I came to tell you that I don't give a hoot!
4321,0,2,29,31,1.064516129032258,0.04485301852605202,564,"Yes, I am silly. But my consultants are all very wise."
4321,0,2,29,31,1.064516129032258,0.04485301852605202,564,Which one shall I bring to Athens?
4321,0,2,29,31,1.064516129032258,0.04485301852605202,564,Meet my brain trust
4321,0,2,29,31,1.064516129032258,0.04485301852605202,564,The pigeons were banned by the government.
4321,0,2,29,31,1.064516129032258,0.04485301852605202,564,Isn't this a hoot?
4321,0,2,29,31,1.064516129032258,0.04485301852605202,564,"You could just set a mouse trap, you know."
4321,0,2,29,31,1.064516129032258,0.04485301852605202,564,Small rodents are just no longer an issue around here.
4321,0,2,29,31,1.064516129032258,0.04485301852605202,564,"Yes, George, I know you want a raise for working late-nights, but this is a little over the top."
4321,0,2,29,31,1.064516129032258,0.04485301852605202,564,"I'd like to buy an owl, Pat."
4321,0,2,29,31,1.064516129032258,0.04485301852605202,564,It just seems a little unfair that the 'pets at work' policy only applies to dogs.
4321,0,2,29,31,1.064516129032258,0.04485301852605202,564,I told you that I don't give a hoot.
4321,0,2,29,31,1.064516129032258,0.04485301852605202,564,"Oh no, not more Harry Potter spam!?"
4321,0,2,29,31,1.064516129032258,0.04485301852605202,564,It's a tootsie pop experiment
4321,0,2,29,31,1.064516129032258,0.04485301852605202,564,"I'm doing due diligence, okay?"
4321,0,2,29,31,1.064516129032258,0.04485301852605202,564,You are making us all crazy with these early morning Hoots!
4321,0,2,29,31,1.064516129032258,0.04485301852605202,564,The idea of a mouse trap gives me the creeps.
4321,0,2,29,31,1.064516129032258,0.04485301852605202,564,"I am still awaiting the report I requested on owls, Ms. Jenkins!"
4321,0,2,29,31,1.064516129032258,0.04485301852605202,564,Agnes can you get J.K. Rowling on the phone?
4321,0,2,29,31,1.064516129032258,0.04485301852605202,564,Free shipping...and the ninth was just one penny.
4321,0,2,29,31,1.064516129032258,0.04485301852605202,564,Al Gore said they're your problem now.
4321,0,2,29,31,1.064516129032258,0.04485301852605202,564,"Ah, shit, Beth. I only wanted one!"
4321,0,2,29,31,1.064516129032258,0.04485301852605202,564,We fired the reference librarian last week.
4321,0,2,29,31,1.064516129032258,0.04485301852605202,564,So you think you 're smart eh?
4321,0,2,29,31,1.064516129032258,0.04485301852605202,564,I really think it's time to restructure the Board of Directors.
4321,0,2,29,31,1.064516129032258,0.04485301852605202,564,And the boss said I don't give a hoot about progress.
4321,0,2,29,31,1.064516129032258,0.04485301852605202,564,Microdosing Mondays are so much better than funny hat Fridays
4321,0,2,29,31,1.064516129032258,0.04485301852605202,564,The janitorial staff is threatening to quit if you don't upgrade the messenger service.
4321,0,2,29,31,1.064516129032258,0.04485301852605202,564,"For lunch we'll have a cheeseburger, fries, coffee and nine plump mice."
4321,0,2,29,31,1.064516129032258,0.04485301852605202,564,We are smart enough to see all angles of view.
4321,0,2,29,31,1.064516129032258,0.04485301852605202,564,Okay. I'll work the night shift.
4321,0,2,29,31,1.064516129032258,0.04485301852605202,564,Unlike other executives at this firm I give a hoot.
4321,0,2,29,31,1.064516129032258,0.04485301852605202,564,Welcome to the Department of Symbolism. Please take an owl and begin interpretation.
4321,0,2,29,31,1.064516129032258,0.04485301852605202,564,You're a wizard Harry!
4321,0,2,29,31,1.064516129032258,0.04485301852605202,564,Watch my head turn 180.
4321,0,2,29,31,1.064516129032258,0.04485301852605202,564,We match you up with a who's who of horned singles.
4321,0,2,29,31,1.064516129032258,0.04485301852605202,564,Owl be seeing you in all the old familiar places.
4321,0,2,29,31,1.064516129032258,0.04485301852605202,564,"Who, who, who do you love?"
4321,0,2,29,31,1.064516129032258,0.04485301852605202,564,"Well, I always wanted to be a Member of Parliament."
4321,0,2,29,31,1.064516129032258,0.04485301852605202,564,No wisecracks. Doh!
4321,0,2,29,31,1.064516129032258,0.04485301852605202,564,My wife said they've got my eyes.
4321,0,2,29,31,1.064516129032258,0.04485301852605202,564,Doctor Who
4321,0,2,29,31,1.064516129032258,0.04485301852605202,564,"Janet, we're bring a class action against Tootsie Pop. Three licks, my ass..."
4321,0,2,29,31,1.064516129032258,0.04485301852605202,564,Sigh. Totally unwise to Parliamentary procedure.
4321,0,2,29,31,1.064516129032258,0.04485301852605202,564,Whoo the hell are you?
4321,0,2,29,31,1.064516129032258,0.04485301852605202,564,I thought you didn't give a hoot about office décor.
4321,0,2,29,31,1.064516129032258,0.04485301852605202,564,I didn't want to be owl alone.
4321,0,2,29,31,1.064516129032258,0.04485301852605202,564,"What, what, what... Where, where, where... Why, why, why, why, why, why, why, why, why..."
4321,1,0,30,31,1.064516129032258,0.06451612903225803,564,Tell Ms. Hermione Granger to call off her owls- I blinked.
4321,0,2,29,31,1.064516129032258,0.04485301852605202,564,My latest restructuring plan has been met with owls of protest.
4321,0,2,29,31,1.064516129032258,0.04485301852605202,564,These guys help me generate the perfect cartoon caption!
4321,0,2,29,31,1.064516129032258,0.04485301852605202,564,"But Miss Landers, I asked if you could give us some extra 'hours' this week."
4321,0,2,29,31,1.064516129032258,0.04485301852605202,564,"Miss Smithers, please file these under ' Who gives a hoot'."
4321,0,2,29,31,1.064516129032258,0.04485301852605202,564,They echo the next Trump appointment.
4321,1,0,30,31,1.064516129032258,0.06451612903225803,564,Vox wrote an explainer about this.
4321,0,2,29,31,1.064516129032258,0.04485301852605202,564,"Sorry, your motion before this parliament does not carry."
4321,0,2,29,31,1.064516129032258,0.04485301852605202,564,"With vision, perseverance, and a great set of hooters, this office could be yours!"
4321,0,2,29,31,1.064516129032258,0.04485301852605202,564,They're encrypted
4321,0,2,29,31,1.064516129032258,0.04485301852605202,564,Buzz me when you come up with the replacement for the Two Turtle Doves.
4321,0,2,29,31,1.064516129032258,0.04485301852605202,564,"Welcome to Hooters, ager 65 and over."
4321,0,2,29,31,1.064516129032258,0.04485301852605202,564,"No, what I said was, ""The price of oil is bound to go up so let's invest all we can."""
4321,0,2,29,31,1.064516129032258,0.04485301852605202,564,They help me convince corporate I still give a hoot.
4321,0,2,29,31,1.064516129032258,0.04485301852605202,564,I am going to need an assistant if you expect me to clean your desk every hour.
4321,0,2,29,31,1.064516129032258,0.04485301852605202,564,"Edna. I don't give a hoot,hoot,hoot, hoot.hoot,hoot,hoot, hoot or hoot. You are still working Easter."
4321,0,2,29,31,1.064516129032258,0.04485301852605202,564,The IRS will never believe that they are your dependents. Perhaps you should have chosen bald eagles instead.
4321,0,2,29,31,1.064516129032258,0.04485301852605202,564,You heard him. Three licks.
4321,0,2,29,31,1.064516129032258,0.04485301852605202,564,What makes you think I give a hoot about your problem?
4321,0,2,29,31,1.064516129032258,0.04485301852605202,564,You've made some smart choices for the new board of directors.
4321,0,2,29,31,1.064516129032258,0.04485301852605202,564,I'm here to apply for the hoot n' nanny job
4321,0,2,29,31,1.064516129032258,0.04485301852605202,564,"I tried to warn you, Greg. The memos are not what they seem."
4321,0,2,29,31,1.064516129032258,0.04485301852605202,564,We're looking for a few good pussycats.
4321,0,2,29,31,1.064516129032258,0.04485301852605202,564,"OK, so your feeling owly today, I get it!"
4321,0,2,29,31,1.064516129032258,0.04485301852605202,564,"Sir, you are aware that the company credit card is not authorized to be used for Hooters, right?"
4321,0,2,29,31,1.064516129032258,0.04485301852605202,564,Who did this?
4321,0,2,29,31,1.064516129032258,0.04485301852605202,564,well.... what exactly were you expecting post apocalypse?
4321,0,2,29,31,1.064516129032258,0.04485301852605202,564,"Tom, you have a call from a Mr. Jones on line 1."" ""Who?"
4321,0,2,29,31,1.064516129032258,0.04485301852605202,564,The ad said they scare away salesmen.
4321,0,2,29,31,1.064516129032258,0.04485301852605202,564,"I know I haven't got much work done this week, but you have to admit the office is finally free of mice."
4321,0,2,29,31,1.064516129032258,0.04485301852605202,564,I just brought them back from Asia.
4321,0,2,29,31,1.064516129032258,0.04485301852605202,564,"But, I thought I had an appointment with Dr. Who !"
4321,0,2,29,31,1.064516129032258,0.04485301852605202,564,A man outside was given this address for Hooters.
4321,0,2,29,31,1.064516129032258,0.04485301852605202,564,It proves I give a hoot.
4321,0,2,29,31,1.064516129032258,0.04485301852605202,564,Now that's a hoot !
4321,0,2,29,31,1.064516129032258,0.04485301852605202,564,"Please call them and explain this is Hogue and Wertz, a Professional Corporation, not a Wizarding Academy."
4321,0,2,29,31,1.064516129032258,0.04485301852605202,564,I see you really do give a hoot
4321,0,2,29,31,1.064516129032258,0.04485301852605202,564,Rehearsal for a hootenanny.
4321,0,2,29,31,1.064516129032258,0.04485301852605202,564,"I got them to look wise along with the mustache and glasses, but I still don't get listened too?"
4321,0,2,29,31,1.064516129032258,0.04485301852605202,564,"Ms. Johnson, can you stow these somewhere until my Order Of the Owls meeting tonight?"
4321,0,2,29,31,1.064516129032258,0.04485301852605202,564,Do you have anything in a parrot?
4321,0,2,29,31,1.064516129032258,0.04485301852605202,564,Whom shall I say is calling?
4321,0,2,29,31,1.064516129032258,0.04485301852605202,564,We had to let the nightwatchman go.
4321,0,2,29,31,1.064516129032258,0.04485301852605202,564,Stuff it!
4321,0,2,29,31,1.064516129032258,0.04485301852605202,564,"'Hoos' on your desk, George."
4321,0,2,29,31,1.064516129032258,0.04485301852605202,564,I'm looking for guidance.
4321,0,2,29,31,1.064516129032258,0.04485301852605202,564,They said hooters was already trademarked.
4321,0,2,29,31,1.064516129032258,0.04485301852605202,564,I'm stuck here and nobody gives a hoot.
4321,0,2,29,31,1.064516129032258,0.04485301852605202,564,"I am relatively certain, Miss Trimble, that this office is now mouse free."
4321,0,2,29,31,1.064516129032258,0.04485301852605202,564,I really don't think that will keep managers away from your desk
4321,0,2,29,31,1.064516129032258,0.04485301852605202,564,Alright already you made your point- you don't give a hoot!
4321,0,2,29,31,1.064516129032258,0.04485301852605202,564,No interruptions Mrs May. Parliament is now in session.
4321,0,2,29,31,1.064516129032258,0.04485301852605202,564,Owl need to see some ID
4321,0,2,29,31,1.064516129032258,0.04485301852605202,564,"No Gladys, actually I don't give a hoot."
4321,0,2,29,31,1.064516129032258,0.04485301852605202,564,We're long on owls.
4321,0,2,29,31,1.064516129032258,0.04485301852605202,564,I couldn't find any yes men so I'm surrounding myself with who birds.
4321,0,2,29,31,1.064516129032258,0.04485301852605202,564,My report is owlmost finished.
4321,0,2,29,31,1.064516129032258,0.04485301852605202,564,"I can't blame any one thing for this...It was tequila, insomnia, home shopping network.. and yeah, Trump..."
4321,0,2,29,31,1.064516129032258,0.04485301852605202,564,Who's on line one.
4321,0,2,29,31,1.064516129032258,0.04485301852605202,564,"Miss Parks, my feathered friends have no desire to, as you so eloquently put it, 'strut their stuff' in the store window today. Call the pigeons."
4321,0,2,29,31,1.064516129032258,0.04485301852605202,564,Too many typos lately...I want to have a fresh pair of eyes handy.
4321,0,2,29,31,1.064516129032258,0.04485301852605202,564,Dispatching the Hogwarts acceptance letters is not as glamorous as one might think.
4321,0,2,29,31,1.064516129032258,0.04485301852605202,564,I never give a hoot
4321,0,2,29,31,1.064516129032258,0.04485301852605202,564,"Jenny, where did owl my supplies go?"
4321,0,2,29,31,1.064516129032258,0.04485301852605202,564,You might want to lay down some newspaper.
4321,0,2,29,31,1.064516129032258,0.04485301852605202,564,"Forget about lenses, Irene. These guys range from .25 to 37.0."
4321,0,2,29,31,1.064516129032258,0.04485301852605202,564,They heard the early bird gets the worm!!
4321,0,2,29,31,1.064516129032258,0.04485301852605202,564,I was so frustrated by the election I decided to create my own Parliament.
4321,1,0,30,31,1.064516129032258,0.06451612903225803,564,Whoo? Whoo? Whoo? Whoo? Whoo? Whoo? Whoo? Whoo? Whoooo? Are you here to see?
4321,0,2,29,31,1.064516129032258,0.04485301852605202,564,Welcome to the new Hooters. We think you'll fit in nicely.
4321,1,0,30,31,1.064516129032258,0.06451612903225803,564,"Please don't bring them into the meeting room again,"
4321,0,2,29,31,1.064516129032258,0.04485301852605202,564,Owl see him now
4321,0,2,29,31,1.064516129032258,0.04485301852605202,564,"I'm sorry, but none of us recognize you. Did we meet at a party, or something?"
4321,0,2,29,31,1.064516129032258,0.04485301852605202,564,"""Do you know who I am""?"
4321,0,2,29,31,1.064516129032258,0.04485301852605202,564,Is this where we apply for the hooters job ?
4321,0,2,29,31,1.064516129032258,0.04485301852605202,564,"Can't you see we're in a meeting, Ms. Detzle?!"
4321,0,2,29,31,1.064516129032258,0.04485301852605202,564,Horton heard you were looking for him?
4321,0,2,29,31,1.064516129032258,0.04485301852605202,564,"Well, the employees suggested a Who's Who, so . . ."
4321,0,2,29,31,1.064516129032258,0.04485301852605202,564,"In hindsight, Hogwarts was probably a poor choice for our company's name."
4321,0,2,29,31,1.064516129032258,0.04485301852605202,564,May I ASK YOUR EXPERIENCE WITH A WISE GUY?
4321,0,2,29,31,1.064516129032258,0.04485301852605202,564,I'm guessing you don't think this is a hoot.
4321,0,2,29,31,1.064516129032258,0.04485301852605202,564,Whaddya mean? You don't give a hoot.
4321,1,0,30,31,1.064516129032258,0.06451612903225803,564,My owlbox is overflowing.
4321,0,2,29,31,1.064516129032258,0.04485301852605202,564,it is who you know....
4321,0,2,29,31,1.064516129032258,0.04485301852605202,564,it's ultimately all the same: you have no option
4321,0,2,29,31,1.064516129032258,0.04485301852605202,564,Owl just come back later...
4321,0,2,29,31,1.064516129032258,0.04485301852605202,564,Their lunch just slithered into reception.
4321,0,2,29,31,1.064516129032258,0.04485301852605202,564,Guess who is in charge?
4321,0,2,29,31,1.064516129032258,0.04485301852605202,564,It’s just my subtle way of saying you should wise-up and give me that raise.
4321,0,2,29,31,1.064516129032258,0.04485301852605202,564,I have to admit that I have a phobia about mice.
4321,0,2,29,31,1.064516129032258,0.04485301852605202,564,Do they think it wise if I ask for a raise?
4321,1,0,30,31,1.064516129032258,0.06451612903225803,564,Whooo's eyes does she claim were. Staring at her breasts?
4321,0,2,29,31,1.064516129032258,0.04485301852605202,564,...are you?
4321,0,2,29,31,1.064516129032258,0.04485301852605202,564,I never thought I'd say this but nice hooters.
4321,0,2,29,31,1.064516129032258,0.04485301852605202,564,Please pull all the files on drones.
4321,0,2,29,31,1.064516129032258,0.04485301852605202,564,"Quite frankly my dear, I don't give a hoot."
4321,0,2,29,31,1.064516129032258,0.04485301852605202,564,'you left the windows open again.'
4321,0,2,29,31,1.064516129032258,0.04485301852605202,564,Men in power don't give a hoot.
4321,0,2,29,31,1.064516129032258,0.04485301852605202,564,"You came to me for wisdom, right?"
4321,0,2,29,31,1.064516129032258,0.04485301852605202,564,Whoooo do you wish to see?
4321,0,2,29,31,1.064516129032258,0.04485301852605202,564,This beta version of Hootsuite can manage our social media and small rodent networks.
4321,0,2,29,31,1.064516129032258,0.04485301852605202,564,"We gotta uncover our corporate spy, so I'm posting these all around so our people remember the question of the week: ""WHOOO!"""
4321,0,2,29,31,1.064516129032258,0.04485301852605202,564,"It's shift change, could you please get the night sticks."
4321,0,2,29,31,1.064516129032258,0.04485301852605202,564,"What have you become, Harry Potter?"
4321,0,2,29,31,1.064516129032258,0.04485301852605202,564,Who's on First-Class?
4321,0,2,29,31,1.064516129032258,0.04485301852605202,564,I'm from HR. Employees are complaining that your stare is creating a hostile working environment.
4321,0,2,29,31,1.064516129032258,0.04485301852605202,564,Owl's well that ends well.
4321,0,2,29,31,1.064516129032258,0.04485301852605202,564,"I'm glad I didn't say, ""I don't give a rat's patoot""!"
4321,0,2,29,31,1.064516129032258,0.04485301852605202,564,"I'll need pens, graph paper and three dozen wood mice."
4321,0,2,29,31,1.064516129032258,0.04485301852605202,564,They're made in Japan...ask a question and you'll get the same 9 answers.
4321,0,2,29,31,1.064516129032258,0.04485301852605202,564,"See, this is what I meant when I said there are a bunch of hooters on my table."
4321,0,2,29,31,1.064516129032258,0.04485301852605202,564,Didn't I say towels?
4321,0,2,29,31,1.064516129032258,0.04485301852605202,564,"Yeah, well, who asked you?"
4321,0,2,29,31,1.064516129032258,0.04485301852605202,564,"No, I will NOT work late tonight. As you can see, I am a NINE owl, not a night owl."
4321,0,2,29,31,1.064516129032258,0.04485301852605202,564,Owl can we help you?
4321,0,2,29,31,1.064516129032258,0.04485301852605202,564,"""Ow' ll come back later"
4321,0,2,29,31,1.064516129032258,0.04485301852605202,564,"I know sometimes I don't show it, Mrs. Bigly, but, well, I do give a hoot."
4321,0,2,29,31,1.064516129032258,0.04485301852605202,564,"Mr. Perkins, Please don't keep asking me the identity of the person in reception."
4321,0,2,29,31,1.064516129032258,0.04485301852605202,564,"Data security is far superior to e-mail, and apprentice wizards earn a fraction of what we used to pay MBAs."
4321,0,2,29,31,1.064516129032258,0.04485301852605202,564,HR sent them. At least these guys will give a hoot.
4321,0,2,29,31,1.064516129032258,0.04485301852605202,564,"Oh no, Mr. Murray. The client wants nine reasonable ""bids."""
4321,0,2,29,31,1.064516129032258,0.04485301852605202,564,Hooters catering again?
4321,0,2,29,31,1.064516129032258,0.04485301852605202,564,I love take a pet to work day.
4321,0,2,29,31,1.064516129032258,0.04485301852605202,564,Who did you say is here?
4321,1,0,30,31,1.064516129032258,0.06451612903225803,564,"The question,miss smith,is not what,but rather hoo?"
4321,0,2,29,31,1.064516129032258,0.04485301852605202,564,"""Contrary to what it may seem, I really don't give a hoot."
4321,0,2,29,31,1.064516129032258,0.04485301852605202,564,Your job isn't for the birds
4321,0,2,29,31,1.064516129032258,0.04485301852605202,564,"Yes... I meant ""whom"" sir."
4321,0,2,29,31,1.064516129032258,0.04485301852605202,564,I can give you the owls with one life each or a cat that doesn't give a hoot.
4321,0,2,29,31,1.064516129032258,0.04485301852605202,564,You should have seen my desk after Taco Friday.
4321,0,2,29,31,1.064516129032258,0.04485301852605202,564,"When I said, 'Let's have a hootin' good time,' this isn't what I had in mind."
4321,0,2,29,31,1.064516129032258,0.04485301852605202,564,I'll give a hoot if you take one.
4321,0,2,29,31,1.064516129032258,0.04485301852605202,564,I'm a bureaucrat. This is how I gather wisdom.
4321,0,2,29,31,1.064516129032258,0.04485301852605202,564,"Yes, Mr. Barnacle, they seem surprisingly alert for this time of day."
4321,0,2,29,31,1.064516129032258,0.04485301852605202,564,I ordered delivery from Hooters
4321,0,2,29,31,1.064516129032258,0.04485301852605202,564,They can't say I don't give a hoot anymore.
4321,0,2,29,31,1.064516129032258,0.04485301852605202,564,"Sorry, but I don't give a hoot."
4321,1,0,30,31,1.064516129032258,0.06451612903225803,564,Now that it's out in the open we don't give a hoot what you think.
4321,0,2,29,31,1.064516129032258,0.04485301852605202,564,"I don't give a flying hoot, the overnight watch is not the best solution to our little 4 legged prowlers."
4321,0,2,29,31,1.064516129032258,0.04485301852605202,564,And they keep the mice down.
4321,0,2,29,31,1.064516129032258,0.04485301852605202,564,"Yes I would agree, this is bazzar"
4321,0,2,29,31,1.064516129032258,0.04485301852605202,564,The only problem is that they sometimes scratch the desk.
4321,0,2,29,31,1.064516129032258,0.04485301852605202,564,How do you feel about our work culture?
4321,0,2,29,31,1.064516129032258,0.04485301852605202,564,"Ah, Will=owl you guarantee my night vision improves more than with prescription eyeglasses"
4321,0,2,29,31,1.064516129032258,0.04485301852605202,564,"Sure, I can call you Betty."
4321,0,2,29,31,1.064516129032258,0.04485301852605202,564,Meet the Temple baseball team.
4321,0,2,29,31,1.064516129032258,0.04485301852605202,564,"The employee's decisions are not ""flying"" so I thought I might give you a little help."
4321,0,2,29,31,1.064516129032258,0.04485301852605202,564,"As the editor in chief, I wish to formally complain that not one of them says ""whom-whom."""
4321,1,0,30,31,1.064516129032258,0.06451612903225803,564,In order to succeed you must five a hoot.
4321,0,2,29,31,1.064516129032258,0.04485301852605202,564,Get with the times. Fish tanks are out.
4321,0,2,29,31,1.064516129032258,0.04485301852605202,564,So WHOOO among them was the whistleblower??
4321,0,2,29,31,1.064516129032258,0.04485301852605202,564,Send in Horton.
4321,1,0,30,31,1.064516129032258,0.06451612903225803,564,Are you the trader who cornered the hootie owl market?
4321,1,0,30,31,1.064516129032258,0.06451612903225803,564,What's Hogwarts on about this time?
4321,0,2,29,31,1.064516129032258,0.04485301852605202,564,This is the last time we recruit at Hogwarts' career fair.
4321,0,2,29,31,1.064516129032258,0.04485301852605202,564,Do you dare still doubt the wisdom in the decisions coming from this office?
4321,0,2,29,31,1.064516129032258,0.04485301852605202,564,Dr. Hu is here to see you.
4321,0,2,29,31,1.064516129032258,0.04485301852605202,564,"In this case, wishing to speak to Who is grammatically correct."
4321,0,2,29,31,1.064516129032258,0.04485301852605202,564,"Well, the mice are all gone..... What now?"
4321,0,2,29,31,1.064516129032258,0.04485301852605202,564,"""Christ, more owls!,"" thought Mrs. Fletcher."
4321,0,2,29,31,1.064516129032258,0.04485301852605202,564,Mr. Popper's Owls?
4321,0,2,29,31,1.064516129032258,0.04485301852605202,564,Management is asking for ideas that lower night security costs.
4321,0,2,29,31,1.064516129032258,0.04485301852605202,564,"Sorry, but I've got alot on my desk right now."
4321,0,2,29,31,1.064516129032258,0.04485301852605202,564,"Yes, Ms. Jenkins, these will do. These will do juuuuuust fine."
4321,0,2,29,31,1.064516129032258,0.04485301852605202,564,I've been nominated for Who's Whoo.
4321,0,2,29,31,1.064516129032258,0.04485301852605202,564,"""Miss Simpson, please escort our new wait staff hires to personnel."" In a bold move, Hooters Restaurant decides to re-market themselves to a decidedly eco-friendly clientele."
4321,0,2,29,31,1.064516129032258,0.04485301852605202,564,My computer broke down.
4321,0,2,29,31,1.064516129032258,0.04485301852605202,564,"Miss Peabody, I suggest you leave early this evening. Come dusk, these babies will be airborne."
4321,0,2,29,31,1.064516129032258,0.04485301852605202,564,"No, they haven't 'just sold cookies' for years."
4321,0,2,29,31,1.064516129032258,0.04485301852605202,564,"I must say, Frank, that you are definitely doing an owl-standing job."
4321,0,2,29,31,1.064516129032258,0.04485301852605202,564,Whooo are they?
4321,0,2,29,31,1.064516129032258,0.04485301852605202,564,"Don't tell Trump, but Owler's the new thing"
4321,0,2,29,31,1.064516129032258,0.04485301852605202,564,I have a meeting later with my editor on whom vs. who.
4321,0,2,29,31,1.064516129032258,0.04485301852605202,564,Some wisenheimer left these for you.
4321,0,2,29,31,1.064516129032258,0.04485301852605202,564,I'm wise beyond my years.
4321,0,2,29,31,1.064516129032258,0.04485301852605202,564,How many dependents did you say I claimed again?
4321,0,2,29,31,1.064516129032258,0.04485301852605202,564,I always wanted to be Keith Moon.
4321,0,2,29,31,1.064516129032258,0.04485301852605202,564,They all got to the final auditions for Harry Potter messenger owls
4321,0,2,29,31,1.064516129032258,0.04485301852605202,564,Why is the night shift on strike?
4321,0,2,29,31,1.064516129032258,0.04485301852605202,564,"Our new Twitter department are really gonna turn some heads, don't you think?"
4321,0,2,29,31,1.064516129032258,0.04485301852605202,564,They'll be a great addition to the security team.
4321,0,2,29,31,1.064516129032258,0.04485301852605202,564,I've decided to start giving a hoot.
4321,0,2,29,31,1.064516129032258,0.04485301852605202,564,"No, Margaret, I don't do online dating."
4321,0,2,29,31,1.064516129032258,0.04485301852605202,564,"You can see, I really do give a hoot."
4321,0,2,29,31,1.064516129032258,0.04485301852605202,564,"Sir, the board recommended ten owls and there are only nine."
4321,0,2,29,31,1.064516129032258,0.04485301852605202,564,I hope you're fully convinced of my proficiency in Hootsuite.
4321,0,2,29,31,1.064516129032258,0.04485301852605202,564,Do you happen to have any moist owlettes laying around? There seems to be a coffee disaster in the break room.
4321,0,2,29,31,1.064516129032258,0.04485301852605202,564,I'll just need you to start tidying up after the night shift.
4321,0,2,29,31,1.064516129032258,0.04485301852605202,564,Please stop asking me who-who?
4321,0,2,29,31,1.064516129032258,0.04485301852605202,564,Don't they make me look wise?
4321,0,2,29,31,1.064516129032258,0.04485301852605202,564,I was tired of people saying I didn't give a hoot.
4321,0,2,29,31,1.064516129032258,0.04485301852605202,564,I don't give a hoot what they say!
4321,0,2,29,31,1.064516129032258,0.04485301852605202,564,I overestimated the demand for wisdom in 2017.
4321,0,2,29,31,1.064516129032258,0.04485301852605202,564,"I said that the office needs paper towels, not owls."
4321,0,2,29,31,1.064516129032258,0.04485301852605202,564,"Lois, I said, make sure ALL staff come to the meeting."
4321,0,2,29,31,1.064516129032258,0.04485301852605202,564,"They do make you look wiser, but who needs a Reference librarian when you can look it up yourself on Google?"
4321,0,2,29,31,1.064516129032258,0.04485301852605202,564,*scOWLS*
4321,0,2,29,31,1.064516129032258,0.04485301852605202,564,"I believe Mr. Plimpton was urging us to generate collective wisdom, not collected wisdom."
4321,0,2,29,31,1.064516129032258,0.04485301852605202,564,The fact that they can see in the dark and rotate their heads 270 degrees is impressive but I'm not how that will benefit the accounting department.
4321,0,2,29,31,1.064516129032258,0.04485301852605202,564,It's not the where or the when or the why. It is the whoo.
4321,0,2,29,31,1.064516129032258,0.04485301852605202,564,Tell him owl be right there.
4321,0,2,29,31,1.064516129032258,0.04485301852605202,564,"No, no, this is the second floor Harry Potter Hogwarts desk, Abbott and Costello is on first."
4321,0,2,29,31,1.064516129032258,0.04485301852605202,564,"Miss McGonagall, this is the 21st century and it’s time that Hogwarts School started to use email."
4321,0,2,29,31,1.064516129032258,0.04485301852605202,564,I'm here for the counting job.
4321,0,2,29,31,1.064516129032258,0.04485301852605202,564,This isn't what I had in mind when I said we need to clean up our rodent problem.
4321,0,2,29,31,1.064516129032258,0.04485301852605202,564,"Frankly Scarlet, I just wanted to make it very clear that I don't give a hoot!"
4321,0,2,29,31,1.064516129032258,0.04485301852605202,564,Whooo are yoooo???
4321,0,2,29,31,1.064516129032258,0.04485301852605202,564,"Well, I certainly don't give a hoot."
4321,0,2,29,31,1.064516129032258,0.04485301852605202,564,"Yes, this is where you check your owl."
4321,0,2,29,31,1.064516129032258,0.04485301852605202,564,"They're our receptionists-in-training. Now, whooom did you want to see?"
4321,0,2,29,31,1.064516129032258,0.04485301852605202,564,We pride ourself on being a bird of a different feather.
4321,0,2,29,31,1.064516129032258,0.04485301852605202,564,"I was advised to surround myself with wise old owls, but so far, I'm unimpressed."
4321,0,2,29,31,1.064516129032258,0.04485301852605202,564,Careful - owl be watching you.
4321,0,2,29,31,1.064516129032258,0.04485301852605202,564,"Puckford, this is not what I meant when I asked you to keep an eye on things."
4321,0,2,29,31,1.064516129032258,0.04485301852605202,564,I tried to talk to human resources about this but they said it's out of their jurisdiction.
4321,0,2,29,31,1.064516129032258,0.04485301852605202,564,I'm self branding.Wise man or Hoot?
4321,0,2,29,31,1.064516129032258,0.04485301852605202,564,They say I'm a hoot
4321,0,2,29,31,1.064516129032258,0.04485301852605202,564,"Oh, Mr. Simpson, you are a wise, wise man!"
4321,0,2,29,31,1.064516129032258,0.04485301852605202,564,"I don't give a hoot what you think is proper office etiquette, Helen."
4321,0,2,29,31,1.064516129032258,0.04485301852605202,564,"This isn't scaring me, Harold."
4321,0,2,29,31,1.064516129032258,0.04485301852605202,564,My computer is being repaired.
4321,0,2,29,31,1.064516129032258,0.04485301852605202,564,That is not what they mean by artificial intelligence
4321,0,2,29,31,1.064516129032258,0.04485301852605202,564,"All right, I'll reply to Rowling's messages..."
4321,0,2,29,31,1.064516129032258,0.04485301852605202,564,"I'm sorry, George, but we no longer need a parliamentarian."
4321,0,2,29,31,1.064516129032258,0.04485301852605202,564,Hoo said no pets allowed?
4321,0,2,29,31,1.064516129032258,0.04485301852605202,564,"OK, you've proved you give a hoot !"
4321,0,2,29,31,1.064516129032258,0.04485301852605202,564,Let's just say we no longer have a problem with mice.
4321,0,2,29,31,1.064516129032258,0.04485301852605202,564,Are these the who's whose I've heard so much about?
4321,0,2,29,31,1.064516129032258,0.04485301852605202,564,"This isn't what I meant when I said, ""Let's have 'Hooters' for lunch""."
4321,0,2,29,31,1.064516129032258,0.04485301852605202,564,Owl eyes are on you.
4321,0,2,29,31,1.064516129032258,0.04485301852605202,564,"Step back quietly, Bunny."
4321,0,2,29,31,1.064516129032258,0.04485301852605202,564,"Ms. Smithers, I am eating lunch at my desk today, if you'd like to join me."
4321,0,2,29,31,1.064516129032258,0.04485301852605202,564,All of these owls and we're still no closer to determining just how many licks it actually takes.
4321,0,2,29,31,1.064516129032258,0.04485301852605202,564,They're more cost effective for tovernight deliveries.
4321,0,2,29,31,1.064516129032258,0.04485301852605202,564,Nancy quickly learned that Joe didn't give a hoot.
4321,0,2,29,31,1.064516129032258,0.04485301852605202,564,I'm boning up on parliamentary procedure before the next board meeting.
4321,0,2,29,31,1.064516129032258,0.04485301852605202,564,I recently quit caffeine.
4321,0,2,29,31,1.064516129032258,0.04485301852605202,564,"Come on, ask me. After all these years, I think we finally figured out the answer. Ask me: How many licks does it take to get to the center of a Tootsie Roll Pop?"
4321,0,2,29,31,1.064516129032258,0.04485301852605202,564,Whoooo did you say you were to see?
4321,0,2,29,31,1.064516129032258,0.04485301852605202,564,Who cooks for you? Who cooks for you all?
4321,0,2,29,31,1.064516129032258,0.04485301852605202,564,Is Harry Potter still interning here?
4321,1,0,30,31,1.064516129032258,0.06451612903225803,564,You let the Mary Kay lady in IT sell her stuff.
4321,0,2,29,31,1.064516129032258,0.04485301852605202,564,Say goodbye to our old email server.
4321,0,2,29,31,1.064516129032258,0.04485301852605202,564,No ma'am. I said I'd like a dust towel for the office.
4321,0,2,29,31,1.064516129032258,0.04485301852605202,564,"It's me, that's who. Now was there something you wanted?"
4321,0,2,29,31,1.064516129032258,0.04485301852605202,564,"After the DNC emails disaster, Anthony Weiner wants us to send his d*ck pics the old-fashioned way."
4321,0,2,29,31,1.064516129032258,0.04485301852605202,564,You're such a hoot.
4321,0,2,29,31,1.064516129032258,0.04485301852605202,564,"Why, Mr. Jenkins, I thought you didn't give a hoot."
4321,0,2,29,31,1.064516129032258,0.04485301852605202,564,"""Who's responsible for this? Who? Who?"
4321,0,2,29,31,1.064516129032258,0.04485301852605202,564,"For the next couple of weeks, you're on the morning shift."
4321,0,2,29,31,1.064516129032258,0.04485301852605202,564,"Neither witty nor wise, I've brought in some consultants."
4321,0,2,29,31,1.064516129032258,0.04485301852605202,564,"Who, Who, Who says I'm not fit to continue as Chairman?"
4321,0,2,29,31,1.064516129032258,0.04485301852605202,564,It keeps the rats away.
4321,0,2,29,31,1.064516129032258,0.04485301852605202,564,"No, they won't count women for a minyan."
4321,1,0,30,31,1.064516129032258,0.06451612903225803,564,"Who, Gladys, Who?"
4321,0,2,29,31,1.064516129032258,0.04485301852605202,564,"Would you also send in: what, where, when, how, and why."
4321,0,2,29,31,1.064516129032258,0.04485301852605202,564,I can explain...
4321,0,2,29,31,1.064516129032258,0.04485301852605202,564,I know Who is behind this.
4321,0,2,29,31,1.064516129032258,0.04485301852605202,564,I'm making my case for a bigger desk.
4321,0,2,29,31,1.064516129032258,0.04485301852605202,564,"Sure, Bill, I'll tell them you don't give a hoot."
4321,0,2,29,31,1.064516129032258,0.04485301852605202,564,"No. I said ""Hugh"" not ""Who"". Who said ""Who""?"
4321,0,2,29,31,1.064516129032258,0.04485301852605202,564,"It would seem to be a wise decision, sir."
4321,0,2,29,31,1.064516129032258,0.04485301852605202,564,May 2017: endless academic ennui
4321,0,2,29,31,1.064516129032258,0.04485301852605202,564,I can't take it Mr. Carstairs.........I don't know Whoooo?
4321,0,2,29,31,1.064516129032258,0.04485301852605202,564,Do you have any more Tootsie Pops?
4321,0,2,29,31,1.064516129032258,0.04485301852605202,564,"Yes, I spent the weekend. Parliamentary procedure requires a motion to recess."
4321,0,2,29,31,1.064516129032258,0.04485301852605202,564,"Cipherus Judge Tax Preparation Services for the Magically Employed: ""Janet, I've just heard from Hogwarts and they're wondering where their tax returns are!"""
4321,0,2,29,31,1.064516129032258,0.04485301852605202,564,I'm simply too impatient to raise giraffes.
4321,0,2,29,31,1.064516129032258,0.04485301852605202,564,"sir,your employes don't give a hoot about you"
4321,1,0,30,31,1.064516129032258,0.06451612903225803,564,"Hoo, me?"
4321,0,2,29,31,1.064516129032258,0.04485301852605202,564,"Miss Pierson, when I asked you to order White Owls I meant the cigar not the bird !"
4321,0,2,29,31,1.064516129032258,0.04485301852605202,564,"As you can see, the board is unanimous."
4321,0,2,29,31,1.064516129032258,0.04485301852605202,564,Our mouse problem is over.
4321,0,2,29,31,1.064516129032258,0.04485301852605202,564,The focus group voted 9-0 for this caption.
4321,0,2,29,31,1.064516129032258,0.04485301852605202,564,"Can we move past the ""Who?"" to the ""What, Where, When and Why?"""
4321,0,2,29,31,1.064516129032258,0.04485301852605202,564,"He: ""No, no, no! I said bring me a towel, not eight owls."" She: ""Use the extra owl as your towel."""
4321,0,2,29,31,1.064516129032258,0.04485301852605202,564,We are off to a board meeting. Please clean up the desk.
4321,0,2,29,31,1.064516129032258,0.04485301852605202,564,"Huh, ‘wisdom’, so I thought I’d get a desk full of them"
4321,0,2,29,31,1.064516129032258,0.04485301852605202,564,I personally don't give a hoot.
4665,0,2,30,32,1.0625,0.04347552147751577,564,When we switched to the new message system I thought they would send the cages first too.
4665,0,2,30,32,1.0625,0.04347552147751577,564,Being an smart as an owl isn't good enough for me.
4665,1,0,31,32,1.0625,0.0625,564,"I know you wanted a cat to deal with the mice, but these owls actually have nine lives!"
4665,0,2,30,32,1.0625,0.04347552147751577,564,It's a wise guise convention.
4665,0,2,30,32,1.0625,0.04347552147751577,564,Groupon was offering deeply discounted stuffed owls.
4665,0,2,30,32,1.0625,0.04347552147751577,564,Is that a possum in your purse or are you just glad to see me?
4665,0,2,30,32,1.0625,0.04347552147751577,564,Owl get the report if I'm wise enough.
4665,0,2,30,32,1.0625,0.04347552147751577,564,Hootie has been confirmed by a simple majority and now the Nine Wise Owls will hear your appeal.
4665,0,2,30,32,1.0625,0.04347552147751577,564,Is this a wise Supreme Court decision?
4665,1,0,31,32,1.0625,0.0625,564,"Why would you call me a night owl Mrs. Phillips, why not a naturalist ?"
4665,1,0,31,32,1.0625,0.0625,564,"Are you, er, a mouse or something????????... (Written by my 7-year-old son, Leif Digre.)"
4665,0,2,30,32,1.0625,0.04347552147751577,564,I thought you said the 3-D printer would be a forward move for our company.
4665,0,2,30,32,1.0625,0.04347552147751577,564,"No, the glasses don't make you look wiser."
4665,0,2,30,32,1.0625,0.04347552147751577,564,"As money is speech, how much can they get for a United Screech?"
4665,0,2,30,32,1.0625,0.04347552147751577,564,"I'm sorry, but the tenth owl is not really free."
4680,1,0,32,33,1.0606060606060606,0.06060606060606058,564,The answer's still no wise guy
4680,0,2,31,33,1.0606060606060606,0.04218003305174255,564,"When they told me it was a 12-owl desk, I thought with 9 I'd have space for my laptop."
4680,1,0,32,33,1.0606060606060606,0.06060606060606058,564,After retiring from Hogwarts they deliver memos about leftover sandwiches in the conference room.
4680,1,0,32,33,1.0606060606060606,0.06060606060606058,564,"If they're that smart, why aren't they down in Wall Street?"
4680,0,2,31,33,1.0606060606060606,0.04218003305174255,564,"I had the choice between barn wood, and barn owl wood, now I'm thinking I should have gone with barn wood."
4680,0,2,31,33,1.0606060606060606,0.04218003305174255,564,Just tell him I don't give a hoot!
4686,0,2,32,34,1.0588235294117647,0.0409594484601642,564,Try to find out what if anything their parliament does.
4686,0,2,32,34,1.0588235294117647,0.0409594484601642,564,It was either sanctuary or deported to outer space.
4686,1,0,33,34,1.0588235294117647,0.05882352941176471,564,Are there any more out there?
4686,0,2,32,34,1.0588235294117647,0.0409594484601642,564,"Nine out of ten are wise and give a hoot, one out of ten lies and should get the boot!"
4686,1,0,33,34,1.0588235294117647,0.05882352941176471,564,Hoo stole my heart away? Hoo makes me dream all day? Hoo means my happiness? Hoo? Hoo? Hoo? Hoo? Hoo? Hoo? Hoo? Hoo?
4691,1,0,34,35,1.0571428571428572,0.05714285714285715,564,I'm afraid we don't have 10 owls today. OR Which one should I get?
4692,0,2,34,36,1.0555555555555556,0.0387184473576205,564,"Yes, Minister?"" ""Find out what's going on at Hogwarts!"
4693,0,2,35,37,1.054054054054054,0.03768738858261605,564,"Because I'm a wizard, that's why."
4694,0,2,38,40,1.05,0.03489912202260563,564,Wipe their asses every day or you're out of here.
4695,0,1,25,26,1.0384615384615385,0.03922322702763681,564,"""We don't give a hoot!"" is our new customer service slogan."
4695,0,1,25,26,1.0384615384615385,0.03922322702763681,564,"If you wear a name tag, they stop asking, ""Who?"""
4695,0,1,25,26,1.0384615384615385,0.03922322702763681,564,I told my broker to invest me in Hooters.
4695,0,1,25,26,1.0384615384615385,0.03922322702763681,564,"Ms. Ferguson, please find out who cooks for who tonight."
4695,0,1,25,26,1.0384615384615385,0.03922322702763681,564,They answer all of our employee complaint lines !
4695,0,1,25,26,1.0384615384615385,0.03922322702763681,564,"Andrew, when I said I wanted the ""collective wisdom of your colleagues"" this is not the meeting I had planned."
4695,0,1,25,26,1.0384615384615385,0.03922322702763681,564,"I asked Bill how he was doing this morning and he answered back, ""who""."
4695,0,1,25,26,1.0384615384615385,0.03922322702763681,564,"The consensus is whooo, not whom"
4695,0,1,25,26,1.0384615384615385,0.03922322702763681,564,But none of us give a hoot!
4695,0,1,25,26,1.0384615384615385,0.03922322702763681,564,What do you mean 'WHO am I?'
4695,0,1,25,26,1.0384615384615385,0.03922322702763681,564,Be sure to use the small pink slips this time.
4695,0,1,25,26,1.0384615384615385,0.03922322702763681,564,We publish hoo dunnits.
4695,0,1,25,26,1.0384615384615385,0.03922322702763681,564,"Yup, they'd certainly be wiser than his current National Security Council"
4695,0,1,25,26,1.0384615384615385,0.03922322702763681,564,"Marge, if you want to stand out in your client's mind, you have to take some risks. Did I convince him to switch suppliers? Not sure. Probably not. But ask yourself this: which meeting do you think he's gonna remember? ""Hoo"" knows, Marge."
4695,0,1,25,26,1.0384615384615385,0.03922322702763681,564,We've reached an agreement — find out who-who are top ten sales reps are and send them each a hefty field mouse bonus.
4695,0,1,25,26,1.0384615384615385,0.03922322702763681,564,What time is sunset?
4695,0,1,25,26,1.0384615384615385,0.03922322702763681,564,'Owl' see you and raise you nine.
4695,0,1,25,26,1.0384615384615385,0.03922322702763681,564,"Sir, I'm pretty sure the decorator asked for nine worn dowls."
4695,0,1,25,26,1.0384615384615385,0.03922322702763681,564,We will let you know in a day or two.
4695,0,1,25,26,1.0384615384615385,0.03922322702763681,564,I promise they won't hurt you . . . much.
4695,0,1,25,26,1.0384615384615385,0.03922322702763681,564,"Here's a hoot for every time I hollered at your gorgeous ass. I'm sorry, Stacy."
4695,0,1,25,26,1.0384615384615385,0.03922322702763681,564,It's an old building and I'm allergic to mice and cats.
4695,0,1,25,26,1.0384615384615385,0.03922322702763681,564,I hate working 3rd shift.
4695,0,1,25,26,1.0384615384615385,0.03922322702763681,564,I think it's a prank from some wise guy.
4695,0,1,25,26,1.0384615384615385,0.03922322702763681,564,"Sir I don't know either if it's to who they belong, or to whom they belong."
4695,0,1,25,26,1.0384615384615385,0.03922322702763681,564,"Let no one say we don't give a hoot in HR, Miss Dinwiddie."
4695,0,1,25,26,1.0384615384615385,0.03922322702763681,564,There was a special in Diagon Alley
4695,0,1,25,26,1.0384615384615385,0.03922322702763681,564,Owl be needing next Friday off.
4695,0,1,25,26,1.0384615384615385,0.03922322702763681,564,"Not a flock, Miss Merkel. Don't you know a parliament when you see one?"
4695,0,1,25,26,1.0384615384615385,0.03922322702763681,564,As you can see I am prepared to give a hoot.
4695,0,1,25,26,1.0384615384615385,0.03922322702763681,564,"No, madam; they will frighten away mice, but not door-to-door salespersons."
4695,0,1,25,26,1.0384615384615385,0.03922322702763681,564,You have all these eyes but still don't know who left the coffee machine on?
4695,0,1,25,26,1.0384615384615385,0.03922322702763681,564,"Sandra, I'd like to introduce you to the night shift crew."
4695,0,1,25,26,1.0384615384615385,0.03922322702763681,564,You've made your point... But I still don't give a hoot.
4695,0,1,25,26,1.0384615384615385,0.03922322702763681,564,Actually my family is from France. Why would you think I'm a Wise guy?
4695,0,1,25,26,1.0384615384615385,0.03922322702763681,564,The mice got into my candy bars.
4695,0,1,25,26,1.0384615384615385,0.03922322702763681,564,"Nine of them, Mildred, for my baseball team. Hoo's on first."
4695,0,1,25,26,1.0384615384615385,0.03922322702763681,564,"You're wise. You know it. And now you know, I know it."
4695,0,1,25,26,1.0384615384615385,0.03922322702763681,564,"Ms. Johnson, you'll find our department is a veritable Who's Who in the industry."
4695,0,1,25,26,1.0384615384615385,0.03922322702763681,564,Doctor Whoooo?
4695,0,1,25,26,1.0384615384615385,0.03922322702763681,564,"Because, Mildred; everybody but you seems to give a Hoot."
4695,0,1,25,26,1.0384615384615385,0.03922322702763681,564,Maybe your decision to hire only owls wasn't the wisest.
4695,0,1,25,26,1.0384615384615385,0.03922322702763681,564,What do you mean I don't give a hoot?
4695,0,1,25,26,1.0384615384615385,0.03922322702763681,564,"I think I found a new twist on the ""herding cats"" cliché."
4695,0,1,25,26,1.0384615384615385,0.03922322702763681,564,"From now on, Ms. Quimby, management will give a hoot!"
4695,0,1,25,26,1.0384615384615385,0.03922322702763681,564,They could use some wisdom on the Perkins account.
4695,0,1,25,26,1.0384615384615385,0.03922322702763681,564,"Well of course we are owl here -- who, hooo else were you expecting?"
4695,0,1,25,26,1.0384615384615385,0.03922322702763681,564,"How about the what, when and where?"
4695,0,1,25,26,1.0384615384615385,0.03922322702763681,564,"Well, I see Helen got the dogs in the settlement."
4695,0,1,25,26,1.0384615384615385,0.03922322702763681,564,I suppose you're wondering why I gathered you owls here.
4695,0,1,25,26,1.0384615384615385,0.03922322702763681,564,I wanted two females.
4695,0,1,25,26,1.0384615384615385,0.03922322702763681,564,It's much quieter on the dayshift.
4695,0,1,25,26,1.0384615384615385,0.03922322702763681,564,"You're right, Ms. Ibis, this job is a hoot."
4695,0,1,25,26,1.0384615384615385,0.03922322702763681,564,Not what I meant by a new pair of hooters.
4695,0,1,25,26,1.0384615384615385,0.03922322702763681,564,"I'm sorry Mrs Cranston, but we don't give a hoot about your suggestion."
4695,0,1,25,26,1.0384615384615385,0.03922322702763681,564,Owl ask you later.
4695,0,1,25,26,1.0384615384615385,0.03922322702763681,564,"Who, who, who is your taxidermist?"
4695,0,1,25,26,1.0384615384615385,0.03922322702763681,564,"Gertrude, you obviously are not getting the message: It's a hoot to work here! Repeat after me: 'Hoot!'"
4695,0,1,25,26,1.0384615384615385,0.03922322702763681,564,Tell me about a time you disagreed with a decision. What did you do?
4695,0,1,25,26,1.0384615384615385,0.03922322702763681,564,Another one of HR's bird brain ideas?
4695,0,1,25,26,1.0384615384615385,0.03922322702763681,564,"Yes, Ms. Maples, as you can see, I do give a hoot."
4695,0,1,25,26,1.0384615384615385,0.03922322702763681,564,Mice. They love mice. Take it to a good home with mice.
4695,0,1,25,26,1.0384615384615385,0.03922322702763681,564,"I said nine holes, not nibe owls!"
4695,0,1,25,26,1.0384615384615385,0.03922322702763681,564,Owl be damned if you think owl let them go.
4695,0,1,25,26,1.0384615384615385,0.03922322702763681,564,We do not think that would be wise.
4695,0,1,25,26,1.0384615384615385,0.03922322702763681,564,I'm here about the Hootenanny
4695,0,1,25,26,1.0384615384615385,0.03922322702763681,564,I believe I said owl get back to you.
4695,0,1,25,26,1.0384615384615385,0.03922322702763681,564,"You really are a night owl, aren't you!"
4695,0,1,25,26,1.0384615384615385,0.03922322702763681,564,"I resent you saying, ""I don't give a 'hoot'."""
4695,0,1,25,26,1.0384615384615385,0.03922322702763681,564,"Are these your employees, or your pets?"
4695,0,1,25,26,1.0384615384615385,0.03922322702763681,564,How should I choose? They all seem qualified
4695,0,1,25,26,1.0384615384615385,0.03922322702763681,564,I wanted to make sure you know I wasn't serious when I said I didn't give a hoot.
4695,0,1,25,26,1.0384615384615385,0.03922322702763681,564,Everyone needs an angle
4695,0,1,25,26,1.0384615384615385,0.03922322702763681,564,I'm going to need more Tootsie Pops.
4695,0,1,25,26,1.0384615384615385,0.03922322702763681,564,I saw a mouse.
4695,0,1,25,26,1.0384615384615385,0.03922322702763681,564,"I'm sorry Sir, I thought you said to offer the owly employees overtime this week."
4695,0,1,25,26,1.0384615384615385,0.03922322702763681,564,They said you wouldn't give a hoot.
4695,0,1,25,26,1.0384615384615385,0.03922322702763681,564,I do give a hoot! If fact I give 9.
4695,0,1,25,26,1.0384615384615385,0.03922322702763681,564,Do the glasses make me look smarter?
4695,0,1,25,26,1.0384615384615385,0.03922322702763681,564,I thought you didn't give a hoot?
4695,0,1,25,26,1.0384615384615385,0.03922322702763681,564,"Hoo hoo hoo hoo hoo hoo hoo hoo hoo who called, Miss Effers?"
4695,0,1,25,26,1.0384615384615385,0.03922322702763681,564,I told you I was in a parliament meeting!
4695,0,1,25,26,1.0384615384615385,0.03922322702763681,564,Hoo's Hoo?
4695,0,1,25,26,1.0384615384615385,0.03922322702763681,564,"Because I'm not the one who suggested an office building shaped like a barn, am I."
4695,0,1,25,26,1.0384615384615385,0.03922322702763681,564,I told them they could work from home
4695,0,1,25,26,1.0384615384615385,0.03922322702763681,564,You're profit doesn't always come from ordinary things.
4695,0,1,25,26,1.0384615384615385,0.03922322702763681,564,I guess owl come back later.
4695,0,1,25,26,1.0384615384615385,0.03922322702763681,564,"Once again, Brenda and Fred see right through the parliament but this time have no idea what to do about it."
4695,0,1,25,26,1.0384615384615385,0.03922322702763681,564,This is a brotherhood meeting.
4695,0,1,25,26,1.0384615384615385,0.03922322702763681,564,"O.K., Owl take one home!"
4695,0,1,25,26,1.0384615384615385,0.03922322702763681,564,Send me an owl.
4695,0,1,25,26,1.0384615384615385,0.03922322702763681,564,"Take a message, can't you see I'm in parliament ?"
4695,0,1,25,26,1.0384615384615385,0.03922322702763681,564,Who what?
4695,0,1,25,26,1.0384615384615385,0.03922322702763681,564,Who's here to see me again? Who? Who?
4695,0,1,25,26,1.0384615384615385,0.03922322702763681,564,"It's not a question of why, but who."
4695,0,1,25,26,1.0384615384615385,0.03922322702763681,564,I wanted live owls. These are Fake Whos. You're fired!
4695,0,1,25,26,1.0384615384615385,0.03922322702763681,564,The President asked that you check the Hogwarts cables for bugs.
4695,0,1,25,26,1.0384615384615385,0.03922322702763681,564,Is this the reason why they call you doctor who?
4695,0,1,25,26,1.0384615384615385,0.03922322702763681,564,There are a lot of pests around here.
4695,0,1,25,26,1.0384615384615385,0.03922322702763681,564,How do you know they give a hoot?
4695,0,1,25,26,1.0384615384615385,0.03922322702763681,564,Me! But why why why why why why why why why?
4695,0,1,25,26,1.0384615384615385,0.03922322702763681,564,I understand you give a hoot?
4695,0,1,25,26,1.0384615384615385,0.03922322702763681,564,I'm an official member of parliament.
4695,0,1,25,26,1.0384615384615385,0.03922322702763681,564,"So, you do give a hoot about my raise."
4695,0,1,25,26,1.0384615384615385,0.03922322702763681,564,O Rly? Sure I give a hoot! Pick one.
4695,0,1,25,26,1.0384615384615385,0.03922322702763681,564,Tootsie Pop is no longer testing on animals.
4695,0,1,25,26,1.0384615384615385,0.03922322702763681,564,"Mr. Jones, it's clear you don't give a hoot!"
4695,0,1,25,26,1.0384615384615385,0.03922322702763681,564,"Actually, it looks like the boss gave a lot of hoots."
4695,0,1,25,26,1.0384615384615385,0.03922322702763681,564,It's Raúl. Not Raool or Rawl or Raille. Just Raúl. Raúl.
4695,0,1,25,26,1.0384615384615385,0.03922322702763681,564,Everyone keeps asking that! The real question is WHY?
4695,0,1,25,26,1.0384615384615385,0.03922322702763681,564,I see you are having a big dinner tonight.
4695,0,1,25,26,1.0384615384615385,0.03922322702763681,564,Some people line up their ducks in a row. I line up my owls.
4695,0,1,25,26,1.0384615384615385,0.03922322702763681,564,Get rid of him. We don't give a hoot how you do it.
4695,0,1,25,26,1.0384615384615385,0.03922322702763681,564,"Anything else, sir?"" ""Owl let you know later."
4695,0,1,25,26,1.0384615384615385,0.03922322702763681,564,They appear to be working. No birds in here.
4695,0,1,25,26,1.0384615384615385,0.03922322702763681,564,"I asked for a towel Bertha, not owl!I spilled my coffee!"
4695,0,1,25,26,1.0384615384615385,0.03922322702763681,564,What makes you think I don't give a hoot?
4695,0,1,25,26,1.0384615384615385,0.03922322702763681,564,"'Guess Hoooo's next' is getting a bit tired, Ms. Smith."
4695,0,1,25,26,1.0384615384615385,0.03922322702763681,564,You need to do more than just give a hoot.
4695,0,1,25,26,1.0384615384615385,0.03922322702763681,564,Please renew my Owl of the Month Club membership.
4695,0,1,25,26,1.0384615384615385,0.03922322702763681,564,Not why. Who. Who. Who.
4695,0,1,25,26,1.0384615384615385,0.03922322702763681,564,I call it my 'wisdom shield'......
4695,0,1,25,26,1.0384615384615385,0.03922322702763681,564,Find out who the wise ass is who gifted these!
4695,0,1,25,26,1.0384615384615385,0.03922322702763681,564,Shhh. They're offering their collective wisdom.
4695,0,1,25,26,1.0384615384615385,0.03922322702763681,564,We're out of wise old men.
4695,0,1,25,26,1.0384615384615385,0.03922322702763681,564,I can call you Betty You can call me Owl.
4695,0,1,25,26,1.0384615384615385,0.03922322702763681,564,Which one of you is the accountant?
4695,0,1,25,26,1.0384615384615385,0.03922322702763681,564,You'll need to go through a test before you're accepted.
4695,0,1,25,26,1.0384615384615385,0.03922322702763681,564,Human resources. That's who.
4695,0,1,25,26,1.0384615384615385,0.03922322702763681,564,Why me over you? Some little birdies told HR who.
4695,0,1,25,26,1.0384615384615385,0.03922322702763681,564,Owls are nice. I was once married to one. Let's fly with falcons.
4695,0,1,25,26,1.0384615384615385,0.03922322702763681,564,"Good morning Phyllis! We are placing a wise owl to perch at each of your desks, please welcome them and show them the breakroom, get them set up with ID badges and please show them the restroom locations."
4695,0,1,25,26,1.0384615384615385,0.03922322702763681,564,"Yes of course, madam. We have a fine selection of hooters you may choose from right here in the shop."
4695,0,1,25,26,1.0384615384615385,0.03922322702763681,564,My daughter got accepted to Hogwarts.
4695,0,1,25,26,1.0384615384615385,0.03922322702763681,564,Their belief that I am their mother has MADE me their mother.
4695,0,1,25,26,1.0384615384615385,0.03922322702763681,564,Working here is a hoot
4695,0,1,25,26,1.0384615384615385,0.03922322702763681,564,"Give a hoot, change that suit."
4695,0,1,25,26,1.0384615384615385,0.03922322702763681,564,"Yes, Parliament is in session and your issue is next."
4695,0,1,25,26,1.0384615384615385,0.03922322702763681,564,"'I said, I wanted one owl and one pussycat."""
4695,0,1,25,26,1.0384615384615385,0.03922322702763681,564,We're lunching in. Please order us a cheeseburger and nine mice.
4695,0,1,25,26,1.0384615384615385,0.03922322702763681,564,More coffee please!
4695,0,1,25,26,1.0384615384615385,0.03922322702763681,564,How do you catch a unique bunny? Unique up on it.
4695,0,1,25,26,1.0384615384615385,0.03922322702763681,564,Hoos calling.
4695,0,1,25,26,1.0384615384615385,0.03922322702763681,564,"I'm starting to think you don't give a hoot about this company, Sharon."
4695,0,1,25,26,1.0384615384615385,0.03922322702763681,564,"Thank you, Miss Saunders, but these will not be the mascots for Whooten & Whooten"
4695,0,1,25,26,1.0384615384615385,0.03922322702763681,564,I thought it prudent to bring in a team of wise guys.
4695,0,1,25,26,1.0384615384615385,0.03922322702763681,564,I really wish you'd start giving a hoot around here.
4695,0,1,25,26,1.0384615384615385,0.03922322702763681,564,Whoooo were you here to see?
4695,0,1,25,26,1.0384615384615385,0.03922322702763681,564,"Ugh, this always works in my garden..."
4695,0,1,25,26,1.0384615384615385,0.03922322702763681,564,"You're here to see who,who,who,who,who,who,who,who,who,who?"
4695,0,1,25,26,1.0384615384615385,0.03922322702763681,564,So now you're a member of parliament?
4695,0,1,25,26,1.0384615384615385,0.03922322702763681,564,I told you to get your ducks in a row.
4695,0,1,25,26,1.0384615384615385,0.03922322702763681,564,"""Owl be here if you need me."" ""The gang's owl here."". ""Owls well that ends well."" You want Dad jokes? I've got plenty of Dad jokes?"
4695,0,1,25,26,1.0384615384615385,0.03922322702763681,564,They'll be asking to the questions.
4695,0,1,25,26,1.0384615384615385,0.03922322702763681,564,I didn't Hooters had such an a remunerative loyalty program
4695,0,1,25,26,1.0384615384615385,0.03922322702763681,564,WISE ASS !!
4695,0,1,25,26,1.0384615384615385,0.03922322702763681,564,Owls returning home in Amazonas' forest biggest office.
4695,0,1,25,26,1.0384615384615385,0.03922322702763681,564,And has the Parliament decided on a lunch order?
4695,0,1,25,26,1.0384615384615385,0.03922322702763681,564,Fresh interns. They don't give a hoot.
4695,0,1,25,26,1.0384615384615385,0.03922322702763681,564,"I'm telling you, this year's teaching board will be different."
4695,0,1,25,26,1.0384615384615385,0.03922322702763681,564,The team just feels that you don't give a hoot.
4695,0,1,25,26,1.0384615384615385,0.03922322702763681,564,That's not true. I have many hoots to give.
4695,0,1,25,26,1.0384615384615385,0.03922322702763681,564,"It's wisdom we are trying to impart Ms. Featherstone. One for each student, if you please."
4695,0,1,25,26,1.0384615384615385,0.03922322702763681,564,"What part of ""Give a hoot"" don't you understand?"
4695,0,1,25,26,1.0384615384615385,0.03922322702763681,564,Can you lay your hands on a copy of Whoo's Whoo?
4695,0,1,25,26,1.0384615384615385,0.03922322702763681,564,"Fine...'You called, Prime Minister?'"
4695,0,1,25,26,1.0384615384615385,0.03922322702763681,564,The Board has appointed me Parliamentarian.
4695,0,1,25,26,1.0384615384615385,0.03922322702763681,564,It's our intermediate step from human employees to robots.
4695,0,1,25,26,1.0384615384615385,0.03922322702763681,564,"No need to worry about mice, Miss Clumpkin"
4695,0,1,25,26,1.0384615384615385,0.03922322702763681,564,I bet having them is a real hoot.
4695,0,1,25,26,1.0384615384615385,0.03922322702763681,564,Owlette Towelettes needs a new mascot.
4695,0,1,25,26,1.0384615384615385,0.03922322702763681,564,How can you still say I don't give a hoot?
4695,0,1,25,26,1.0384615384615385,0.03922322702763681,564,"We had to use the Nuclear Option, but it broke the Filibuster."
4695,0,1,25,26,1.0384615384615385,0.03922322702763681,564,Who am I supposed to believe?
4695,0,1,25,26,1.0384615384615385,0.03922322702763681,564,"I told you I don't give a hoot about you, but I was outvoted eight to one."
4695,0,1,25,26,1.0384615384615385,0.03922322702763681,564,"I didn't literally mean,""Surround yourself with wise old birds!"""
4695,0,1,25,26,1.0384615384615385,0.03922322702763681,564,I don't give a hoot you're overrun with mice.
4695,0,1,25,26,1.0384615384615385,0.03922322702763681,564,I've decided to add a night shift.
4695,0,1,25,26,1.0384615384615385,0.03922322702763681,564,"I asked you to prepare a list of Who's Who in the Parliament, not a parliament of owls!"
4695,0,1,25,26,1.0384615384615385,0.03922322702763681,564,Are you applying for the new hoot tan nanny?
4695,0,1,25,26,1.0384615384615385,0.03922322702763681,564,Owl be with you in a moment
4695,0,1,25,26,1.0384615384615385,0.03922322702763681,564,"I apologize, but those reports are going to be a bit late."
4695,0,1,25,26,1.0384615384615385,0.03922322702763681,564,"One more thing, more owls."
4695,0,1,25,26,1.0384615384615385,0.03922322702763681,564,Hello Mrs Desmacher whom did you say you were looking for? Im looking for Mr. Carpriato? Who Who Who Who Who Who Who Who Who. Nevermind!
4695,0,1,25,26,1.0384615384615385,0.03922322702763681,564,Owls it goin'
4695,0,1,25,26,1.0384615384615385,0.03922322702763681,564,Do you you think they give a hoot?
4695,0,1,25,26,1.0384615384615385,0.03922322702763681,564,What happened to the other ones?
4695,0,1,25,26,1.0384615384615385,0.03922322702763681,564,"One per office, Miss Kramer, to inspire the attainment of wisdom we so sorely lack."
4695,0,1,25,26,1.0384615384615385,0.03922322702763681,564,I'd like to think that I do give a hoot about how this looks.
4695,0,1,25,26,1.0384615384615385,0.03922322702763681,564,"Ms. Ryan, Hoo's been in my office?"
4695,0,1,25,26,1.0384615384615385,0.03922322702763681,564,Owl be needing a reservation for nine at Hooters.
4695,0,1,25,26,1.0384615384615385,0.03922322702763681,564,"Yes, a mouse."
4695,0,1,25,26,1.0384615384615385,0.03922322702763681,564,Owl be in touch.
4695,0,1,25,26,1.0384615384615385,0.03922322702763681,564,I am still more qualified.
4695,0,1,25,26,1.0384615384615385,0.03922322702763681,564,You said we were suppose to get our owls on Wednesday.
4695,0,1,25,26,1.0384615384615385,0.03922322702763681,564,This way Miss Smith owl never be lonely at the top
4695,0,1,25,26,1.0384615384615385,0.03922322702763681,564,It worked at Hogwarts.
4695,0,1,25,26,1.0384615384615385,0.03922322702763681,564,"Can't you see I'm on ""do not disturb""?"
4695,0,1,25,26,1.0384615384615385,0.03922322702763681,564,I see you brought your desk with you from the House of Commons.
4695,0,1,25,26,1.0384615384615385,0.03922322702763681,564,That sounds like a really hoot.
4695,0,1,25,26,1.0384615384615385,0.03922322702763681,564,Aren't you the one who said he doesn't give a hoot?
4695,0,1,25,26,1.0384615384615385,0.03922322702763681,564,It's a hoot to be with the hoot's hoot of hoot owls.
4695,0,1,25,26,1.0384615384615385,0.03922322702763681,564,I asked for Al's desk.
4695,0,1,25,26,1.0384615384615385,0.03922322702763681,564,You have no authority over me. I'm claiming parliamentary privilege.
4695,0,1,25,26,1.0384615384615385,0.03922322702763681,564,"Who is my next appointment, Mary? Who? Who? Who? Who?"
4695,0,1,25,26,1.0384615384615385,0.03922322702763681,564,We don't have show and tell day at our office.
4695,0,1,25,26,1.0384615384615385,0.03922322702763681,564,"""You can hoot and holler all you want! I'm outta here!"
4695,0,1,25,26,1.0384615384615385,0.03922322702763681,564,Model casting
4903,0,1,26,27,1.037037037037037,0.03774256780481986,564,"Sir, why can't you be owl by yourself?"
4903,0,1,26,27,1.037037037037037,0.03774256780481986,564,"I get it that you don't give a hoot about your job,but this is ridiculous !"
4903,0,1,26,27,1.037037037037037,0.03774256780481986,564,They were on sale at Costco.
4903,0,1,26,27,1.037037037037037,0.03774256780481986,564,We are the endagered species too.
4903,0,1,26,27,1.037037037037037,0.03774256780481986,564,"Give a hoot, get a hoot."
4903,0,1,26,27,1.037037037037037,0.03774256780481986,564,It just feels like you don't trust me anymore.
4903,0,1,26,27,1.037037037037037,0.03774256780481986,564,Don't you think it would be wise to get some mice on the Board?
4903,0,1,26,27,1.037037037037037,0.03774256780481986,564,- You must be wiser 3 times then all of them!
4903,0,1,26,27,1.037037037037037,0.03774256780481986,564,This is where the owlery really is.
4903,0,1,26,27,1.037037037037037,0.03774256780481986,564,"They don't give a hoot about who governs, but they want a parliament."
4903,0,1,26,27,1.037037037037037,0.03774256780481986,564,"Since my memo apparently wasn't clear, let me be blunt: I don't give a hoot."
4903,0,1,26,27,1.037037037037037,0.03774256780481986,564,Tell Mr. Delvecchio his wise guys don't scare me.
4903,0,1,26,27,1.037037037037037,0.03774256780481986,564,They're like retro CCTV.
4903,0,1,26,27,1.037037037037037,0.03774256780481986,564,"No, I meant I'd love to see ""Parliament,"" the band."
4903,0,1,26,27,1.037037037037037,0.03774256780481986,564,You still sound like an idiot.
4903,0,1,26,27,1.037037037037037,0.03774256780481986,564,"Yes, Deb, It's easier for you to just come in. An intercom would take up far too much space"
4903,0,1,26,27,1.037037037037037,0.03774256780481986,564,Our E-mail server is still down sir and I do believe you've been reading way too much Harry Potter.
4903,0,1,26,27,1.037037037037037,0.03774256780481986,564,"Any word on that shipment of field mice, Mrs. Dorkin?"
4903,0,1,26,27,1.037037037037037,0.03774256780481986,564,"Contrary to what you've heard around the water cooler Ms. Jones, as you can clearly see, when it comes to my work, I still have plenty of hoots to give."
4903,0,1,26,27,1.037037037037037,0.03774256780481986,564,Animal Control says they're waiting for you to hatch.
4903,0,1,26,27,1.037037037037037,0.03774256780481986,564,"Don't tell me, the Hogwarts intern's started."
4903,0,1,26,27,1.037037037037037,0.03774256780481986,564,So this is your way of looking for it?
4903,0,1,26,27,1.037037037037037,0.03774256780481986,564,WHO is my next appointment?
4903,0,1,26,27,1.037037037037037,0.03774256780481986,564,"You may not give a hoot, but I like 'em."
4903,0,1,26,27,1.037037037037037,0.03774256780481986,564,"Per your request, Horton has arrived."
4903,0,1,26,27,1.037037037037037,0.03774256780481986,564,"Well, first we just tried to fire them all, but it turns out that owls are a suspect class."
4903,0,1,26,27,1.037037037037037,0.03774256780481986,564,Who's in charge around here?
4903,0,1,26,27,1.037037037037037,0.03774256780481986,564,"Sir, those are fake.....just like our news."
4903,0,1,26,27,1.037037037037037,0.03774256780481986,564,"No, I said I would like to see the Powells."
4903,0,1,26,27,1.037037037037037,0.03774256780481986,564,"Sorry, but you cannot just accumulate wisdom like that."
4903,0,1,26,27,1.037037037037037,0.03774256780481986,564,"No, I don't give a hoot...."
4903,0,1,26,27,1.037037037037037,0.03774256780481986,564,"Roberta, these are the new interns. Please find them roosts and some dead mice."
4903,0,1,26,27,1.037037037037037,0.03774256780481986,564,"That's not what I meant by ""parliamentary procedure."""
4903,0,1,26,27,1.037037037037037,0.03774256780481986,564,"Do you really think that's wise, sir?"
4903,0,1,26,27,1.037037037037037,0.03774256780481986,564,This is not what I meant when I said we needed a parliament!
4903,0,1,26,27,1.037037037037037,0.03774256780481986,564,If we're going to represent Hogwarts they have to learn to use email.
4903,0,1,26,27,1.037037037037037,0.03774256780481986,564,Is there any reason you can't go to the guy with eagles?
4903,0,1,26,27,1.037037037037037,0.03774256780481986,564,I need the number for a good hoot nanny.
4903,0,1,26,27,1.037037037037037,0.03774256780481986,564,I'm surrounded by wisecracks!
4903,0,1,26,27,1.037037037037037,0.03774256780481986,564,"My dear,true wisdom is basically just a numbers game."
4903,0,1,26,27,1.037037037037037,0.03774256780481986,564,I'm quitting. Taking up taxidermy.
4903,0,1,26,27,1.037037037037037,0.03774256780481986,564,I am ever so sorry but the Magical Secretary advertisement stated a ten O.W.L.s prerequisite and you are one short.
4903,0,1,26,27,1.037037037037037,0.03774256780481986,564,"I told you, Lois, I don't *care* that you're a cat lady. You'll have to come up with something else."
4903,0,1,26,27,1.037037037037037,0.03774256780481986,564,They'll be replacing the nighttime security guards.
4903,0,1,26,27,1.037037037037037,0.03774256780481986,564,"I said get me the Finals, not Nine owls!"
4903,0,1,26,27,1.037037037037037,0.03774256780481986,564,Gather the mice and reschedule the Hawk. Is that right?
4903,0,1,26,27,1.037037037037037,0.03774256780481986,564,Let my wife know that the Barred meeting will probably go late tonight.
4903,0,1,26,27,1.037037037037037,0.03774256780481986,564,...and they're a helluva lot cheaper than consultants
4903,0,1,26,27,1.037037037037037,0.03774256780481986,564,You really really are a wise-ass.
4903,0,1,26,27,1.037037037037037,0.03774256780481986,564,"No sir, I checked; this doesn't qualify you as an MP"
4903,0,1,26,27,1.037037037037037,0.03774256780481986,564,My son was just accepted to Temple
4903,0,1,26,27,1.037037037037037,0.03774256780481986,564,I told you I'd be a part of parliament!
4903,0,1,26,27,1.037037037037037,0.03774256780481986,564,"Oh, them?? Them nine Wise-Guys remind me to say ""WHO"" may I say is calling?"" instead of ""whom."""
4903,0,1,26,27,1.037037037037037,0.03774256780481986,564,But you don't ask with respect. You don't offer friendship. You don't even think to call me Godfather.
4903,0,1,26,27,1.037037037037037,0.03774256780481986,564,Hoo do you do?
4903,0,1,26,27,1.037037037037037,0.03774256780481986,564,"Mr. Jones, I thought you did not give a hoot?"
4903,0,1,26,27,1.037037037037037,0.03774256780481986,564,"Last year I had only seven owls. This year I have nine, and next year I'm sure I'll have all twelve owls."
4903,0,1,26,27,1.037037037037037,0.03774256780481986,564,Thanks anyway.. These animals just won't do! I need at least 10 to do the trick..
4903,0,1,26,27,1.037037037037037,0.03774256780481986,564,Whooo are you? Get it?
4903,0,1,26,27,1.037037037037037,0.03774256780481986,564,I'm afraid you're simply too mousy to be a good fit here.
4903,0,1,26,27,1.037037037037037,0.03774256780481986,564,I through getting crapped on at work.
4903,0,1,26,27,1.037037037037037,0.03774256780481986,564,We'll need to find another intern for the graveyard shift in digital.
4903,0,1,26,27,1.037037037037037,0.03774256780481986,564,Please kneel. It would make the interview panel more comfortable.
4903,0,1,26,27,1.037037037037037,0.03774256780481986,564,Excuse me but I believe your owls are sitting on my desk
4903,0,1,26,27,1.037037037037037,0.03774256780481986,564,Get me the overtime budget.
4968,0,1,27,28,1.0357142857142858,0.036369648372665396,564,You say you're a hoot en nanny?
4968,0,1,27,28,1.0357142857142858,0.036369648372665396,564,Who...Who...Who did you want to speak with?
4968,0,1,27,28,1.0357142857142858,0.036369648372665396,564,Guess who is eating at Hooters today?
4968,0,1,27,28,1.0357142857142858,0.036369648372665396,564,Night shift staff meeting?
4968,0,1,27,28,1.0357142857142858,0.036369648372665396,564,They're loaners while my Macbook is being fixed
4968,0,1,27,28,1.0357142857142858,0.036369648372665396,564,You're right. I'm sorry. It's clear you do give a hoot about this job.
4968,0,1,27,28,1.0357142857142858,0.036369648372665396,564,"IT says you need to empty your sent items folder, the server is overloaded."
4968,0,1,27,28,1.0357142857142858,0.036369648372665396,564,I think I need to switch to a tablet. The mouse pad is in the way of my working!
4968,0,1,27,28,1.0357142857142858,0.036369648372665396,564,You took my lunch request a bit literally.
4968,0,1,27,28,1.0357142857142858,0.036369648372665396,564,Owl think of something to say at the meeting.
4968,0,1,27,28,1.0357142857142858,0.036369648372665396,564,I believe I asked for a parliament of towelettes.
4968,0,1,27,28,1.0357142857142858,0.036369648372665396,564,Mr. Partial really DID give a hoot about Ms. Grim's staring contests.
4968,0,1,27,28,1.0357142857142858,0.036369648372665396,564,"Sir, ITS CAT'S - NOT OWLS"
4968,0,1,27,28,1.0357142857142858,0.036369648372665396,564,"You were right, Carol. We need to emphasize wisdom rules here."
4968,0,1,27,28,1.0357142857142858,0.036369648372665396,564,There's a man named Trump who wants to be next and he doesn't give a hoot that he has no appointment.
4968,0,1,27,28,1.0357142857142858,0.036369648372665396,564,"""Hoo?"" did you sat was calling?"
4968,0,1,27,28,1.0357142857142858,0.036369648372665396,564,"If you want a lot of wisdom, take two."
4968,0,1,27,28,1.0357142857142858,0.036369648372665396,564,"Do you have a ""What""?"
4968,0,1,27,28,1.0357142857142858,0.036369648372665396,564,I know we need wisdom...but 9 owls??
4968,0,1,27,28,1.0357142857142858,0.036369648372665396,564,"When I ask to go home early why do you always say, ""Who?"""
4968,0,1,27,28,1.0357142857142858,0.036369648372665396,564,I hate to be gulled.
4968,0,1,27,28,1.0357142857142858,0.036369648372665396,564,I figured owl advice would the best way to decide if we should air this Pepsi commercial with Kendall Jenner.
4968,0,1,27,28,1.0357142857142858,0.036369648372665396,564,I am just about to head home ... it's almost 6 AM.
4991,0,1,28,29,1.0344827586206897,0.03509312031717982,564,"Jerry, your board meeting is in five minutes. I'd hate to ruffle your feathers about it."
4991,0,1,28,29,1.0344827586206897,0.03509312031717982,564,"What works in accounting, but who is my first appointment?"
4991,0,1,28,29,1.0344827586206897,0.03509312031717982,564,"If you ask me, I think ""The Whos"" is a dumb name to a bird act."
4991,0,1,28,29,1.0344827586206897,0.03509312031717982,564,This isn't Canada and surrounding yourself with a parliament of owls does not make you its monarch!
4991,0,1,28,29,1.0344827586206897,0.03509312031717982,564,"To anyone, just ""who"" do you think you are?"
4991,0,1,28,29,1.0344827586206897,0.03509312031717982,564,I heard they keep things from being covered in crap.
4991,0,1,28,29,1.0344827586206897,0.03509312031717982,564,""" I don't give a hoot what you say....I deserve a raise""."
4991,0,1,28,29,1.0344827586206897,0.03509312031717982,564,"Sir you can't fire me! I have a fami-"" ""You see all these owls Karen? It's obvious I don't give a Hoot!!!"
4991,0,1,28,29,1.0344827586206897,0.03509312031717982,564,There are some pigeons here who say they have an appointment.
4991,0,1,28,29,1.0344827586206897,0.03509312031717982,564,"I really don't give a hoot, but do you like your rice boiled, fried, or sauteed?"
5001,0,1,29,30,1.0333333333333334,0.03390317518104052,564,"Welcome to Athena Corporation, Ms Jones. Do you prefer Minerva, or Min?"
5001,0,1,29,30,1.0333333333333334,0.03390317518104052,564,We don't give a hoot Ms. Jones. You're fired.
5001,0,1,29,30,1.0333333333333334,0.03390317518104052,564,I always wanted to be a parliamentarian.
5001,0,1,29,30,1.0333333333333334,0.03390317518104052,564,And I'm in charge of hollering.
5001,0,1,29,30,1.0333333333333334,0.03390317518104052,564,"OK, hoot stole my sandwich from the fridge?"
5001,0,1,29,30,1.0333333333333334,0.03390317518104052,564,I still don't know who's on first.
5001,0,1,29,30,1.0333333333333334,0.03390317518104052,564,"I said you looked peckish, not owlish."
5001,0,1,29,30,1.0333333333333334,0.03390317518104052,564,"I said in order to win this case, we'll need the judge to hear plenty avowals."
5001,0,1,29,30,1.0333333333333334,0.03390317518104052,564,"Yes, I do see your parliament, and yes you are still fired!"
5001,0,1,29,30,1.0333333333333334,0.03390317518104052,564,"So, I hear that you no longer give a hoot..."
5011,0,1,30,31,1.032258064516129,0.032791291789197645,564,"""Who's"" in charge here?"
5011,0,1,30,31,1.032258064516129,0.032791291789197645,564,We're installing the Luddite version of the Internet. Pick the one you like the best and take it back to your desk. The oak trees will be here next week.
5011,0,1,30,31,1.032258064516129,0.032791291789197645,564,It's all about hoo you know
5011,0,1,30,31,1.032258064516129,0.032791291789197645,564,"Is this the new library collection of ""Who?"
5011,0,1,30,31,1.032258064516129,0.032791291789197645,564,Tell the wife call the owlet I don't give a Hoot.
5011,0,1,30,31,1.032258064516129,0.032791291789197645,564,"Mrs. Thomas, when the mayor said our city has a rat problem, I think he was referring to certain politicians. Please return these."
5011,0,1,30,31,1.032258064516129,0.032791291789197645,564,I thought Dilbey said no more consultants!
5018,0,1,31,32,1.03125,0.031750031750047626,564,I get the idea you want to go to Hooters for lunch
5018,0,1,31,32,1.03125,0.031750031750047626,564,The owls won't make me forget about the one way mirroe
5020,0,1,32,33,1.0303030303030303,0.030772872744833184,564,"I've brought in a real who's who for this job, Sharon."
5020,0,1,32,33,1.0303030303030303,0.030772872744833184,564,"They're replacing you, Mrs Jenkins, because they do give a hoot."
5022,0,1,34,35,1.0285714285714285,0.028988551782622423,564,"Technically we're a parliament, but we've been subsumed by the entrenched bureaucracy."
5023,0,1,35,36,1.0277777777777777,0.028171808490950554,564,"Lois, at this time we feel it would be unwise to go out on a limb. Your suggestion, however, will be retained."
5024,0,0,21,21,1.0,0.048795003647426664,564,I decided I needed all the help I could get.
5024,0,0,21,21,1.0,0.048795003647426664,564,I know they did things differently at Hogwarts but here we prefer to communicate by email.
5024,0,0,21,21,1.0,0.048795003647426664,564,"No, just owls, not penguins..."
5024,0,0,21,21,1.0,0.048795003647426664,564,I plan to bring Hogwarts to its knees.
5024,0,0,21,21,1.0,0.048795003647426664,564,...we've decided we want a standing desk.
5024,0,0,21,21,1.0,0.048795003647426664,564,I mentioned to the Board t
5024,0,0,21,21,1.0,0.048795003647426664,564,Who's on my desk?
5024,0,0,21,21,1.0,0.048795003647426664,564,Spam to Hogwarts Parents?
5024,0,0,21,21,1.0,0.048795003647426664,564,"Since you're gonna be here all night finishing those reports, I thought I would lend a hand by bringing in some friends to keep you company."
5024,0,0,21,21,1.0,0.048795003647426664,564,"""Hoot Hoot"" ""Did you just fart?!"" said the lady ""Nooooo"" said the man"
5024,0,0,21,21,1.0,0.048795003647426664,564,"Actually Mr. Conflager, you are supposed to use ""Whys"" to get to the root of your problem, not ""Whos"""
5024,0,0,23,23,1.0,0.044455422447438706,564,"It doesn't matter who said it sir, it's why they said it that matters."
5024,0,0,21,21,1.0,0.048795003647426664,564,How many owls does it take to stop a pen thief?
5024,0,0,21,21,1.0,0.048795003647426664,564,Office parliament is in session.
5024,0,0,21,21,1.0,0.048795003647426664,564,We are his bodyguards.
5024,0,0,21,21,1.0,0.048795003647426664,564,"Mr. Donaldson, the Head of Human Resources, you had a meeting with him last week."
5024,0,0,21,21,1.0,0.048795003647426664,564,"Frank, what are you doing at my desk?"
5024,0,0,21,21,1.0,0.048795003647426664,564,"Of course the owl decoys are working, you don't see any ducks or geese do you?"
5024,0,0,21,21,1.0,0.048795003647426664,564,Tell the bunny-rabbits that I'll have to reschedule.
5024,0,0,25,25,1.0,0.040824829046386304,564,"I knew HR would nix your ""Hooters"" mouse pad."
5024,0,0,21,21,1.0,0.048795003647426664,564,MR PRESIDENT THEY NEED TO GO!
5024,0,0,21,21,1.0,0.048795003647426664,564,We are the last part of the EPA.
5024,0,0,21,21,1.0,0.048795003647426664,564,"How many suckers will it take to lick our corporate scandal, Janice?"
5024,0,0,21,21,1.0,0.048795003647426664,564,Who looks wiser now?
5024,0,0,21,21,1.0,0.048795003647426664,564,Hoo are you trying to scam with those?
5024,0,0,21,21,1.0,0.048795003647426664,564,Ten wise owls would make the difference!
5024,0,0,21,21,1.0,0.048795003647426664,564,Are all of them for adoption?
5024,0,0,21,21,1.0,0.048795003647426664,564,The publishing office of Who's Whoo in America.
5024,0,0,21,21,1.0,0.048795003647426664,564,"""Parliament is now in session. Pray continue"
5024,0,0,21,21,1.0,0.048795003647426664,564,"I'm teaching them to say ""whom"" when used as a direct object."
5024,0,0,21,21,1.0,0.048795003647426664,564,I'm determined to find the mole at last.
5024,0,0,21,21,1.0,0.048795003647426664,564,"We need to hire a Hoot Nanny."""
5024,0,0,21,21,1.0,0.048795003647426664,564,I'm owl by myself.
5024,0,0,21,21,1.0,0.048795003647426664,564,"Stop saying ""z... on first base?""."
5024,0,0,21,21,1.0,0.048795003647426664,564,We've got to stop using acronyms in our emails - ASAP
5024,0,0,21,21,1.0,0.048795003647426664,564,Who did this?
5024,0,0,21,21,1.0,0.048795003647426664,564,Yeah so we're off of a climate science and back to testing the tootsiepop hypothesis. Orders from the White House.
5024,0,0,21,21,1.0,0.048795003647426664,564,I said call an exterminator!
5024,0,0,21,21,1.0,0.048795003647426664,564,"The people have asked for a new Parliament and by jove, that's what we'll give them."
5024,0,0,21,21,1.0,0.048795003647426664,564,"I can't leave, the parliament will lose its quorum."
5024,0,0,21,21,1.0,0.048795003647426664,564,WHO LOOKING AT ME? WHO LOOKING AT ME? WELL WHO THE HELL ELSE YOU LOOKING AT? WHO WHO
5024,0,0,21,21,1.0,0.048795003647426664,564,Unfortunately they're all on H1B visas.
5024,0,0,21,21,1.0,0.048795003647426664,564,I'm remembering the days when I gave a hoot.
5024,0,0,21,21,1.0,0.048795003647426664,564,"I had placed an order for ""wisdom""."
5024,0,0,21,21,1.0,0.048795003647426664,564,You said you needed staff who could do the overnight flight to LA
5024,0,0,21,21,1.0,0.048795003647426664,564,"OK, Sol, you made your point. When it comes to matters of parliamentary procedure, there is no one wiser than you."
5024,0,0,21,21,1.0,0.048795003647426664,564,You had some big sex life didn't you?
5024,0,0,21,21,1.0,0.048795003647426664,564,"I don't know who started this rumor, but I am not a predator."
5024,0,0,21,21,1.0,0.048795003647426664,564,Be wise and spread out old New Yorker Magazines on Your desk.
5024,0,0,21,21,1.0,0.048795003647426664,564,"Who, who, who, who, who, who, who, who, who are you?"
5024,0,0,21,21,1.0,0.048795003647426664,564,"Oh Ben, you're such a hoot!"
5024,0,0,21,21,1.0,0.048795003647426664,564,"If you don't mind, 9:00 a.m. is when we like to get a little shut-eye around here."
5024,0,0,21,21,1.0,0.048795003647426664,564,"If they worked like they did in my garden, we wouldn't be having this conversation."
5024,0,0,21,21,1.0,0.048795003647426664,564,"But, your e-mail set the meeting for 9 Owl'Clock."
5024,0,0,21,21,1.0,0.048795003647426664,564,"Hillary, frustrated with email in general has decided to rebrand"
5024,0,0,21,21,1.0,0.048795003647426664,564,They are here to investigate the tootsie pop findings.
5024,0,0,21,21,1.0,0.048795003647426664,564,I told you my new coworkers were a real hoot. They're also pretty wise too.
5024,0,0,21,21,1.0,0.048795003647426664,564,"Couldn't you find a mouse trap, Miss Jones?"
5024,0,0,21,21,1.0,0.048795003647426664,564,All departments have rejected them. It's all we can do to keep them awake.
5024,0,0,21,21,1.0,0.048795003647426664,564,"Well, I really used to turn some heads."
5024,0,0,21,21,1.0,0.048795003647426664,564,Call Abbott and Costello. I have a great routine for them.
5024,0,0,21,21,1.0,0.048795003647426664,564,Are you among the wise?
5024,0,0,23,23,1.0,0.044455422447438706,564,They corrected me. I just said 'to who'?
5024,0,0,21,21,1.0,0.048795003647426664,564,"I want to put them on the endangered species list but they won't tell me their names, they just keep saying ""Who?"""
5024,0,0,22,22,1.0,0.046524210519923545,564,And I make ten.
5024,0,0,22,22,1.0,0.046524210519923545,564,An Herald Owl would be a great mascot for a new literary imprint.
5024,0,0,21,21,1.0,0.048795003647426664,564,I know you're running for parliament but this has gone too far.
5024,0,0,21,21,1.0,0.048795003647426664,564,Please bring in the photographer for the proxy-statement pictures.
5024,0,0,21,21,1.0,0.048795003647426664,564,Again Mr. Tuttle I didn't see a mouse last week; I had just dropped my luck rabbit's foot.
5024,0,0,21,21,1.0,0.048795003647426664,564,"It's okay, I've been reading 'A Perfect Mess.'"
5024,0,0,21,21,1.0,0.048795003647426664,564,I'll never buy glasses at 'America's Best' ever again.
5024,0,0,21,21,1.0,0.048795003647426664,564,It's the adjunct faculty; they're demanding overtime for teaching night classes.
5024,0,0,21,21,1.0,0.048795003647426664,564,"Thank you, Miss Jones. That will be all for today."
5024,0,0,23,23,1.0,0.044455422447438706,564,Who can tell them apart?
5024,0,0,21,21,1.0,0.048795003647426664,564,You can't pass up on nine for the price of one.
5024,0,0,21,21,1.0,0.048795003647426664,564,Who's the boss here? Who wants to know?
5024,0,0,22,22,1.0,0.046524210519923545,564,But I ordered tea towels Ms Honeybun.
5024,0,0,21,21,1.0,0.048795003647426664,564,"As a bonus they sing, 'Owl Be Seeing You in All the Old Familiar Places'."
5024,0,0,21,21,1.0,0.048795003647426664,564,I am thinking about trying to overthrow our current administration with this wise parliament
5024,0,0,21,21,1.0,0.048795003647426664,564,My solution to Washington gridlock
5024,0,0,21,21,1.0,0.048795003647426664,564,It really does not make you look any wiser.
5024,0,0,21,21,1.0,0.048795003647426664,564,Call UPS. Tell them we aren't paying their invoice this month.
5024,0,0,21,21,1.0,0.048795003647426664,564,Pardon my stare.
5024,0,0,21,21,1.0,0.048795003647426664,564,I want a refund.
5024,0,0,21,21,1.0,0.048795003647426664,564,You're up next for the owl cam auditions...
5024,0,0,21,21,1.0,0.048795003647426664,564,A Dr. Doolittle would like to talk with you.
5024,0,0,21,21,1.0,0.048795003647426664,564,I understand you've been turning some heads around here.
5024,0,0,21,21,1.0,0.048795003647426664,564,She said you deserved the bird!
5024,0,0,21,21,1.0,0.048795003647426664,564,I am pretty sure I asked you for nine bowls
5024,0,0,21,21,1.0,0.048795003647426664,564,"The more you have, the more you want, sir?"
5024,0,0,21,21,1.0,0.048795003647426664,564,Does this come with the telephone wire or do I just hope my ex parks under one?
5024,0,0,21,21,1.0,0.048795003647426664,564,"Mr. Overly Wise, Mr. Big Rat is here to see you..."
5024,0,0,21,21,1.0,0.048795003647426664,564,Owl get to your evaluation this afternoon.
5024,0,0,21,21,1.0,0.048795003647426664,564,"Here's the deal, Aves. That joke about the agency protecting us 'from' the environment -- less joke, more ""other duties as assigned."""
5024,0,0,22,22,1.0,0.046524210519923545,564,"You know, like the song, 'Hail, hail, the owls gang here!'"
5024,0,0,21,21,1.0,0.048795003647426664,564,"We owl agree, that would be the wise choice."
5024,0,0,21,21,1.0,0.048795003647426664,564,"I'm looking for Preet Bharara."" ""Who?"" ""Who?"" ""Who?"" ""Who?"" ""Who?"" ""Who?"" ""Who?"" ""Who?"" ""Who?"
5024,0,0,21,21,1.0,0.048795003647426664,564,"I'm creating new jobs, taking computers out of intelligent and wise decision making. These owls don't hoot, they 'AI'"
5024,0,0,21,21,1.0,0.048795003647426664,564,Not a wise move Martha. Who gave you permission to do this?
5024,0,0,21,21,1.0,0.048795003647426664,564,I don't give a hoot what you have to say.
5024,0,0,21,21,1.0,0.048795003647426664,564,Do you really think you can corner the market on Hogwarts mail carriers?
5024,0,0,21,21,1.0,0.048795003647426664,564,"Get those owls out of here or I'm going to ""hoot"" you out."
5024,0,0,21,21,1.0,0.048795003647426664,564,Wait till I tell you about my day. It was a HOOT!
5024,0,0,21,21,1.0,0.048795003647426664,564,"Oh big whoop Becky, yeah I got some owls, what of it? Don't act like you don't have a drawer full of lizards in your office, we've all seen it."
5024,0,0,24,24,1.0,0.04256282653793743,564,Owl I want for Christmas!
5024,0,0,21,21,1.0,0.048795003647426664,564,"OK Ms Jones, bring in the pussy cats. Leave the pea green boats in the lobby"
5024,0,0,21,21,1.0,0.048795003647426664,564,"Thank you Bridget, that will be all."
5024,0,0,21,21,1.0,0.048795003647426664,564,I am not a big fan of our new desk-share program.
5024,0,0,21,21,1.0,0.048795003647426664,564,It's a postage rate hedge.
5024,0,0,21,21,1.0,0.048795003647426664,564,Ask Wisdom Services for live rodents this time to get them off my desk.
5024,0,0,21,21,1.0,0.048795003647426664,564,Someone from the Audubon Society is here about cutting down trees for the new parking lot.
5024,0,0,23,23,1.0,0.044455422447438706,564,"Ironically, they're all looking in the same direction."
5024,0,0,21,21,1.0,0.048795003647426664,564,The world will beat a path to our door - just wait and see.
5024,0,0,21,21,1.0,0.048795003647426664,564,Now that they're selling my Internet history I've decided to send all my messages by owl.
5024,0,0,23,23,1.0,0.044455422447438706,564,"My apology sir, I thought your affection with hooters was being directed at me."
5024,0,0,21,21,1.0,0.048795003647426664,564,Who gives a hoot.
5024,0,0,22,22,1.0,0.046524210519923545,564,"Sir, this company is really going to the birds."
5024,0,0,21,21,1.0,0.048795003647426664,564,"I Don't Give A Hoot"" handouts for people who bring me dumb ideas."
5024,0,0,21,21,1.0,0.048795003647426664,564,This shows that I can be wise without being old.
5024,0,0,21,21,1.0,0.048795003647426664,564,"How many times must I tell you, the correct pronound is whom not who"
5024,0,0,21,21,1.0,0.048795003647426664,564,They were brought in out of the rain.
5024,0,0,21,21,1.0,0.048795003647426664,564,I just keep them around for a hoot.
5024,0,0,21,21,1.0,0.048795003647426664,564,I felt Hooting Resources should be present for this discussion.
5024,0,0,21,21,1.0,0.048795003647426664,564,"I'm trying to make it into ""Hoo's Hoo"""
5024,0,0,21,21,1.0,0.048795003647426664,564,The five-to-four will ensure your legacy
5024,0,0,21,21,1.0,0.048795003647426664,564,"Cancel my subscription to ""Who's Hoo."""
5024,0,0,21,21,1.0,0.048795003647426664,564,"Good morning, Dr. Wise."
5024,0,0,21,21,1.0,0.048795003647426664,564,"Sorry, I don't know from what."
5024,0,0,21,21,1.0,0.048795003647426664,564,The incarnation of my Tabby.
5024,0,0,21,21,1.0,0.048795003647426664,564,Forget it! You'll never know how many licks it takes to get to the center!
5024,0,0,21,21,1.0,0.048795003647426664,564,"I know who. Now the question is ""how""?"
5024,0,0,21,21,1.0,0.048795003647426664,564,"Sir, I need the name of your accountant... who who who who who who?"
5024,0,0,21,21,1.0,0.048795003647426664,564,My fowling system is slightly owldated.
5024,0,0,21,21,1.0,0.048795003647426664,564,"Alright, who can help me?"
5024,0,0,21,21,1.0,0.048795003647426664,564,"I need a bigger desk, but no one around here gives a hoot."
5024,0,0,21,21,1.0,0.048795003647426664,564,today we are hatching a hoot
5024,0,0,21,21,1.0,0.048795003647426664,564,I meant the White Owl cigars.
5024,0,0,21,21,1.0,0.048795003647426664,564,"Oh, for Pete's sake!"
5024,0,0,21,21,1.0,0.048795003647426664,564,These are the prizes for the best save our planet essays
5024,0,0,21,21,1.0,0.048795003647426664,564,"Sorry, Doris, but you've ruffled one too many feathers around here."
5024,0,0,21,21,1.0,0.048795003647426664,564,Who put bread crumbs on my desk?
5024,0,0,21,21,1.0,0.048795003647426664,564,"you have got to stop spending the company money on owls"" ""piss off Karen"
5024,0,0,22,22,1.0,0.046524210519923545,564,"Brenda, I said I needed a BOWEL movement!"
5024,0,0,21,21,1.0,0.048795003647426664,564,"Let me guess, your the wise guy?"
5024,0,0,21,21,1.0,0.048795003647426664,564,Meet the summer interns from Whoville U.
5024,0,0,21,21,1.0,0.048795003647426664,564,I spilled a glass of water on it.
5024,0,0,21,21,1.0,0.048795003647426664,564,I said this will require hours not owls
5024,0,0,24,24,1.0,0.04256282653793743,564,Sam brooding his flock was no longer just a brood!
5024,0,0,21,21,1.0,0.048795003647426664,564,"I distinctly said in my dictation to you, ""Order nine dowels for my new desk."""
5024,0,0,21,21,1.0,0.048795003647426664,564,This is the nature reference desk. Whoooooooooooooo wants to know?
5024,0,0,21,21,1.0,0.048795003647426664,564,Your services will no longer be needed.
5024,0,0,21,21,1.0,0.048795003647426664,564,This dangnamit building is crawling with pidgies.
5024,0,0,21,21,1.0,0.048795003647426664,564,"See, I told you parliament can be a hoot!"
5024,0,0,21,21,1.0,0.048795003647426664,564,"I see the CEO Wisdom Meter is almost ""off the desk"""
5024,0,0,21,21,1.0,0.048795003647426664,564,What have we got on Ontological Web Languages?
5024,0,0,21,21,1.0,0.048795003647426664,564,I always wondered where you got your wise answers from...
5024,0,0,21,21,1.0,0.048795003647426664,564,"No. ""What would Jane Austen do?"" is just not helpful."
5024,0,0,21,21,1.0,0.048795003647426664,564,"Sir, I've always thought that you and your birds are so wise."
5024,0,0,21,21,1.0,0.048795003647426664,564,She doubted he didn't give a hoot.
5024,0,0,21,21,1.0,0.048795003647426664,564,I think there's a glitch in the fertility drug.
5024,0,0,21,21,1.0,0.048795003647426664,564,"Jim, get out of my chair and bring me some wipes."
5024,0,0,21,21,1.0,0.048795003647426664,564,"So, who's ready to admit that Hogwarts is a fictional school and there are no market for students who require owls?"
5024,0,0,21,21,1.0,0.048795003647426664,564,That's not what a parliamentarian does.
5024,0,0,22,22,1.0,0.046524210519923545,564,"""Owls well that ends well."" is NOT an acceptable answer Ms. Owlsley!"
5024,0,0,21,21,1.0,0.048795003647426664,564,Sure. Just give me a minute to clear out my inbox.
5024,0,0,21,21,1.0,0.048795003647426664,564,Nine wise owls Miss Jones could not hurt the bottom line.
5024,0,0,21,21,1.0,0.048795003647426664,564,"Sir, why do you have all these owls?"" ""Because the freaks come out at night!"
5024,0,0,21,21,1.0,0.048795003647426664,564,You hired who?
5024,0,0,21,21,1.0,0.048795003647426664,564,Branch office guru.
5024,0,0,21,21,1.0,0.048795003647426664,564,"Apparently, there's a lay off at Hogwarts."
5024,0,0,21,21,1.0,0.048795003647426664,564,"I'm still trying to figure out what David Lynch meant by "" The owls are not what they seem."""
5024,0,0,21,21,1.0,0.048795003647426664,564,"I said ""Night Owl""."
5024,0,0,21,21,1.0,0.048795003647426664,564,"I know you're upset about not getting the promotion, but do you really think you can become the ""wise, old owl"" of the firm this way?"
5024,0,0,21,21,1.0,0.048795003647426664,564,We'll need to place an ad for a hoot nanny.
5024,0,0,21,21,1.0,0.048795003647426664,564,"Betty, as the newly endowed Hooters' ""You can call me Owl"" Professor of Philosophy, welcome."
5024,0,0,21,21,1.0,0.048795003647426664,564,"Yes, Elaine, you read my email right - ""Hold Owl, Might Caw"""
5024,0,0,21,21,1.0,0.048795003647426664,564,"Please send in the next owl, Miss Phineas."
5024,0,0,21,21,1.0,0.048795003647426664,564,surround yourself with those who have the same goal as you
5024,0,0,21,21,1.0,0.048795003647426664,564,I'm quitting and moving to Hogwarts.
5024,0,0,21,21,1.0,0.048795003647426664,564,I don't give hoots. I take them.
5024,0,0,22,22,1.0,0.046524210519923545,564,I thought you cleared your desk before you went home.
5024,0,0,21,21,1.0,0.048795003647426664,564,"Surprisingly, it's a 10 to 1 vote, the hoo hoo's have won once again."
5024,0,0,21,21,1.0,0.048795003647426664,564,"No Amelia! I said, ""Get me Al's"", not ""owls""!"
5024,0,0,21,21,1.0,0.048795003647426664,564,They're called a parliament. Whoooooo wants to know?
5024,0,0,21,21,1.0,0.048795003647426664,564,"On the contrary, they're exactly what they seem."
5024,0,0,21,21,1.0,0.048795003647426664,564,Parliament's at a standstill again.
5024,0,0,21,21,1.0,0.048795003647426664,564,"Would you like to join me for a Hootenanny tonight, Ms. Wise?"
5024,0,0,21,21,1.0,0.048795003647426664,564,Who dunnit?
5024,0,0,21,21,1.0,0.048795003647426664,564,"It's our client's, J.K. Rowling, hot line."
5024,0,0,23,23,1.0,0.044455422447438706,564,"Thank you Ms. Smyth, but I asked for Parliament ""filtered,"" not ""feathered."""
5024,0,0,21,21,1.0,0.048795003647426664,564,Prepare to pull an owl nighter.
5024,0,0,21,21,1.0,0.048795003647426664,564,Thanks for meeting me at the owlffice.
5024,0,0,21,21,1.0,0.048795003647426664,564,I'm the head Wisenheimer.
5024,0,0,21,21,1.0,0.048795003647426664,564,Just file them under O.
5024,0,0,21,21,1.0,0.048795003647426664,564,One goes on watch every three hours and the last one is a midnight owl.
5024,0,0,21,21,1.0,0.048795003647426664,564,"Helen, would you please tell the interns they all got into Hogwarts?"
5024,0,0,21,21,1.0,0.048795003647426664,564,You said you needed nine owls ahead of any special oldel.
5024,0,0,21,21,1.0,0.048795003647426664,564,Your new intrusion alert surveillance system appears to be functioning working well.
5024,0,0,21,21,1.0,0.048795003647426664,564,I said bring me the files for Benjamin Cowls.
5024,0,0,21,21,1.0,0.048795003647426664,564,"And now...get ready for our stirring rendition of "" Hoo's Your Daddy"""
5024,0,0,21,21,1.0,0.048795003647426664,564,Owl be with you in a moment
5024,0,0,21,21,1.0,0.048795003647426664,564,"Stan, that is not what I meant when I asked you to give a hoot."
5024,0,0,21,21,1.0,0.048795003647426664,564,"Ms. Boswell, I said ""let's define what the stock earns,"" not ""get me the nine nocturnes."""
5024,0,0,21,21,1.0,0.048795003647426664,564,Gesundheit!
5024,0,0,21,21,1.0,0.048795003647426664,564,Don't worry....they never attack old bats!
5024,0,0,21,21,1.0,0.048795003647426664,564,I thought it was the most eco friendly way to address our rodent problem
5024,0,0,21,21,1.0,0.048795003647426664,564,"No, I didn't get the memo."
5024,0,0,21,21,1.0,0.048795003647426664,564,Whooo's in charge?
5024,0,0,21,21,1.0,0.048795003647426664,564,Does anyone of them give a hoot?
5024,0,0,21,21,1.0,0.048795003647426664,564,"Henceforth, I prefer that you address me by my nom de plume."
5024,0,0,21,21,1.0,0.048795003647426664,564,Can it wait? I'm addressing the local parliament.
5024,0,0,21,21,1.0,0.048795003647426664,564,"Miss Dodson, your paperweight collection is starting to curb my productivity."
5024,0,0,21,21,1.0,0.048795003647426664,564,This promotion makes you corporate hootnanny.
5024,0,0,21,21,1.0,0.048795003647426664,564,It's the type of thing that'll make your head spin.
5024,0,0,21,21,1.0,0.048795003647426664,564,Gertrude. Find us some voles!
5024,0,0,21,21,1.0,0.048795003647426664,564,"If I hear 'Is Dr. Who in?' one more time, I'm going to screech."
5024,0,0,21,21,1.0,0.048795003647426664,564,"Sir, this isn't a joke. Mrs. Hooter flew all the way from Vancouver to meet with you."
5024,0,0,21,21,1.0,0.048795003647426664,564,"I'm planning to make my version of Hitchcock's ""The Birds"" with a cast of porcelain owls."
5024,0,0,21,21,1.0,0.048795003647426664,564,"To tell you the truth, I can't wait until the ""Give a Hoot"" promotion ends."
5024,0,0,21,21,1.0,0.048795003647426664,564,They keep all the crank calls away.
5024,0,0,21,21,1.0,0.048795003647426664,564,"I find that they are way more effective than email. In this economy, our clients appreciate a personal touch."
5024,0,0,21,21,1.0,0.048795003647426664,564,"Who, Who, Who do you want to see?"
5024,0,0,21,21,1.0,0.048795003647426664,564,"I specified that we want to hire older worker-learners, Ms Jones. Get these 'applicants' out of here."
5024,0,0,21,21,1.0,0.048795003647426664,564,"You're entitled to your opinion, but they say I'm a hoot!"
5024,0,0,21,21,1.0,0.048795003647426664,564,I've been elected to parliament.
5024,0,0,21,21,1.0,0.048795003647426664,564,"They don't give a hoot, you know -- they are all MPs in waiting, waiting to be admitted to the Parliament."
5024,0,0,21,21,1.0,0.048795003647426664,564,Who who who who who's here ?
5024,0,0,21,21,1.0,0.048795003647426664,564,You were right. I shouldn't have signed up for this Hogwarts messaging service while it was still in beta.
5024,0,0,23,23,1.0,0.044455422447438706,564,Were preparing our advertising pitch for Hooters.
5024,0,0,21,21,1.0,0.048795003647426664,564,"Now for the what, when and where."
5024,0,0,21,21,1.0,0.048795003647426664,564,Let's see if you think I'm still 'overcompensating' when that infernal mouse is gone.
5024,0,0,22,22,1.0,0.046524210519923545,564,"Our firm is virtual ""Who's Who"" in its field."
5024,0,0,21,21,1.0,0.048795003647426664,564,That won't make you any wiser.
5024,0,0,21,21,1.0,0.048795003647426664,564,Go ahead.Take your vacation.Owl keep my eyes on them.
5024,0,0,21,21,1.0,0.048795003647426664,564,"Actually, madam, this parliament is adjourned for lunch."
5024,0,0,21,21,1.0,0.048795003647426664,564,They're good at fielding but what I really need are bats.
5024,0,0,21,21,1.0,0.048795003647426664,564,I'll howl if I need you.
5024,0,0,21,21,1.0,0.048795003647426664,564,File with the flamingos.
5024,0,0,21,21,1.0,0.048795003647426664,564,"Nine or none, the employees still won't believe you give two hoots!"
5024,0,0,21,21,1.0,0.048795003647426664,564,"Sir, we can't hire them if they don't have an H-1B visa."
5024,0,0,21,21,1.0,0.048795003647426664,564,This isn't personal. It's a committee decision to end your employment.
5024,0,0,21,21,1.0,0.048795003647426664,564,They are awaiting a hearing by the senate judiciary committee.
5024,0,0,21,21,1.0,0.048795003647426664,564,We've been a little short on wisdom lately
5024,0,0,21,21,1.0,0.048795003647426664,564,Whooo is the wisest of them all?
5024,0,0,21,21,1.0,0.048795003647426664,564,Take the rest of the night off. We'll be fine.
5024,0,0,21,21,1.0,0.048795003647426664,564,"I preferred the bald eagle paper weights, but these were on sale."
5024,0,0,21,21,1.0,0.048795003647426664,564,"Well, we don't give a hoot what you think."
5024,0,0,21,21,1.0,0.048795003647426664,564,"Ms Brown, would you pick up a few bags of potato chips for the directors meeting this afternoon."
5024,0,0,21,21,1.0,0.048795003647426664,564,So how does this mail-blast thing work again?
5024,0,0,21,21,1.0,0.048795003647426664,564,What a hoot!
5024,0,0,21,21,1.0,0.048795003647426664,564,"I'm sorry, parliament is currently in session."
5024,0,0,21,21,1.0,0.048795003647426664,564,Call the pet shop and have them deliver nine mice.
5024,0,0,21,21,1.0,0.048795003647426664,564,"As the wise old owls say ""You are Fired"""
5024,0,0,24,24,1.0,0.04256282653793743,564,If we put these around the podium when Maxine Water or Michelle Obama speaks they may not appear to be so dumb.
5024,0,0,21,21,1.0,0.048795003647426664,564,"They don't carry company memos, they use them."
5024,0,0,21,21,1.0,0.048795003647426664,564,"Who are you? Who, Who, Who, Who?"
5024,0,0,21,21,1.0,0.048795003647426664,564,Hoo do you think you are with this wise guy routine?
5024,0,0,21,21,1.0,0.048795003647426664,564,"Jenny, you can send the vulture capitalists in now."
5024,0,0,21,21,1.0,0.048795003647426664,564,I tweeted that I give a hoot and viola.
5024,0,0,21,21,1.0,0.048795003647426664,564,"The Ministry of Magic isn't accepting my emails, Harriet. I'm sending that by owl."
5024,0,0,21,21,1.0,0.048795003647426664,564,Please! No wisecracks about my owls.
5024,0,0,21,21,1.0,0.048795003647426664,564,So then I say ‘Owl bet you can’t guess what I have on my desk’ – cracks me up every time.
5024,0,0,24,24,1.0,0.04256282653793743,564,You've taken this Harry Potter thing a bit too far.
5024,0,0,21,21,1.0,0.048795003647426664,564,I understand your grievances but you can't beat the working owls
5024,0,0,25,25,1.0,0.040824829046386304,564,Breaking news from He-Who-Must-Not-Be-Emailed.
5024,0,0,21,21,1.0,0.048795003647426664,564,Nancy this isn't what I meant when I said I need to see Parliament.
5024,0,0,21,21,1.0,0.048795003647426664,564,One is just an emergency backup.
5024,0,0,21,21,1.0,0.048795003647426664,564,"Whooooo, said that?"
5024,0,0,24,24,1.0,0.04256282653793743,564,Now where are the pussy cats!
5024,0,0,21,21,1.0,0.048795003647426664,564,"Well, you do shine through in a clutch."
5024,0,0,21,21,1.0,0.048795003647426664,564,"Wise as ... 1, 2, 3 ... 9 owls ? ... really Henry, your bespeckled bald head already does the trick"
5024,0,0,21,21,1.0,0.048795003647426664,564,You told me to let you know when your behavior ever started to seem weird.
5024,0,0,21,21,1.0,0.048795003647426664,564,"Margaret was not thrilled with the Owl Award, given after 25 years of service."
5024,0,0,21,21,1.0,0.048795003647426664,564,"I'm sorry, what was your name again?"
5024,0,0,21,21,1.0,0.048795003647426664,564,Do you see any pigeons?
5024,0,0,21,21,1.0,0.048795003647426664,564,What did I say about the flowers? We're an owl office.
5024,0,0,21,21,1.0,0.048795003647426664,564,who....who...who...who...who..who...who...who...whom shall I say is calling?
5024,0,0,21,21,1.0,0.048795003647426664,564,"Okay Bill, I won't argue with you about what you ""100% positively know for a fact"" I said, but honestly, why would *anyone* request a nine owl work day?"
5024,0,0,21,21,1.0,0.048795003647426664,564,Should I turn the desk to face the observation window?
5024,0,0,21,21,1.0,0.048795003647426664,564,Doctor Barnes why do you - oh I see!
5024,0,0,22,22,1.0,0.046524210519923545,564,"Martha, hoo do you think you need to be paid the same as?"
5024,0,0,23,23,1.0,0.044455422447438706,564,He won't take no for an answer this Mr. Potter.
5024,0,0,21,21,1.0,0.048795003647426664,564,"Frankly, we need people who give a hoot."
5024,0,0,22,22,1.0,0.046524210519923545,564,These are all the clients who refused to accept my help!
5024,0,0,22,22,1.0,0.046524210519923545,564,I've been waiting for someone to give a hoot.
5024,0,0,21,21,1.0,0.048795003647426664,564,Congratulations on winning the hoot court championship.
5024,0,0,21,21,1.0,0.048795003647426664,564,"I asked for all your ""ails"" to be put on my desk, Mrs. Wisenhunt."
5024,0,0,21,21,1.0,0.048795003647426664,564,Did you say anything about working for less than the legal minimum?
5024,0,0,21,21,1.0,0.048795003647426664,564,"Hoot, Hoover, Whoville, I've heard them all, Madge. Just get me a Yoo-hoo and send in Mr Yahoo."
5024,0,0,21,21,1.0,0.048795003647426664,564,"Whooooo am I meeting with today, Miss Jones?"
5024,0,0,21,21,1.0,0.048795003647426664,564,"They want to know who let the dogs out."" ""Who who who who who who?"
5024,0,0,21,21,1.0,0.048795003647426664,564,Hoo should I say is calling?
5024,0,0,21,21,1.0,0.048795003647426664,564,Who's my next appointment? Who? Who?
5024,0,0,22,22,1.0,0.046524210519923545,564,"Goodness gracious, what a hoot!"
5024,0,0,21,21,1.0,0.048795003647426664,564,Just whoo do you think you are?
5024,0,0,21,21,1.0,0.048795003647426664,564,This place is for the birds. I'm outta here!
5024,0,0,21,21,1.0,0.048795003647426664,564,New computer?
5024,0,0,21,21,1.0,0.048795003647426664,564,I'll retrieve your complaint document after an act by Parliament.
5024,0,0,21,21,1.0,0.048795003647426664,564,I owely have eyes for you.
5024,0,0,21,21,1.0,0.048795003647426664,564,Is this the information desk?
5024,0,0,21,21,1.0,0.048795003647426664,564,I thought there was just one wise old owl.
5024,0,0,21,21,1.0,0.048795003647426664,564,Are not you overdoing it a bit?
5024,0,0,21,21,1.0,0.048795003647426664,564,More focus and less pigeoning.
5024,0,0,21,21,1.0,0.048795003647426664,564,I'm not cleaning up their mess.
5024,0,0,21,21,1.0,0.048795003647426664,564,It's your 2 o'clock with the anti daylight savings lobby.
5024,0,0,22,22,1.0,0.046524210519923545,564,That sounds like a really hoot.
5024,0,0,21,21,1.0,0.048795003647426664,564,I still don't give a hoot!
5024,0,0,22,22,1.0,0.046524210519923545,564,"""With the proposed Trump budget, you're now looking at ten endangered species."
5024,0,0,21,21,1.0,0.048795003647426664,564,I'm hoping to enhance my nest egg.
5024,0,0,21,21,1.0,0.048795003647426664,564,Fine. Owl o-llow it.
5024,0,0,21,21,1.0,0.048795003647426664,564,"Good night, sir."
5024,0,0,21,21,1.0,0.048795003647426664,564,I want you to look into this and find out the owl and why of it.
5024,0,0,21,21,1.0,0.048795003647426664,564,"Is this a wise choice, Bromley?"
5024,0,0,21,21,1.0,0.048795003647426664,564,They're protesting the new EPA guidelines.
5024,0,0,21,21,1.0,0.048795003647426664,564,"Who are you, Olga, who who, who who?"
5024,0,0,21,21,1.0,0.048795003647426664,564,Howl are you today?
5024,0,0,21,21,1.0,0.048795003647426664,564,"Birds of a feather, Alice."
5024,0,0,21,21,1.0,0.048795003647426664,564,"WHO, WHO, WHO are you?"
5024,0,0,21,21,1.0,0.048795003647426664,564,"It's a room full of owls; a ""whom."""
5024,0,0,21,21,1.0,0.048795003647426664,564,Owl's are very smart. They were watching the rabbits and did as rabbits do.
5024,0,0,24,24,1.0,0.04256282653793743,564,"The problem with these stubborn students,Dean, is that they've got the ""who"" down pat, but they'll never be good reporters until they get the ""what"", ""why"", ""where"", and ""when""."
5024,0,0,21,21,1.0,0.048795003647426664,564,It's autosuggestion. So you'll let your daughter sail to Belize with me.
5024,0,0,21,21,1.0,0.048795003647426664,564,"They wanted to be first in line for the President's salary, but the mammal caucus already cut a deal."
5024,0,0,21,21,1.0,0.048795003647426664,564,"I've heard your request, Mrs. Adams, and frankly, I don't give a hoot."
5024,0,0,21,21,1.0,0.048795003647426664,564,Well...it beats bats in the belfrey
5024,0,0,21,21,1.0,0.048795003647426664,564,Just gearing up for the 'owlidays...
5024,0,0,21,21,1.0,0.048795003647426664,564,I don't give a hoot if this is their way of saying I am their wise leader.
5024,0,0,21,21,1.0,0.048795003647426664,564,"You tell him that I don't just give a hoot, I give 8 and a screech."
5024,0,0,21,21,1.0,0.048795003647426664,564,Well owl be darned...
5024,0,0,21,21,1.0,0.048795003647426664,564,It's Hooters' new desktop app.
5024,0,0,21,21,1.0,0.048795003647426664,564,"Yes ma'am, these are the Whos in Whoville that you put on hold."
5024,0,0,21,21,1.0,0.048795003647426664,564,I wasn't trying to ruffle any feathers.
5024,0,0,21,21,1.0,0.048795003647426664,564,"You are a very wise man, Mr. Jones."
5024,0,0,24,24,1.0,0.04256282653793743,564,Coulda fooled me; I didn't know you were so erudite. Now I see you're mentoring owls.
5024,0,0,21,21,1.0,0.048795003647426664,564,"Mrs. Bunion, Your money is AWOL!"
5024,0,0,21,21,1.0,0.048795003647426664,564,What have I told you about tying letters to the owls? We use email for a reason.
5024,0,0,21,21,1.0,0.048795003647426664,564,I am testing the osmosis principle and already feel wiser.
5024,0,0,21,21,1.0,0.048795003647426664,564,we haven't had a problem with rodents since we got them.
5024,0,0,21,21,1.0,0.048795003647426664,564,Because then I would only have eight.
5024,0,0,21,21,1.0,0.048795003647426664,564,"Letter to shareholders--All corporate assets have been converted to plastic owls, effectively cornering the market. Huge profits projected."
5024,0,0,21,21,1.0,0.048795003647426664,564,"Honey, our son wants Tootsie Pops for his birthday, not owls."
5024,0,0,21,21,1.0,0.048795003647426664,564,"""The temps have arrived. Plan on some late nights, Mrs. Rappaport."
5024,0,0,21,21,1.0,0.048795003647426664,564,"When one asks ""who"", I laugh, and shoot him, and say ""you, motherfucker."""
5024,0,0,21,21,1.0,0.048795003647426664,564,What makes you think we don't have the night shift covered?
5024,0,0,21,21,1.0,0.048795003647426664,564,"...and which ""little bird"" told you that?"
5024,0,0,21,21,1.0,0.048795003647426664,564,"Sir, this is a casting call for a Tootsie Roll commercial. The DMV is two doors down."
5024,0,0,21,21,1.0,0.048795003647426664,564,do you guys do owl post?
5024,0,0,21,21,1.0,0.048795003647426664,564,It makes me feel more secure.
5024,0,0,21,21,1.0,0.048795003647426664,564,Dumbeldor wanted to know if you got his messages.
5024,0,0,21,21,1.0,0.048795003647426664,564,"The H-owl-idays are coming. Sell these."""
5024,0,0,21,21,1.0,0.048795003647426664,564,"Harry, Hermione and Ron have been really worried since Donald decided to run for the headmaster post against Minerva McGonagall. Can you imagine that? A muggle in charge of Hogwarts!?"
5024,0,0,25,25,1.0,0.040824829046386304,564,"Strange as it may seem, they give ball players nowadays very peculiar names. As you can see, ..."
5024,0,0,21,21,1.0,0.048795003647426664,564,Me.
5024,0,0,22,22,1.0,0.046524210519923545,564,"No, of course I didn't take your owl. Why do you ask?"
5024,0,0,21,21,1.0,0.048795003647426664,564,Some customers are starting to complain about your new giveaway promotion.
5024,0,0,21,21,1.0,0.048795003647426664,564,"What do you mean, you can still see my hands?"
5024,0,0,22,22,1.0,0.046524210519923545,564,Well I don't give a hoot either.
5024,0,0,21,21,1.0,0.048795003647426664,564,Wiseacre.
5024,0,0,21,21,1.0,0.048795003647426664,564,Note all whooo accepted my meeting invite.
5024,0,0,21,21,1.0,0.048795003647426664,564,"Sorry, I don't give a hoot."
5024,0,0,21,21,1.0,0.048795003647426664,564,My decisions are based on a majority vote.
5024,0,0,21,21,1.0,0.048795003647426664,564,Send a memo to Potter and copy the staff.
5024,0,0,21,21,1.0,0.048795003647426664,564,DO YOU WANT THE WISE OR OTHERWISE ?
5024,0,0,21,21,1.0,0.048795003647426664,564,Is there something wrong with Potter's intercom?
5024,0,0,21,21,1.0,0.048795003647426664,564,I will only require security services until the third Thursday in November.
5024,0,0,21,21,1.0,0.048795003647426664,564,"Miss Jones, when I asked you to setup a meeting with members of parliament, this is not what I had in mind."
5024,0,0,25,25,1.0,0.040824829046386304,564,I said come back in nine hours!
5024,0,0,21,21,1.0,0.048795003647426664,564,Alright. Whoooo keeps pushing the buzzer?
5024,0,0,22,22,1.0,0.046524210519923545,564,"I didn't know the term was ""parliament"" but a bunch of owls doesn't make you prime minister!"
5024,0,0,22,22,1.0,0.046524210519923545,564,I was offended that they said I didn't give a hoot.
5024,0,0,21,21,1.0,0.048795003647426664,564,"Honey, I distinctly said I wanted a new 9-iron for my birthday."
5024,0,0,21,21,1.0,0.048795003647426664,564,"And I thought this job was for the birds, not the owl's"
5024,0,0,21,21,1.0,0.048795003647426664,564,Go ahead...tell me one more time which form of the word to use as the object of a preposition.
5024,0,0,21,21,1.0,0.048795003647426664,564,"Since even nine of them are, apparently, too subtle for you. GET OUT!"
5024,0,0,21,21,1.0,0.048795003647426664,564,"I see your advisers are in ""Who's Hoot."""
5024,0,0,21,21,1.0,0.048795003647426664,564,This was not what I had in mind when I asked you to implement HootSuite.
5024,0,0,22,22,1.0,0.046524210519923545,564,Hooters?
5024,0,0,21,21,1.0,0.048795003647426664,564,Now that I have my support group.....I don't give a hoot.
5024,0,0,21,21,1.0,0.048795003647426664,564,I need some owl food.
5024,0,0,21,21,1.0,0.048795003647426664,564,I didn't *literally* mean 'surround yourself with some wise old owls.'
5024,0,0,21,21,1.0,0.048795003647426664,564,I'm just tired of being corrected every five minutes.
5024,0,0,21,21,1.0,0.048795003647426664,564,I think the operable word here isn't what but who. (who in italics)
5024,0,0,21,21,1.0,0.048795003647426664,564,I'm pretty sure that the last owl is the ninth not the 9nd.
5024,0,0,21,21,1.0,0.048795003647426664,564,Miss Jones bring me a latte and 9 mice.
5024,0,0,21,21,1.0,0.048795003647426664,564,It's called a murder of crows but I'm not sure what you call a desk top full of owls.
5024,0,0,21,21,1.0,0.048795003647426664,564,We've been pranked by Hogwarts again.
5024,0,0,21,21,1.0,0.048795003647426664,564,I don't give a hoot Barnyard....I mean Barnie.
5024,0,0,21,21,1.0,0.048795003647426664,564,"I thought when you said you wanted to be in parliament, you meant something different."
5024,0,0,21,21,1.0,0.048795003647426664,564,"i do give a hoot, i didn't know you meant it literally !"
5024,0,0,21,21,1.0,0.048795003647426664,564,"Short of a diploma from Oxford, I think it shouts, ""Yikes, this man is wise!"" What do you think Marsha?"
5024,0,0,21,21,1.0,0.048795003647426664,564,"Nothing is pecking my seedlings, Ms. Witherall."
5024,0,0,21,21,1.0,0.048795003647426664,564,"I know you meant ""throw in the towel."""
5024,0,0,21,21,1.0,0.048795003647426664,564,All the little birdies told me.
5024,0,0,21,21,1.0,0.048795003647426664,564,But this is the nocturnal section.
5024,0,0,21,21,1.0,0.048795003647426664,564,"What makes you think I'm a night owl? No excuse, sir, I simply overslept!"
5024,0,0,21,21,1.0,0.048795003647426664,564,"""How Many Licks It Takes to Get to the Center of a Tootsie Pop"" is the only scientific research project you could get funding for?"
5024,0,0,21,21,1.0,0.048795003647426664,564,I told you that I don't give a hoot; in fact I don't give 9 hoots.
5024,0,0,22,22,1.0,0.046524210519923545,564,"My classes' teenagers voted laptops, not stuffed owls, as their cool prizes."
5024,0,0,21,21,1.0,0.048795003647426664,564,"Pleased to meet you. Hope you guessed my name, who, who... who, who!"
5024,0,0,21,21,1.0,0.048795003647426664,564,"Which one do you want me to cook for your dinner, sir?"
5024,0,0,21,21,1.0,0.048795003647426664,564,Ja! Nine!
5024,0,0,21,21,1.0,0.048795003647426664,564,"I've answered all their questions, why won't they just go away?"
5024,0,0,21,21,1.0,0.048795003647426664,564,"So just to be clear, you really don't care?"
5024,0,0,21,21,1.0,0.048795003647426664,564,My opinion about your promotional idea for the National Taxidermy Convention? Unwise.
5024,0,0,21,21,1.0,0.048795003647426664,564,Any reference books on owls?
5024,0,0,21,21,1.0,0.048795003647426664,564,I don't give a hoot what their numbers are!
5024,0,0,21,21,1.0,0.048795003647426664,564,hoo IS the chosen candidate!
5024,0,0,21,21,1.0,0.048795003647426664,564,With experience comes wisdom.
5024,0,0,21,21,1.0,0.048795003647426664,564,"So, nine pussycats, and nine pea green boats? And then what else?"
5024,0,0,21,21,1.0,0.048795003647426664,564,Reprimanded again for saying you couldn't give a hoot???
5024,0,0,21,21,1.0,0.048795003647426664,564,Ten coffee orders was not part of my original remit.
5024,0,0,21,21,1.0,0.048795003647426664,564,I agree. More wisdom will surely help.
5024,0,0,21,21,1.0,0.048795003647426664,564,"I know, Ms. Smith. If I give a hoot, I won't pollute."
5024,0,0,21,21,1.0,0.048795003647426664,564,"No, I would say it makes you a wise ass!"
5024,0,0,21,21,1.0,0.048795003647426664,564,"I don't think Sarah McLachlan wrote it as, ""Owls remember you."""
5024,0,0,21,21,1.0,0.048795003647426664,564,They're picketing at Hooters.
5024,0,0,21,21,1.0,0.048795003647426664,564,So this meeting's been a hoot...
5024,0,0,22,22,1.0,0.046524210519923545,564,"About your raise request, how many hoots would you like me give?"
5024,0,0,22,22,1.0,0.046524210519923545,564,"I said, ""We'll buy lunch from Hooters, not buy whoo-ters."""
5024,0,0,21,21,1.0,0.048795003647426664,564,"The less you say, the more they herd."
5024,0,0,21,21,1.0,0.048795003647426664,564,"We give a hoot, that's who!"
5024,0,0,21,21,1.0,0.048795003647426664,564,Because you're way over the hill (and crows had sold out).
5024,0,0,21,21,1.0,0.048795003647426664,564,"I understand the pun, Jeffrey, but the Christmas party won't be a ""hoot"" with 10 untrained owls there."
5024,0,0,21,21,1.0,0.048795003647426664,564,"I see your ""I don't give a hoot"" Ms Markham, and raise you..."
5024,0,0,21,21,1.0,0.048795003647426664,564,Could you take care of the mails Mrs Rowling's been sending about her payments? I do have other authors to attend to you see
5024,0,0,21,21,1.0,0.048795003647426664,564,"Remember the owl from 'Twin Peaks'? Well, that was actually played by nine different owls, and now I have to take care of them until I die."
5024,0,0,21,21,1.0,0.048795003647426664,564,Any message for me?
5024,0,0,21,21,1.0,0.048795003647426664,564,"Complicated, isn't it, Mr. Thurston?"
5024,0,0,21,21,1.0,0.048795003647426664,564,"Who's who, you ask?"
5024,0,0,21,21,1.0,0.048795003647426664,564,The question is not 'Which?' but 'Who?'
5024,0,0,21,21,1.0,0.048795003647426664,564,"Wise guy, huh?"
5024,0,0,22,22,1.0,0.046524210519923545,564,"Who bought all these owls, Janet? WHO, WHO?!"
5024,0,0,21,21,1.0,0.048795003647426664,564,"Janet, I said 'Billable hours on my desk by 3 PM.' 'Hours.'"
5024,0,0,21,21,1.0,0.048795003647426664,564,"Oh yeah? Well hoooo do you think you are, Joanne?"
5024,0,0,21,21,1.0,0.048795003647426664,564,They prey on twitters.
5024,0,0,21,21,1.0,0.048795003647426664,564,Still trying to get to Word Brain Owl level 9 boss? You can get the answers on the web you know.
5024,0,0,21,21,1.0,0.048795003647426664,564,Th I've told them who's getting a pink slip. They will deliver the news and keep me out of it...
5024,0,0,22,22,1.0,0.046524210519923545,564,``I count ten.''
5024,0,0,21,21,1.0,0.048795003647426664,564,"Johnson can say whatever he wants about me, Miss Danvers. But just like this desktop full of mute owls, I don't give a hoot."
5024,0,0,22,22,1.0,0.046524210519923545,564,"I know, Miss Smith, a wise old owl told me."
5024,0,0,21,21,1.0,0.048795003647426664,564,"Miss Jones, get me the Hitchcock file."
5024,0,0,21,21,1.0,0.048795003647426664,564,Feeling any wiser?
5024,0,0,21,21,1.0,0.048795003647426664,564,Some honorable members.
5024,0,0,21,21,1.0,0.048795003647426664,564,He's not for sale.
5024,0,0,21,21,1.0,0.048795003647426664,564,"You mean it wasn't 1 mouse and 9 calzones? Oops, got lunch wrong again."
5024,0,0,21,21,1.0,0.048795003647426664,564,"I'm sorry, but we think you don't fit in on the night shift."
5024,0,0,21,21,1.0,0.048795003647426664,564,I'm thinking that's a wise decision Mr. Hooty.
5024,0,0,21,21,1.0,0.048795003647426664,564,They are all indifferent. They don't give a hoot!
5024,0,0,21,21,1.0,0.048795003647426664,564,Yes I do realize they're magical but Royal Mail would be 37% less than what we spend on mice.
5024,0,0,21,21,1.0,0.048795003647426664,564,Of course there are no pigeons or other pests in here. It's working!
5024,0,0,21,21,1.0,0.048795003647426664,564,"Yes, I'm the president of 'Hooters'. What were you expecting"
5024,0,0,21,21,1.0,0.048795003647426664,564,"You Mr. Wilson, you, you, you, that's who."
5024,0,0,22,22,1.0,0.046524210519923545,564,"I don't give a hoot, we are not returning night deliveries"
5024,0,0,21,21,1.0,0.048795003647426664,564,Oh I give a hoot and then some!
5024,0,0,21,21,1.0,0.048795003647426664,564,My loan officers have looked into your finances and determined they do not give a hoot about any of this.
5024,0,0,21,21,1.0,0.048795003647426664,564,Who are you trying to blame? Who? Who?
5024,0,0,22,22,1.0,0.046524210519923545,564,Herbert that is too many owls to have in a work environment.
5024,0,0,21,21,1.0,0.048795003647426664,564,Who's envious?
5024,0,0,21,21,1.0,0.048795003647426664,564,I still think there are more practical ways to demonstrate that this is the same as 18 in the bush.
5024,0,0,21,21,1.0,0.048795003647426664,564,"They're called ""Motivational Mascots."" Every employee will get one."
5024,0,0,21,21,1.0,0.048795003647426664,564,Why did I put all these birds on my desk? I thought it would be a hoot.
5024,0,0,21,21,1.0,0.048795003647426664,564,I don't think we have much on owls. Sorry.
5024,0,0,21,21,1.0,0.048795003647426664,564,I think the boss said a permanent not parliament solution.
5024,0,0,21,21,1.0,0.048795003647426664,564,You can run but you can't hide.
5024,0,0,22,22,1.0,0.046524210519923545,564,well where did you think the answers came from?
5024,0,0,21,21,1.0,0.048795003647426664,564,"Oh, they told me you were a yes-man, not a hoo-man."
5024,0,0,21,21,1.0,0.048795003647426664,564,Who do you like?
5024,0,0,21,21,1.0,0.048795003647426664,564,I thought we could use more fun in the office. Aren't they a hoot?
5024,0,0,21,21,1.0,0.048795003647426664,564,We google the ole' fashioned way.
5024,0,0,21,21,1.0,0.048795003647426664,564,"If you're looking for my inbox, I'm using it for potty training."
5024,0,0,21,21,1.0,0.048795003647426664,564,Are you owlright?
5024,0,0,21,21,1.0,0.048795003647426664,564,You should see all the elephinos in my office.
5024,0,0,21,21,1.0,0.048795003647426664,564,The only thing to do now is turn my head.
5024,0,0,21,21,1.0,0.048795003647426664,564,"Who said ""Birds can't swim""?"
5024,0,0,21,21,1.0,0.048795003647426664,564,We had to downsize our human resources department.
5024,0,0,22,22,1.0,0.046524210519923545,564,This will be owl problem.
5024,0,0,21,21,1.0,0.048795003647426664,564,I was led to believe it was #internationaltakeowlstoworkday.
5024,0,0,21,21,1.0,0.048795003647426664,564,"Frankly, Miss Butler, I don't give a hoot."
5024,0,0,21,21,1.0,0.048795003647426664,564,"Hey pussycat, pick me!"
5024,0,0,21,21,1.0,0.048795003647426664,564,Does this make me a member of Parliament?
5024,0,0,21,21,1.0,0.048795003647426664,564,"They come from a 5 year tenure at the Tyrell Corporation, and yes, they're artificial."
5024,0,0,21,21,1.0,0.048795003647426664,564,I thought they'd help with our mouse problem.
5024,0,0,21,21,1.0,0.048795003647426664,564,My Secret Santa is a taxidermist.
5024,0,0,21,21,1.0,0.048795003647426664,564,"You're a real hoot, Mr. Jacobson."
5024,0,0,21,21,1.0,0.048795003647426664,564,"No, Miss Jackson, not a parliament of owls - a minyan. We need one more."
5024,0,0,21,21,1.0,0.048795003647426664,564,Yes our board of directors is a parliament of owls.
5024,0,0,21,21,1.0,0.048795003647426664,564,If you don't water that potted plant it's going to die.
5024,0,0,24,24,1.0,0.04256282653793743,564,These Who's Who offers are getting ridiculous.
5024,0,0,21,21,1.0,0.048795003647426664,564,"You're right, Margaret. I stink as your night manager. Here's hoping these night owls can mentor me."
5024,0,0,21,21,1.0,0.048795003647426664,564,I'm running for parliament
5024,0,0,21,21,1.0,0.048795003647426664,564,"Okay, I apologize for calling ypu a wise old bird"
5024,0,0,21,21,1.0,0.048795003647426664,564,"Since I no longer give a hoot, I've decided to outsource the job."
5024,0,0,21,21,1.0,0.048795003647426664,564,This human scarecrow was a waste of budget.
5024,0,0,21,21,1.0,0.048795003647426664,564,"Frankly, Ms. Wiseman, I don't give a hoot about my next appointment. I'm waiting on a call from 'parliament!'"
5024,0,0,21,21,1.0,0.048795003647426664,564,"Thanks to the nuclear option, we're back at full strength."
5024,0,0,24,24,1.0,0.04256282653793743,564,Do you really think that is wise?
5024,0,0,24,24,1.0,0.04256282653793743,564,I give one a poke anytime someone asks for a biography.
5024,0,0,21,21,1.0,0.048795003647426664,564,"I'm sorry, but no. Besides, it's take YOUR owls to work day."
5024,0,0,21,21,1.0,0.048795003647426664,564,Whose hoo is who?
5024,0,0,21,21,1.0,0.048795003647426664,564,"Sorry sir, you've just been awarded another ""Wise Old Owl"" trophy."
5024,0,0,21,21,1.0,0.048795003647426664,564,"No, I will not have sex with them either."
5024,0,0,21,21,1.0,0.048795003647426664,564,Hoooo... were you expecting to see?
5024,0,0,24,24,1.0,0.04256282653793743,564,They're starting to make me not give a hoot.
5024,0,0,21,21,1.0,0.048795003647426664,564,Legal says it does take nine.
5024,0,0,21,21,1.0,0.048795003647426664,564,"...so the explanation for this, as you see, is perfectly simple."
5024,0,0,21,21,1.0,0.048795003647426664,564,"Miss Smith, Miss Smith, Miss Smith, etc."
5024,0,0,21,21,1.0,0.048795003647426664,564,"This Parliament of Owls might be wise, but they're not very smart."
5024,0,0,21,21,1.0,0.048795003647426664,564,Jealous?
5024,0,0,21,21,1.0,0.048795003647426664,564,We all agree. 'Who' is better than 'whom'.
5024,0,0,21,21,1.0,0.048795003647426664,564,No one's laughing jackass.
5024,0,0,21,21,1.0,0.048795003647426664,564,"Frankly, Miss Oliver, the complaint department does not give a hoot about your complaint. The men can leave the toilet seats up in the unisex bathroom."
5024,0,0,21,21,1.0,0.048795003647426664,564,"After filming this scene, Hitchcock decided to order script rewrites."
5024,0,0,21,21,1.0,0.048795003647426664,564,"Apparently, I'm supposed to give a hoot!"
5024,0,0,21,21,1.0,0.048795003647426664,564,"I need the Wilson file, the Lewis contract and nine lollipops."
5024,0,0,21,21,1.0,0.048795003647426664,564,They're supposed to scare away crows but they work on co-workers too.
5024,0,0,21,21,1.0,0.048795003647426664,564,I've already given two hoots!
5024,0,0,21,21,1.0,0.048795003647426664,564,What do you mean ‘All the job positions at Hooters have already been filled’?
5024,0,0,21,21,1.0,0.048795003647426664,564,"More work? Ah, c'est trop chouette!"
5024,0,0,21,21,1.0,0.048795003647426664,564,The owls are not what they seem.
5024,0,0,21,21,1.0,0.048795003647426664,564,I practicing owlgebra
5024,0,0,21,21,1.0,0.048795003647426664,564,I told you ten times WHO my meeting is with!
5024,0,0,21,21,1.0,0.048795003647426664,564,"Sir, the applicants are here for the Hooters job."
5024,0,0,23,23,1.0,0.044455422447438706,564,"Madam, I don't give a hoot."
5024,0,0,21,21,1.0,0.048795003647426664,564,We're waiting for Glimfeather.
5024,0,0,21,21,1.0,0.048795003647426664,564,I could give a hoot.
5024,0,0,21,21,1.0,0.048795003647426664,564,You gonna fuck ALL dem birds?
5024,0,0,21,21,1.0,0.048795003647426664,564,"In this office we say ""Owl do you do?"
5024,0,0,23,23,1.0,0.044455422447438706,564,"long night last night sir? Sorry, but you're still an idiot."
5024,0,0,27,27,1.0,0.03774256780481986,564,I've already told you my name 16 times.
5024,0,0,21,21,1.0,0.048795003647426664,564,I'm addicted to Parliaments.
5024,0,0,21,21,1.0,0.048795003647426664,564,"I said, I don't know hoo."
5024,0,0,21,21,1.0,0.048795003647426664,564,"Bonnie, I have to tell you, I don't give a hoot...I collect them."
5024,0,0,21,21,1.0,0.048795003647426664,564,"I've lost count, but they're roughly the 94th sign of the apocalypse."
5024,0,0,21,21,1.0,0.048795003647426664,564,It's a whoooo's hooooooo with Tax day at Hogwarts.
5024,0,0,21,21,1.0,0.048795003647426664,564,Eight of my nine advisers recommend your dismissal.
5024,0,0,21,21,1.0,0.048795003647426664,564,"Actually, the De-hoo-ey Decimal System."
5024,0,0,21,21,1.0,0.048795003647426664,564,"Just Bixby's little joke, Ms Larson;apparently What's His Name has been confirmed. Is my squirting lapel pin still in your desk?"
5024,0,0,21,21,1.0,0.048795003647426664,564,Hoo hoo's on first?
5024,0,0,22,22,1.0,0.046524210519923545,564,"Obviously, I don't give a hoot!"
5024,0,0,21,21,1.0,0.048795003647426664,564,"I just coined a new phrase: ""Like a desk full of owls."""
5024,0,0,21,21,1.0,0.048795003647426664,564,"Okay, Which one of you out glue on my seat?"
5024,0,0,21,21,1.0,0.048795003647426664,564,"Okay, Which one of you out glue on my seat?"
5024,0,0,21,21,1.0,0.048795003647426664,564,"It's for our new TV show, WHOO Do You Think You Are?"
5024,0,0,21,21,1.0,0.048795003647426664,564,Hoo wants to see me?
5024,0,0,21,21,1.0,0.048795003647426664,564,"I've always wanted to be a parliament member, even if only a parliament of owls."
5024,0,0,21,21,1.0,0.048795003647426664,564,The new desk sharing policy is not working as planned
5024,0,0,21,21,1.0,0.048795003647426664,564,"Mrs. Sharp, just turn out the lights when you leave the room."
5024,0,0,21,21,1.0,0.048795003647426664,564,"I get it, Frank. You're one of the who's who of audit managers."
5024,0,0,21,21,1.0,0.048795003647426664,564,This is how many hoots I give.
5024,0,0,21,21,1.0,0.048795003647426664,564,Your problems are not my problems. I don't give a hoo.
5024,0,0,21,21,1.0,0.048795003647426664,564,I'm not sure this is a wise move.
5024,0,0,21,21,1.0,0.048795003647426664,564,"Just ""who"" do you think will repair our email hack?"
5024,0,0,23,23,1.0,0.044455422447438706,564,"So it IS a 76% yes. Miss Pilkington, call the Wedding Planner."
5024,0,0,21,21,1.0,0.048795003647426664,564,hm i'll take all of them
5024,0,0,21,21,1.0,0.048795003647426664,564,h'owl you our company better?
5024,0,0,21,21,1.0,0.048795003647426664,564,I told Joe we'll take the night shift.
5024,0,0,21,21,1.0,0.048795003647426664,564,Apparently they've decided to convene parliament on my desk.
5024,0,0,21,21,1.0,0.048795003647426664,564,Whooo knew?
5024,0,0,21,21,1.0,0.048795003647426664,564,Birds of a feather sir?
5024,0,0,21,21,1.0,0.048795003647426664,564,I've assembled an army of the finest troops from across the country. We attack at sunrise.
5024,0,0,21,21,1.0,0.048795003647426664,564,There's a squeeze on barns.
5024,0,0,21,21,1.0,0.048795003647426664,564,"No, no cream or sugar. Just nine mice."
5024,0,0,21,21,1.0,0.048795003647426664,564,"They scare away birds, squirrels and other pests, I guess they don't work on old bats."
5024,0,0,22,22,1.0,0.046524210519923545,564,"Seriously, Linda, what's all the hoot about?"
5024,0,0,21,21,1.0,0.048795003647426664,564,tell my wife we'll be working late tonight.
5024,0,0,21,21,1.0,0.048795003647426664,564,My consultants are all here.
5024,0,0,21,21,1.0,0.048795003647426664,564,Owl see you on the unemployment line.
5024,0,0,21,21,1.0,0.048795003647426664,564,Boss said he didn't give a hoot where we found the wise counsel.
5024,0,0,21,21,1.0,0.048795003647426664,564,Just file them all under 'O'.
5024,0,0,21,21,1.0,0.048795003647426664,564,You're right. I don't care a hoot.
5024,0,0,21,21,1.0,0.048795003647426664,564,I'm running for parliament
5024,0,0,21,21,1.0,0.048795003647426664,564,I think they're part rabbit.
5024,0,0,21,21,1.0,0.048795003647426664,564,This IS the parliament.
5024,0,0,21,21,1.0,0.048795003647426664,564,"Sir, in 5 minutes the conference room is yours!"
5024,0,0,21,21,1.0,0.048795003647426664,564,THEY might give a hoot.
5024,0,0,21,21,1.0,0.048795003647426664,564,I must fix the 'B' on my keyboard.
5024,0,0,21,21,1.0,0.048795003647426664,564,Owl of you are fired. Your mnemonic devices are no longer needed. Whoo gives a hoot.
5024,0,0,21,21,1.0,0.048795003647426664,564,Doctor Who
5024,0,0,21,21,1.0,0.048795003647426664,564,I'm cornering the market on owls.
5024,0,0,21,21,1.0,0.048795003647426664,564,"Final preparation-trophies for the ""Hootie Awards""."
5024,0,0,21,21,1.0,0.048795003647426664,564,"Yes, Ms. Prothero, the collective noun for owls is 'parliament.' Now take your terms of venery, and Owl be right with you!"
5024,0,0,21,21,1.0,0.048795003647426664,564,Honors class.
5024,0,0,21,21,1.0,0.048795003647426664,564,We're preparing for the inevitable defunding of the postal service.
5024,0,0,21,21,1.0,0.048795003647426664,564,How are you planning to get all that wisdom to leave?
5024,0,0,21,21,1.0,0.048795003647426664,564,You deserve more wisdom.
5024,0,0,21,21,1.0,0.048795003647426664,564,"Parliamentary, my dear Miss Watson."
5024,0,0,21,21,1.0,0.048795003647426664,564,They came with the new eyeglasses.
5024,0,0,21,21,1.0,0.048795003647426664,564,Do you think it wise to name your potato chip company after an old owl?
5024,0,0,21,21,1.0,0.048795003647426664,564,They make me look smarter.
5024,0,0,21,21,1.0,0.048795003647426664,564,"Ever since you were a young boy, you played that silver ball."
5024,0,0,21,21,1.0,0.048795003647426664,564,Hmm. These were supposed to work on ANY species!
5024,0,0,21,21,1.0,0.048795003647426664,564,They swarmed to my desk as soon as I mentioned the latest office romance.
5024,0,0,21,21,1.0,0.048795003647426664,564,"They belong in a barn, but the decorative effect can't be beat."
5024,0,0,21,21,1.0,0.048795003647426664,564,"Your report is impressive, but the other Tootsie Pop quants say the answer is three licks."
5024,0,0,21,21,1.0,0.048795003647426664,564,"Hey Barb, did you know a group if owls is called a parliament?"
5024,0,0,21,21,1.0,0.048795003647426664,564,"What do you mean, ""why?"""
5024,0,0,21,21,1.0,0.048795003647426664,564,"No, I haven't seen any mice recently, but HR is not going to accept that as a valid excuse."
5024,0,0,23,23,1.0,0.044455422447438706,564,How many pussycats did you want?
5024,0,0,21,21,1.0,0.048795003647426664,564,They're part of our new Hogwarts theme.
5024,0,0,21,21,1.0,0.048795003647426664,564,"Your children are here to see you, Mr. Smith."" ""Who?"
5024,0,0,21,21,1.0,0.048795003647426664,564,Contact Horton ASAP and tell him he heard correctly.
5024,0,0,23,23,1.0,0.044455422447438706,564,Lumosity was a bust.
5024,0,0,21,21,1.0,0.048795003647426664,564,Mike said he saw a mouse in the break room
5024,0,0,22,22,1.0,0.046524210519923545,564,"Feel free to look around before you choose who you'll take, owl wait."
5024,0,0,21,21,1.0,0.048795003647426664,564,I told you we get a better value for our money if we buy it from Costco.
5024,0,0,21,21,1.0,0.048795003647426664,564,Really?
5024,0,0,21,21,1.0,0.048795003647426664,564,"No, George. The rest of us will absolutely not refer to your work space as the Parliament Funkadelic."
5024,0,0,21,21,1.0,0.048795003647426664,564,"Im sorry Agnes, only the owly employees are eligible for O.T."
5024,0,0,21,21,1.0,0.048795003647426664,564,Let me guess-the boss wants to see me again?
5024,0,0,21,21,1.0,0.048795003647426664,564,You're still fired.
5024,0,0,21,21,1.0,0.048795003647426664,564,"Every move you make, owl be watching you."
5024,0,0,21,21,1.0,0.048795003647426664,564,Owl consider your promotion because we give a hoot.
5024,0,0,21,21,1.0,0.048795003647426664,564,I ordered a dozen!
5024,0,0,27,27,1.0,0.03774256780481986,564,"It's okay, Ms. Peabody, the Endangered Employees Act was just repealed."
5024,0,0,21,21,1.0,0.048795003647426664,564,They are protecting me from rats Mary...
5024,0,0,22,22,1.0,0.046524210519923545,564,Could you bring me back a bagel and coffee and nine mice?
5024,0,0,21,21,1.0,0.048795003647426664,564,Well this office party is sure a hoot.
5024,0,0,21,21,1.0,0.048795003647426664,564,They've hired us to counsel them concerning whether they can legally name their rock band The Whos.
5024,0,0,21,21,1.0,0.048795003647426664,564,"Yes, the all nighter was very productive."
5024,0,0,21,21,1.0,0.048795003647426664,564,"I'm sorry, sir -- she said they were out of the Great Horned. Will these be suitable instead?"
5024,0,0,21,21,1.0,0.048795003647426664,564,"Miss Jenkins, take a letter: Dear J.K. Rowling,"
5024,0,0,21,21,1.0,0.048795003647426664,564,I keep them because they turn heads.
5024,0,0,21,21,1.0,0.048795003647426664,564,"Frankly, Mr. Smith... I don't give a hoot."
5024,0,0,21,21,1.0,0.048795003647426664,564,Keep trying Margret. I know I saw that blue duck. There has to be something other than stuffed owls in the claw machine.
5024,0,0,21,21,1.0,0.048795003647426664,564,Works well with others.
5024,0,0,21,21,1.0,0.048795003647426664,564,Welcome to Hootsuite. Don't ask what we do or how we make money — you don't want to know.
5024,0,0,22,22,1.0,0.046524210519923545,564,This is our new staff of total geniuses.
5024,0,0,21,21,1.0,0.048795003647426664,564,"""Who""wants to know?"
5024,0,0,21,21,1.0,0.048795003647426664,564,Hogwarts had to re-home a few.
5024,0,0,21,21,1.0,0.048795003647426664,564,I got tired of the spotty internet connection while I do my research.
5024,0,0,23,23,1.0,0.044455422447438706,564,Owl get back to you.
5024,0,0,21,21,1.0,0.048795003647426664,564,"These wise old owls were fired by Trump. They were replaced by vultures, billionaires and family members."
5024,0,0,21,21,1.0,0.048795003647426664,564,Guard the front door. We gotta scat.
5024,0,0,21,21,1.0,0.048795003647426664,564,Frank didn't even give a hoot about the mess.
5024,0,0,21,21,1.0,0.048795003647426664,564,"Well, they didn't make me any smarter."
5024,0,0,21,21,1.0,0.048795003647426664,564,Checkmate.
5024,0,0,21,21,1.0,0.048795003647426664,564,"I'm holding auditions for my ""Who's On First"" routine."
5024,0,0,21,21,1.0,0.048795003647426664,564,"Our board of directors told me to use maximum wisdom, so I created an advisory board loaded with impeccable qualifications."
5024,0,0,21,21,1.0,0.048795003647426664,564,Howl if you need me.
5024,0,0,21,21,1.0,0.048795003647426664,564,"And this is our Board of Directors at ""Who's Who""."
5024,0,0,21,21,1.0,0.048795003647426664,564,We're looking for a pussycat.
5024,0,0,21,21,1.0,0.048795003647426664,564,They are the process. It replaces purpose.
5024,0,0,21,21,1.0,0.048795003647426664,564,"As you can see, Lechuza and Athene Noctua are still missing."
5024,0,0,21,21,1.0,0.048795003647426664,564,*These* are the new environmentally-friendly pencil sharpeners?
5024,0,0,21,21,1.0,0.048795003647426664,564,"I'm sorry, this might take owl night to finish my work"
5024,0,0,21,21,1.0,0.048795003647426664,564,"Oh Harold, you're a hoot!"
5024,0,0,21,21,1.0,0.048795003647426664,564,They don't call me the office wise guy for nothing.
5024,0,0,22,22,1.0,0.046524210519923545,564,Whodunit? Who indeed?
5024,0,0,21,21,1.0,0.048795003647426664,564,"In this department, the question we need to figure out isn't 'Who's who?' but rather 'Whose hoo?'"
5024,0,0,21,21,1.0,0.048795003647426664,564,Wisdom doesn't come cheap.
5024,0,0,21,21,1.0,0.048795003647426664,564,Susan explains to John she moved to a new office because of the mice problem.
5024,0,0,22,22,1.0,0.046524210519923545,564,Is this the parliament that voted for Brexit?
5024,0,0,21,21,1.0,0.048795003647426664,564,"Well, that settles it Doris, I'm heading to wizarding school."
5024,0,0,21,21,1.0,0.048795003647426664,564,I'm getting inspiration for my who-dunnit.
5024,0,0,21,21,1.0,0.048795003647426664,564,"Diane, unplug the router. I'm moving all communication to O-mail."
5024,0,0,21,21,1.0,0.048795003647426664,564,"Yes, Ms. Johnson, it does appear to be quite the ""Whoo""-dunit. Now let's start trying to track down my phone and computer, shall we?"
5024,0,0,21,21,1.0,0.048795003647426664,564,Employees are expected to bring their own grandfather clocks.
5024,0,0,22,22,1.0,0.046524210519923545,564,"A WISE OLD OWL ONCE SAID,WHOOO.."
5024,0,0,21,21,1.0,0.048795003647426664,564,They won't leave until we correct the fake news about early birds. They say they've got all night if they need to.
5024,0,0,21,21,1.0,0.048795003647426664,564,The Harry Potter Effect may actually be more responsible for society's devolving communication than social media.
5024,0,0,21,21,1.0,0.048795003647426664,564,"""Do you know who I am""?"
5024,0,0,23,23,1.0,0.044455422447438706,564,"Your proposal isn't turning any heads with the shareholders, I'm afraid."
5024,0,0,21,21,1.0,0.048795003647426664,564,"You know, there's an easier way to send a group text."
5024,0,0,21,21,1.0,0.048795003647426664,564,"My intended captionss for the previous contest were either ""Sorry, I've gotta run"" or ""Don't mind the panting, I'm staying in shape for when my clients come after me."" I realize these entries are too late. Such is the story of my life!"
5024,0,0,24,24,1.0,0.04256282653793743,564,"Will you send the chef up here, please?"
5024,0,0,21,21,1.0,0.048795003647426664,564,My penguins have nine lives.
5024,0,0,23,23,1.0,0.044455422447438706,564,Who approved this?
5024,0,0,21,21,1.0,0.048795003647426664,564,Who do you want to stay at my post?
5024,0,0,22,22,1.0,0.046524210519923545,564,"I'm sorry, who are you looking for?"
5024,0,0,21,21,1.0,0.048795003647426664,564,Quiet please; parliament is in session.
5024,0,0,21,21,1.0,0.048795003647426664,564,Eeylops Owl Emporium has really gone corporate.
5024,0,0,21,21,1.0,0.048795003647426664,564,Owl'll you get them all home?
5024,0,0,21,21,1.0,0.048795003647426664,564,Owl toys? I asked for Altoids!
5024,0,0,21,21,1.0,0.048795003647426664,564,You say someone ordered field mice with the expense account? Hmm. I wonder who.
5024,0,0,21,21,1.0,0.048795003647426664,564,They have H1-Owl visas.
5024,0,0,21,21,1.0,0.048795003647426664,564,Are these your children?
5024,0,0,23,23,1.0,0.044455422447438706,564,Work has suddenly gotten burdensome.
5024,0,0,21,21,1.0,0.048795003647426664,564,The HR Department says owls are exempt from sexual harassment charges.
5024,0,0,21,21,1.0,0.048795003647426664,564,Whom shall I say is calling?
5024,0,0,21,21,1.0,0.048795003647426664,564,I always feel bad tossing these Hogwarts Alumni event invites.
5024,0,0,21,21,1.0,0.048795003647426664,564,"The meeting was 'heated,' said nine government officials who spoke on condition of anonymity."
5024,0,0,21,21,1.0,0.048795003647426664,564,"Because the wise are attracted to the wise, Madge."
5024,0,0,21,21,1.0,0.048795003647426664,564,I'm re-openning the Tootsie Pop study.
5024,0,0,24,24,1.0,0.04256282653793743,564,Hoosier daddy.
5024,0,0,21,21,1.0,0.048795003647426664,564,What do you mean? I'm sitting right here.
5024,0,0,21,21,1.0,0.048795003647426664,564,"What do you mean, ""illegible""?"
5024,0,0,21,21,1.0,0.048795003647426664,564,"Introduce me to your owls, Al who's who/"
5024,0,0,21,21,1.0,0.048795003647426664,564,"Unlike your wand, Ms. Potter, you must choose your owl."
5024,0,0,21,21,1.0,0.048795003647426664,564,"I've consulted with my advisory board and we feel the best path forward is to ask ""who, who""."
5024,0,0,21,21,1.0,0.048795003647426664,564,I thought they could help in locating the Wingert v. Mouse files.
5024,0,0,22,22,1.0,0.046524210519923545,564,I was thinking we should move to a parliamentary system
5024,0,0,21,21,1.0,0.048795003647426664,564,It's the Family's Brain Trust of the Executive Branch
5024,0,0,21,21,1.0,0.048795003647426664,564,"I make the decisions around here. That's who, who, who, who, who, who, who, who, who, who!"
5024,0,0,21,21,1.0,0.048795003647426664,564,You should see my collection of pussycats.
5024,0,0,21,21,1.0,0.048795003647426664,564,Who's the dumb schmuck now?!
5024,0,0,21,21,1.0,0.048795003647426664,564,"Who, who, who, who, who, who, who, who, who's asking?"
5024,0,0,21,21,1.0,0.048795003647426664,564,"They're surprisingly easy to house train, but my wife left me after I got the fifth one."
5024,0,0,21,21,1.0,0.048795003647426664,564,"This is a fine mess we're in, Owly!"
5024,0,0,21,21,1.0,0.048795003647426664,564,"Would you say that I have a plethora of desk owls, Ms. Higgins?"
5024,0,0,21,21,1.0,0.048795003647426664,564,"And bring us a large bowl of mice for our lunch, please."
5024,0,0,21,21,1.0,0.048795003647426664,564,"Sir, The Other 10 Owls You've Ordered Have Arrived"
5024,0,0,23,23,1.0,0.044455422447438706,564,"Don't apologize, Beth. We here at Wise Enterprises LIKE mice."
5024,0,0,21,21,1.0,0.048795003647426664,564,I think they're here to protest disenfranchisement of a minority class.
5024,0,0,21,21,1.0,0.048795003647426664,564,It's research for my book on Owsly LSD.
5024,0,0,23,23,1.0,0.044455422447438706,564,Hoo...are...you?
5024,0,0,21,21,1.0,0.048795003647426664,564,Whooo Whooo Whooo wants to know?
5024,0,0,21,21,1.0,0.048795003647426664,564,"I know you hate lawyers, but those will only keep away actual rats."
5024,0,0,21,21,1.0,0.048795003647426664,564,Who did you want to see?
5024,0,0,21,21,1.0,0.048795003647426664,564,You're the one who encouraged me to start bird watching.
5024,0,0,22,22,1.0,0.046524210519923545,564,It is the decision of the board that the staff will need to begin working nights.
5024,0,0,21,21,1.0,0.048795003647426664,564,Premature Owlsheimers.
5024,0,0,21,21,1.0,0.048795003647426664,564,The glasses and mustache makes our mascot look much smarter.
5024,0,0,21,21,1.0,0.048795003647426664,564,"All I sais was ""I don't give a hoot."""
5024,0,0,23,23,1.0,0.044455422447438706,564,"I'm sorry, Ms. Michaels, but the Board and I have decided that further diversity is out of the question."
5024,0,0,22,22,1.0,0.046524210519923545,564,They do wonders for my wisdom quotient.
5024,0,0,21,21,1.0,0.048795003647426664,564,"I can't believe we failed to make ""Hoo's Hoo"" again."
5024,0,0,21,21,1.0,0.048795003647426664,564,"You know, most people just frame their degree."
5024,0,0,22,22,1.0,0.046524210519923545,564,Hoot old you Owl do anything for a bad pun?
5024,0,0,21,21,1.0,0.048795003647426664,564,Hoo... hoo... hoo are you looking at?
5024,0,0,21,21,1.0,0.048795003647426664,564,My goal this quarter is to wise up.
5024,0,0,21,21,1.0,0.048795003647426664,564,I need you to set up my twitter account
5024,0,0,21,21,1.0,0.048795003647426664,564,"Since you'll be working a lot at night, I brought some friends to keep you company."
5024,0,0,21,21,1.0,0.048795003647426664,564,"I'm tellin' you, they've got the best wings."
5024,0,0,21,21,1.0,0.048795003647426664,564,We have to sell these today to meet our GAAP EPS targets for the year.
5024,0,0,21,21,1.0,0.048795003647426664,564,This isn't what I had in mind for a Hootenanny
5024,0,0,21,21,1.0,0.048795003647426664,564,They make me look smarter.
5024,0,0,21,21,1.0,0.048795003647426664,564,The company's new official policy is not to give a hoot!
5024,0,0,21,21,1.0,0.048795003647426664,564,My father always said that it was better to have the wisdom of nine owls than the strength of nine horses.
5024,0,0,21,21,1.0,0.048795003647426664,564,Touché. Your subtle hint to stop acting like a wise guy is duly noted.
5024,0,0,21,21,1.0,0.048795003647426664,564,The Gryffindor students sent owls supporting the petition to get new Firebolts for the quidditch team.
5024,0,0,23,23,1.0,0.044455422447438706,564,And WHO would you be?
5024,0,0,21,21,1.0,0.048795003647426664,564,Did you send the memo out to the staff about feeding the pigeons?
5024,0,0,21,21,1.0,0.048795003647426664,564,You always have friends over and you never invite me.
5024,0,0,21,21,1.0,0.048795003647426664,564,"Hoo, hoo, hoo, hoo, hoo, hoo, hoo, hoo, hoo……do you think you are?"
5024,0,0,24,24,1.0,0.04256282653793743,564,"At karaoke night, when you keep singing ""You Can Call Me Owl"" I get it now"
5024,0,0,21,21,1.0,0.048795003647426664,564,"No, Betsy, In Spanish it's ""Nueve Buhos."""
5024,0,0,23,23,1.0,0.044455422447438706,564,Sorry Ruth. It's not just collective wisdom. They work the night shift too.
5024,0,0,22,22,1.0,0.046524210519923545,564,"I'm morally bankrupt, but they give a hoot"
5024,0,0,21,21,1.0,0.048795003647426664,564,"Miss Higgins, please order extra copies of The New Yorker this week."
5024,0,0,21,21,1.0,0.048795003647426664,564,"Being wise, or bird crappers, that's it."
5024,0,0,21,21,1.0,0.048795003647426664,564,"No, the investors still don't believe you give a hoot."
5024,0,0,21,21,1.0,0.048795003647426664,564,"The consensus is ""whooo"""
5024,0,0,21,21,1.0,0.048795003647426664,564,"Looks like a ""Who dunnit"" to me."
5024,0,0,21,21,1.0,0.048795003647426664,564,"Well, I guess this proves it--- Barred Owls are truly invasive."
5024,0,0,21,21,1.0,0.048795003647426664,564,Ho did it?
5024,0,0,21,21,1.0,0.048795003647426664,564,Owl be right with you.
5024,0,0,21,21,1.0,0.048795003647426664,564,Please tell me you've come because the owl wrangler has agreed to settle.
5024,0,0,21,21,1.0,0.048795003647426664,564,"But ""Bring Your Pet To Work Day"" is next week, Sir."
5024,0,0,21,21,1.0,0.048795003647426664,564,Who's on line one.
5024,0,0,21,21,1.0,0.048795003647426664,564,"When I return from my vacation, I'll be checking their droppings."
5024,0,0,21,21,1.0,0.048795003647426664,564,Too much?
5024,0,0,21,21,1.0,0.048795003647426664,564,It's 9 Owl Clock.
5024,0,0,21,21,1.0,0.048795003647426664,564,You'll have to get your own.
5024,0,0,21,21,1.0,0.048795003647426664,564,Why would I ask for only nine owls?
5024,0,0,21,21,1.0,0.048795003647426664,564,"?So finally... and there's no right answer here... do you have any hands-on owl experience, or knowledge of nocturnal birds in general? ?"
5024,0,0,21,21,1.0,0.048795003647426664,564,You seem a little owly this morning.
5024,0,0,22,22,1.0,0.046524210519923545,564,There's nothing like an office with a bird's-eye view.
5024,0,0,21,21,1.0,0.048795003647426664,564,"18 mice and a side of rabbits, then the 2:00 owls."
5024,0,0,21,21,1.0,0.048795003647426664,564,I'm sorry sir. We have not been able to find the missing one.
5024,0,0,21,21,1.0,0.048795003647426664,564,"MICROdoses of LSD, Donna. MICRO, as in SMALL."
5024,0,0,25,25,1.0,0.040824829046386304,564,"Who sez, ""Sez who?"""
5024,0,0,21,21,1.0,0.048795003647426664,564,The are protesting the lack of owls in the Fantastic Beast movie by staging a sit in.
5024,0,0,21,21,1.0,0.048795003647426664,564,My shrink recommended sound therapy.
5024,0,0,21,21,1.0,0.048795003647426664,564,"Filed by tomorrow, please."
5024,0,0,21,21,1.0,0.048795003647426664,564,I wish the wizarding would had e-mail.
5024,0,0,21,21,1.0,0.048795003647426664,564,Looks like a hoo-tenanny.
5024,0,0,21,21,1.0,0.048795003647426664,564,"Who's a give a hoot, I don't believe that was a wise choice."
5024,0,0,21,21,1.0,0.048795003647426664,564,"Wrong assembly of ""parliament,"" Marge. Now contemplating your ""murder of crows"" though."
5024,0,0,21,21,1.0,0.048795003647426664,564,The plaintiff owl is here to see you.
5024,0,0,21,21,1.0,0.048795003647426664,564,Do these owls make me look Wise?
5024,0,0,21,21,1.0,0.048795003647426664,564,We're moving HUGE numbers of these 'WHOO--ME WORRY? Owl Paperweights' from the 'Climate-Change Denial Gift Shop' @ The Real White House.gov!
5024,0,0,21,21,1.0,0.048795003647426664,564,"So, you've quit smoking again?"
5024,0,0,21,21,1.0,0.048795003647426664,564,"I didn't ask for your commentary on my Owls, Donna. I wanted you to tell me when Jennings will be here."
5024,0,0,21,21,1.0,0.048795003647426664,564,"Mrs. Jones, the expression is 'I'll see you now' - not 'owl see you'. Now please take them back to where you got them."
5024,0,0,21,21,1.0,0.048795003647426664,564,For night owls only!
5024,0,0,21,21,1.0,0.048795003647426664,564,Maybe next time you'll think twice before not giving a hoot
5024,0,0,21,21,1.0,0.048795003647426664,564,"They ate my cat, all nine lives of him."
5024,0,0,21,21,1.0,0.048795003647426664,564,Tryna buy an owl?
5024,0,0,21,21,1.0,0.048795003647426664,564,"Present your petition. But keep in mind, it's become much harder to get a consensus with the parliament these days."
5024,0,0,21,21,1.0,0.048795003647426664,564,"Who says I never listen? You specifically asked for a nine-owl workday, right?"
5024,0,0,21,21,1.0,0.048795003647426664,564,Ironically they were here when I came in early
5024,0,0,21,21,1.0,0.048795003647426664,564,"Funny, you don't strike me as a hoot nanny."
5024,0,0,21,21,1.0,0.048795003647426664,564,They're the scriptwriters for our latest Hoodunnit.
5024,0,0,21,21,1.0,0.048795003647426664,564,I'm a professional whistle blower and I get the who award every year.
5024,0,0,21,21,1.0,0.048795003647426664,564,I'm going to hang them on the window to keep birds from flying into it.
5024,0,0,21,21,1.0,0.048795003647426664,564,With the right algorithm you can bake a pie
5024,0,0,21,21,1.0,0.048795003647426664,564,"I'm sorry, I misunderstood. I thought you had problems with your bowel movements."
5024,0,0,21,21,1.0,0.048795003647426664,564,Meet our new postal team
5024,0,0,21,21,1.0,0.048795003647426664,564,Not regular? When was your last owl movement?
5024,0,0,21,21,1.0,0.048795003647426664,564,"just ""who"" do you think you're here to see?"
5024,0,0,21,21,1.0,0.048795003647426664,564,"What, when, where or why the F? Please just not, who the F?"
5024,0,0,21,21,1.0,0.048795003647426664,564,"This is not the parliament I was referring to, Archimedes."
5024,0,0,21,21,1.0,0.048795003647426664,564,So what if it's only 3:00. Go get me a dry martini and 9 mice!
5024,0,0,21,21,1.0,0.048795003647426664,564,We can only keep one. Whoo do you like best?
5024,0,0,22,22,1.0,0.046524210519923545,564,Do you really think that is wise?
5024,0,0,21,21,1.0,0.048795003647426664,564,Helps keep the paperwork from cluttering up my desk.
5024,0,0,21,21,1.0,0.048795003647426664,564,Let's try two gofers.
5024,0,0,21,21,1.0,0.048795003647426664,564,"Of course I'm powerful, Diane. I could dissolve parliament with just the wave of my hand!"
5024,0,0,21,21,1.0,0.048795003647426664,564,"Remind me Miss Fotheringay, what's the name of that restaurant where they wear those little tight shorts?"
5024,0,0,21,21,1.0,0.048795003647426664,564,Each one got five starts on Amazon.
5024,0,0,22,22,1.0,0.046524210519923545,564,The admissions desk at Hogwarts University decided it was time to switch to an electronic muggle mailing system.
5024,0,0,23,23,1.0,0.044455422447438706,564,Me! That's who...
5024,0,0,21,21,1.0,0.048795003647426664,564,keep your wits about your secretary.
5024,0,0,21,21,1.0,0.048795003647426664,564,"You're late, Ms. Smith. Around here we start at eight owls, sharp."
5024,0,0,23,23,1.0,0.044455422447438706,564,"The company doesn't have much of a health plan, but they do have a new exercise room."
5024,0,0,21,21,1.0,0.048795003647426664,564,"""Who?"", do you say?"
5024,0,0,21,21,1.0,0.048795003647426664,564,"I'm telling you, this Fitbit will change your life."
5024,0,0,21,21,1.0,0.048795003647426664,564,You must be here for the Tootsie Pop audition.
5024,0,0,21,21,1.0,0.048795003647426664,564,I'm trying the latest social media trend. I heard it's a hoot.
5024,0,0,21,21,1.0,0.048795003647426664,564,Owl be there shortly.
5024,0,0,21,21,1.0,0.048795003647426664,564,I would like to hold owl calls.
5024,0,0,21,21,1.0,0.048795003647426664,564,In case you forgot I am applying for the job of night owl.
5024,0,0,21,21,1.0,0.048795003647426664,564,Who's next?
5024,0,0,21,21,1.0,0.048795003647426664,564,They just appeared when I told some wise ass to go fuck himself.
5024,0,0,21,21,1.0,0.048795003647426664,564,"You'll be able to do this in about 200,000 years."
5024,0,0,21,21,1.0,0.048795003647426664,564,I'm hoping one of them can come up with a better caption than Dator's.
5024,0,0,21,21,1.0,0.048795003647426664,564,"We're fine. Thank you, Mrs. Cooper."
5024,0,0,21,21,1.0,0.048795003647426664,564,"Alright, I'll go back to using Google."
5024,0,0,21,21,1.0,0.048795003647426664,564,I'm in this group thread with a bunch of Hogwarts friends
5024,0,0,21,21,1.0,0.048795003647426664,564,Man says :Hoot there Women say's that hoot be me Man says :well owl I help you (Hoot is what owls say ) (Owl I help ... how can I help u That's the joke )
5024,0,0,21,21,1.0,0.048795003647426664,564,You think owls are a big deal? You should have seen the capuchin monkeys.
5024,0,0,21,21,1.0,0.048795003647426664,564,I need to speak with our Librarian
5024,0,0,21,21,1.0,0.048795003647426664,564,Owl bet you have no pants on.
5024,0,0,21,21,1.0,0.048795003647426664,564,No 'WISE'cracks!!!
5024,0,0,21,21,1.0,0.048795003647426664,564,Does it look like I give a hoot?
5024,0,0,23,23,1.0,0.044455422447438706,564,And who are you?
5024,0,0,21,21,1.0,0.048795003647426664,564,What are you trying to be a wise guy?
5024,0,0,21,21,1.0,0.048795003647426664,564,Regular business owls start at nine.
5024,0,0,21,21,1.0,0.048795003647426664,564,"The older I get, the wiser I become."
5024,0,0,21,21,1.0,0.048795003647426664,564,Yes we all know you are a Rice University Alumnus.
5024,0,0,22,22,1.0,0.046524210519923545,564,"WHAT ARE YOU, SOME KIND OF WISE GUY?"
5024,0,0,21,21,1.0,0.048795003647426664,564,I don't think this is what they meant by being wise like a owl
5024,0,0,21,21,1.0,0.048795003647426664,564,"I understand your concern, but I've only got so many hoots to give."
5024,0,0,21,21,1.0,0.048795003647426664,564,Hidden Spy
5024,0,0,21,21,1.0,0.048795003647426664,564,WHO is going to buy one of these?
5024,0,0,21,21,1.0,0.048795003647426664,564,"Order some soy sauce, vegetables, and some white wine. We'll turn this into a team-building and stir-fry experience."
5024,0,0,21,21,1.0,0.048795003647426664,564,"Okay honey, the parliament will address your proposal now."
5024,0,0,21,21,1.0,0.048795003647426664,564,I know the auditions are starting. So who's on first?
5024,0,0,21,21,1.0,0.048795003647426664,564,I don't give a hoot how many owls it takes to make me look smarter.
5024,0,0,21,21,1.0,0.048795003647426664,564,I plan to start a Tennessee Fried Owl restaurant.
5024,0,0,21,21,1.0,0.048795003647426664,564,Most are wise but this breed is just sort of shifty
5024,0,0,22,22,1.0,0.046524210519923545,564,"You, Madame, requested my wise council."
5024,0,0,21,21,1.0,0.048795003647426664,564,"I asked for hooters, not hooters!"
5024,0,0,21,21,1.0,0.048795003647426664,564,"What do you mean,I love The New Yorker to much?"
5024,0,0,21,21,1.0,0.048795003647426664,564,Is Al in?
5024,0,0,21,21,1.0,0.048795003647426664,564,"The boss says I work like a night owl, but between you and me, I don't see it."
5024,0,0,23,23,1.0,0.044455422447438706,564,"Drinks after work, owl 'bout it?"
5024,0,0,21,21,1.0,0.048795003647426664,564,Tell catering to cancel the canapés . We're going out to lunch.
5024,0,0,21,21,1.0,0.048795003647426664,564,But which one gives the last hoot?
5024,0,0,23,23,1.0,0.044455422447438706,564,I don't give a hoot about your weekend either.
5024,0,0,21,21,1.0,0.048795003647426664,564,I see you've solved your wobbly desk problem.
5024,0,0,21,21,1.0,0.048795003647426664,564,"I thought we agreed, adopting a parliament isn't the answer."
5024,0,0,21,21,1.0,0.048795003647426664,564,It's part of the new security program. I can't even use the bathroom without these fellas.
5024,0,0,21,21,1.0,0.048795003647426664,564,"You're right about one thing Mr. Williams, one wise owl wasn't going to be nearly enough."
5024,0,0,21,21,1.0,0.048795003647426664,564,"A wise old owl sat on a oak, the more he heard the less he spoke, except to say Fox News is a joke"
5024,0,0,21,21,1.0,0.048795003647426664,564,They seem to think they have a meeting with Mayor Adam Young.
5024,0,0,21,21,1.0,0.048795003647426664,564,"Well, since our computers are down and Hogwarts is undergoing renovations, it seemed like a win-win at the time."
5024,0,0,21,21,1.0,0.048795003647426664,564,"""Mr. Jones is here to see you sir."" ""WHO?"" who- who- who- who- who- who-who-who-who!"
5024,0,0,21,21,1.0,0.048795003647426664,564,This is part of our new anti-pollution campaign
5024,0,0,21,21,1.0,0.048795003647426664,564,The board likes the chips but says you're still not any wiser.
5024,0,0,21,21,1.0,0.048795003647426664,564,"Starting those hootnanigans again, huh?n"
5024,0,0,21,21,1.0,0.048795003647426664,564,"That, who or which?"
5024,0,0,24,24,1.0,0.04256282653793743,564,I'm sorry sir but no pets aloud inside the classroom.
5024,0,0,23,23,1.0,0.044455422447438706,564,"They know you're smart,Sir, and wise too,"
5024,0,0,21,21,1.0,0.048795003647426664,564,I thought this was a payment bank.
5024,0,0,21,21,1.0,0.048795003647426664,564,Owls about a coffee?
5024,0,0,21,21,1.0,0.048795003647426664,564,The Harry Potter casting director will see you now.
5024,0,0,21,21,1.0,0.048795003647426664,564,"As you can hear, my complaint department doesn't give a hoot about your problem."
5024,0,0,21,21,1.0,0.048795003647426664,564,Tell me about your previous hoot 'n' nannying experience.
5024,0,0,21,21,1.0,0.048795003647426664,564,"Sorry Joe, still no luck getting Harry Potter's forwarding address."
5024,0,0,21,21,1.0,0.048795003647426664,564,"I'm sorry, Gary, no one's left to give a hoot -- you're fired."
5024,0,0,21,21,1.0,0.048795003647426664,564,"Who are you? Who, Who, Who, Who?"
5024,0,0,21,21,1.0,0.048795003647426664,564,Your call. I'm either very wise or a very wise-guy.
5024,0,0,21,21,1.0,0.048795003647426664,564,"I don't give a hoot when they say, "" a cluttered desk is a sign of a cluttered mind""."
5024,0,0,21,21,1.0,0.048795003647426664,564,I could give two hoots
5024,0,0,21,21,1.0,0.048795003647426664,564,You the guy advertised for a hoot nanny?
5024,0,0,21,21,1.0,0.048795003647426664,564,"Yes, Miss Dubedat, I did say to bring me another one."
5024,0,0,21,21,1.0,0.048795003647426664,564,"But choose wisely Ms. Brockhammer, for which owl you choose will determine WHOooo lives and WHOooo dies."
5024,0,0,21,21,1.0,0.048795003647426664,564,They're not what they seem.
5024,0,0,21,21,1.0,0.048795003647426664,564,Our Hooters came first.
5024,0,0,21,21,1.0,0.048795003647426664,564,"I ordered this desk used from Hogwarts, they threw in free delivery."
5024,0,0,21,21,1.0,0.048795003647426664,564,I do not know who they are.
5024,0,0,21,21,1.0,0.048795003647426664,564,I claim santuary.
5024,0,0,21,21,1.0,0.048795003647426664,564,"I'm calling to let you know about a ""wheel revolution"" in office furniture."
5024,0,0,21,21,1.0,0.048795003647426664,564,"How many times do we have to ask you: Who, exactly, are you looking for?"
5024,0,0,21,21,1.0,0.048795003647426664,564,"Hoo do you think you are, Jim?"
5024,0,0,21,21,1.0,0.048795003647426664,564,All 9 members of the acceptance committee voted against your Who's Who application.
5024,0,0,21,21,1.0,0.048795003647426664,564,Quickly Miss Stubbs! Amazon...Depends for owls.
5024,0,0,21,21,1.0,0.048795003647426664,564,Who what?
5024,0,0,21,21,1.0,0.048795003647426664,564,"I don't give a hoot, I want them out of here."
5024,0,0,21,21,1.0,0.048795003647426664,564,The photographer is here. Your tie is crooked. I'll send him in.
5024,0,0,21,21,1.0,0.048795003647426664,564,"Ann, this monthly vitamin subscription has really helped my night-time vision!"
5024,0,0,21,21,1.0,0.048795003647426664,564,You have never seen an acapelo group like this.
5024,0,0,21,21,1.0,0.048795003647426664,564,You're a wizard Chuck!
5024,0,0,21,21,1.0,0.048795003647426664,564,"But, madam, I'm only the Assistant Branch Manager"
5024,0,0,21,21,1.0,0.048795003647426664,564,We’re aggressively marketing to the White House.
5024,0,0,21,21,1.0,0.048795003647426664,564,There were more applicants last night
5024,0,0,21,21,1.0,0.048795003647426664,564,"They graduated at the top of their class, plus they like the night shift."
5024,0,0,21,21,1.0,0.048795003647426664,564,"Ms. Grundy, I asked for 9 desk DOWELS!"
5024,0,0,21,21,1.0,0.048795003647426664,564,How else would I find out how many licks this is going to take?
5024,0,0,21,21,1.0,0.048795003647426664,564,When I asked for a bonus Mr. Norton I asked for nine hours not owls.
5024,0,0,21,21,1.0,0.048795003647426664,564,My sitter is on vacation.
5024,0,0,21,21,1.0,0.048795003647426664,564,Now get me some pussycats!
5024,0,0,21,21,1.0,0.048795003647426664,564,They want to know what I think? I don't give a hoot.
5024,0,0,21,21,1.0,0.048795003647426664,564,The Hedwig extras are still demanding full compensation.
5024,0,0,21,21,1.0,0.048795003647426664,564,"Time to step up your game, Alexa. People are asking for wisdom, not just answers."
5024,0,0,21,21,1.0,0.048795003647426664,564,"Of course we're listed in ""Who's Who""!"
5024,0,0,21,21,1.0,0.048795003647426664,564,"Frankly, my dear, I don't give nine hoots!"
5024,0,0,21,21,1.0,0.048795003647426664,564,My inbox is already full.
5024,0,0,21,21,1.0,0.048795003647426664,564,"Do we have any leads on where these birds came from?"" ""I'm afraid not sir... it's a classic hoot-done-it."
5024,0,0,23,23,1.0,0.044455422447438706,564,Owl is it going?
5024,0,0,21,21,1.0,0.048795003647426664,564,"'This is genius, nobody wpyld suspect Owls for drones. Irene call the a Pentagon.'"
5024,0,0,21,21,1.0,0.048795003647426664,564,"You may not give a hoot about an open barn door, Evelyn, but our visitors beg to differ."
5024,0,0,21,21,1.0,0.048795003647426664,564,"Look, this'll be owl little secret."
5024,0,0,21,21,1.0,0.048795003647426664,564,"Sorry lady, I can't do your taxes."
5024,0,0,21,21,1.0,0.048795003647426664,564,"Sir, we can't offer the employess this kind of 360-degree feedback."
5024,0,0,21,21,1.0,0.048795003647426664,564,"'Owls go who, cows go moo, not who.'"
5024,0,0,21,21,1.0,0.048795003647426664,564,How about getting one on a lark?
5024,0,0,21,21,1.0,0.048795003647426664,564,The boss said to make it a real hootenanny.
5024,0,0,21,21,1.0,0.048795003647426664,564,I am trying to reset my sleep rhythm and this should be my nap time.
5024,0,0,21,21,1.0,0.048795003647426664,564,WISE ASS !!
5024,0,0,21,21,1.0,0.048795003647426664,564,Rotating teams of night vigilance.
5024,0,0,21,21,1.0,0.048795003647426664,564,The Ministry stopped using owls years ago.
5024,0,0,21,21,1.0,0.048795003647426664,564,Finally Bernard was willing to admit that Evelyn really did give a hoot.
5024,0,0,21,21,1.0,0.048795003647426664,564,Black coffee for me and three blind mice for the accreditation committee...
5024,0,0,21,21,1.0,0.048795003647426664,564,"He tweeted that no one gives a hoot, cancelled their awareness campaigns, and put a bounty on them."
5024,0,0,21,21,1.0,0.048795003647426664,564,Finance is beginning to think this Drake obsession has gone a bit too far.
5024,0,0,21,21,1.0,0.048795003647426664,564,Hoooo would you like to buy?
5024,0,0,21,21,1.0,0.048795003647426664,564,These are the judges for the new mouse eating contest.
5024,0,0,21,21,1.0,0.048795003647426664,564,"Working late again, sir?"
5024,0,0,21,21,1.0,0.048795003647426664,564,"Nine little owls sittin' on the desk. One flies away and eight are left. Hey, that almost rimes. Eight little owls sittin' on the desk. One flies away and . . ."
5024,0,0,21,21,1.0,0.048795003647426664,564,This is a simple disagreement- no need for parliament
5024,0,0,21,21,1.0,0.048795003647426664,564,I like people to know that I give a hoot.
5024,0,0,21,21,1.0,0.048795003647426664,564,I’m closing more deals than I ever did with the rabbits.
5024,0,0,21,21,1.0,0.048795003647426664,564,Your 2 o'clock is here. Who?
5024,0,0,21,21,1.0,0.048795003647426664,564,what do you mean you don't give a hoot !
5024,0,0,21,21,1.0,0.048795003647426664,564,"Maybe the ad shouldn't have read ""Wanted -nine Hooters dressed to kill"""
5024,0,0,21,21,1.0,0.048795003647426664,564,That's the ninth win this month!
5024,0,0,21,21,1.0,0.048795003647426664,564,"In that moment, he became Presidential."
5024,0,0,21,21,1.0,0.048795003647426664,564,They keep me up at night.
5024,0,0,21,21,1.0,0.048795003647426664,564,I see you were withholding my Hogwarts acceptance letter.
5024,0,0,21,21,1.0,0.048795003647426664,564,I'm sorry sir. I think we dropped the B in the bowl-a-thon announcement.
5024,0,0,21,21,1.0,0.048795003647426664,564,"Mrs. Williams, please bring in nine more scratch pads."
5024,0,0,21,21,1.0,0.048795003647426664,564,"Lester says he doesn't give a hoot who's here, he's not coming to your meeting."
5024,0,0,21,21,1.0,0.048795003647426664,564,We're starting a new night shift as of today !
5024,0,0,21,21,1.0,0.048795003647426664,564,"Wait, why did you assume we're in water?"
5024,0,0,21,21,1.0,0.048795003647426664,564,I guess I confused 'Bring Your Kid to Work Day' with 'Bring Your Nine Owls to Work Day.'
5024,0,0,21,21,1.0,0.048795003647426664,564,"It's still working, Marjorie, I'm not getting any good ideas. Bring me another owl!"
5024,0,0,21,21,1.0,0.048795003647426664,564,"You told them you didn't give a hoot, then two hoots, then one-by-one up to nine hoots. If they don't give a hoot about your hoots, maybe try the Art of the Deal?"
5024,0,0,21,21,1.0,0.048795003647426664,564,"Oh, I guess you missed the memo about Bring Your Pets To Work day."
5024,0,0,21,21,1.0,0.048795003647426664,564,Now this is organic pest control.
5024,0,0,21,21,1.0,0.048795003647426664,564,"I understand this is government class, but is a parliament necessary?"
5024,0,0,21,21,1.0,0.048795003647426664,564,I want the one with the bomb!
5024,0,0,21,21,1.0,0.048795003647426664,564,Drones are so yesterday. This is our new fly-by-night delivery fleet.
5024,0,0,21,21,1.0,0.048795003647426664,564,"I can call you Betty, and Betty when you call me, you can call me Owl."
5024,0,0,21,21,1.0,0.048795003647426664,564,I give a hoot.
5024,0,0,21,21,1.0,0.048795003647426664,564,"Forget Alexa. People want wisdom, not answers."
5024,0,0,21,21,1.0,0.048795003647426664,564,Who is going on over here?
5024,0,0,21,21,1.0,0.048795003647426664,564,One equals owls. Two equals owls. But three? Three equals my desk.
5024,0,0,23,23,1.0,0.044455422447438706,564,I finally have cast the hootenanny
5024,0,0,21,21,1.0,0.048795003647426664,564,Proceeds go toward my son's Boy Scout troop.
5024,0,0,21,21,1.0,0.048795003647426664,564,"Who, Who's Here to see me?"
5024,0,0,21,21,1.0,0.048795003647426664,564,"Sorry about the job, but you know what they say: It's not what you know, but what you who."
5024,0,0,21,21,1.0,0.048795003647426664,564,Owl wish I did not assert you're a hoot!
5024,0,0,21,21,1.0,0.048795003647426664,564,Whooooo are these new faces around the office?
5024,0,0,21,21,1.0,0.048795003647426664,564,I count nine. All I need now is a pussy cat.
5024,0,0,21,21,1.0,0.048795003647426664,564,Don't explain... Owl see you later
5024,0,0,22,22,1.0,0.046524210519923545,564,I've been selected for who's who again
5024,0,0,21,21,1.0,0.048795003647426664,564,My Brain Trust.
5024,0,0,21,21,1.0,0.048795003647426664,564,"Ms. Jones, please go to the store and buy 9 dozen mice."
5024,0,0,21,21,1.0,0.048795003647426664,564,So who's in cahoots with the parliament now?
5024,0,0,22,22,1.0,0.046524210519923545,564,Our hoot-nanny quit.
5024,0,0,21,21,1.0,0.048795003647426664,564,"Some of the staff would like to have a word with you, Sir... To wit, Who?"
5024,0,0,21,21,1.0,0.048795003647426664,564,"Yes, Dot, I know they're owls, but put them in a row for me anyway, will you?"
5024,0,0,22,22,1.0,0.046524210519923545,564,Joe from Accounting told me liked Hooters so I thought I'd give them a try.
5024,0,0,21,21,1.0,0.048795003647426664,564,Who are you is a profound question. It's not a hoot!
5024,0,0,21,21,1.0,0.048795003647426664,564,We're experimenting with a new night-time delivery system.
5024,0,0,21,21,1.0,0.048795003647426664,564,"Of course they're not pink, but don't you think the ears are kind of cute?"
5024,0,0,22,22,1.0,0.046524210519923545,564,"Believe me, working here is a hoot."
5024,0,0,21,21,1.0,0.048795003647426664,564,"If that's your idea of giving a hoot, it's not working"
5024,0,0,21,21,1.0,0.048795003647426664,564,I understand you're a real who's hoot to know around here.
5024,0,0,21,21,1.0,0.048795003647426664,564,You can just say your name once.
5024,0,0,21,21,1.0,0.048795003647426664,564,Who exactly would you like to see?
5024,0,0,21,21,1.0,0.048795003647426664,564,Let the board know that the deal went through; we've bought out Hooters!
5024,0,0,21,21,1.0,0.048795003647426664,564,You like pigeons?
5024,0,0,21,21,1.0,0.048795003647426664,564,And who are you?
5024,0,0,21,21,1.0,0.048795003647426664,564,My wife is crazy about owls. I bring a new one home if I am in the doghouse with her.
5024,0,0,21,21,1.0,0.048795003647426664,564,Say goodbye to your skunk problem.
5024,0,0,21,21,1.0,0.048795003647426664,564,I just approved your leave of absence request.
5024,0,0,21,21,1.0,0.048795003647426664,564,Dolores grew tired of hearing her raise would take an act of parliament.
5024,0,0,21,21,1.0,0.048795003647426664,564,Why do you think wisdom can be transfered?
5024,0,0,22,22,1.0,0.046524210519923545,564,"You'll be looking for a blue jay with nine lives, Miss Jones."
5024,0,0,23,23,1.0,0.044455422447438706,564,We're the only ones here that don't give a hoot.
5024,0,0,24,24,1.0,0.04256282653793743,564,And now we sit back and wait for the money to start rolling in.
5024,0,0,21,21,1.0,0.048795003647426664,564,"It's been a hoot, but you're fired."
5024,0,0,21,21,1.0,0.048795003647426664,564,"Sadly Mrs. crane, they have just voted me off the island."
5024,0,0,21,21,1.0,0.048795003647426664,564,I warned you that budget cuts were coming to the Reference Department!
5024,0,0,21,21,1.0,0.048795003647426664,564,"So, you are in cahoots."
5024,0,0,21,21,1.0,0.048795003647426664,564,Well it seems to be working! Have you seen any bats lately??
5024,0,0,21,21,1.0,0.048795003647426664,564,I am obviously The Owl. You don't look like The Pussycat.
5024,0,0,22,22,1.0,0.046524210519923545,564,What happened? Did you spill a drop of water and they started multiplying?
5024,0,0,21,21,1.0,0.048795003647426664,564,You ordered legal catalogs for our 9 division heads. That Chinese firm sent 9 ??? and explained these were eagles with cat heads.
5024,0,0,21,21,1.0,0.048795003647426664,564,Looks like you've been Barred from practicing law in the forest.
5024,0,0,21,21,1.0,0.048795003647426664,564,"I don't know what you're talking about Alice, office life is a hoot."
5024,0,0,22,22,1.0,0.046524210519923545,564,"Here lady, these owls help you sleep at night. Take one only for $1.00...Please take one!"
5024,0,0,21,21,1.0,0.048795003647426664,564,"Boss, you have to tell your clients that there aren't any good parts for owls once the Harry Potter movies ended."
5024,0,0,21,21,1.0,0.048795003647426664,564,"These days, Minerva's owls only fly at desks."
5024,0,0,21,21,1.0,0.048795003647426664,564,"As you can see Miss Barnes, I don't give a hoot."
5024,0,0,27,27,1.0,0.03774256780481986,564,"All right, all right! I'm The Tenth Owl!"
5024,0,0,24,24,1.0,0.04256282653793743,564,ICE? I thought you said mice.
5024,0,0,21,21,1.0,0.048795003647426664,564,I ordered nine copies of 'Howl.'
5024,0,0,21,21,1.0,0.048795003647426664,564,I'm assigned today's lunches. Grab an owl. The microwave is on the file cabinet.
5024,0,0,21,21,1.0,0.048795003647426664,564,"When you close your eyes, what do you dream of?"
5024,0,0,21,21,1.0,0.048795003647426664,564,"I know owls are wise, that is why they are replacing me."
5024,0,0,22,22,1.0,0.046524210519923545,564,This is not what I had in mind when I said I wanted to go to a Who concert.
5024,0,0,21,21,1.0,0.048795003647426664,564,"Please restart our newspaper delivery, please."
5024,0,0,21,21,1.0,0.048795003647426664,564,Whooo do you think you're talkong to?
5024,0,0,21,21,1.0,0.048795003647426664,564,Meet the most qualified applicants for that midnight watchtower guard position.
5024,0,0,21,21,1.0,0.048795003647426664,564,"If this doesn't halt those cat-calls you've been hearing, I'm not sure what else I can do."
5024,0,0,21,21,1.0,0.048795003647426664,564,"HR admits their ""wise, old"" posting backfired."
5024,0,0,21,21,1.0,0.048795003647426664,564,These will be cheaper than a night watchman.
5024,0,0,24,24,1.0,0.04256282653793743,564,"This is the third time this week, Harry."
5024,0,0,21,21,1.0,0.048795003647426664,564,"Owls are the new cats, madame!"""
5024,0,0,21,21,1.0,0.048795003647426664,564,I meant potato chips.
5024,0,0,21,21,1.0,0.048795003647426664,564,"I can assure you Susan, going forward, Owl be positioned to respond to all departmental concerns."
5024,0,0,21,21,1.0,0.048795003647426664,564,"Oh, Mrs. Murdoch: can you please file these? ... let us see ... oh, yes, under Foreign Affairs. We might need them for the meeting next week. Thanks for taking care of it!"
5024,0,0,21,21,1.0,0.048795003647426664,564,"'Owl' let you in on a little secret, Susan"
5024,0,0,21,21,1.0,0.048795003647426664,564,"They say owls bring wisdom. So, I'll take one for each cabinet member...and rwio or three for their boss."
5024,0,0,21,21,1.0,0.048795003647426664,564,I came to you for wise advice but I see you are busy.
5024,0,0,21,21,1.0,0.048795003647426664,564,Hedwig 'wanna-bes' for the Harry Potter show...
5024,0,0,23,23,1.0,0.044455422447438706,564,I fired the night watchmen.
5024,0,0,21,21,1.0,0.048795003647426664,564,They add a little magic to delivering bad performance reviews.
5024,0,0,21,21,1.0,0.048795003647426664,564,"The ""what"" reference desk is two doors down."
5024,0,0,21,21,1.0,0.048795003647426664,564,I thought we were having the Tootsie Pop call-back next week...
5024,0,0,21,21,1.0,0.048795003647426664,564,"I'm sorry sir, but it's becoming extremely difficult to cover up your collusion with Hogwarts."
5024,0,0,21,21,1.0,0.048795003647426664,564,Hoo Hoo let the dogs out.
5024,0,0,21,21,1.0,0.048795003647426664,564,"Ask ""who can do it for our country, not why!"""
5024,0,0,21,21,1.0,0.048795003647426664,564,"""Yes men"" bore me."
5024,0,0,24,24,1.0,0.04256282653793743,564,The pigeons have been particularly aggressive recently.
5024,0,0,21,21,1.0,0.048795003647426664,564,"Aren't you pushing the barred a bit to far , sir !"
5024,0,0,21,21,1.0,0.048795003647426664,564,"The softball team roster is all set, and Hootie #4 will bat clean-up."
5024,0,0,21,21,1.0,0.048795003647426664,564,They keep the hawks away.
5024,0,0,21,21,1.0,0.048795003647426664,564,Defended by owls
5024,0,0,21,21,1.0,0.048795003647426664,564,"Miss Moneypenny, advise Q to sound the owl clear."
5024,0,0,21,21,1.0,0.048795003647426664,564,Who said that?
5024,0,0,24,24,1.0,0.04256282653793743,564,"This doesn't prove that you give a ""hoot"" about work."
5024,0,0,21,21,1.0,0.048795003647426664,564,9 unread messages
5024,0,0,21,21,1.0,0.048795003647426664,564,"What do you mean, ""why?"""
5024,0,0,25,25,1.0,0.040824829046386304,564,Just whoo do you think you are?
5024,0,0,22,22,1.0,0.046524210519923545,564,Can I interest you in giving a Hoot?
5024,0,0,21,21,1.0,0.048795003647426664,564,Please take a litter.
5024,0,0,21,21,1.0,0.048795003647426664,564,Owl take your suggestion under consideration.
5024,0,0,21,21,1.0,0.048795003647426664,564,"I think we will call them ""SECURITY 9"", for our customers who aren't in to electronics."
5024,0,0,21,21,1.0,0.048795003647426664,564,They can't get through unless Voldemort loses.
5024,0,0,21,21,1.0,0.048795003647426664,564,I don't give a hoot! Get rid of them.
5024,0,0,21,21,1.0,0.048795003647426664,564,Owl be with you in just a sec.
5024,0,0,21,21,1.0,0.048795003647426664,564,This proves I do give a hoot.
5024,0,0,21,21,1.0,0.048795003647426664,564,Why the Scowl?
5024,0,0,23,23,1.0,0.044455422447438706,564,Tell Johnson to get in here.
5024,0,0,25,25,1.0,0.040824829046386304,564,"Better than Watson, I think."
5024,0,0,21,21,1.0,0.048795003647426664,564,Please show Stuart Little in Jill.
5024,0,0,23,23,1.0,0.044455422447438706,564,"I know you can line them up, but we'll need more than ""hoots"" for the opening."
5024,0,0,21,21,1.0,0.048795003647426664,564,They're to enforce parliamentary procedure at the staff meeting.
5024,0,0,21,21,1.0,0.048795003647426664,564,Haven't you ever been told to surround yourself with those that are smarter than you?
5024,0,0,21,21,1.0,0.048795003647426664,564,"Mr. Potter, I am not a magician."
5024,0,0,21,21,1.0,0.048795003647426664,564,"Sir, your pussycats have arrived."
5024,0,0,21,21,1.0,0.048795003647426664,564,Owl have to get back to you on that.
5024,0,0,21,21,1.0,0.048795003647426664,564,"....bears a hibernating, 9 owls a who-ing, 8 frogs a ......"
5024,0,0,21,21,1.0,0.048795003647426664,564,Please ask IT to remove Crazy Owls from my desktop.
5024,0,0,21,21,1.0,0.048795003647426664,564,....and the rest of our board are rattlesnakes.
5024,0,0,21,21,1.0,0.048795003647426664,564,"I think when you reject a suggestion, saying you don't give a hoot is a little too much."
5024,0,0,25,25,1.0,0.040824829046386304,564,They call me BIG AL.
5024,0,0,21,21,1.0,0.048795003647426664,564,At two o'clock it's card tricks and at three I saw you in half.
5024,0,0,21,21,1.0,0.048795003647426664,564,It's part of my new Monday morning routine.
5024,0,0,21,21,1.0,0.048795003647426664,564,Recheck my files: I specifically requested the L's.
5024,0,0,25,25,1.0,0.040824829046386304,564,"Whhhhoooooooo goes there?"" ""Richard this is getting out of hand..."" ""Is it Linda, is it"
5024,0,0,21,21,1.0,0.048795003647426664,564,I'm letting you go Miss Klug. I have all the wisdom I need right here.
5024,0,0,21,21,1.0,0.048795003647426664,564,It's basic management; surround yourself with wise old birds!
5024,0,0,21,21,1.0,0.048795003647426664,564,"Ms. Clausen, have you seen my mouse?"
5024,0,0,21,21,1.0,0.048795003647426664,564,This is not what I meant when I said we should replace Congress with a Parliament.
5024,0,0,21,21,1.0,0.048795003647426664,564,"We're not just cleaning house, Marge, we're cleaning the barn, and we're starting at the top!"
5024,0,0,21,21,1.0,0.048795003647426664,564,"We have to leave TODAY. The Health Depart-"" ""Who who who who who ...?"
5024,0,0,21,21,1.0,0.048795003647426664,564,"I have no proof, but I'm pretty sure Whoo did it."
5024,0,0,21,21,1.0,0.048795003647426664,564,"Yes, they are all Hogwarts approved."
5024,0,0,21,21,1.0,0.048795003647426664,564,They all have high IQ's
5024,0,0,21,21,1.0,0.048795003647426664,564,Hoo...are...you?
5024,0,0,24,24,1.0,0.04256282653793743,564,What animals on a treadmill dream about!
5024,0,0,21,21,1.0,0.048795003647426664,564,Tell Owl Capone his wise guys got my attention.
5024,0,0,21,21,1.0,0.048795003647426664,564,"Yes, I did enjoy my trip to Athens."
5024,0,0,21,21,1.0,0.048795003647426664,564,Did you really think I was going to give a Hoot?
5024,0,0,21,21,1.0,0.048795003647426664,564,Hoo did you wish to see?
5024,0,0,26,26,1.0,0.03922322702763681,564,"I'm a night owl, I also have 9 owls for pets"
5024,0,0,21,21,1.0,0.048795003647426664,564,Good question. But I thought ten would be a little bit much.
5024,0,0,21,21,1.0,0.048795003647426664,564,It's unanimous let's order from hooters.
5024,0,0,21,21,1.0,0.048795003647426664,564,"I shouldn't be much longer,..., I'm almost to the door."
5024,0,0,21,21,1.0,0.048795003647426664,564,Want to buy an owl?
5024,0,0,21,21,1.0,0.048795003647426664,564,Can't you just write yourself a note reminding you to ask 'who' is calling?
5024,0,0,21,21,1.0,0.048795003647426664,564,"Ms. Jones, I have surrounded myself with the wisest staff yet."
5024,0,0,21,21,1.0,0.048795003647426664,564,"M..M..M...Miss W..Whipple, Whoo...Whooo, Whoooo...Whoooo....will be completing those latest W..W..Wisemen Company reports?"
5024,0,0,21,21,1.0,0.048795003647426664,564,I'm expecting a shipment of bowls.
5024,0,0,21,21,1.0,0.048795003647426664,564,"Ok, WHO said WHAT?"
5024,0,0,21,21,1.0,0.048795003647426664,564,What? It's take your pet to work today. These are my pets.
5024,0,0,21,21,1.0,0.048795003647426664,564,Everywhere I look - wise guys.
5024,0,0,21,21,1.0,0.048795003647426664,564,Who said that I don't give a hoot?
5024,0,0,21,21,1.0,0.048795003647426664,564,Do you think this is a wise move?
5024,0,0,22,22,1.0,0.046524210519923545,564,"Great idea Karen, but you do realize that even kids who get into Harvard would still rather go to Hogwarts, right?"
5024,0,0,21,21,1.0,0.048795003647426664,564,Parliament is sitting late.
5024,0,0,21,21,1.0,0.048795003647426664,564,They don't trust the EPA anymore.
5024,0,0,21,21,1.0,0.048795003647426664,564,"I just wanted your lunch order, this doesn't need to be a parliamentary ordeal."
5024,0,0,21,21,1.0,0.048795003647426664,564,I think you might be misinterpreting wildlife protection.
5024,0,0,21,21,1.0,0.048795003647426664,564,I see you're taking advantage of the new company vision plan.
5024,0,0,21,21,1.0,0.048795003647426664,564,I knew the tree house office space was too good to be true!
5024,0,0,21,21,1.0,0.048795003647426664,564,"Sorry, I'm busy with clients."
5024,0,0,22,22,1.0,0.046524210519923545,564,Who are you calling a birdbrain?
5024,0,0,21,21,1.0,0.048795003647426664,564,We've got the hoo's hoo joining us today.
5024,0,0,21,21,1.0,0.048795003647426664,564,I'm just glad that I didn't try to bum a Camel.
5024,0,0,21,21,1.0,0.048795003647426664,564,"Not Which or What But Who, Mrs. Jones"
5024,0,0,21,21,1.0,0.048795003647426664,564,Try to remain very still.
5024,0,0,21,21,1.0,0.048795003647426664,564,"I wish you gave a hoot, Miss Jones."
5024,0,0,21,21,1.0,0.048795003647426664,564,We don't seem to give a hoot!
5024,0,0,21,21,1.0,0.048795003647426664,564,Who? Who? Who me?
5024,0,0,21,21,1.0,0.048795003647426664,564,"Who are you, who, who ... who, who? Who are you, who, who ... who, who?"
5024,0,0,21,21,1.0,0.048795003647426664,564,How is the email strike going?
5024,0,0,21,21,1.0,0.048795003647426664,564,I don't give a hoot. We stand united!
5024,0,0,23,23,1.0,0.044455422447438706,564,"No sir, I don't know who."
5024,0,0,21,21,1.0,0.048795003647426664,564,I see you have resorted to the nine wise men.
5024,0,0,21,21,1.0,0.048795003647426664,564,"""I think the Board is saying 'You need to wise up'""."
5024,0,0,24,24,1.0,0.04256282653793743,564,I love to sing-a.
5024,0,0,21,21,1.0,0.048795003647426664,564,"I appreciate your efforts, but I distinctly remember saying, ""order paper towels"" not owls!"
5024,0,0,21,21,1.0,0.048795003647426664,564,Have you see the nine pussycats I ought in yesterday ?
5024,0,0,21,21,1.0,0.048795003647426664,564,We need to talk.
5024,0,0,21,21,1.0,0.048795003647426664,564,There must be a better way than using owls to notify people that their copies of Harry Potter are over due.
5024,0,0,22,22,1.0,0.046524210519923545,564,"Trust me, Margaret. I do, in fact, give a hoot."
5024,0,0,21,21,1.0,0.048795003647426664,564,I thought this was scheduled for Tuesday.
5024,0,0,21,21,1.0,0.048795003647426664,564,Mr. Potter is driving me nuts with all of his messages. The good side is that our mouse problem is solved.
5024,0,0,21,21,1.0,0.048795003647426664,564,"I'm sorry it had to come to this Harry, but we're shutting your department down."
5024,0,0,22,22,1.0,0.046524210519923545,564,We like to ask: 'Who?'
5024,0,0,21,21,1.0,0.048795003647426664,564,I see all the Who's Whoos recipients have flown in to receive their plagues.
5024,0,0,21,21,1.0,0.048795003647426664,564,"I said, Do you have a can opener?"
5024,0,0,21,21,1.0,0.048795003647426664,564,"Sir, I'm not so sure that surrounding yourself with owls will help your night vision."
5024,0,0,21,21,1.0,0.048795003647426664,564,My wife is into taxidermy.
5024,0,0,21,21,1.0,0.048795003647426664,564,Who is responsible for this?
5024,0,0,21,21,1.0,0.048795003647426664,564,"Tell me that you didn't just say ""Who?"""
5024,0,0,21,21,1.0,0.048795003647426664,564,"The spotted owl is longer endangered. It's time to thin out the herd, whatever."
5024,0,0,21,21,1.0,0.048795003647426664,564,"""They are owls,"" said Patsy, ""but they look much smarter than the last class!"" ""Hoo hoo, who does, "" said the owls in unison."
5024,0,0,21,21,1.0,0.048795003647426664,564,They're nine times more effective than stool pigeons.
5024,0,0,21,21,1.0,0.048795003647426664,564,What about pussycats?
5024,0,0,21,21,1.0,0.048795003647426664,564,I've had enough of your wise cracks. I quit!
5024,0,0,21,21,1.0,0.048795003647426664,564,I put them here so you never forget how wise I truly am.
5024,0,0,21,21,1.0,0.048795003647426664,564,They can't all not give a hoot.
5024,0,0,21,21,1.0,0.048795003647426664,564,We sell them as a set to bowling alleys where people hate Trump's tweets.
5024,0,0,21,21,1.0,0.048795003647426664,564,"Just one, please. My husband is allergic."
5024,0,0,21,21,1.0,0.048795003647426664,564,Quick.. Get me the pigeon statue.
5024,0,0,21,21,1.0,0.048795003647426664,564,"Thank you, Gwynneth. These need to be stored with the bouquet of pheasants."
5024,0,0,21,21,1.0,0.048795003647426664,564,"Hey, everyone likes hooters!"
5024,0,0,21,21,1.0,0.048795003647426664,564,"No calls this afternoon, I'll be observing parliamentary procedures."
5024,0,0,22,22,1.0,0.046524210519923545,564,"Those are some decent hooters you have there, sir."
5024,0,0,21,21,1.0,0.048795003647426664,564,So... who cooks for you?
5024,0,0,21,21,1.0,0.048795003647426664,564,Do you know where to find an owl litter box?
5024,0,0,21,21,1.0,0.048795003647426664,564,"The saying has nothing to do with owls, it's ""the early bird gets the worm."""
5024,0,0,21,21,1.0,0.048795003647426664,564,"During your probationary period, we will be watching."
5024,0,0,21,21,1.0,0.048795003647426664,564,"Well Ma'am, this place crawls with politicians."
5024,0,0,21,21,1.0,0.048795003647426664,564,Mr. Hitchcock cancelled.
5024,0,0,22,22,1.0,0.046524210519923545,564,Harold did it.
5024,0,0,21,21,1.0,0.048795003647426664,564,Under no circumstances should you use the night depository to return your owl.
5024,0,0,22,22,1.0,0.046524210519923545,564,"I think you missed the ""b,"" but these things can hold candy with a little bit of training."
5024,0,0,24,24,1.0,0.04256282653793743,564,"I'm sorry, but your job has been owl-tumated."
5024,0,0,21,21,1.0,0.048795003647426664,564,"Ms. Clark, President Trump's Cabinet would like to order lunch in please."
5024,0,0,21,21,1.0,0.048795003647426664,564,"Well Miss Hornby, as those NEA funds are clearly not needed...."
5024,0,0,21,21,1.0,0.048795003647426664,564,"For the grand prize pick two from drawer #1, 4 from #2 or or 3 from drawer #3"
5024,0,0,21,21,1.0,0.048795003647426664,564,"I bought them as first editions, before I found out Allen Ginsberg wasn't from London."
5024,0,0,24,24,1.0,0.04256282653793743,564,"I don't care where you went on vacation, Carol. I don't need you leaving mementos on my desk."
5024,0,0,21,21,1.0,0.048795003647426664,564,"I know, 'Birds of a feather', but how do you fit in?"
5024,0,0,23,23,1.0,0.044455422447438706,564,Are you trying to make me feel bad about working nights?
5024,0,0,22,22,1.0,0.046524210519923545,564,We had a parliament of Owls.......would you like one?
5024,0,0,21,21,1.0,0.048795003647426664,564,"You can't have one, I don't give a hoot."
5024,0,0,21,21,1.0,0.048795003647426664,564,I'm afraid you're just not cute enough.
