rank,funny,somewhat_funny,unfunny,count,score,precision,contest,caption
1,137,65,201,403,1.8411910669975187,0.04498450258899197,565,"Wow, you are literally a hot mess."
2,186,133,285,604,1.836092715231788,0.03533623677414701,565,"No, I recommended exorcism, not exercise."
3,186,169,293,648,1.8348765432098766,0.03317164798606023,565,""" I can only make out : ' ... is required IMMEDIATELY ' ."
4,149,85,226,460,1.8326086956521739,0.04141288840180232,565,"From the ashes, your bill will magically appear."
5,60,84,158,302,1.6754966887417218,0.0452586478077868,565,The good news is this disease will be named after you.
6,51,86,142,279,1.6738351254480286,0.04588744232734129,565,"As you can see, we take patient confidentiality very seriously."
7,54,89,150,293,1.6723549488054608,0.04490837148580733,565,Let's handle the burning questions first.
8,53,71,145,269,1.657992565055762,0.04806286283160859,565,I'm going to refer you an exorcist in your network.
9,57,52,144,253,1.6561264822134387,0.05180156762532456,565,Your wife said it's best if you don't know who the father is.
10,37,51,103,191,1.6544502617801047,0.0568275170378187,565,"Actually, this time, it is as bad as it looks."
11,50,52,133,235,1.646808510638298,0.05286570536592389,565,The tests do confirm you are a flaming asshole.
12,50,54,135,239,1.6443514644351465,0.052162186332727865,565,"So the labs all come back normal, but I’d still like to get you to an exorcist."
13,46,60,131,237,1.641350210970464,0.05118120731760316,565,We finally got a reply from your insurance.
13,46,60,131,237,1.641350210970464,0.05118120731760316,565,Any family history of spontaneous combustion?
15,23,76,99,198,1.6161616161616161,0.04878366786148894,565,"Damn it Jim, I’m a doctor, not an exorcist!"
15,41,40,117,198,1.6161616161616161,0.05746982845900348,565,I think there's a good chance this'll be named for you.
17,36,53,114,203,1.6157635467980296,0.05410288165073,565,I recommend plenty of liquids.
18,33,57,110,200,1.615,0.053367739111652907,565,"We still don't know what you have, but we're pretty sure it's biblical."
19,32,42,103,177,1.5988700564971752,0.05847525860023856,565,"Honestly, I wouldn't even bother putting your pants back on."
20,33,39,105,177,1.5932203389830508,0.059073881146451256,565,We found a match
21,21,61,92,174,1.5919540229885059,0.05283433416877828,565,"In this case, the best treatment is diet and exorcism."
21,23,57,94,174,1.5919540229885059,0.05407724478159635,565,Nothing that bed rest and an exorcism won't fix.
23,23,54,93,170,1.588235294117647,0.05508480649242788,565,"Well, it's definitely not a cold."
24,25,49,95,169,1.5857988165680474,0.056615692299317254,565,Looks like it's just general inflammation.
25,28,35,93,156,1.5833333333333333,0.062322258982719224,565,"If you look closer at my degree on the wall, you'll notice it actually says infernal medicine."
26,27,41,95,163,1.5828220858895705,0.05954709960943682,565,Your test results are a bit alarming.
27,24,45,91,160,1.58125,0.058460244917799116,565,I'm sure this is just a temporary flare-up.
28,21,50,88,159,1.578616352201258,0.05670099303501594,565,It's pretty clear that you haven't been taking your anti inflammatory drugs.
28,16,60,83,159,1.578616352201258,0.053074901145992594,565,I can't help you. I'm referring you to an exorcist.
28,26,40,93,159,1.578616352201258,0.06010873556029078,565,"Sorry, Jim. Unfortunately, what happened in Vegas didn't stay in Vegas."
28,27,38,94,159,1.578616352201258,0.06076735625775548,565,Have you tried exorcising?
32,22,46,88,156,1.5769230769230769,0.05826159706170474,565,The Priest will be here for the exorcism soon.
33,20,51,87,158,1.5759493670886076,0.05628613492432117,565,The results came back positive as Hell.
33,25,41,92,158,1.5759493670886076,0.05975999715642668,565,The good news is you're covered under your fire and casualty insurance.
35,23,42,89,154,1.5714285714285714,0.05960651244659068,565,Got your results back. They look like hell.
36,18,50,83,151,1.5695364238410596,0.05677882714450794,565,"Just a guess, but are you feeling a burning sensation?"
37,21,40,85,146,1.5616438356164384,0.06067842145602111,565,Your inflammation appears to be spreading.
38,27,26,90,143,1.5594405594405594,0.06629475355337414,565,"Sir, you really need to see an Exorcist!"
39,21,39,85,145,1.5586206896551724,0.06102246780889084,565,It appears to be an inflammation.
39,21,39,85,145,1.5586206896551724,0.06102246780889084,565,I'm not sure you'll be able to handle this.
41,22,34,84,140,1.5571428571428572,0.06353044974136449,565,It''s just a flare-up.
42,19,40,82,141,1.553191489361702,0.060749733189230354,565,"I'll be honest, it's not the best sign."
43,17,40,78,135,1.548148148148148,0.061056226086237106,565,I'll prescribe an anti-inflammatory.
43,17,40,78,135,1.548148148148148,0.061056226086237106,565,We take patient confidentiality very seriously here.
43,20,34,81,135,1.548148148148148,0.0637145015081679,565,Your lab tests look like hell!
46,17,33,73,123,1.5447154471544715,0.0655633402297137,565,The good news? There's no need for a second opinion.
47,19,33,79,131,1.5419847328244274,0.06434962303921171,565,"Unfortunately, it's a pre-extinguishing condition."
48,12,46,72,130,1.5384615384615385,0.05794518223945803,565,I'm referring you to an exorcist.
48,18,34,78,130,1.5384615384615385,0.06382168636933047,565,We take your privacy very seriously.
50,21,24,78,123,1.5365853658536586,0.06954918802129995,565,We've swapped 'repeal and replace' for 'crash and burn.'
51,12,43,70,125,1.536,0.059615975343267125,565,Make a wish
52,13,40,71,124,1.532258064516129,0.06106353060000295,565,It's giving you 10 commandments.
53,19,26,76,121,1.5289256198347108,0.0685086913764741,565,"""Fever"" is not exactly the word for it."
54,20,25,78,123,1.5284552845528456,0.06861591537488884,565,We can't keep giving you medicines for Bipolar Disorder every time your Exorcist is out of town!
55,18,26,74,118,1.5254237288135593,0.06883886671593609,565,Good news. We found a match.
55,15,32,71,118,1.5254237288135593,0.06560637100009248,565,When was your most recent flare-up?
57,18,27,75,120,1.525,0.06794554171287077,565,"well, your test results are not what I hoped for."
57,15,33,72,120,1.525,0.06477984695434663,565,I'll consult an exorcist.
59,16,25,68,109,1.5229357798165137,0.0709102152474564,565,Eternal damnation is a pre-existing condition.
60,19,21,74,114,1.5175438596491229,0.07182978566753323,565,You're toast
60,14,31,69,114,1.5175438596491229,0.06620605058013096,565,I'd better skip straight to the bad news.
62,15,26,68,109,1.5137614678899083,0.0697243235495439,565,I hate the new patient records privacy procedures.
63,19,19,73,111,1.5135135135135136,0.07337077243790686,565,The new Trumpcare has simplified our record keeping.
64,13,28,66,107,1.5046728971962617,0.0681956686942413,565,I see you're still smoking.
64,10,34,63,107,1.5046728971962617,0.0642000155676714,565,Unfortunately the fire department is out-of-network.
66,16,23,70,109,1.5045871559633028,0.07094317885747149,565,"So, your test results have set off a few alarms."
66,14,27,68,109,1.5045871559633028,0.06850653469405799,565,"Actually, it's worse than it looks."
68,17,20,71,108,1.5,0.07265427123790053,565,I'm afraid I have some bad news. I stored your test results on my Samsung Galaxy Note 7.
68,17,16,67,100,1.5,0.07719841941125452,565,"Your heart is fine, but I'm worried about your soul."
68,10,32,62,104,1.5,0.0655305229635817,565,Your results appear to confirm inflammation.
71,11,28,62,101,1.495049504950495,0.06839570708582393,565,"Yes, I'm afraid it's flared up again"
71,13,24,64,101,1.495049504950495,0.07123210197467307,565,It's a medical miracle. Your bill is on fire but not consumed.
73,17,15,68,100,1.49,0.07719187689508436,565,Now would be a good time for that urine sample
73,11,27,62,100,1.49,0.06889459083603477,565,..and we take very seriously the privacy of your medical records.
73,13,23,64,100,1.49,0.0717670192393766,565,It's chartburn. I can help you with that.
76,10,28,61,99,1.4848484848484849,0.06789777983271914,565,I'm afraid that was the good news.
77,11,25,61,97,1.4845360824742269,0.07045721152512946,565,I'm going to need a urine sample. Quickly!
78,13,19,62,94,1.4787234042553192,0.07521603660756261,565,Inflammation. You should see how we depict constipation.
78,10,25,59,94,1.4787234042553192,0.07050610161351065,565,Let's just forget we ever did that test.
78,17,11,66,94,1.4787234042553192,0.08107141642139282,565,"This is not an attempt to win because I submitted another entry to avoid using profanity. I only want to know if minor (or major) profanity is allowed. This would have been my caption. Well, this x-ray proves it. You are a flaming asshole."
81,9,25,57,91,1.4725274725274726,0.07047832275375876,565,The results are in... you're a pyromaniac
81,10,23,58,91,1.4725274725274726,0.07218998699531143,565,I'm referring you to an exorcist.
83,14,14,62,90,1.4666666666666666,0.0793229779538103,565,Now would be a good time for that urine sample
83,12,18,60,90,1.4666666666666666,0.07611017705396578,565,Roast two marshmallows and call me in the morning.
85,9,23,56,88,1.4659090909090908,0.0721893474854644,565,We got your urine sample back from the lab. We found that burning sensation you complained about.
85,10,21,57,88,1.4659090909090908,0.07397658352634863,565,Have you visited any sites from the Old Testament in the last six months?
87,9,22,56,87,1.4597701149425288,0.07275940825222507,565,You sure you wore a condom?
87,10,20,57,87,1.4597701149425288,0.07457371987219019,565,Perhaps I should start with the good news
87,11,18,58,87,1.4597701149425288,0.07634492715261329,565,The inflammation appears to be spreading.
90,10,19,56,85,1.4588235294117646,0.07587572984798069,565,"Your vital signs are good, but I'm a bit worried about you in the afterlife."
90,10,19,56,85,1.4588235294117646,0.07587572984798069,565,"The test not only indicates that you have six months to live, it also tells us where you'll be going."
90,14,11,60,85,1.4588235294117646,0.08293114348202042,565,Your health is fine. It's your afterlife I'm concerned about.
93,8,19,50,77,1.4545454545454546,0.07743639937748306,565,"Well, it's more inflamed than we thought."
94,8,22,54,84,1.4523809523809523,0.072661006660493,565,Patient confidentiality is our number one priority.
94,10,18,56,84,1.4523809523809523,0.0765071588428556,565,Your insurance plan requires me to torch any evidence of pre-existing conditions.
94,11,16,57,84,1.4523809523809523,0.07835947349778967,565,I wouldn't start any long books.
97,7,23,52,82,1.451219512195122,0.07186683255380011,565,"Believe me, you didn't want to know."
97,9,19,54,82,1.451219512195122,0.07594122639133905,565,You may experience a burning sensation...
97,10,17,55,82,1.451219512195122,0.0778985493322754,565,The good news? We can definitely rule out hypothermia.
97,10,17,55,82,1.451219512195122,0.0778985493322754,565,"Now that I've taken down all the relevant information, patient privacy laws require that I burn your medical record."
97,5,27,50,82,1.451219512195122,0.06754711967812747,565,The good news is that your asbestos level is also high.
102,7,22,52,81,1.4444444444444444,0.07243558228002943,565,"On the bright side, your lipids look great."
102,10,16,55,81,1.4444444444444444,0.07856742013183861,565,Please don't let this worry you.
102,9,18,54,81,1.4444444444444444,0.07657804862272345,565,We've located a match.
102,6,24,51,81,1.4444444444444444,0.07027283689263066,565,"Given your lab results, I'd prefer that you don't touch anything on your way out."
102,6,24,51,81,1.4444444444444444,0.07027283689263066,565,"Uh, any exorcisms you didn't tell us about?"
102,8,20,53,81,1.4444444444444444,0.07453559924999299,565,It appears your insurance has been declined.
108,9,15,51,75,1.44,0.08107387355352506,565,We are committed to maintaining the privacy of patient results.
109,10,14,54,78,1.435897435897436,0.08076751289210134,565,I'd say your bowel is beyond merely irritable.
110,11,11,54,76,1.4342105263157894,0.08447054156038708,565,You just finished paying off my mortgage.
110,7,19,50,76,1.4342105263157894,0.07570841181516923,565,"So, you say your laser vision is acting up."
110,7,19,50,76,1.4342105263157894,0.07570841181516923,565,Our top priority is getting this inflammation under control.
113,8,16,50,74,1.4324324324324325,0.07952348150068188,565,The bad news isn't that you're dying - it's where you're headed after that.
113,9,14,51,74,1.4324324324324325,0.08181819697924704,565,You have one hell of a fever.
115,9,14,52,75,1.4266666666666667,0.08092557660560071,565,You have some inflammation.
115,9,14,52,75,1.4266666666666667,0.08092557660560071,565,I think we can rule out a false positive.
115,8,16,51,75,1.4266666666666667,0.07866758283173945,565,I think we're looking at a flare up.
115,11,10,54,75,1.4266666666666667,0.08526235787069032,565,This happens sometimes when Paul Ryan's health plan is exposed to light.
119,10,11,52,73,1.4246575342465753,0.08484431130621939,565,"I think we can just skip over the ""good news"" part?"
119,8,15,50,73,1.4246575342465753,0.08023417073427205,565,"The prognosis isn't good, Sir. You're going straight to hell."
119,9,13,51,73,1.4246575342465753,0.08257142155262615,565,"Your Healthcare plan has been programmed to self-destruct at the first sign of a serious illness, so we'll have to work fast."
119,9,13,51,73,1.4246575342465753,0.08257142155262615,565,Liar liar charts on fire
119,5,21,47,73,1.4246575342465753,0.07277341301602387,565,Our tests indicate severe inflammation.
119,6,19,48,73,1.4246575342465753,0.07534246575342467,565,It is just acid reflux. The lab is being dramatic.
125,3,23,44,70,1.4142857142857144,0.06898512199803451,565,No smoke. That's a good sign.
125,7,15,48,70,1.4142857142857144,0.08009532918264751,565,"Forget exercise, you need an exorcism."
125,7,15,48,70,1.4142857142857144,0.08009532918264751,565,Your test results show some inflammation.
125,9,11,50,70,1.4142857142857144,0.08510827872054014,565,Any history of spontaneous combustion in the family?
125,8,13,49,70,1.4142857142857144,0.08263982352246951,565,Our new privacy procedures are lo-tech.
125,6,17,47,70,1.4142857142857144,0.07746730330874069,565,You may want a second opinion.
125,8,13,49,70,1.4142857142857144,0.08263982352246951,565,Okay...THAT's not good.
125,7,15,48,70,1.4142857142857144,0.08009532918264751,565,I'm going to need a urine sample. Immediately.
125,9,11,50,70,1.4142857142857144,0.08510827872054014,565,Your bowel syndrome isn't just irritable. It's mad as hell.
125,8,13,49,70,1.4142857142857144,0.08263982352246951,565,Seems they don't like your preexisting condition.
125,8,13,49,70,1.4142857142857144,0.08263982352246951,565,I'm afraid it's flared up again.
125,9,11,50,70,1.4142857142857144,0.08510827872054014,565,Your insurance company got back to us.
125,6,17,47,70,1.4142857142857144,0.07746730330874069,565,Your test results are in. You're going to hell.
125,6,17,47,70,1.4142857142857144,0.07746730330874069,565,It's probably nothing serious.
139,8,12,48,68,1.411764705882353,0.08442153033359522,565,"Can you point out on this chart how intense the ""burning sensation"" is?"
139,8,12,48,68,1.411764705882353,0.08442153033359522,565,You're having another flare-up.
139,7,14,47,68,1.411764705882353,0.08178027403409562,565,Your best option is a bucket list.
139,5,18,45,68,1.411764705882353,0.07622368461012001,565,"Oops, I forgot to tell you your mission."
139,4,20,44,68,1.411764705882353,0.07328757420442214,565,Your lab work is conclusive. All I can do is refer you to an exorcist.
139,6,16,46,68,1.411764705882353,0.07905081693643279,565,This is what happens when you bring lies about exercise and diet to my office.
139,6,16,46,68,1.411764705882353,0.07905081693643279,565,"I tell you, this patient privacy stuff is really getting out of hand."
139,5,18,45,68,1.411764705882353,0.07622368461012001,565,"No records, no malpractice."
139,4,20,44,68,1.411764705882353,0.07328757420442214,565,I'm gonna need that urine sample now.
139,6,16,46,68,1.411764705882353,0.07905081693643279,565,"On the upside, you might as well quit diet & exercise."
139,5,18,45,68,1.411764705882353,0.07622368461012001,565,It's pyromania.
139,8,12,48,68,1.411764705882353,0.08442153033359522,565,I can make your preexisting conditions disappear!
139,6,16,46,68,1.411764705882353,0.07905081693643279,565,you have a bad case of chart burn
152,3,23,45,71,1.408450704225352,0.06825642499288853,565,"After reading this report, I'm surprised you're able to sit down."
153,8,11,48,67,1.4029850746268657,0.0852264429732949,565,The results are back. You're going to Hell.
153,6,15,46,67,1.4029850746268657,0.0797432035544918,565,I see your fever is off the charts.
153,7,13,47,67,1.4029850746268657,0.08253037348459476,565,It's clear you need an anti-inflammatory.
153,8,11,48,67,1.4029850746268657,0.0852264429732949,565,I'm going to start you on some anti inflammatories
153,5,17,45,67,1.4029850746268657,0.076855022469319,565,Your lab results suggest you have an inflamation.
153,6,15,46,67,1.4029850746268657,0.0797432035544918,565,Expect a flare-up or two.
153,4,19,44,67,1.4029850746268657,0.07385398055884286,565,The test results confirm your burning sensation.
160,7,12,46,65,1.4,0.08435273922869733,565,"This report confirms it, you are a flaming a*#hole."
160,7,12,46,65,1.4,0.08435273922869733,565,"Well, it's definitely inflamed."
160,6,14,45,65,1.4,0.08145314840210525,565,The lab report for your hemmoroids is back ...
160,7,12,46,65,1.4,0.08435273922869733,565,"And behold the bill was burning with fire, yet the bill was not consumed."
160,5,16,44,65,1.4,0.0784464540552736,565,"Obviously, we're concerned about inflammation."
160,10,6,49,65,1.4,0.09250779592927455,565,Well...it's the Mother Of All Bills.
160,5,16,44,65,1.4,0.0784464540552736,565,The good news is that whatever you have won't last long.
160,4,18,43,65,1.4,0.07531983087525437,565,We just moved our records over to Snapchat.
160,4,18,43,65,1.4,0.07531983087525437,565,I'm going to refer you to an arsonist.
160,9,8,48,65,1.4,0.0898717034272917,565,"Your test result, should you choose to accept it, ..."
160,6,14,45,65,1.4,0.08145314840210525,565,"So, under Trump Care...."
160,7,12,46,65,1.4,0.08435273922869733,565,We should treat this before it spreads.
160,6,14,45,65,1.4,0.08145314840210525,565,Apparently your insurance won't cover it.
160,6,14,45,65,1.4,0.08145314840210525,565,It's the latest revision..... the Combustible Care Act.
160,6,14,45,65,1.4,0.08145314840210525,565,It's easier for me to just burn your bill than to deal with your insurance company
160,9,8,48,65,1.4,0.0898717034272917,565,"If you don't mind, I'm going to give you the bad news quickly."
160,9,8,48,65,1.4,0.0898717034272917,565,We're converting to a paperless system.
160,5,16,44,65,1.4,0.0784464540552736,565,Have you been experiencing any hot flashes of late?
160,6,14,45,65,1.4,0.08145314840210525,565,Your cholesterol levels are great but your nitroglycerides are off the chart.
160,8,10,47,65,1.4,0.08715591687403583,565,The good news is you won't be around to see the bill.
180,5,12,39,56,1.3928571428571428,0.08708322422045936,565,This your coverage. This is your coverage on TrumpCare. Any questions?
180,7,8,41,56,1.3928571428571428,0.09424536720355063,565,The good news is that you won’t have to worry about the fate of Obamacare.
182,6,13,45,64,1.390625,0.08218611373989324,565,The insurance company doesn't seem inclined to accept our appeal.
182,6,13,45,64,1.390625,0.08218611373989324,565,Now might be a good time to get an advance directive.
182,9,7,48,64,1.390625,0.09078905512098859,565,I think we can skip the thermometer.
182,7,11,46,64,1.390625,0.08515039070784357,565,There's no cause for alarm.
182,5,15,44,64,1.390625,0.07911084341375031,565,"Sorry, this happens now every time a new patient has a pre-existing conditon."
182,8,9,47,64,1.390625,0.08801488955699574,565,Apparently your Trumpcare insurance policy self-destructs upon implementation.
182,5,15,44,64,1.390625,0.07911084341375031,565,Your phosphorus level is a little too high.
182,6,13,45,64,1.390625,0.08218611373989324,565,Apparently your insurance company disagrees with the treatment plan.
182,8,9,47,64,1.390625,0.08801488955699574,565,"""It looks like the answer to your prayers is 'NO'""."
182,9,7,48,64,1.390625,0.09078905512098859,565,"Sorry, but all your records were on my Galaxy Note 7."
182,6,13,45,64,1.390625,0.08218611373989324,565,And then there's the bad news
182,7,11,46,64,1.390625,0.08515039070784357,565,your inflammation levels are off the chart!
182,6,13,45,64,1.390625,0.08218611373989324,565,We take patient confidentiality very seriously.
182,6,13,45,64,1.390625,0.08218611373989324,565,Well that explains your fever.
182,7,11,46,64,1.390625,0.08515039070784357,565,"It says here that, ""you are currently on fire"", is that correct?"
182,9,7,48,64,1.390625,0.09078905512098859,565,"Ok, now if you'll just bend over for me...."
198,6,12,44,62,1.3870967741935485,0.08403758416593776,565,"The good news is, you might as well just keep smoking."
198,6,12,44,62,1.3870967741935485,0.08403758416593776,565,"An inflammatory response, yes, but we need to run a few more tests."
198,6,12,44,62,1.3870967741935485,0.08403758416593776,565,"According to these vitals, you seem to have a fever, at least on paper."
198,6,12,44,62,1.3870967741935485,0.08403758416593776,565,No cause for alarm. It's our new data protection software.
198,7,10,45,62,1.3870967741935485,0.08712712713167857,565,I've seen worse.
198,5,14,43,62,1.3870967741935485,0.08083003663660228,565,The results from your hemorrhoid test are back.
198,5,14,43,62,1.3870967741935485,0.08083003663660228,565,You have the worst case of heart burn I've ever seen!
198,6,12,44,62,1.3870967741935485,0.08403758416593776,565,Trumpcare.
198,8,8,46,62,1.3870967741935485,0.09011080408026713,565,"Under the circumstances, you might want to skip the treatment and go straight to cremation."
198,7,10,45,62,1.3870967741935485,0.08712712713167857,565,Your test results are alarming.
198,5,14,43,62,1.3870967741935485,0.08083003663660228,565,This is how we make sure no one has access to your records.
198,5,14,43,62,1.3870967741935485,0.08083003663660228,565,What we do know is that you have an inflammatory condition.
210,7,11,47,65,1.3846153846153846,0.08404528224389292,565,my prognosis is death followed by damnation
211,6,11,43,60,1.3833333333333333,0.08600245255557767,565,"I don't want to extinguish all hope, BUT..."
211,2,19,39,60,1.3833333333333333,0.0716696228532331,565,I think I should refer you to a specialist
211,0,23,37,60,1.3833333333333333,0.06329764084940143,565,It does say you need to burn more carbs.
211,9,5,46,60,1.3833333333333333,0.09534850339576222,565,I've pioneered an exciting new method of hemorrhoid extraction...
211,4,15,41,60,1.3833333333333333,0.07916109109120167,565,Your fever is off the charts!
211,4,15,41,60,1.3833333333333333,0.07916109109120167,565,It is more common than you may think in men over fifty.
211,3,17,40,60,1.3833333333333333,0.07550832133836045,565,The inflammation is more serious than we thought.
211,4,15,41,60,1.3833333333333333,0.07916109109120167,565,"No insurance. No money. I'm afraid that there's really nothing that i can do. However, there is this contract with the devil."
211,4,15,41,60,1.3833333333333333,0.07916109109120167,565,I'd like to send you to a witch doctor.
211,4,15,41,60,1.3833333333333333,0.07916109109120167,565,You'll need to take this with plenty of water.
211,5,13,42,60,1.3833333333333333,0.08265258673606023,565,It looks like you're going straight to hell.
211,6,11,43,60,1.3833333333333333,0.08600245255557767,565,It appears your procedure exceeds your coverage
211,4,15,41,60,1.3833333333333333,0.07916109109120167,565,Unfortunately we printed your test results from a Samsung Galaxy Note 7.
211,5,13,42,60,1.3833333333333333,0.08265258673606023,565,We'll start by eliminating all spicy foods.
211,6,11,43,60,1.3833333333333333,0.08600245255557767,565,I'm afraid your clap has turned in to an applause
226,4,14,41,59,1.3728813559322033,0.07980947902708653,565,Who did you say referred you?
226,6,10,43,59,1.3728813559322033,0.08682430543610901,565,This is your brain on Trumpcare.
226,8,6,45,59,1.3728813559322033,0.09331327390221894,565,The coroner is on his way.
226,3,16,40,59,1.3728813559322033,0.07605984095849185,565,I thought you gave up the spicy foods?
226,8,6,45,59,1.3728813559322033,0.09331327390221894,565,Like I tell all of my patients....What you don't know can't hurt you.
231,5,11,41,57,1.368421052631579,0.08536953047744911,565,You may want to tell your wife about this.
231,7,7,43,57,1.368421052631579,0.0924180153759012,565,"""According to your 'Explanation of Benefits', your only covered for cremation""!"
231,5,11,41,57,1.368421052631579,0.08536953047744911,565,Any family history of spontaneous combustion?
231,6,9,42,57,1.368421052631579,0.08896360576089647,565,"According to our records, your symptoms are flaring up again."
231,5,11,41,57,1.368421052631579,0.08536953047744911,565,"Unfortunately, this is all I can do under TrumpCare."
231,5,11,41,57,1.368421052631579,0.08536953047744911,565,"Another flare-up, I see."
231,7,7,43,57,1.368421052631579,0.0924180153759012,565,"Your Cholesterol Level is So High, It Started a Grease Fire."
231,2,17,38,57,1.368421052631579,0.0735408558953444,565,"Yes, there definitely seems to be some inflammation."
231,7,7,43,57,1.368421052631579,0.0924180153759012,565,Your insurance company says they don't cover it.
231,4,13,40,57,1.368421052631579,0.08161734079164801,565,Oops! It looks like congress just passed health care reform.
231,6,9,42,57,1.368421052631579,0.08896360576089647,565,"First, the good news: it no longer matters if you quit smoking."
231,5,11,41,57,1.368421052631579,0.08536953047744911,565,You have a classic case of burnout.
231,3,15,39,57,1.368421052631579,0.07768412902169858,565,There's a lot of pressure to go paperless.
231,5,11,41,57,1.368421052631579,0.08536953047744911,565,Looks like insurance will be denying this
231,3,15,39,57,1.368421052631579,0.07768412902169858,565,It hurts me to tell you this.
231,3,15,39,57,1.368421052631579,0.07768412902169858,565,I think what we're looking at is some kind of inflammation.
231,4,13,40,57,1.368421052631579,0.08161734079164801,565,This is why we can assure confidentiality of patient records.
231,7,7,43,57,1.368421052631579,0.0924180153759012,565,Now this may burn just a little bit.
231,6,9,42,57,1.368421052631579,0.08896360576089647,565,We switched to paper because our cellular phones were exploding.
231,8,5,44,57,1.368421052631579,0.09574787716738378,565,"I'm a doctor; you only need to say ""burning sensation""."
231,7,7,43,57,1.368421052631579,0.0924180153759012,565,I'm sorry. It's chartburn.
231,3,15,39,57,1.368421052631579,0.07768412902169858,565,"I'm sorry, it's spread to your soul."
231,5,11,41,57,1.368421052631579,0.08536953047744911,565,I'm afraid it's worse than it looks.
231,5,11,41,57,1.368421052631579,0.08536953047744911,565,"As you might guess, this isn't great news."
231,5,11,41,57,1.368421052631579,0.08536953047744911,565,Let me go over these results quickly.
231,5,11,41,57,1.368421052631579,0.08536953047744911,565,It's called TrumpCare.
231,8,5,44,57,1.368421052631579,0.09574787716738378,565,"These are the exercises I want you to do at home, but you're never gonna get around to em, so..."
231,6,9,42,57,1.368421052631579,0.08896360576089647,565,I think it's time we address your inflammation levels.
231,7,7,43,57,1.368421052631579,0.0924180153759012,565,I see here that you're suffering from a burning sensation.
231,6,9,42,57,1.368421052631579,0.08896360576089647,565,"Now, about your pyrokinesis . . ."
231,6,9,42,57,1.368421052631579,0.08896360576089647,565,This might burn.
231,6,9,42,57,1.368421052631579,0.08896360576089647,565,This'll only burn for a second.
231,3,15,39,57,1.368421052631579,0.07768412902169858,565,Worst case of burnout I've ever seen.
231,5,11,41,57,1.368421052631579,0.08536953047744911,565,"Yes, it's catching."
265,8,6,46,60,1.3666666666666667,0.0919551188323559,565,It's either heartburn or you're the Devil.
266,5,10,40,55,1.3636363636363635,0.08747731351357967,565,"Mr. Hunt, your office just sent me your medical records, but unfortunately, I thought they were kidding when they said they would self-destruct in 20 seconds. Anyway, you have Chlamydia."
266,6,8,41,55,1.3636363636363635,0.09124517002534316,565,"Judging by your colonoscopy results, I'm guessing you're fond of spicy food."
268,2,17,39,58,1.3620689655172413,0.07254043602767966,565,Look on the bright side: test results usually aren't so clear.
269,6,8,42,56,1.3571428571428572,0.08983596678192864,565,"Well, it's definitely not a cold."
269,6,8,42,56,1.3571428571428572,0.08983596678192864,565,"With your pants testing positive, I’d say you’re a pathological liar."
269,4,12,40,56,1.3571428571428572,0.08229094499969293,565,"In a moment, you will feel a slight burning sensation."
269,5,10,41,56,1.3571428571428572,0.08614609845078962,565,I recommend an anti-inflammatory.
269,6,8,42,56,1.3571428571428572,0.08983596678192864,565,"If we burn this, you don't have a pre-existing condition."
269,2,16,38,56,1.3571428571428572,0.07398039152533047,565,"I need to run more tests, but my initial diagnosis is pyromania."
269,6,8,42,56,1.3571428571428572,0.08983596678192864,565,Do the hemorrhoids feel like this?
269,4,12,40,56,1.3571428571428572,0.08229094499969293,565,"Well Mr. Wilson, looks like a nasty case of spontaneous combustion"
269,3,14,39,56,1.3571428571428572,0.07824607964359517,565,Your report clearly indicates Acute Inflamation .
269,4,12,40,56,1.3571428571428572,0.08229094499969293,565,I imagine you'll want a second opinion.
269,3,14,39,56,1.3571428571428572,0.07824607964359517,565,We've successfully removed your heartburn.
269,2,16,38,56,1.3571428571428572,0.07398039152533047,565,Let’s just keep an eye on it for now.
269,3,14,39,56,1.3571428571428572,0.07824607964359517,565,I diagnose pyromania.
269,6,8,42,56,1.3571428571428572,0.08983596678192864,565,I'm going to have to prescribe an anti-inflamitory!
269,4,12,40,56,1.3571428571428572,0.08229094499969293,565,"So, you say it's a burning sensation?"
284,5,8,38,51,1.3529411764705883,0.09213600097624101,565,I will need a list of the last five people you've been intimate with. Immediately.
284,5,8,38,51,1.3529411764705883,0.09213600097624101,565,I see here you didn't cut down on spicy foods.
284,5,8,38,51,1.3529411764705883,0.09213600097624101,565,Your health plan went from repeal and replace to incinerate.
287,4,11,39,54,1.3518518518518519,0.08425033165473296,565,Your results are difficult to interpret.
287,5,9,40,54,1.3518518518518519,0.08830022878508999,565,"On the other hand, your pyrokinesis is just fine."
287,1,17,36,54,1.3518518518518519,0.07072257295398894,565,I'm going to refer your case to a specialist. A priest.
287,4,11,39,54,1.3518518518518519,0.08425033165473296,565,How recently since you returned from Burning Man?
287,5,9,40,54,1.3518518518518519,0.08830022878508999,565,Paul Ryan American Care Act - Version 2.0
287,5,9,40,54,1.3518518518518519,0.08830022878508999,565,I won't keep you in suspense.
287,4,11,39,54,1.3518518518518519,0.08425033165473296,565,"Well, we can rule out hypothermia."
287,5,9,40,54,1.3518518518518519,0.08830022878508999,565,Your test results look like hell!
287,4,11,39,54,1.3518518518518519,0.08425033165473296,565,The medication has a few side effects.
287,3,13,38,54,1.3518518518518519,0.07999566465981617,565,Is there a history of spontaneous combustion in your family?
287,6,7,41,54,1.3518518518518519,0.09217235172797736,565,Let's start with the good news.
287,4,11,39,54,1.3518518518518519,0.08425033165473296,565,"At least the results are conclusive, you have to be happy about that."
287,4,11,39,54,1.3518518518518519,0.08425033165473296,565,I'm afraid you're going to have to tell your wife about this.
287,4,11,39,54,1.3518518518518519,0.08425033165473296,565,In cases like this we like to treat fire with fire.
287,6,7,41,54,1.3518518518518519,0.09217235172797736,565,It reduces my malpractice premiums.
287,6,7,41,54,1.3518518518518519,0.09217235172797736,565,Now let's test your reflexes....
287,5,9,40,54,1.3518518518518519,0.08830022878508999,565,"The DNA test shows you to be a mix of Northern Italian, Montenegrin, and spawn of Satan."
287,5,9,40,54,1.3518518518518519,0.08830022878508999,565,"If it's any consolation, Inflammatory Bill Disease is an extremely common condition."
287,7,5,42,54,1.3518518518518519,0.0958882393343037,565,Results are in...your gonna have to back off on the Sriracha.
287,6,7,41,54,1.3518518518518519,0.09217235172797736,565,This is your brain on politics
287,6,7,41,54,1.3518518518518519,0.09217235172797736,565,"Looks like you're covered under ACA.... Oh, wait..."
287,4,11,39,54,1.3518518518518519,0.08425033165473296,565,Your health is perfect but your soul worries me.
287,5,9,40,54,1.3518518518518519,0.08830022878508999,565,You're worried about side effects?
287,4,11,39,54,1.3518518518518519,0.08425033165473296,565,Ya... um... it's not good.
287,4,11,39,54,1.3518518518518519,0.08425033165473296,565,And the chili pepper eating contest? When was that?
287,2,15,37,54,1.3518518518518519,0.07550161816013631,565,You were right. You shouldn't have come in.
287,2,15,37,54,1.3518518518518519,0.07550161816013631,565,Your insurance says you can burn in hell before they’ll cover this.
287,3,13,38,54,1.3518518518518519,0.07999566465981617,565,Usually that only happens during urination.
315,4,10,38,52,1.3461538461538463,0.08633922095068138,565,It appears your inflammation has spread.
315,5,8,39,52,1.3461538461538463,0.09060137354004033,565,It's the worst case of inflammation that I've ever seen!
315,2,14,36,52,1.3461538461538463,0.07711138339070239,565,I guess they were serious about these paperless medical records.
315,5,8,39,52,1.3461538461538463,0.09060137354004033,565,"Here at the sperm bank, we take our donor's identity very seriously"
315,3,12,37,52,1.3461538461538463,0.08185544124491197,565,I've billed you for a new printer.
315,4,10,38,52,1.3461538461538463,0.08633922095068138,565,"Your heartburn is not only off the charts, it's destroying the charts."
315,5,8,39,52,1.3461538461538463,0.09060137354004033,565,And your blood pressure is 666 over 666.
315,5,8,39,52,1.3461538461538463,0.09060137354004033,565,Tell me more about this burning sensation.
315,2,14,36,52,1.3461538461538463,0.07711138339070239,565,Even your chart is inflamed.
315,3,12,37,52,1.3461538461538463,0.08185544124491197,565,This may burn a little.
315,4,10,38,52,1.3461538461538463,0.08633922095068138,565,"Do you want the bad news or the really, really bad news first?"
315,4,10,38,52,1.3461538461538463,0.08633922095068138,565,Is this what it feels like when you urinate?
315,4,10,38,52,1.3461538461538463,0.08633922095068138,565,"If you can blow this out before it gets to my fingers, I won't have to listen to your lungs."
315,5,8,39,52,1.3461538461538463,0.09060137354004033,565,"Everything’s fine! By the way, you were never here."
315,5,8,39,52,1.3461538461538463,0.09060137354004033,565,"Now, let's see, it says here that your previous doctor was a.....Dante?"
315,5,8,39,52,1.3461538461538463,0.09060137354004033,565,Your test results came back positive for inflammation I'm afraid!
315,3,12,37,52,1.3461538461538463,0.08185544124491197,565,I'd say you're suffering from burnout.
332,3,11,36,50,1.34,0.08383657572069263,565,"As you see, Mr. Greene, the inflammation is worse than we expected."
332,4,9,37,50,1.34,0.08857142857142856,565,I prescribe not watching anymore politics on TV
332,6,5,39,50,1.34,0.09735271449943325,565,You're a wizard Harry!
332,4,9,37,50,1.34,0.08857142857142856,565,"For malpractice insurance purposes, there will be no record of my diagnosis."
332,2,13,35,50,1.34,0.0788177955664784,565,It's just my way of avoiding a malpractice suit
332,3,11,36,50,1.34,0.08383657572069263,565,"I won't say it's hopeless, but I'm prescribing brimstone."
332,3,11,36,50,1.34,0.08383657572069263,565,"I'm sorry, but your test results are classified."
332,5,7,38,50,1.34,0.09306569985658475,565,Holy Smokes!
332,3,11,36,50,1.34,0.08383657572069263,565,This is the worst part of the job
332,4,9,37,50,1.34,0.08857142857142856,565,You have a disease of biblical proportion!
332,3,11,36,50,1.34,0.08383657572069263,565,The good news is that you can never get hypothermia.
332,3,11,36,50,1.34,0.08383657572069263,565,"OMG, you've got Samsung's disease!"
332,6,5,39,50,1.34,0.09735271449943325,565,I thought there was hope. Apparently not.
332,4,9,37,50,1.34,0.08857142857142856,565,"Your lab report says, ""Liar, liar, pants on fire."""
332,3,11,36,50,1.34,0.08383657572069263,565,"So, YOU'RE the guy dating my receptionist."
347,5,7,39,51,1.3333333333333333,0.0914659120760047,565,Appears to be a serious inflammation.
347,4,9,38,51,1.3333333333333333,0.0870729541614687,565,"Right, but, medicine isn't actually a science."
347,4,9,38,51,1.3333333333333333,0.0870729541614687,565,Here's how heartburns works.
347,3,11,37,51,1.3333333333333333,0.08244625898677896,565,Imagine this is your stomach lining.
347,3,11,37,51,1.3333333333333333,0.08244625898677896,565,"I'm sorry Mr. Smith, some things just won't stay in Vegas."
347,5,7,39,51,1.3333333333333333,0.0914659120760047,565,The good news is you have six months to live. After that things get grim.
347,4,9,38,51,1.3333333333333333,0.0870729541614687,565,Side effects? Why do you ask?
347,3,11,37,51,1.3333333333333333,0.08244625898677896,565,It's a new HIPAA requirement.
347,4,9,38,51,1.3333333333333333,0.0870729541614687,565,You must have Trumpcare!
347,3,11,37,51,1.3333333333333333,0.08244625898677896,565,We could've just told your wife it was from a toilet seat.
357,4,9,39,52,1.3269230769230769,0.08562235054373873,565,"If you're too embarrassed to say it, is THIS how it feels down there?"
358,4,8,37,49,1.3265306122448979,0.08934643222152173,565,"How are you at metaphors, Mr. Quimby?"
358,4,8,37,49,1.3265306122448979,0.08934643222152173,565,Hmm .. the DNA test says you are 1/4 Dragon.
358,3,10,36,49,1.3265306122448979,0.08445380284309616,565,"According to the test results, you're a ""hot mess""."
358,2,12,35,49,1.3265306122448979,0.07925972923626559,565,It's the lab report on your hemorrhoids
358,4,8,37,49,1.3265306122448979,0.08934643222152173,565,It's definitely not a cold.
358,3,10,36,49,1.3265306122448979,0.08445380284309616,565,Does your health plan include any shamans?
358,2,12,35,49,1.3265306122448979,0.07925972923626559,565,"Your prescription, should you choose to accept it, will self-destruct in 15 seconds."
358,3,10,36,49,1.3265306122448979,0.08445380284309616,565,These new tests tell me how long you've got and where you're going... after.
358,4,8,37,49,1.3265306122448979,0.08934643222152173,565,You can do this. It's only ten commandments.
358,3,10,36,49,1.3265306122448979,0.08445380284309616,565,"Well, first off, your blood pressure is rather high."
358,1,14,34,49,1.3265306122448979,0.07370050571435525,565,I see you're in the high risk insurance pool.
358,3,10,36,49,1.3265306122448979,0.08445380284309616,565,Your health plan doesn't cover chartburn.
358,3,10,36,49,1.3265306122448979,0.08445380284309616,565,The blood test shows your inflammatory markers are pretty elevated.
358,2,12,35,49,1.3265306122448979,0.07925972923626559,565,Does it itch too?
358,5,6,38,49,1.3265306122448979,0.09398470666427278,565,I see that you were referred by a Doctor Faustus...
358,4,8,37,49,1.3265306122448979,0.08934643222152173,565,It looks like a case of inflammatory billing syndrome.
358,2,12,35,49,1.3265306122448979,0.07925972923626559,565,We're having a little trouble with your insurance.
358,5,6,38,49,1.3265306122448979,0.09398470666427278,565,I am surprised you are able to sit.
358,2,12,35,49,1.3265306122448979,0.07925972923626559,565,We go above and beyond HIPAA in protecting your privacy rights.
358,2,12,35,49,1.3265306122448979,0.07925972923626559,565,Your medical records will self-destruct in five seconds. Good luck Jim.
358,2,12,35,49,1.3265306122448979,0.07925972923626559,565,"First the good news: Your plan has excellent cremation coverage, anyway."
358,4,8,37,49,1.3265306122448979,0.08934643222152173,565,"Well, we could always get a third opinion."
380,3,10,37,50,1.32,0.08300479455047971,565,"Well, looking at these results, you maybe an arsonist."
381,5,5,37,47,1.3191489361702127,0.0966907722496155,565,"Don't fret, Mr. McDaniels, flaming medical record syndrome has been fairly common ever since Pfizer invented a pill for it."
381,3,9,35,47,1.3191489361702127,0.0865965742845523,565,"I'm an optimist, but this can't be good."
381,3,9,35,47,1.3191489361702127,0.0865965742845523,565,Your flare-up is worse than we originally thought.
381,2,11,34,47,1.3191489361702127,0.08107957386183322,565,"Well, it appears you've been burning everything except calories"
381,4,7,36,47,1.3191489361702127,0.09178254767668796,565,"I'm sorry, Mr. Thompson. Your insurance canceled you this morning."
381,2,11,34,47,1.3191489361702127,0.08107957386183322,565,It’s also called Mrs. O'Leary's Cow Disease.
381,3,9,35,47,1.3191489361702127,0.0865965742845523,565,The tests confirm you're going to need something stronger than Prilosec.
381,5,5,37,47,1.3191489361702127,0.0966907722496155,565,Well there's your second opinion.
381,3,9,35,47,1.3191489361702127,0.0865965742845523,565,"On second thought, let's keep you out of the oxygen tent."
381,3,9,35,47,1.3191489361702127,0.0865965742845523,565,It seems you got it from an old flame.
381,4,7,36,47,1.3191489361702127,0.09178254767668796,565,I think the diagnosis speaks for itself
381,2,11,34,47,1.3191489361702127,0.08107957386183322,565,Your magnesium levels are a little high.
381,3,9,35,47,1.3191489361702127,0.0865965742845523,565,Where's a smore when you need one?
381,2,11,34,47,1.3191489361702127,0.08107957386183322,565,You tested positive for oil
395,4,6,35,45,1.3111111111111111,0.09439987064610972,565,You have a case of spontaneous combustion.
395,4,6,35,45,1.3111111111111111,0.09439987064610972,565,It will be best if you pay before you leave.
395,5,4,36,45,1.3111111111111111,0.09960640836865496,565,Looks like inflammation.
395,4,6,35,45,1.3111111111111111,0.09439987064610972,565,"Okay, we can forget about the good news."
395,2,10,33,45,1.3111111111111111,0.08301285176284588,565,"Donald Jr, do you have any immediate family that have experienced everything going up in flames?"
395,4,6,35,45,1.3111111111111111,0.09439987064610972,565,The test results indicate a severe inflammation.
395,3,8,34,45,1.3111111111111111,0.08888888888888889,565,"And I see under aliases you've written in ""The Human Torch"", Mr. Storm?"
395,3,8,34,45,1.3111111111111111,0.08888888888888889,565,So do you want the good news or the bad news first?
395,2,10,33,45,1.3111111111111111,0.08301285176284588,565,Let me begin by asking whether your affairs are in order.
395,4,6,35,45,1.3111111111111111,0.09439987064610972,565,"Is it arson, doc?"
395,3,8,34,45,1.3111111111111111,0.08888888888888889,565,These test results self-distruct as required by HIPPA.
395,0,14,31,45,1.3111111111111111,0.06979205927323111,565,You have quite a bit of inflammation.
395,5,4,36,45,1.3111111111111111,0.09960640836865496,565,Worst case of acid reflux I've ever seen.
395,1,12,32,45,1.3111111111111111,0.07668789048930226,565,... Just until we get our new encryption software.
395,3,8,34,45,1.3111111111111111,0.08888888888888889,565,I'll take that urine sample now.
395,2,10,33,45,1.3111111111111111,0.08301285176284588,565,This hurts me as much as it hurts you.
395,3,8,34,45,1.3111111111111111,0.08888888888888889,565,"Oh, it's a new HIPAA regulation."
395,4,6,35,45,1.3111111111111111,0.09439987064610972,565,That's quite a gas problem you have there.
395,3,8,34,45,1.3111111111111111,0.08888888888888889,565,OK listen up. I have to read fast.
395,2,10,33,45,1.3111111111111111,0.08301285176284588,565,I see you have a Republican health insurance policy.
395,6,2,37,45,1.3111111111111111,0.10455399369801359,565,Looks like another Republican health care plan has gone up in flames.
395,2,10,33,45,1.3111111111111111,0.08301285176284588,565,It's our new privacy policy.
395,3,8,34,45,1.3111111111111111,0.08888888888888889,565,Our lab supervisor is a drama queen.
395,4,6,35,45,1.3111111111111111,0.09439987064610972,565,I see you've had a flare-up.
395,3,8,34,45,1.3111111111111111,0.08888888888888889,565,It says here you have some sort of burning sensation.
395,3,8,34,45,1.3111111111111111,0.08888888888888889,565,I think it's safe to say something is inflamed.
395,4,6,35,45,1.3111111111111111,0.09439987064610972,565,You're dehydrated.
395,2,10,33,45,1.3111111111111111,0.08301285176284588,565,"The good news is, we caught it early."
395,4,6,35,45,1.3111111111111111,0.09439987064610972,565,A very bad case of hemorrhoids.
395,3,8,34,45,1.3111111111111111,0.08888888888888889,565,It's the new confidentiality rules. You can't see your test results; and neither can I.
395,4,6,35,45,1.3111111111111111,0.09439987064610972,565,"Ok, now if you'll just bend over for me...."
395,1,12,32,45,1.3111111111111111,0.07668789048930226,565,The ulcers are fine. The burning sensation is in your deductible.
395,4,6,35,45,1.3111111111111111,0.09439987064610972,565,I'll prescribe an anti-inflammatory.
395,5,4,36,45,1.3111111111111111,0.09960640836865496,565,If your spontaneous combustions last more than four hours call me.
395,2,10,33,45,1.3111111111111111,0.08301285176284588,565,You're toast
395,5,4,36,45,1.3111111111111111,0.09960640836865496,565,I'm sorry but I think the inflammation is spreading.
395,2,10,33,45,1.3111111111111111,0.08301285176284588,565,About this burning sensation...
395,4,6,35,45,1.3111111111111111,0.09439987064610972,565,I'm afraid you have gas...
395,4,6,35,45,1.3111111111111111,0.09439987064610972,565,"Mr. Blaine, you're a fantastic magician and you can burn the results all you want, but you still have Gonorrhea."
395,3,8,34,45,1.3111111111111111,0.08888888888888889,565,Welcome to Trumpcare!
395,4,6,35,45,1.3111111111111111,0.09439987064610972,565,The insurance company is giving it's answer now.
395,4,6,35,45,1.3111111111111111,0.09439987064610972,565,It's the new HIPPA requirement to ensure patient confidentiality.
395,3,8,34,45,1.3111111111111111,0.08888888888888889,565,It says you've gone viral
395,5,4,36,45,1.3111111111111111,0.09960640836865496,565,Your test results indicate that you have the fire bug that's been going around.
395,3,8,34,45,1.3111111111111111,0.08888888888888889,565,"Rest, plenty of fluids, and three Hail Mary's should do the trick."
395,3,8,34,45,1.3111111111111111,0.08888888888888889,565,I can't locate my spirometer. See if you can blow out the flame from where you're sitting.
395,5,4,36,45,1.3111111111111111,0.09960640836865496,565,"""Well Sam, I see that you're still smoking""!"
395,3,8,34,45,1.3111111111111111,0.08888888888888889,565,This is repeal. I'll replace it soon.
395,4,6,35,45,1.3111111111111111,0.09439987064610972,565,Go home and put a LOT of ice on it.
395,1,12,32,45,1.3111111111111111,0.07668789048930226,565,"I'm still going to bill you, Superman."
395,4,6,35,45,1.3111111111111111,0.09439987064610972,565,"I'm so sorry, this isn't supposed to happen unless you say ""malpractice."""
395,4,6,35,45,1.3111111111111111,0.09439987064610972,565,"I'll need a urine sample, and fast."
395,1,12,32,45,1.3111111111111111,0.07668789048930226,565,I recommend an anti-inflammatory.
395,0,14,31,45,1.3111111111111111,0.06979205927323111,565,I guess Congress finally repealed Obamacare.
395,3,8,34,45,1.3111111111111111,0.08888888888888889,565,I wish I had wetter news.
395,3,8,34,45,1.3111111111111111,0.08888888888888889,565,Hell if I know . . .
395,4,6,35,45,1.3111111111111111,0.09439987064610972,565,Results just in from Theranos.
395,2,10,33,45,1.3111111111111111,0.08301285176284588,565,"Don't worry, I can recommend a good anti-inflammatory."
395,2,10,33,45,1.3111111111111111,0.08301285176284588,565,The good news is...I've seen worse.
395,3,8,34,45,1.3111111111111111,0.08888888888888889,565,I have excellent fireside manner.
395,2,10,33,45,1.3111111111111111,0.08301285176284588,565,Based on these results I'm thinking anti-inflammatories.
395,5,4,36,45,1.3111111111111111,0.09960640836865496,565,"Of course, it might just be nothing!"
395,4,6,35,45,1.3111111111111111,0.09439987064610972,565,"Your insurance is for fire, not health!"
395,3,8,34,45,1.3111111111111111,0.08888888888888889,565,But the good news is that I've set the bad news on fire.
459,2,9,32,43,1.302325581395349,0.08506973050767944,565,We printed off the review you left on Yelp. Will you still be wanting us to perform that prostate exam?
459,3,7,33,43,1.302325581395349,0.09134702381971774,565,This is our new urine test ... ready?
459,3,7,33,43,1.302325581395349,0.09134702381971774,565,I recommend cremation.
459,3,7,33,43,1.302325581395349,0.09134702381971774,565,That's strange.... now I feel the burning sensation.
459,5,3,35,43,1.302325581395349,0.10275756996378335,565,Let's start with the good news.
459,4,5,34,43,1.302325581395349,0.0972198460849993,565,"""What do you know? 'Burn in eternal hellfire' is a diagnosis""."
459,0,13,30,43,1.302325581395349,0.0708662093279121,565,"H2O is a proven cure, but the pharmaceutical companies have priced it out of reach."
459,4,5,34,43,1.302325581395349,0.0972198460849993,565,I suspect inflammation.
459,1,11,31,43,1.302325581395349,0.07829073595629517,565,Your results show a lot of inflammation.
459,4,5,34,43,1.302325581395349,0.0972198460849993,565,I've got the results for the tests we did on why your head spins completely around.
459,4,5,34,43,1.302325581395349,0.0972198460849993,565,Remember this is a drug trial; half the participants will get a placebo.
459,2,9,32,43,1.302325581395349,0.08506973050767944,565,This is why we need you to be truthful on these forms.
459,3,7,33,43,1.302325581395349,0.09134702381971774,565,I think you'll have to stop using Tinder.
459,2,9,32,43,1.302325581395349,0.08506973050767944,565,Your lab results look good compared with this letter from my ex.
459,2,9,32,43,1.302325581395349,0.08506973050767944,565,Liar liar charts on fire
459,2,9,32,43,1.302325581395349,0.08506973050767944,565,How long have you worked at the nuclear power plant?
459,2,9,32,43,1.302325581395349,0.08506973050767944,565,I'm afraid it's bad news.
459,3,7,33,43,1.302325581395349,0.09134702381971774,565,I'm also getting a burning sensation.
459,2,9,32,43,1.302325581395349,0.08506973050767944,565,You didn't really want to know the results anyway.
459,3,7,33,43,1.302325581395349,0.09134702381971774,565,Could you describe that burning sensation one more time?
459,3,7,33,43,1.302325581395349,0.09134702381971774,565,"That's funny, it's usually only women who have hot flashes."
459,1,11,31,43,1.302325581395349,0.07829073595629517,565,Let me be brief.
459,3,7,33,43,1.302325581395349,0.09134702381971774,565,What jumps out at me is a diagnosis of inflammation.
459,2,9,32,43,1.302325581395349,0.08506973050767944,565,"Well, I'm afraid hell is calling."
459,3,7,33,43,1.302325581395349,0.09134702381971774,565,"Its time to get started on your bucket list, Frank."
459,4,5,34,43,1.302325581395349,0.0972198460849993,565,Your tests uncovered some inflammation
459,3,7,33,43,1.302325581395349,0.09134702381971774,565,"I have your test results, Mr. Giovanni. You're going to die and go to hell."
459,3,7,33,43,1.302325581395349,0.09134702381971774,565,Oops. Looks like they just repealed the Affordable Care Act.
459,2,9,32,43,1.302325581395349,0.08506973050767944,565,I'll be brief.
459,3,7,33,43,1.302325581395349,0.09134702381971774,565,Your chart indicates a flare up.
459,3,7,33,43,1.302325581395349,0.09134702381971774,565,Letting you see your results might kill you.
459,3,7,33,43,1.302325581395349,0.09134702381971774,565,This calls for an anti-inflamatory
459,3,7,33,43,1.302325581395349,0.09134702381971774,565,New filing system...they've asked I send everything up into the cloud.
459,4,5,34,43,1.302325581395349,0.0972198460849993,565,I accidentally ordered the 'zesty cajun' lipid panel.
459,1,11,31,43,1.302325581395349,0.07829073595629517,565,This is the worst case of heartburn that I have ever seen.
459,1,11,31,43,1.302325581395349,0.07829073595629517,565,"Looks like the Russians got to your files first, Mr. Comey."
459,4,5,34,43,1.302325581395349,0.0972198460849993,565,Bend over.
459,3,7,33,43,1.302325581395349,0.09134702381971774,565,Your secret is safe with me....
459,1,11,31,43,1.302325581395349,0.07829073595629517,565,You'll feel a slight burning sensation at first
459,3,7,33,43,1.302325581395349,0.09134702381971774,565,"I've never seen inflammation this bad, Mr. Marston!"
459,2,9,32,43,1.302325581395349,0.08506973050767944,565,Your results indicate inflammation.
459,3,7,33,43,1.302325581395349,0.09134702381971774,565,Your test results indicate a high level of inflammation.
459,3,7,33,43,1.302325581395349,0.09134702381971774,565,My diagnosis is pyromania.
459,3,7,33,43,1.302325581395349,0.09134702381971774,565,I haven’t much time so please pay attention.
459,2,9,32,43,1.302325581395349,0.08506973050767944,565,We're going to need to get you on an anti-inflammatory.
459,4,5,34,43,1.302325581395349,0.0972198460849993,565,"Well, the results from your STD screening are back."
459,3,7,33,43,1.302325581395349,0.09134702381971774,565,"Sorry Congressman, it's a bad case of ""liar liar pants on fire""."
459,3,7,33,43,1.302325581395349,0.09134702381971774,565,As you can see it's catching.
459,3,7,33,43,1.302325581395349,0.09134702381971774,565,I'm afraid your insurance doesn't cover spontaneous combustion.
459,3,7,33,43,1.302325581395349,0.09134702381971774,565,"After the recent hack of our database, we switched to a stricter patient record privacy policy."
459,1,11,31,43,1.302325581395349,0.07829073595629517,565,"With this ancient fire spell, I shall drive the demons from your body!"
459,4,5,34,43,1.302325581395349,0.0972198460849993,565,The good news is your insurance company answered your claim quickly.
459,2,9,32,43,1.302325581395349,0.08506973050767944,565,"It's not the WORST results I've seen, but....."
459,3,7,33,43,1.302325581395349,0.09134702381971774,565,Trust me. You don't want to read this.
459,5,3,35,43,1.302325581395349,0.10275756996378335,565,"Yes, it does appear to be contagious."
459,2,9,32,43,1.302325581395349,0.08506973050767944,565,Around here we take patient confidentiality very seriously.
459,3,7,33,43,1.302325581395349,0.09134702381971774,565,Your lab results are now paperless.
459,2,9,32,43,1.302325581395349,0.08506973050767944,565,These are answers to your burning questions.
459,4,5,34,43,1.302325581395349,0.0972198460849993,565,Any plans for the weekend?
459,1,11,31,43,1.302325581395349,0.07829073595629517,565,The inflammation's spreading.
459,3,7,33,43,1.302325581395349,0.09134702381971774,565,The good news is you don't have to worry about the interest rate on the 12 month payment plan.
459,1,11,31,43,1.302325581395349,0.07829073595629517,565,"Well, looks like your heart burn really is off the charts."
459,4,5,34,43,1.302325581395349,0.0972198460849993,565,"It's anti-hacking paper, to keep your medical data secure."
459,3,7,33,43,1.302325581395349,0.09134702381971774,565,"Really, Dwayne? Liar, Liar chart on fire."
459,1,11,31,43,1.302325581395349,0.07829073595629517,565,Have you tried Prilosec?
524,3,7,34,44,1.2954545454545454,0.0895109183139428,565,I could get fired for this.
524,2,9,33,44,1.2954545454545454,0.08339737432901621,565,I'm starting to get concerned about this inflammation
524,1,11,32,44,1.2954545454545454,0.07679869525286717,565,It's a witch doctor referral.
527,3,6,33,42,1.2857142857142858,0.09198870231668352,565,Your lab work is back. It looks like hell.
527,2,8,32,42,1.2857142857142858,0.08544285322996292,565,Quick give me a urine sample!
527,4,4,34,42,1.2857142857142858,0.0980987336296338,565,Maybe your fire insurance will cover this.
527,2,8,32,42,1.2857142857142858,0.08544285322996292,565,Your temperature was 451.
527,1,10,31,42,1.2857142857142858,0.0783520324066106,565,I wouldn't be alarmed by a little inflammation.
527,1,10,31,42,1.2857142857142858,0.0783520324066106,565,"When I see results like these, Bob, alarms go off."
527,4,4,34,42,1.2857142857142858,0.0980987336296338,565,"Thanks to your surgery, I've been able to burn my $1,000,000 mortgage"
527,2,8,32,42,1.2857142857142858,0.08544285322996292,565,You need to hydrate more.
527,1,10,31,42,1.2857142857142858,0.0783520324066106,565,"No, THIS is a burning sensation!"
527,4,4,34,42,1.2857142857142858,0.0980987336296338,565,It’s how we comply with medical record privacy regulations.
527,2,8,32,42,1.2857142857142858,0.08544285322996292,565,What makes you think it's bad news?
527,3,6,33,42,1.2857142857142858,0.09198870231668352,565,Cialis may not be right for you.
527,2,8,32,42,1.2857142857142858,0.08544285322996292,565,The good news is that the burning sensation will only last 30 seconds or so.
527,3,6,33,42,1.2857142857142858,0.09198870231668352,565,"Mr. Allerdyce, please. Superpowers are no match to high cholesterol numbers."
527,2,8,32,42,1.2857142857142858,0.08544285322996292,565,Your results are fine. This is the new normal.
527,1,10,31,42,1.2857142857142858,0.0783520324066106,565,I'll be frank - the results weren't good.
527,2,8,32,42,1.2857142857142858,0.08544285322996292,565,It's all TrumpCare covers for bad test results.
527,4,4,34,42,1.2857142857142858,0.0980987336296338,565,Your brain scans show lobal warming.
527,4,4,34,42,1.2857142857142858,0.0980987336296338,565,Does spontaneous combustion run in your family?
527,4,4,34,42,1.2857142857142858,0.0980987336296338,565,Don't take this with water
527,2,8,32,42,1.2857142857142858,0.08544285322996292,565,These confidentiality rules are becoming a headache.
527,0,12,30,42,1.2857142857142858,0.07055211404639924,565,I'm sending you to a specialist. Stephen King.
527,2,8,32,42,1.2857142857142858,0.08544285322996292,565,Better for you to skip this and go straight to a second opinion.
527,3,6,33,42,1.2857142857142858,0.09198870231668352,565,"To be administered no more than once a day, with plenty of water."
527,3,6,33,42,1.2857142857142858,0.09198870231668352,565,Blow out your lab results and make a wish!
527,2,8,32,42,1.2857142857142858,0.08544285322996292,565,"The good news, you're going to live forever. The bad news, you'll have to relocate."
527,3,6,33,42,1.2857142857142858,0.09198870231668352,565,I'm sending your records to the cloud.
527,2,8,32,42,1.2857142857142858,0.08544285322996292,565,I'll be more careful during your laser surgery.
527,4,4,34,42,1.2857142857142858,0.0980987336296338,565,Does it burn when you pee?
527,4,4,34,42,1.2857142857142858,0.0980987336296338,565,Clark Kent disagrees with the findings of his physical examination.
527,3,6,33,42,1.2857142857142858,0.09198870231668352,565,I've never seen such inflammation in a lab report
527,3,6,33,42,1.2857142857142858,0.09198870231668352,565,Look on the bright side. You won't have to file your taxes next year.
527,3,6,33,42,1.2857142857142858,0.09198870231668352,565,"This might result in a bit of redness, swelling or discoloration of the skin."
527,3,6,33,42,1.2857142857142858,0.09198870231668352,565,You may experience a bit of discomfort.
527,3,6,33,42,1.2857142857142858,0.09198870231668352,565,"Frankly, your lab results cause me some concern"
527,4,4,34,42,1.2857142857142858,0.0980987336296338,565,"In this case, I suggest we both consult Google."
527,3,6,33,42,1.2857142857142858,0.09198870231668352,565,It appears you've got a severe case of chartburn.
527,2,8,32,42,1.2857142857142858,0.08544285322996292,565,Our filing system has been upgraded since the last cyber-attack.
527,2,8,32,42,1.2857142857142858,0.08544285322996292,565,Your pyrocyte count is off the charts.
527,1,10,31,42,1.2857142857142858,0.0783520324066106,565,"First, the good news."
527,3,6,33,42,1.2857142857142858,0.09198870231668352,565,Just picked up your health care coverage plan.
527,2,8,32,42,1.2857142857142858,0.08544285322996292,565,Our updated firewall protects against anyone ever seeing your records!
527,2,8,32,42,1.2857142857142858,0.08544285322996292,565,Your test came back positive for arson.
527,3,6,33,42,1.2857142857142858,0.09198870231668352,565,This is your prescription on drugs.
527,3,6,33,42,1.2857142857142858,0.09198870231668352,565,"Now, imagine this is your liver."
527,2,8,32,42,1.2857142857142858,0.08544285322996292,565,I see you're sexually active.
527,3,6,33,42,1.2857142857142858,0.09198870231668352,565,Your colonoscopy report says extensive jalapeños.
527,3,6,33,42,1.2857142857142858,0.09198870231668352,565,According to your test results it appears you haven't stopped smoking.
527,3,6,33,42,1.2857142857142858,0.09198870231668352,565,Labs concur. It burns when you pee.
527,1,10,31,42,1.2857142857142858,0.0783520324066106,565,So it feels like that when you urinate?
527,2,8,32,42,1.2857142857142858,0.08544285322996292,565,Just wait till they get started on tax reform.
527,4,4,34,42,1.2857142857142858,0.0980987336296338,565,This way I never have to worry about malpractice
527,3,6,33,42,1.2857142857142858,0.09198870231668352,565,I'm not sure you're going to be able to handle the test results.
527,2,8,32,42,1.2857142857142858,0.08544285322996292,565,So much for preexisting conditions!
527,1,10,31,42,1.2857142857142858,0.0783520324066106,565,"If this doesn't work, I suggest you try ice."
527,3,6,33,42,1.2857142857142858,0.09198870231668352,565,"You have the lab results from hell, I'm afraid."
527,1,10,31,42,1.2857142857142858,0.0783520324066106,565,"Now, I don't want to alarm you..."
527,2,8,32,42,1.2857142857142858,0.08544285322996292,565,Definitely inflammation here.
527,3,6,33,42,1.2857142857142858,0.09198870231668352,565,You say you been having heart burn lately
527,3,6,33,42,1.2857142857142858,0.09198870231668352,565,This doesn't end well.
527,1,10,31,42,1.2857142857142858,0.0783520324066106,565,"Well, let's start with the good news."
527,2,8,32,42,1.2857142857142858,0.08544285322996292,565,...and then let's say this is your urinary tract.
527,3,6,33,42,1.2857142857142858,0.09198870231668352,565,I'm afraid it isn't all good news.
527,1,10,31,42,1.2857142857142858,0.0783520324066106,565,Your test results are positive for inflammation.
527,3,6,33,42,1.2857142857142858,0.09198870231668352,565,"Yes, it's fire - but it's the good kind."
527,3,6,33,42,1.2857142857142858,0.09198870231668352,565,"Bill, schmill. You'll be dead in a week."
527,3,6,33,42,1.2857142857142858,0.09198870231668352,565,You want the good news first?
527,3,6,33,42,1.2857142857142858,0.09198870231668352,565,"So, your colonoscopy results are back. Lets see here..."
527,3,6,33,42,1.2857142857142858,0.09198870231668352,565,My professional diagnosis is that you're Satan.
527,4,4,34,42,1.2857142857142858,0.0980987336296338,565,Drink plenty of fluids.
527,2,8,32,42,1.2857142857142858,0.08544285322996292,565,No need for alarm. Our smoke detector has that covered.
527,2,8,32,42,1.2857142857142858,0.08544285322996292,565,I'll have to make this quick.
527,1,10,31,42,1.2857142857142858,0.0783520324066106,565,"Yeah, I'd say your fever's pretty high."
527,2,8,32,42,1.2857142857142858,0.08544285322996292,565,There's no paper trail for malpractice suits.
527,1,10,31,42,1.2857142857142858,0.0783520324066106,565,"With HIPAA rules, it's better I burn these right away."
527,2,8,32,42,1.2857142857142858,0.08544285322996292,565,"If you want a second opinion, you better hurry!"
527,4,4,34,42,1.2857142857142858,0.0980987336296338,565,Your Insurance Company just got back to me on your coverage.
527,2,8,32,42,1.2857142857142858,0.08544285322996292,565,You asked to go paperless.
527,1,10,31,42,1.2857142857142858,0.0783520324066106,565,"Unfortunately,your prior condition has flared up again!"
527,3,6,33,42,1.2857142857142858,0.09198870231668352,565,It appears that the diagnosis is Spontaneous Combustion.
527,2,8,32,42,1.2857142857142858,0.08544285322996292,565,You must have a very high security clearance.
527,3,6,33,42,1.2857142857142858,0.09198870231668352,565,I found a solution for people without health insurance.
527,2,8,32,42,1.2857142857142858,0.08544285322996292,565,So there are two options..
527,2,8,32,42,1.2857142857142858,0.08544285322996292,565,Looks to me like a severe case of halitosis.
527,2,8,32,42,1.2857142857142858,0.08544285322996292,565,You might want to get a second opinion
527,3,6,33,42,1.2857142857142858,0.09198870231668352,565,I'm going to need you to pee on this
527,3,6,33,42,1.2857142857142858,0.09198870231668352,565,"Well, normally I'd rule out demonic possession..."
527,3,6,33,42,1.2857142857142858,0.09198870231668352,565,The inflammation seems to be spreading.
527,3,6,33,42,1.2857142857142858,0.09198870231668352,565,Your test results show severe inflammatory response.
527,0,12,30,42,1.2857142857142858,0.07055211404639924,565,This report will self destruct in 30 seconds.
527,1,10,31,42,1.2857142857142858,0.0783520324066106,565,"Don't worry, it's our latest measure in data security."
527,1,10,31,42,1.2857142857142858,0.0783520324066106,565,"Well, this explains your night sweats."
527,2,8,32,42,1.2857142857142858,0.08544285322996292,565,I recommend reducing your carbon footprint.
527,0,12,30,42,1.2857142857142858,0.07055211404639924,565,"How long have I been smoking? Sorry, are you asking me or chart?"
527,1,10,31,42,1.2857142857142858,0.0783520324066106,565,"I don't mean to set off any alarms, but you might not have time for a second opinion."
527,3,6,33,42,1.2857142857142858,0.09198870231668352,565,It seems you forgot to pay your premium.
527,5,2,35,42,1.2857142857142858,0.10384989997861468,565,Your insurance claim was denied.
527,2,8,32,42,1.2857142857142858,0.08544285322996292,565,Why would you think it's bad news?
527,3,6,33,42,1.2857142857142858,0.09198870231668352,565,"No need to worry, it's just some mild inflammation."
527,2,8,32,42,1.2857142857142858,0.08544285322996292,565,Relax as I secure your personal data with our God-Only-Knows™ encryption technology.
527,3,6,33,42,1.2857142857142858,0.09198870231668352,565,There's a problem with your insurance...
527,1,10,31,42,1.2857142857142858,0.0783520324066106,565,"Very very quickly, please verify your name and date of birth."
629,1,9,30,40,1.275,0.07996393417804533,565,I've got some good news and some hot news
629,4,3,33,40,1.275,0.10119478551479127,565,You're fine but I'm afraid this bill will burn a hole in your pocket.
629,1,9,30,40,1.275,0.07996393417804533,565,"Hmm, this could be a little more serious than we first thought."
629,3,5,32,40,1.275,0.09464847243000454,565,think you have problems? look at me!
629,2,7,31,40,1.275,0.08761439408728482,565,I think it's heartburn.
629,0,11,29,40,1.275,0.07149950690165272,565,Your charts indicate a history of inflammation.
629,3,5,32,40,1.275,0.09464847243000454,565,This doesn't end well.
629,2,7,31,40,1.275,0.08761439408728482,565,No worries....you won't be here for long.
629,2,7,31,40,1.275,0.08761439408728482,565,This treatment is fairly controversial.
629,1,9,30,40,1.275,0.07996393417804533,565,"On the plus side, you'll be less dependent on fossil fuels."
629,3,5,32,40,1.275,0.09464847243000454,565,Worst case of heartburn I've ever seen.
629,2,7,31,40,1.275,0.08761439408728482,565,You have chartburn.
629,3,5,32,40,1.275,0.09464847243000454,565,And I thought your cholesterol was high.
629,2,7,31,40,1.275,0.08761439408728482,565,This won't happen after we switch to electronic medical records.
629,2,7,31,40,1.275,0.08761439408728482,565,Any medical experiments I should know about?
629,1,9,30,40,1.275,0.07996393417804533,565,It's a lot more than a flicker of hope
629,3,5,32,40,1.275,0.09464847243000454,565,"Trust me, you don't want to know."
629,4,3,33,40,1.275,0.10119478551479127,565,"For you, this lab report looks entirely normal, Mr. Lucifer."
629,4,3,33,40,1.275,0.10119478551479127,565,This is the effects of the GOP healthcare bill.
629,2,7,31,40,1.275,0.08761439408728482,565,I burned a copy of your medical report for your records.
629,1,9,30,40,1.275,0.07996393417804533,565,Your insurance company doesn't pay me to explain the results.
629,2,7,31,40,1.275,0.08761439408728482,565,This treatment should have an immediate effect in reducing your list of symptoms.
629,2,7,31,40,1.275,0.08761439408728482,565,"One thing I can tell you, these test results will be difficult to handle."
629,4,3,33,40,1.275,0.10119478551479127,565,"If your health plan won't cover it, your fire insurance will."
629,0,11,29,40,1.275,0.07149950690165272,565,I think you'll be fine if you cut back on the jalapeños.
629,1,9,30,40,1.275,0.07996393417804533,565,Your rectal exam results are saying you should lay off on Taco Bell.
629,0,11,29,40,1.275,0.07149950690165272,565,The results call for an anti-inflammatory.
629,4,3,33,40,1.275,0.10119478551479127,565,Worst diagnosis of Heat Burn I have ever seen...
629,2,7,31,40,1.275,0.08761439408728482,565,Let's start over - the readout says you're dead.
629,3,5,32,40,1.275,0.09464847243000454,565,I have your spontaneous human combustion test results.
629,3,5,32,40,1.275,0.09464847243000454,565,"This isn't your chart, it's just your money."
629,2,7,31,40,1.275,0.08761439408728482,565,Coverage is being denied!
629,3,5,32,40,1.275,0.09464847243000454,565,Let's just say the Gates of Hell are ready to claim you.
629,0,11,29,40,1.275,0.07149950690165272,565,It saves on malpractice suits.
629,2,7,31,40,1.275,0.08761439408728482,565,I often see this during flu and brush fire season.
629,2,7,31,40,1.275,0.08761439408728482,565,"Your pyrokinesis is indeed impressive, but the bill will still need to be paid."
629,3,5,32,40,1.275,0.09464847243000454,565,Do you have any long-term travel plans?
629,3,5,32,40,1.275,0.09464847243000454,565,Apparently we are no longer accepting your health plan. You've been assigned to the high risk pool.
629,1,9,30,40,1.275,0.07996393417804533,565,Wow! I've never seen a referral denied THAT quickly!
629,3,5,32,40,1.275,0.09464847243000454,565,"Before I give you the results, check out this flyer from the crematorium."
629,3,5,32,40,1.275,0.09464847243000454,565,I'm afraid it's chartburn.
629,1,9,30,40,1.275,0.07996393417804533,565,"Well, first of all, you look terrific."
629,3,5,32,40,1.275,0.09464847243000454,565,"Our new, interactive records system tells me that you have a fever."
629,2,7,31,40,1.275,0.08761439408728482,565,"On a scale from 1 to 10, with this being a 10, rate your burning sensation."
629,3,5,32,40,1.275,0.09464847243000454,565,Good news first?
629,2,7,31,40,1.275,0.08761439408728482,565,YOU HAVE TO LAY OFF THE HOT SAUCE.
629,2,7,31,40,1.275,0.08761439408728482,565,The test results show that you might want to curb your sex life a bit....
629,2,7,31,40,1.275,0.08761439408728482,565,"Ah, don't read anything into this."
629,4,3,33,40,1.275,0.10119478551479127,565,"I'm afraid the news is not good. Moreover, I've received this from hell confirming your reservation."
629,2,7,31,40,1.275,0.08761439408728482,565,"No, it doesn't mean you're hot stuff"
629,3,5,32,40,1.275,0.09464847243000454,565,You might feel a slight burning sensation
629,3,5,32,40,1.275,0.09464847243000454,565,I think we can skip the urinalysis.
629,1,9,30,40,1.275,0.07996393417804533,565,And there's no family history of pyrokinesis?
629,2,7,31,40,1.275,0.08761439408728482,565,Apparently your insurance company is denying coverage.
629,1,9,30,40,1.275,0.07996393417804533,565,The only thing I can find is some inflammation in your chart.
629,3,5,32,40,1.275,0.09464847243000454,565,This won't take long.
629,3,5,32,40,1.275,0.09464847243000454,565,"Sorry, it's HIPAA. Says ""Burn after reading."""
629,0,11,29,40,1.275,0.07149950690165272,565,Your chart indicates you should be drinking more water.
629,3,5,32,40,1.275,0.09464847243000454,565,"...But other than that, everything appears normal."
629,2,7,31,40,1.275,0.08761439408728482,565,"I'm sorry, but your insurance doesn't cover demonic possession."
629,1,9,30,40,1.275,0.07996393417804533,565,Your results are... abnormal.
629,3,5,32,40,1.275,0.09464847243000454,565,"Relax, this isn't your test results. It's my divorce agreement."
629,3,5,32,40,1.275,0.09464847243000454,565,It's fine. No one can read my handwriting anyway.
629,1,9,30,40,1.275,0.07996393417804533,565,"You've been watching cable news again, haven't you."
629,2,7,31,40,1.275,0.08761439408728482,565,As you can see it's not good news.
629,2,7,31,40,1.275,0.08761439408728482,565,"It's confirmed, you are a hot mess."
629,2,7,31,40,1.275,0.08761439408728482,565,Sir. I'm afraid that your insurer denied treatment for pyromania.
629,2,7,31,40,1.275,0.08761439408728482,565,I think it is under control.
629,1,9,30,40,1.275,0.07996393417804533,565,"While I suspected an unusual form of heartburn, the report indicates you're just a flaming idiot."
629,3,5,32,40,1.275,0.09464847243000454,565,You'll need to fill a script for a nonnegotiable ceasefire.
629,2,7,31,40,1.275,0.08761439408728482,565,No no no. Your results are fine.
629,1,9,30,40,1.275,0.07996393417804533,565,Your secret is safe with me....
629,1,9,30,40,1.275,0.07996393417804533,565,This isn't your diagnosis. It's your bill.
629,1,9,30,40,1.275,0.07996393417804533,565,"It's hot at first, but then you'll get used to it!"
629,1,9,30,40,1.275,0.07996393417804533,565,"That's fine, I didn't like the second opinion anyway."
629,3,5,32,40,1.275,0.09464847243000454,565,I think what we need here is an anti-inflammatory.
629,2,7,31,40,1.275,0.08761439408728482,565,"Clark, stop staring at your lab report."
629,0,11,29,40,1.275,0.07149950690165272,565,"Uh, well, this IS the second opinion."
629,4,3,33,40,1.275,0.10119478551479127,565,The inflammation is even worse than I thought.
629,2,7,31,40,1.275,0.08761439408728482,565,I'm afraid there isn't much time.
629,3,5,32,40,1.275,0.09464847243000454,565,"You're right. You have a hunka, hunka burning love"
629,3,5,32,40,1.275,0.09464847243000454,565,"I can't say how long you have to live, but you're going to hell."
629,1,9,30,40,1.275,0.07996393417804533,565,"Well Sam, it looks like the diagnosis is chart burn."
629,3,5,32,40,1.275,0.09464847243000454,565,This is you sitting on your ass.
629,2,7,31,40,1.275,0.08761439408728482,565,"Your test results appear quite normal, Speaker Ryan."
629,2,7,31,40,1.275,0.08761439408728482,565,"No, this test is pretty conclusive."
629,2,7,31,40,1.275,0.08761439408728482,565,"Sorry, appears you have Trumpcare."
629,1,9,30,40,1.275,0.07996393417804533,565,You need to drink more water.
629,2,7,31,40,1.275,0.08761439408728482,565,HIPPA guidelines - it improves confidentiality.
629,1,9,30,40,1.275,0.07996393417804533,565,I think I am going to start you on some anti-inflammatory agents.
629,2,7,31,40,1.275,0.08761439408728482,565,Hold on. I'm getting a message from your insurance company!
629,3,5,32,40,1.275,0.09464847243000454,565,Your heartburn results are back.
629,3,5,32,40,1.275,0.09464847243000454,565,Test results? This is your insurance policy.
629,2,7,31,40,1.275,0.08761439408728482,565,And that's just your liver!
629,2,7,31,40,1.275,0.08761439408728482,565,Your chart says smoker
629,2,7,31,40,1.275,0.08761439408728482,565,It's even worse than it looks.
629,4,3,33,40,1.275,0.10119478551479127,565,And for my next trick I'm going to make you stop smoking.
629,3,5,32,40,1.275,0.09464847243000454,565,"Well, I think we have the answer from your provider."
629,2,7,31,40,1.275,0.08761439408728482,565,Let me put it this way.
728,1,8,29,38,1.263157894736842,0.08162826022989232,565,Your test results are disturbing.
728,2,6,30,38,1.263157894736842,0.08992023117655254,565,I should have started with the good news.
728,1,8,29,38,1.263157894736842,0.08162826022989232,565,"Whatever you've got, it's getting braver."
728,1,8,29,38,1.263157894736842,0.08162826022989232,565,It appears you need a very strong anti-inflammatory
728,3,4,31,38,1.263157894736842,0.09750960507319413,565,I think I will give you that referral.
728,3,4,31,38,1.263157894736842,0.09750960507319413,565,This diagnosis will self-destruct in five seconds. Good luck.
728,3,4,31,38,1.263157894736842,0.09750960507319413,565,...and we are left with only the bad news.
728,2,6,30,38,1.263157894736842,0.08992023117655254,565,"According to the lab results, you're a hot mess."
728,2,6,30,38,1.263157894736842,0.08992023117655254,565,"Your cholesterol looks better, but you need to lay off the habañeros."
728,2,6,30,38,1.263157894736842,0.08992023117655254,565,I’d say you narrowly escaped a case of spontaneous combustion.
728,2,6,30,38,1.263157894736842,0.08992023117655254,565,"Amazing test. Not only do we know how and when you’ll die, but where you’ll be spending eternity."
728,1,8,29,38,1.263157894736842,0.08162826022989232,565,These lab results show acute inflammation.
728,2,6,30,38,1.263157894736842,0.08992023117655254,565,Do you want to call your wife or the undertaker?
728,2,6,30,38,1.263157894736842,0.08992023117655254,565,Where would you like your ashes spread?
728,2,6,30,38,1.263157894736842,0.08992023117655254,565,What you don't know can't hurt you.
728,3,4,31,38,1.263157894736842,0.09750960507319413,565,It's our new way to get rid of disease.
728,1,8,29,38,1.263157894736842,0.08162826022989232,565,"Let's see here...do you want the good .....oh, never mind."
728,1,8,29,38,1.263157894736842,0.08162826022989232,565,Then we read the ashes.
728,2,6,30,38,1.263157894736842,0.08992023117655254,565,"Ashes to ashes, dust to dust, we're burning your files, you have 6 months to live."
728,2,6,30,38,1.263157894736842,0.08992023117655254,565,You have a fever.
728,1,8,29,38,1.263157894736842,0.08162826022989232,565,We've determined the cause of the burning sensaton.
728,2,6,30,38,1.263157894736842,0.08992023117655254,565,Have you traveled to Hell in the last 60 days?
728,3,4,31,38,1.263157894736842,0.09750960507319413,565,Do you want to hear the good news or the bad news first?
728,3,4,31,38,1.263157894736842,0.09750960507319413,565,The lab results show you're healthy but still eternally damned.
728,1,8,29,38,1.263157894736842,0.08162826022989232,565,This can't be good.
728,2,6,30,38,1.263157894736842,0.08992023117655254,565,Just our way of showing how much we respect your privacy.
728,2,6,30,38,1.263157894736842,0.08992023117655254,565,Flame bursts typically mean you’re in a high-deductible plan—and you lied about being a nonsmoker on the form.
728,1,8,29,38,1.263157894736842,0.08162826022989232,565,My malpractice attorney doesn't believe in paper trails.
728,1,8,29,38,1.263157894736842,0.08162826022989232,565,We maintain confidentiality by keeping no records.
728,2,6,30,38,1.263157894736842,0.08992023117655254,565,"The good news is, I'm not sleeping with your wife."
728,3,4,31,38,1.263157894736842,0.09750960507319413,565,"I know its frustrating, but we take patient confidentiality very seriously."
728,2,6,30,38,1.263157894736842,0.08992023117655254,565,Bad news. Your inflammation has spread.
728,2,6,30,38,1.263157894736842,0.08992023117655254,565,The medical privacy laws are getting out of hand.
728,1,8,29,38,1.263157894736842,0.08162826022989232,565,"You're just fine, but your chart's terminal."
728,1,8,29,38,1.263157894736842,0.08162826022989232,565,Have you been having any hot flashes?
728,2,6,30,38,1.263157894736842,0.08992023117655254,565,"I'm sorry to say, you are one hot mess!"
728,2,6,30,38,1.263157894736842,0.08992023117655254,565,Your lab results indicate you have spontaneous indigestion.
728,2,6,30,38,1.263157894736842,0.08992023117655254,565,This insures that your medical records are HIPAA compliant.
728,1,8,29,38,1.263157894736842,0.08162826022989232,565,Your file was fake news.
728,2,6,30,38,1.263157894736842,0.08992023117655254,565,I'm putting you on the water diet.
728,2,6,30,38,1.263157894736842,0.08992023117655254,565,Probably a good time to update your life insurance.
728,2,6,30,38,1.263157894736842,0.08992023117655254,565,"Mexican food during your colonoscopy fasting, Ralph?"
728,2,6,30,38,1.263157894736842,0.08992023117655254,565,"Whether the glass is half empty or full, you might want to dump it on this and hope for the best."
728,3,4,31,38,1.263157894736842,0.09750960507319413,565,"Not only can I not show you, but these new HIPPA privacy safeguards prevent me from even reading your test results."
728,3,4,31,38,1.263157894736842,0.09750960507319413,565,Symptoms may include a burning sensation when you pay.
728,2,6,30,38,1.263157894736842,0.08992023117655254,565,Sorry...this has been happening ever since Congress attempted to reform health care.
728,1,8,29,38,1.263157894736842,0.08162826022989232,565,Says here you're a pyromaniac.
728,2,6,30,38,1.263157894736842,0.08992023117655254,565,We use self-destructing paper to protect your privacy
728,2,6,30,38,1.263157894736842,0.08992023117655254,565,We're going to treat this aggressively with water and sand.
728,1,8,29,38,1.263157894736842,0.08162826022989232,565,Do you want the good news or the bad news first....and hurry up and decide.
728,2,6,30,38,1.263157894736842,0.08992023117655254,565,A little on the high side
728,4,2,32,38,1.263157894736842,0.10454950113805384,565,You have quite the inflammation
728,2,6,30,38,1.263157894736842,0.08992023117655254,565,We can definitely get you in that trial.
728,0,10,28,38,1.263157894736842,0.07239266372688179,565,"Yes, a burning sensation...I can see that."
728,3,4,31,38,1.263157894736842,0.09750960507319413,565,"Your test results, Mr. Phelps."
728,2,6,30,38,1.263157894736842,0.08992023117655254,565,Looks like your premiums just went up again.
728,4,2,32,38,1.263157894736842,0.10454950113805384,565,"Alt-insurance, alt-treatment!"
728,2,6,30,38,1.263157894736842,0.08992023117655254,565,This diagnosis will self-destruct in five seconds.
728,2,6,30,38,1.263157894736842,0.08992023117655254,565,It's the results from your afterlife screening.
728,1,8,29,38,1.263157894736842,0.08162826022989232,565,Path lab's sick sense of humor.
728,3,4,31,38,1.263157894736842,0.09750960507319413,565,Inflammation seems to be your problem.
728,1,8,29,38,1.263157894736842,0.08162826022989232,565,"Good, you're sitting down."
728,2,6,30,38,1.263157894736842,0.08992023117655254,565,Preliminary results suggest heartburn.
728,1,8,29,38,1.263157894736842,0.08162826022989232,565,The anti-inflammatory doesn't seem to be working.
728,3,4,31,38,1.263157894736842,0.09750960507319413,565,When is this fucking acid going to wear off?
728,1,8,29,38,1.263157894736842,0.08162826022989232,565,You should get second opinion.
728,3,4,31,38,1.263157894736842,0.09750960507319413,565,These new informed consents self destruct after signing
728,1,8,29,38,1.263157894736842,0.08162826022989232,565,Mind if I get that urine sample right here and now?
728,1,8,29,38,1.263157894736842,0.08162826022989232,565,I thought this was better than telling you your test results.
728,1,8,29,38,1.263157894736842,0.08162826022989232,565,OK. Records show you just moved here from Hell. Is that correct ?
728,1,8,29,38,1.263157894736842,0.08162826022989232,565,Your heartburn is getting a little serious!
728,3,4,31,38,1.263157894736842,0.09750960507319413,565,I guess the filibuster didn't work.
728,1,8,29,38,1.263157894736842,0.08162826022989232,565,Let's say your lab results are rather concerning
728,3,4,31,38,1.263157894736842,0.09750960507319413,565,Looks like we'll be scheduling you for a covert operation.
728,3,4,31,38,1.263157894736842,0.09750960507319413,565,You have a serious inflammation!
728,2,6,30,38,1.263157894736842,0.08992023117655254,565,"It's not cancer, just inflammation."
728,2,6,30,38,1.263157894736842,0.08992023117655254,565,I could try to diagnose this but would feel better if you saw a specialist.
728,0,10,28,38,1.263157894736842,0.07239266372688179,565,I recommend blowing on it.
728,1,8,29,38,1.263157894736842,0.08162826022989232,565,"It's a hellish diagnosis, I'm afraid."
728,0,10,28,38,1.263157894736842,0.07239266372688179,565,"Your prognosis is, well....it's not great."
728,0,10,28,38,1.263157894736842,0.07239266372688179,565,It looks like a referral to a specialist is in order.
728,2,6,30,38,1.263157894736842,0.08992023117655254,565,There's good news and there's bad news.
728,2,6,30,38,1.263157894736842,0.08992023117655254,565,Good news is I've identified what's causing that burning sensation.
728,2,6,30,38,1.263157894736842,0.08992023117655254,565,You tested positive for eternal damnation.
728,2,6,30,38,1.263157894736842,0.08992023117655254,565,I have some good news and some bad news.
728,4,2,32,38,1.263157894736842,0.10454950113805384,565,"If you'd told me you were with the CIA, I wouldn't have held your chart to read it."
728,2,6,30,38,1.263157894736842,0.08992023117655254,565,This ensures full compliance with HIPAA
728,2,6,30,38,1.263157894736842,0.08992023117655254,565,"As bad as this looks, the cure can be found in the sink to your left...."
728,1,8,29,38,1.263157894736842,0.08162826022989232,565,We're going digital.
728,2,6,30,38,1.263157894736842,0.08992023117655254,565,"On the whole, I'd say you're done for."
728,1,8,29,38,1.263157894736842,0.08162826022989232,565,The horcrux has been destroyed.
728,3,4,31,38,1.263157894736842,0.09750960507319413,565,I see here that you have not been eating an apple a day
728,4,2,32,38,1.263157894736842,0.10454950113805384,565,"Well, it's not good news."
728,1,8,29,38,1.263157894736842,0.08162826022989232,565,Malpractice? I don't think you have a case.
728,3,4,31,38,1.263157894736842,0.09750960507319413,565,"See, you really need to take it with a glass of water!"
728,3,4,31,38,1.263157894736842,0.09750960507319413,565,Make a wish
728,1,8,29,38,1.263157894736842,0.08162826022989232,565,We call it Repeal and Incinerate.
825,2,5,29,36,1.25,0.09236745114890868,565,"Forget the aspirin, a glass of water will do fine."
825,3,3,30,36,1.25,0.10059347702036957,565,And I see here your insurance was denied.
825,1,7,28,36,1.25,0.08333333333333333,565,Whoops -- I see your insurance just lapsed.
825,1,7,28,36,1.25,0.08333333333333333,565,"The lab tests came back as inconclusive, but I think we're dealing with chronic inflammation"
825,2,5,29,36,1.25,0.09236745114890868,565,Sorry. It wasn't a false alarm.
825,2,5,29,36,1.25,0.09236745114890868,565,Your health insurance company is going up in flames.
825,1,7,28,36,1.25,0.08333333333333333,565,Mr. Travolta it seems you have a rare case of 'disco inferno'
825,1,7,28,36,1.25,0.08333333333333333,565,Seems to be more of a spiritual dilemma.
825,1,7,28,36,1.25,0.08333333333333333,565,I’ve alerted the CDC and the Fire Department.
825,1,7,28,36,1.25,0.08333333333333333,565,Your labs showed some red flags.
825,1,7,28,36,1.25,0.08333333333333333,565,It's going to take more than an anti-inflammatory.
825,0,9,27,36,1.25,0.07319250547113999,565,"Well, that explains the burning."
825,1,7,28,36,1.25,0.08333333333333333,565,Maybe it's better you didn't know the results.
825,2,5,29,36,1.25,0.09236745114890868,565,"Yeah, but other than that, your test results seem perfectly normal."
825,3,3,30,36,1.25,0.10059347702036957,565,"Well, the good news is that you don't have hypothermia"
825,1,7,28,36,1.25,0.08333333333333333,565,"I can't guarantee confidentiality, but it's a start!"
825,3,3,30,36,1.25,0.10059347702036957,565,This will sting a bit.
825,1,7,28,36,1.25,0.08333333333333333,565,I've got good news and bad news. You're gonna want the good news first.
825,0,9,27,36,1.25,0.07319250547113999,565,"We've received your test results, Mr. Brown, and I'm concerned."
825,1,7,28,36,1.25,0.08333333333333333,565,Do you experience burning during urination?
825,2,5,29,36,1.25,0.09236745114890868,565,"Now, do you think cremation is right for you?"
825,2,5,29,36,1.25,0.09236745114890868,565,"That's some fever you have there, Mr. Burns."
825,0,9,27,36,1.25,0.07319250547113999,565,"To be honest with you, your lab results are a report from hell"
825,3,3,30,36,1.25,0.10059347702036957,565,"I'm afraid I have some bad news, Kevin. Your test results have self-immolated."
825,1,7,28,36,1.25,0.08333333333333333,565,It appears Satan likes your résumé.
825,1,7,28,36,1.25,0.08333333333333333,565,Your Urology report came back
825,1,7,28,36,1.25,0.08333333333333333,565,It looks like you ate a fire ant.
825,0,9,27,36,1.25,0.07319250547113999,565,"The test results are positive, yet again, concerning your eternal damnation."
825,2,5,29,36,1.25,0.09236745114890868,565,And when did you start losing control of your super power?
825,2,5,29,36,1.25,0.09236745114890868,565,We're very serious about patient privacy.
825,2,5,29,36,1.25,0.09236745114890868,565,I would say we need to run some more tests.
825,3,3,30,36,1.25,0.10059347702036957,565,Let's just start from scratch.
825,1,7,28,36,1.25,0.08333333333333333,565,Just how long did you work on your tan in Chernobyl?
825,1,7,28,36,1.25,0.08333333333333333,565,Your test results indicate you have an inflammation.
825,1,7,28,36,1.25,0.08333333333333333,565,"No, it's not a miracle. I was trying to hide my cigarette."
825,0,9,27,36,1.25,0.07319250547113999,565,You have spontaneous combustion. And apparently it's contagious.
825,2,5,29,36,1.25,0.09236745114890868,565,Report shows you have a flaming hemorrhoid.
825,2,5,29,36,1.25,0.09236745114890868,565,You say this started after you watched a Steven King Movie ?
825,1,7,28,36,1.25,0.08333333333333333,565,"I've got the test results. You were right, you are a hot mess."
825,3,3,30,36,1.25,0.10059347702036957,565,This is going to hurt.
825,2,5,29,36,1.25,0.09236745114890868,565,Do you have any family history of spontaneous combustion?
825,1,7,28,36,1.25,0.08333333333333333,565,"Well, there goes the good news."
825,2,5,29,36,1.25,0.09236745114890868,565,Oh. You printed out my Web M.D. physician reviews?
825,1,7,28,36,1.25,0.08333333333333333,565,You have the worst case of reflux I've ever seen.
825,3,3,30,36,1.25,0.10059347702036957,565,"No, no, you're still dying. The good news is that I remembered to bring my fireproof gloves today."
825,1,7,28,36,1.25,0.08333333333333333,565,I'm afraid it's pyrokinesis.
825,1,7,28,36,1.25,0.08333333333333333,565,The problem appears to be inflammation.
825,1,7,28,36,1.25,0.08333333333333333,565,Time to cut down on the habaneros.
825,2,5,29,36,1.25,0.09236745114890868,565,"Your diagnosis, should you choose to accept it..."
825,2,5,29,36,1.25,0.09236745114890868,565,Your heartburn is obviously more severe than we thought.
825,1,7,28,36,1.25,0.08333333333333333,565,you have a bad case of chart burn
825,0,9,27,36,1.25,0.07319250547113999,565,"Sir, this is why you don't eat ghost peppers."
825,2,5,29,36,1.25,0.09236745114890868,565,These are your lab results. Anything you'd like to tell me?
825,1,7,28,36,1.25,0.08333333333333333,565,These lab results suggest we should both quit smoking.
825,2,5,29,36,1.25,0.09236745114890868,565,Your Tabasco numbers are a little high.
825,0,9,27,36,1.25,0.07319250547113999,565,I'm afraid your chronic inflammation is off the charts.
825,2,5,29,36,1.25,0.09236745114890868,565,Sorry for the wait. We've been putting out fires all morning.
825,1,7,28,36,1.25,0.08333333333333333,565,"I am not going to sugarcoat it, the results of your tests are not good..."
825,2,5,29,36,1.25,0.09236745114890868,565,"According to our new virtual medical records, you either have heartburn or hemorrhoids."
825,3,3,30,36,1.25,0.10059347702036957,565,"Sorry, our paperless charting is not portable."
825,1,7,28,36,1.25,0.08333333333333333,565,"Okay Mr. Trump. So now that I have burned your physical report, you want me to write that you are in the most incredible shape of any man I have ever seen.."
825,2,5,29,36,1.25,0.09236745114890868,565,Privacy regulations. You'll never know.
825,1,7,28,36,1.25,0.08333333333333333,565,Odds are your insurance won't cover it.
825,3,3,30,36,1.25,0.10059347702036957,565,Here's our new privacy policy.
825,2,5,29,36,1.25,0.09236745114890868,565,I recommend taking this with a glass of water.
825,2,5,29,36,1.25,0.09236745114890868,565,Your biopsy results tell me you are still eating those hot peppers.
825,2,5,29,36,1.25,0.09236745114890868,565,About that STD...
825,0,9,27,36,1.25,0.07319250547113999,565,Looks like they've moved their ACA replacement to production.
825,2,5,29,36,1.25,0.09236745114890868,565,"You'd be correct to assume that it is not good news, Mr. Young."
825,1,7,28,36,1.25,0.08333333333333333,565,We should have had you on a stronger anti-inflammatory.
825,2,5,29,36,1.25,0.09236745114890868,565,Please point to your level of inflammation.
825,2,5,29,36,1.25,0.09236745114890868,565,"Okay, fine, other than the burning sensation, everything is normal."
825,2,5,29,36,1.25,0.09236745114890868,565,It's called SnapChart
825,2,5,29,36,1.25,0.09236745114890868,565,Your diagnosis is not good.
825,1,7,28,36,1.25,0.08333333333333333,565,Trumpcare requires us to reduce our files.
825,0,9,27,36,1.25,0.07319250547113999,565,"Given your medical history, I’ll pursue a less traditional approach."
825,2,5,29,36,1.25,0.09236745114890868,565,I'm sorry to say you have hemroids.
825,2,5,29,36,1.25,0.09236745114890868,565,Man. Our new report writer really whips these out fast.
825,3,3,30,36,1.25,0.10059347702036957,565,"This is usually used to treat something else, but it might work here."
825,0,9,27,36,1.25,0.07319250547113999,565,"Now, no one will know you're a woman unless you want them to."
825,2,5,29,36,1.25,0.09236745114890868,565,We just received this reply from your health insurance provider and it doesn't look encouraging.
825,3,3,30,36,1.25,0.10059347702036957,565,"Feeling a little feverish, are you?"
825,3,3,30,36,1.25,0.10059347702036957,565,Let's just say you shouldn't buy green bananas.
825,2,5,29,36,1.25,0.09236745114890868,565,"Noses are fucking hard as hell to draw, amirite? Sometimes you just gotta say fuck it and draw whatever."
825,0,9,27,36,1.25,0.07319250547113999,565,We're going paperless.
825,1,7,28,36,1.25,0.08333333333333333,565,"Well, it appears as though the Affordable Care Act has been repealed after all."
825,2,5,29,36,1.25,0.09236745114890868,565,There goes your health plan.
825,2,5,29,36,1.25,0.09236745114890868,565,Your libido is off-the-charts!
825,2,5,29,36,1.25,0.09236745114890868,565,Our tests indicate you have a rare form of spontaneous combustion!
825,1,7,28,36,1.25,0.08333333333333333,565,What did you eat
825,2,5,29,36,1.25,0.09236745114890868,565,Too soon for my performance art piece on Trumpcare Mr Ryan?
825,3,3,30,36,1.25,0.10059347702036957,565,I see you're having a flare up.
825,0,9,27,36,1.25,0.07319250547113999,565,To show you our commitment to electronic medical records.
825,2,5,29,36,1.25,0.09236745114890868,565,Quick: the good news first or the bad??
825,3,3,30,36,1.25,0.10059347702036957,565,I'm afraid it's worse than heartburn. It's chartburn.
825,1,7,28,36,1.25,0.08333333333333333,565,Your prognosis sounds much better than it appears.
825,1,7,28,36,1.25,0.08333333333333333,565,Telling me in advance that my nurse is your ex-wife would have been prudent.
825,4,1,31,36,1.25,0.1081958835000168,565,...and that's just the lab report.
825,0,9,27,36,1.25,0.07319250547113999,565,Side effects may include pyrokinesis.
825,1,7,28,36,1.25,0.08333333333333333,565,I'm afraid you've had another flare up
825,2,5,29,36,1.25,0.09236745114890868,565,You got a hunka hunka burning love from somebody.
825,2,5,29,36,1.25,0.09236745114890868,565,I see you're still a pyromaniac.
825,1,7,28,36,1.25,0.08333333333333333,565,"Uh oh, it looks like we'e going to need your fire insurance policy number."
825,1,7,28,36,1.25,0.08333333333333333,565,"When this happens to a patient's records, it's usually not a good omen."
825,2,5,29,36,1.25,0.09236745114890868,565,You really must stop smoking.
825,2,5,29,36,1.25,0.09236745114890868,565,Do you believe in the afterlife?
825,2,5,29,36,1.25,0.09236745114890868,565,"I'm not alarmed, but something has caught my eye."
825,1,7,28,36,1.25,0.08333333333333333,565,The interaction of the drugs you take could be a problem.
825,2,5,29,36,1.25,0.09236745114890868,565,"Dont' be alarmed, it's just a new HIPPA requirement"
825,2,5,29,36,1.25,0.09236745114890868,565,"No need to bend over, just stop, drop, and roll."
825,1,7,28,36,1.25,0.08333333333333333,565,I don't have malpractice insurance but I am covered for fire
825,2,5,29,36,1.25,0.09236745114890868,565,"As you can see, results from tests we ran on your eternal soul are back from the lab..."
825,1,7,28,36,1.25,0.08333333333333333,565,Hemorrhoids.
825,1,7,28,36,1.25,0.08333333333333333,565,I don't see any reason to be concerned
825,1,7,28,36,1.25,0.08333333333333333,565,"By any chance, do you ever experience a burning sensation?"
825,2,5,29,36,1.25,0.09236745114890868,565,That's what I think of your first opinion!
825,4,1,31,36,1.25,0.1081958835000168,565,"We really, really don't accept HMO."
825,2,5,29,36,1.25,0.09236745114890868,565,It seems you’re running a bit of a temperature.
825,4,1,31,36,1.25,0.1081958835000168,565,Your Affordable Care Act benefits are really going up in flames .
825,1,7,28,36,1.25,0.08333333333333333,565,"You're fine, but your chart has a pre-existing ignition."
825,3,3,30,36,1.25,0.10059347702036957,565,Sorry. I'm usually doing a magic act at the club on Thursdays.
825,2,5,29,36,1.25,0.09236745114890868,565,Our HMO is taking this paperless thing seriously.
825,2,5,29,36,1.25,0.09236745114890868,565,Your Obamacare policy finally exploded.
825,2,5,29,36,1.25,0.09236745114890868,565,"The tests were inconclusive, but I think you should drink more water."
825,0,9,27,36,1.25,0.07319250547113999,565,This is just the Constitution. Your Obamacare policy hasn't burst into flames just yet.
825,0,9,27,36,1.25,0.07319250547113999,565,It's worse than I thought.
825,2,5,29,36,1.25,0.09236745114890868,565,We'll be starting you on something for the heartburn.
825,1,7,28,36,1.25,0.08333333333333333,565,Have you tried icing it?
825,2,5,29,36,1.25,0.09236745114890868,565,"No need for alarm, just drink plenty of liquids."
825,1,7,28,36,1.25,0.08333333333333333,565,"Second opinion? Well, I guess we won't be needing this."
825,3,3,30,36,1.25,0.10059347702036957,565,Maybe cut back on the habaneros.
825,1,7,28,36,1.25,0.08333333333333333,565,You really need to quit fracking.
825,2,5,29,36,1.25,0.09236745114890868,565,This is what I think of second opinions.
825,3,3,30,36,1.25,0.10059347702036957,565,"To maintain your insurance, we are confirming that you have no preexisting conditions"
825,2,5,29,36,1.25,0.09236745114890868,565,I tell most patients to avoid asbestos but in your case...
825,2,5,29,36,1.25,0.09236745114890868,565,Evidently your ex-wife has contributed to your medical history.
825,1,7,28,36,1.25,0.08333333333333333,565,New HIPAA privacy rules
825,2,5,29,36,1.25,0.09236745114890868,565,"Unfortunately, the test came back positive."
825,3,3,30,36,1.25,0.10059347702036957,565,Swallow 2 fire extinguishers and call me in the morning.
825,3,3,30,36,1.25,0.10059347702036957,565,I don't think you'll get a second opinion.
825,1,7,28,36,1.25,0.08333333333333333,565,"Now without looking at me, how long has this 'stare at something and it burns' thing been going on?"
825,1,7,28,36,1.25,0.08333333333333333,565,You have no pre existing conditions
825,2,5,29,36,1.25,0.09236745114890868,565,I'm going to have to Google these results
825,1,7,28,36,1.25,0.08333333333333333,565,Would you rather hear the good news first?
825,1,7,28,36,1.25,0.08333333333333333,565,You're a hot mess....
825,2,5,29,36,1.25,0.09236745114890868,565,Not what I intended by a carbon copy of your records...
825,2,5,29,36,1.25,0.09236745114890868,565,I see you haven't been taking those anti-inflammation pills we talked about.
825,2,5,29,36,1.25,0.09236745114890868,565,This is what I think of your Contract of Carriage Mr. Munoz.
825,3,3,30,36,1.25,0.10059347702036957,565,You've been diagnosed with pyromania.
825,3,3,30,36,1.25,0.10059347702036957,565,Your plan only covers a reading of the ashes.
825,1,7,28,36,1.25,0.08333333333333333,565,I see you suffer from a burning sensation.
825,1,7,28,36,1.25,0.08333333333333333,565,All I ever do around here is put out fires.
825,1,7,28,36,1.25,0.08333333333333333,565,Well on paper it looks like classic heartburn.
825,1,7,28,36,1.25,0.08333333333333333,565,Of course you might want to get a second opinion.
825,2,5,29,36,1.25,0.09236745114890868,565,It's our new privacy policy.
825,2,5,29,36,1.25,0.09236745114890868,565,This IS the second opinion.
825,0,9,27,36,1.25,0.07319250547113999,565,You really don't want to know!
825,1,7,28,36,1.25,0.08333333333333333,565,I am going to recommend you get a second opinion.
825,2,5,29,36,1.25,0.09236745114890868,565,Your results suggest it may be serious.
825,2,5,29,36,1.25,0.09236745114890868,565,Right now we can not concern ourselves about the side effects
825,0,9,27,36,1.25,0.07319250547113999,565,"Now for out next test Mr. Kent I'm going to hold up a piece of wood,"
825,2,5,29,36,1.25,0.09236745114890868,565,HIPAA requires that I burn after reading.
825,1,7,28,36,1.25,0.08333333333333333,565,It's not as bad as it looks.
825,1,7,28,36,1.25,0.08333333333333333,565,....and who are you?
825,2,5,29,36,1.25,0.09236745114890868,565,"Before I tell you the results, I must warn you that there is cause for concern."
825,1,7,28,36,1.25,0.08333333333333333,565,"Malpractice insurance is too expensive, we can only afford fire."
825,0,9,27,36,1.25,0.07319250547113999,565,"I'm sorry, sir; your chances just went up in smoke."
825,1,7,28,36,1.25,0.08333333333333333,565,We're well beyond a topical.
825,1,7,28,36,1.25,0.08333333333333333,565,I suggest you cut back on the chili peppers.
825,2,5,29,36,1.25,0.09236745114890868,565,Where did you say those mushrooms came from?
825,3,3,30,36,1.25,0.10059347702036957,565,Your coverage self-combusts in the event of an illness.
825,1,7,28,36,1.25,0.08333333333333333,565,We take confidentiality very seriously in this practice.
825,1,7,28,36,1.25,0.08333333333333333,565,Your blood work says you are toast.
825,0,9,27,36,1.25,0.07319250547113999,565,I share your concerns... pre-existing no longer.
825,3,3,30,36,1.25,0.10059347702036957,565,Just sign right here and you can live forever...
825,0,9,27,36,1.25,0.07319250547113999,565,Definitely a new strain of heartburn.
825,3,3,30,36,1.25,0.10059347702036957,565,"Yes, I'm positive you have eye inflammation."
825,3,3,30,36,1.25,0.10059347702036957,565,"Unfortunately, the inflammation is spreading."
825,4,1,31,36,1.25,0.1081958835000168,565,"It's the new patient privacy regulations,now nobody gets to see the test results."
825,2,5,29,36,1.25,0.09236745114890868,565,Now close your right eye and tell me if you see anything unusual?
825,1,7,28,36,1.25,0.08333333333333333,565,I can only imagine how it feels when you urinate.
825,2,5,29,36,1.25,0.09236745114890868,565,Yes we do take medical privacy very seriously at this clinic.
825,2,5,29,36,1.25,0.09236745114890868,565,"Don't worry about your tiny hands, I have two eyelashes and my nose is an 'L'."
825,1,7,28,36,1.25,0.08333333333333333,565,It's just inflammation.
825,0,9,27,36,1.25,0.07319250547113999,565,The test came back positive: you've got heartburn.
825,1,7,28,36,1.25,0.08333333333333333,565,The test results say that you are going straight to hell.
825,2,5,29,36,1.25,0.09236745114890868,565,You need to lay off the sriracha sauce.
825,0,9,27,36,1.25,0.07319250547113999,565,"I don't know what it is, but I bet it hurts like hell."
825,1,7,28,36,1.25,0.08333333333333333,565,Your chart says you're not going to Heaven.
825,2,5,29,36,1.25,0.09236745114890868,565,Its the Mother Of All Prescriptions.
825,2,5,29,36,1.25,0.09236745114890868,565,"Well, your hemorrhoids have gotten much worse."
825,1,7,28,36,1.25,0.08333333333333333,565,So you really did sell your soul to the devil!
825,1,7,28,36,1.25,0.08333333333333333,565,Your lab report indicates acute inflammation.
825,3,3,30,36,1.25,0.10059347702036957,565,"The good news is, we found out what's wrong with your liver."
825,3,3,30,36,1.25,0.10059347702036957,565,Your labs indicate we up the anti-inflammatories and we do a joint TED talk.
825,2,5,29,36,1.25,0.09236745114890868,565,You've really let yourself go to hell.
825,2,5,29,36,1.25,0.09236745114890868,565,You're letting yourself go to hell
825,2,5,29,36,1.25,0.09236745114890868,565,The inflammation concerns me.
825,2,5,29,36,1.25,0.09236745114890868,565,I didn't realize your heartburn treatment could become ironic.
825,3,3,30,36,1.25,0.10059347702036957,565,This can't be good news...
825,2,5,29,36,1.25,0.09236745114890868,565,"On the bright side, the other three humors look pretty good."
825,2,5,29,36,1.25,0.09236745114890868,565,Sometimes it's not just your pants that catch on fire.
825,2,5,29,36,1.25,0.09236745114890868,565,It's the worst case of inflammation that I've ever seen!
825,2,5,29,36,1.25,0.09236745114890868,565,Then we read the ashes and your treatment plan will be clear
825,2,5,29,36,1.25,0.09236745114890868,565,It's not your test results; it's the amount of the fee for them.
825,2,5,29,36,1.25,0.09236745114890868,565,"I have bad news, your DNA results indicate you are mainly from Hell."
825,1,7,28,36,1.25,0.08333333333333333,565,"Whatever you have, it's not good."
825,2,5,29,36,1.25,0.09236745114890868,565,"The test results indicate that not only are you going to die, you're going to burn in hell."
825,1,7,28,36,1.25,0.08333333333333333,565,We found arsonic in your blood.
825,2,5,29,36,1.25,0.09236745114890868,565,"Oops, your insurance policy seems to be self destructing"
825,1,7,28,36,1.25,0.08333333333333333,565,Highest phosphorous count I've seen.
825,2,5,29,36,1.25,0.09236745114890868,565,I see you suffer from pyrokinesis.
825,3,3,30,36,1.25,0.10059347702036957,565,You have a VERY high fever!
825,1,7,28,36,1.25,0.08333333333333333,565,"Let's see Mr. Lucifer, where should we start?"
1039,1,6,27,34,1.2352941176470589,0.08505868299779072,565,And now could you describe the burning sensation on a scale of one to ten.
1039,2,4,28,34,1.2352941176470589,0.09496057470137043,565,Looks like you have hemorrhoids.
1039,2,4,28,34,1.2352941176470589,0.09496057470137043,565,"This is radical, but you'll never complain of heartburn ever again."
1039,1,6,27,34,1.2352941176470589,0.08505868299779072,565,Your fire policy won't cover these tests either.
1039,1,6,27,34,1.2352941176470589,0.08505868299779072,565,So much for your pre-existing condition.
1039,0,8,26,34,1.2352941176470589,0.07384069581892327,565,The good news is: I have the hottest new research on your condition.
1039,2,4,28,34,1.2352941176470589,0.09496057470137043,565,Aha! A slightly elevated reticulocyte count. We see this in a lot of our demonic possession patients.
1039,1,6,27,34,1.2352941176470589,0.08505868299779072,565,I’m afraid your rhetoric is inflamed.
1039,2,4,28,34,1.2352941176470589,0.09496057470137043,565,You're running a temperature of 451.
1039,1,6,27,34,1.2352941176470589,0.08505868299779072,565,"You could of just said ""I would prefer to not have a colonoscopy."""
1039,1,6,27,34,1.2352941176470589,0.08505868299779072,565,"Your lab report is, well, hellacious."
1039,1,6,27,34,1.2352941176470589,0.08505868299779072,565,The lab has called. This is the worst case of heartburn they have ever seen.
1039,1,6,27,34,1.2352941176470589,0.08505868299779072,565,The tests suggest you cut back on tequila-flamed shrimp tostadas.
1039,0,8,26,34,1.2352941176470589,0.07384069581892327,565,"Well, I suppose it could be a false positive."
1039,0,8,26,34,1.2352941176470589,0.07384069581892327,565,We'll have to adjust your x-ray vision settings.
1039,0,8,26,34,1.2352941176470589,0.07384069581892327,565,' Now is definitely the time to have that end of life discussion with your family.'
1039,0,8,26,34,1.2352941176470589,0.07384069581892327,565,You definitely are going to need a Colonoscopy!
1039,1,6,27,34,1.2352941176470589,0.08505868299779072,565,We'll never speak of these results again.
1039,2,4,28,34,1.2352941176470589,0.09496057470137043,565,"Well, sorry, but that's it for Obamacare."
1039,0,8,26,34,1.2352941176470589,0.07384069581892327,565,I have good news and I have bad news.
1039,1,6,27,34,1.2352941176470589,0.08505868299779072,565,Your inflammation is off the chart
1039,1,6,27,34,1.2352941176470589,0.08505868299779072,565,For burning hemorrhoids we fight fire with fire.
1039,1,6,27,34,1.2352941176470589,0.08505868299779072,565,"Using your psychokinetic power to burn your chart isn't going to change my diagnosis, Fred."
1039,1,6,27,34,1.2352941176470589,0.08505868299779072,565,Classic Chartburn. Lay off the Mexican food.
1039,0,8,26,34,1.2352941176470589,0.07384069581892327,565,You're right. You are burning up.
1039,2,4,28,34,1.2352941176470589,0.09496057470137043,565,Are you sure you're not having any burning upon urination?
1039,2,4,28,34,1.2352941176470589,0.09496057470137043,565,"You know, Mr. Miller, I can always make another copy of your bill."
1039,2,4,28,34,1.2352941176470589,0.09496057470137043,565,"So , Mr. Montag, any preexisting conditions?"
1039,2,4,28,34,1.2352941176470589,0.09496057470137043,565,"I have the results of your tests, and they don't look good."
1039,2,4,28,34,1.2352941176470589,0.09496057470137043,565,You really must take care to hydrate more frequently.
1039,0,8,26,34,1.2352941176470589,0.07384069581892327,565,I wish I could tell you its just a regular hemorrhoid.
1039,2,4,28,34,1.2352941176470589,0.09496057470137043,565,"Just one more magic trick and then we'll check your knee, ok?"
1039,2,4,28,34,1.2352941176470589,0.09496057470137043,565,Let me start from the bottom.
1039,0,8,26,34,1.2352941176470589,0.07384069581892327,565,"OK, it's done Julie, no evidence of the operation ever having had taken place."
1039,2,4,28,34,1.2352941176470589,0.09496057470137043,565,"I don't mean to alarm you, but I've never seen a flare up this bad."
1039,1,6,27,34,1.2352941176470589,0.08505868299779072,565,Looks like you have a pre-existing condition
1039,1,6,27,34,1.2352941176470589,0.08505868299779072,565,I find you devilishly hard to diagnose.
1039,1,6,27,34,1.2352941176470589,0.08505868299779072,565,"Well sir, I guess these were alternative facts after all."
1039,2,4,28,34,1.2352941176470589,0.09496057470137043,565,I find this method significantly reduces any HIPAA violation concerns.
1039,2,4,28,34,1.2352941176470589,0.09496057470137043,565,Your results are worse than I expected.
1039,1,6,27,34,1.2352941176470589,0.08505868299779072,565,I'm sorry. I've been instructed to rigorously deny you treatment.
1039,2,4,28,34,1.2352941176470589,0.09496057470137043,565,You will self-destruct in 10 minutes.
1039,0,8,26,34,1.2352941176470589,0.07384069581892327,565,What kind of chilis did you say you ate?
1039,3,2,29,34,1.2352941176470589,0.10392325024704747,565,"I am going to take the oxygen out of the room, now."
1039,2,4,28,34,1.2352941176470589,0.09496057470137043,565,"On the plus side, we've ruled out asbestos poisoning."
1039,1,6,27,34,1.2352941176470589,0.08505868299779072,565,"Yes, yes, I absolutely understand!"
1039,2,4,28,34,1.2352941176470589,0.09496057470137043,565,I recommend you see a pyrologist.
1039,2,4,28,34,1.2352941176470589,0.09496057470137043,565,Do you have a history of pyromania?
1039,2,4,28,34,1.2352941176470589,0.09496057470137043,565,We're burning all of our records into a cloud.
1039,1,6,27,34,1.2352941176470589,0.08505868299779072,565,I am afraid your lab results are disappointing.
1039,1,6,27,34,1.2352941176470589,0.08505868299779072,565,Told ya you're a hot mess.
1039,1,6,27,34,1.2352941176470589,0.08505868299779072,565,Youe health is fine. This is just another consequence of global warming.
1091,0,7,25,32,1.21875,0.07424858801742054,565,The good news is we found you a match...
1091,1,5,26,32,1.21875,0.08676970585889242,565,"I'm going to have to read this very quickly, so listen carefully."
1091,1,5,26,32,1.21875,0.08676970585889242,565,Now let me know if this recreates your symptoms.
1091,1,5,26,32,1.21875,0.08676970585889242,565,"OMG, you should be dead."
1091,1,5,26,32,1.21875,0.08676970585889242,565,It seems your insurance carrier has refused coverage.
1091,2,3,27,32,1.21875,0.09769908334829336,565,Your cholesterol levels are a little higher than I typically like to see.
1091,1,5,26,32,1.21875,0.08676970585889242,565,I'm afraid it's spreading.
1091,1,5,26,32,1.21875,0.08676970585889242,565,"Should you get ill, my secretary will disavow all knowledge of this diagnosis."
1091,2,3,27,32,1.21875,0.09769908334829336,565,"To answer your question, breathing fire is a constant side effect of your condition."
1091,0,7,25,32,1.21875,0.07424858801742054,565,Medical Privacy meets Mission Impossible.
1091,2,3,27,32,1.21875,0.09769908334829336,565,First the good news---an ambulance has already been dispatched.
1091,2,3,27,32,1.21875,0.09769908334829336,565,Our newest technology to dissuade Russian hackers
1091,0,7,25,32,1.21875,0.07424858801742054,565,You've been burning calories like crazy!
1091,1,5,26,32,1.21875,0.08676970585889242,565,Federal and state laws mandate that you are legally compelled to inform all of your past sexual partners of this diagnosis.
1091,1,5,26,32,1.21875,0.08676970585889242,565,Don't worry -- this always happens whenever Trump mentions Obamacare.
1091,2,3,27,32,1.21875,0.09769908334829336,565,"Apparently you did not read Article VI, Clause D, page 17,954, of the Affordable Care Act."
1091,2,3,27,32,1.21875,0.09769908334829336,565,I picked this up while practicing in Vegas.
1091,2,3,27,32,1.21875,0.09769908334829336,565,They say you should know everything but I’m not convinced.
1091,0,7,25,32,1.21875,0.07424858801742054,565,I got a magic set for my birthday--voilla.
1091,2,3,27,32,1.21875,0.09769908334829336,565,"Really, it only reads that you'll have a slight burning sensation"
1091,2,3,27,32,1.21875,0.09769908334829336,565,"Trust, me. In your condition, this is the best option."
1091,3,1,28,32,1.21875,0.1075232064224037,565,"It's a new hemorrhoid treatment - just bend over and clasp your knees, please."
1091,2,3,27,32,1.21875,0.09769908334829336,565,"Mr. Bond, your secret is safe - this Viagra prescription will self-destruct in 10 seconds."
1091,2,3,27,32,1.21875,0.09769908334829336,565,Looks like you may have heartburn.
1091,0,7,25,32,1.21875,0.07424858801742054,565,"It says, 'You are possessed'."
1091,2,3,27,32,1.21875,0.09769908334829336,565,Looks like your symptoms are flaring up.
1091,1,5,26,32,1.21875,0.08676970585889242,565,"Your insurance did cover the tests, but not the results."
1091,2,3,27,32,1.21875,0.09769908334829336,565,"Mr. Bradbury, you have a body temperature of 451º"
1091,1,5,26,32,1.21875,0.08676970585889242,565,Could you come in 15 minutes early next appointment and fill these out---again?
1091,1,5,26,32,1.21875,0.08676970585889242,565,Good luck getting your prescription filled. This has every indication of Russian interference with the erection process.
1091,2,3,27,32,1.21875,0.09769908334829336,565,"Needless to say, it wasn't good news."
1091,2,3,27,32,1.21875,0.09769908334829336,565,I'm afraid the report speaks for itself.
1091,2,3,27,32,1.21875,0.09769908334829336,565,The results of your labs are alarming.
1091,0,7,25,32,1.21875,0.07424858801742054,565,A simple anti inflammatory should clear this up.
1091,2,3,27,32,1.21875,0.09769908334829336,565,X-ray machine is down so I'm going to read these ashes.
1091,1,5,26,32,1.21875,0.08676970585889242,565,Be sure to take this with a full glass of water.
1091,2,3,27,32,1.21875,0.09769908334829336,565,I'm going to need more tests
1091,1,5,26,32,1.21875,0.08676970585889242,565,"This is your stomach on taco Tuesday, any questions?"
1091,1,5,26,32,1.21875,0.08676970585889242,565,I'm afraid I have some bad news...
1091,1,5,26,32,1.21875,0.08676970585889242,565,"Inflammatory bowel disease, worst case I've seen."
1091,0,7,25,32,1.21875,0.07424858801742054,565,Your chart has a few irregularities.
1091,3,1,28,32,1.21875,0.1075232064224037,565,It's the Administration's new scorched-earth health care reform.
1091,0,7,25,32,1.21875,0.07424858801742054,565,I think these test results are self explanatory.
1091,1,5,26,32,1.21875,0.08676970585889242,565,You had insurance.
1091,2,3,27,32,1.21875,0.09769908334829336,565,It's actually worse than it looks.
1091,2,3,27,32,1.21875,0.09769908334829336,565,What's the name of that Mexican restaurant again?
1091,2,3,27,32,1.21875,0.09769908334829336,565,"Well, I used to say the medical results don't lie."
1091,2,3,27,32,1.21875,0.09769908334829336,565,"Yes, it's for, um uh, patient confidentiality purposes..."
1091,1,5,26,32,1.21875,0.08676970585889242,565,I've seen this before...you're out of network aren't you?
1091,2,3,27,32,1.21875,0.09769908334829336,565,Your chart looks like hell!
1091,1,5,26,32,1.21875,0.08676970585889242,565,Your test results confirm your jalapeno addiction.
1091,2,3,27,32,1.21875,0.09769908334829336,565,After taking a swab of your month the evidence points to a possible link to a dragon from 800 A D.
1091,2,3,27,32,1.21875,0.09769908334829336,565,This is our new breath test. Extinguish this as fast as possible. Go!
1091,1,5,26,32,1.21875,0.08676970585889242,565,This prescription has one little side effect.
1091,2,3,27,32,1.21875,0.09769908334829336,565,"You weren't supposed to urinate directly on the forms, but I think we might have bigger problems here."
1091,0,7,25,32,1.21875,0.07424858801742054,565,You'll be fine but your bill is about to explode.
1091,0,7,25,32,1.21875,0.07424858801742054,565,"And who did you say referred you, Mr. Faust?"
1091,1,5,26,32,1.21875,0.08676970585889242,565,Some insurance authorizations just do this.
1091,1,5,26,32,1.21875,0.08676970585889242,565,The good news is it's not contagious.
1091,0,7,25,32,1.21875,0.07424858801742054,565,"We think you might be possessed,"
1091,0,7,25,32,1.21875,0.07424858801742054,565,"As you can see, the drug's side effects are still being determined."
1091,2,3,27,32,1.21875,0.09769908334829336,565,I found a match for your DNA.
1091,1,5,26,32,1.21875,0.08676970585889242,565,"Well, there went the good news."
1091,1,5,26,32,1.21875,0.08676970585889242,565,So do you want the good news or the bad news first?
1091,2,3,27,32,1.21875,0.09769908334829336,565,"Based on what I'm seeing in the ashes, your ancestors think it's a urinary tract infection."
1091,2,3,27,32,1.21875,0.09769908334829336,565,Our new Internet firewall ensures that no one will ever gain unauthorized access ro your medical records.
1091,2,3,27,32,1.21875,0.09769908334829336,565,That *was* the second opinion.
1091,2,3,27,32,1.21875,0.09769908334829336,565,"Tell me, does your medical insurance have insurance?"
1091,0,7,25,32,1.21875,0.07424858801742054,565,We're serious about patient confidentiality.
1091,2,3,27,32,1.21875,0.09769908334829336,565,The new patient-records confidentiality system is still a little buggy.
1091,2,3,27,32,1.21875,0.09769908334829336,565,"The good news is, your test results will expire before you do."
1091,0,7,25,32,1.21875,0.07424858801742054,565,Lets discuss your hemorrhoid results.
1091,2,3,27,32,1.21875,0.09769908334829336,565,This is the most contagious gonorrhea I've ever seen
1091,1,5,26,32,1.21875,0.08676970585889242,565,"If your hand doesn't burn, you have health coverage."
1091,3,1,28,32,1.21875,0.1075232064224037,565,Vasectomy?
1091,2,3,27,32,1.21875,0.09769908334829336,565,Do I have an inflamed tissue?
1091,2,3,27,32,1.21875,0.09769908334829336,565,No more pre-xisting condition
1091,1,5,26,32,1.21875,0.08676970585889242,565,Seems Trump just bombed your Obamacare.
1091,1,5,26,32,1.21875,0.08676970585889242,565,We take patient confidentiality very seriously.
1091,2,3,27,32,1.21875,0.09769908334829336,565,"Funny, I'm also feeling a burning sensation."
1091,0,7,25,32,1.21875,0.07424858801742054,565,"Trump Care, for now."
1091,2,3,27,32,1.21875,0.09769908334829336,565,"Never mind the Rorschach test. At this juncture, we have three options left: revisit your laser eye surgery, embed you in a fire brigade or sign you up with a Marvel agent. Personally, I favor the last."
1091,0,7,25,32,1.21875,0.07424858801742054,565,"Do you want the good news, first, or the bad news?"
1091,0,7,25,32,1.21875,0.07424858801742054,565,The internet of things says it could be many things.
1091,2,3,27,32,1.21875,0.09769908334829336,565,I'm destroying the evidence. You don't want solicitors finding out you're O-negative.
1091,1,5,26,32,1.21875,0.08676970585889242,565,"Yeah, the Trumpcare rollout has had a few problems."
1091,1,5,26,32,1.21875,0.08676970585889242,565,Samsung tablet.
1091,2,3,27,32,1.21875,0.09769908334829336,565,This is the worst case of inflamed hemorrhoids I've ever seen.
1091,0,7,25,32,1.21875,0.07424858801742054,565,It's part of our Bronze Member confidentiality policy.
1091,1,5,26,32,1.21875,0.08676970585889242,565,"Your condition is flaring up again, I see."
1091,0,7,25,32,1.21875,0.07424858801742054,565,Our policy is to share your medical records with no one.
1091,1,5,26,32,1.21875,0.08676970585889242,565,"Now, about your hemorrhoids..."
1091,0,7,25,32,1.21875,0.07424858801742054,565,My malpractice lawyer insists.
1091,1,5,26,32,1.21875,0.08676970585889242,565,"What's wrong? Well, that seems to be the burning question."
1091,1,5,26,32,1.21875,0.08676970585889242,565,"It's your insurance policy, it's set to auto-destruct"
1091,2,3,27,32,1.21875,0.09769908334829336,565,You don't want your wife to see these charts.
1091,1,5,26,32,1.21875,0.08676970585889242,565,Do you want the good news or the bad news?
1091,2,3,27,32,1.21875,0.09769908334829336,565,"Your test results are negative, but your Twitter feed is on fire."
1091,2,3,27,32,1.21875,0.09769908334829336,565,I'm afraid that your test results reveal some burning issues!
1091,0,7,25,32,1.21875,0.07424858801742054,565,I have the results of your STD tests.
1091,1,5,26,32,1.21875,0.08676970585889242,565,take two tablets and you will be the leader of a great people before you die.
1091,1,5,26,32,1.21875,0.08676970585889242,565,This represents you living with hemorrhoids.
1091,3,1,28,32,1.21875,0.1075232064224037,565,"Nurse, fire extinguisher...and you can forget about the thermometer."
1091,1,5,26,32,1.21875,0.08676970585889242,565,"After you read the patient his bill, it will self destruct so he cannot question it."
1091,2,3,27,32,1.21875,0.09769908334829336,565,"Bad news. It looks inflamed, John."
1091,2,3,27,32,1.21875,0.09769908334829336,565,Looks like a bad case of chartburn.
1091,2,3,27,32,1.21875,0.09769908334829336,565,It would be a mistake to ignore your test results.
1091,3,1,28,32,1.21875,0.1075232064224037,565,"I'm afraid your illness has progressed to the ""make burnt offerings to the gods"" stage."
1091,1,5,26,32,1.21875,0.08676970585889242,565,Now just imagine these are your hemorrhoids...
1091,2,3,27,32,1.21875,0.09769908334829336,565,You have an inflammatory condition.
1091,2,3,27,32,1.21875,0.09769908334829336,565,I don't like the looks of your PSA test results.
1091,0,7,25,32,1.21875,0.07424858801742054,565,We are HIPAA-compliant.
1091,1,5,26,32,1.21875,0.08676970585889242,565,Your test results are back...Why don't you just go out and make the best of today.
1204,1,4,25,30,1.2,0.08840866447369841,565,I have some burning questions about your lifestyle choices.
1204,1,4,25,30,1.2,0.08840866447369841,565,Your lab results seem to indicate you've taken up smoking again.
1204,1,4,25,30,1.2,0.08840866447369841,565,"Your cholesterol looks fine, but you're still running a temperature of 451 degrees Fahrenheit."
1204,0,6,24,30,1.2,0.07427813527082072,565,I hate to be the bearer of bad news but I am just getting warmed up.
1204,0,6,24,30,1.2,0.07427813527082072,565,"No chart, no pre-existing condition."
1204,2,2,26,30,1.2,0.10057307059414874,565,"Goodness, gracious, great balls of fire."
1204,0,6,24,30,1.2,0.07427813527082072,565,I don't think you need a second opinion.
1204,2,2,26,30,1.2,0.10057307059414874,565,You have a great suture in front of you.
1204,1,4,25,30,1.2,0.08840866447369841,565,I think heartburn could be a factor.
1204,2,2,26,30,1.2,0.10057307059414874,565,"Well, you're as healthy as a horse - but God seems to be annoyed with you..."
1204,0,6,24,30,1.2,0.07427813527082072,565,"Based on your test results, I'd appreciate payment in advance."
1204,1,4,25,30,1.2,0.08840866447369841,565,This is your brain on drugs. Do you still have questions?
1204,1,4,25,30,1.2,0.08840866447369841,565,"Your Jedi powers won't save you this time. You still have to cut out salt, drink less, stop smoking, and lose weight."
1204,1,4,25,30,1.2,0.08840866447369841,565,I think we're going to have to increase the strength of your antacids.
1204,1,4,25,30,1.2,0.08840866447369841,565,Have you been experiencing a burning sensation?
1204,2,2,26,30,1.2,0.10057307059414874,565,"Yes, fracking does seem to be involved."
1204,1,4,25,30,1.2,0.08840866447369841,565,"This will take care of you for now. When you get home, take the eye of a newt and some wolf-bane and, at midnight in the dark of the moon…"
1204,2,2,26,30,1.2,0.10057307059414874,565,Results of your hemorrhoids test came back positive.
1204,1,4,25,30,1.2,0.08840866447369841,565,The test results are back: yours is a very inflammatory condition!
1204,2,2,26,30,1.2,0.10057307059414874,565,"Like I told you, Mr. Sweeney, when you smoke, there's fire!"
1204,1,4,25,30,1.2,0.08840866447369841,565,This is not a drill.
1204,2,2,26,30,1.2,0.10057307059414874,565,"It says here you're feeling a burning sensation, is that right?"
1204,0,6,24,30,1.2,0.07427813527082072,565,Let's order some more tests.
1204,0,6,24,30,1.2,0.07427813527082072,565,I see that your heartburn has flared up.
1204,1,4,25,30,1.2,0.08840866447369841,565,"Do you want to talk about this now, or after you update your will?"
1204,0,6,24,30,1.2,0.07427813527082072,565,"You have a very high fever, Mr. Spalding"
1204,1,4,25,30,1.2,0.08840866447369841,565,You'd be more worried if my pants were on fire..
1204,0,6,24,30,1.2,0.07427813527082072,565,Looks like cancer is the GOOD news.
1204,1,4,25,30,1.2,0.08840866447369841,565,It's not good news.
1204,1,4,25,30,1.2,0.08840866447369841,565,"Congratulations, you're burning up the charts."
1204,2,2,26,30,1.2,0.10057307059414874,565,"The test results are not conclusive, but it looks like Beelzebub will have your immortal soul."
1204,1,4,25,30,1.2,0.08840866447369841,565,"For whatever ails you, Popcorn Flambé."
1204,1,4,25,30,1.2,0.08840866447369841,565,When I reach the count of 5 you will be healthy again with no trace of your ailments on file.
1204,1,4,25,30,1.2,0.08840866447369841,565,Have you been baptized?
1204,1,4,25,30,1.2,0.08840866447369841,565,We don't have much time - your chart self-destructs in 5 seconds
1204,0,6,24,30,1.2,0.07427813527082072,565,It appears your hallucinations are contagious.
1204,1,4,25,30,1.2,0.08840866447369841,565,"Yes, I'm afraid it really is inflamed."
1204,2,2,26,30,1.2,0.10057307059414874,565,"Sir, if your alt-medicine shaman interferes with your x-ray one more time, your insurance will refuse to cover it."
1204,2,2,26,30,1.2,0.10057307059414874,565,There is no way to sugarcoat this.
1204,1,4,25,30,1.2,0.08840866447369841,565,"It's the same old, same old--health insurance is got you fired up again."
1204,1,4,25,30,1.2,0.08840866447369841,565,Just as I thought. A nasty case of heartburn.
1204,0,6,24,30,1.2,0.07427813527082072,565,The inflammation has flared up again.
1204,1,4,25,30,1.2,0.08840866447369841,565,"True, it did ask you to circle the area and then best describe what it feels like"
1204,2,2,26,30,1.2,0.10057307059414874,565,The DNA confirms it. Please send my regards to your mother Rosemary.
1204,1,4,25,30,1.2,0.08840866447369841,565,"When you said ""chartburn"" I really thought you meant heartburn, but I stand corrected."
1204,1,4,25,30,1.2,0.08840866447369841,565,This won't happen anymore once we go digital.
1204,0,6,24,30,1.2,0.07427813527082072,565,"In the interest of not alarming the nurses,I have decided to destroy your chart."
1204,1,4,25,30,1.2,0.08840866447369841,565,Now try to guess if these are your test results or your bill.
1204,2,2,26,30,1.2,0.10057307059414874,565,The lab report on your hemorrhoids came in.
1204,1,4,25,30,1.2,0.08840866447369841,565,It's a simple case of hellitosis.
1204,0,6,24,30,1.2,0.07427813527082072,565,HIPPA now requires that all lab results self destruct.
1204,1,4,25,30,1.2,0.08840866447369841,565,"It's our latest procedure to insure medical privacy,"
1204,1,4,25,30,1.2,0.08840866447369841,565,This is a new form of incentivisation that managed care provides us with to discontinue the use of paper-based medical records.
1204,0,6,24,30,1.2,0.07427813527082072,565,"And, do you feel a burning sensation?"
1204,1,4,25,30,1.2,0.08840866447369841,565,"So, spontaneous inflammation is still bothering you?"
1204,1,4,25,30,1.2,0.08840866447369841,565,You need a stronger anti-inflammatory.
1204,1,4,25,30,1.2,0.08840866447369841,565,It appears that you checked 'Other'.
1204,0,6,24,30,1.2,0.07427813527082072,565,I think you've got a bit of a temperature!
1204,1,4,25,30,1.2,0.08840866447369841,565,I think we found the source of your heartburn.
1204,1,4,25,30,1.2,0.08840866447369841,565,I'm thinking you might be contagious.
1204,1,4,25,30,1.2,0.08840866447369841,565,You appear to have an inflamed co-payment.
1204,1,4,25,30,1.2,0.08840866447369841,565,The tests show inflammation.
1204,1,4,25,30,1.2,0.08840866447369841,565,Here are your test results -- hot off the press.
1204,1,4,25,30,1.2,0.08840866447369841,565,New HIPAA regulation!
1204,2,2,26,30,1.2,0.10057307059414874,565,You're a hot mess....
1204,1,4,25,30,1.2,0.08840866447369841,565,"I'm the one with the stethocope, I wouldn't be concerned."
1204,0,6,24,30,1.2,0.07427813527082072,565,I don't think this can wait.
1204,1,4,25,30,1.2,0.08840866447369841,565,It says here you're a smoker.
1204,1,4,25,30,1.2,0.08840866447369841,565,This is a preview of where you're going in about six months.
1204,1,4,25,30,1.2,0.08840866447369841,565,"The news isn't good, but hey, look at the pretty colors."
1204,0,6,24,30,1.2,0.07427813527082072,565,Not to worry. These results indicate you're hot and trending.
1204,1,4,25,30,1.2,0.08840866447369841,565,I'm afraid that your case is simply too hot to handle.
1204,2,2,26,30,1.2,0.10057307059414874,565,"Doc, I think I would rather the prostate exam..."
1204,2,2,26,30,1.2,0.10057307059414874,565,We are trying to go paperless!
1204,2,2,26,30,1.2,0.10057307059414874,565,Maybe I should give the good news first...
1204,1,4,25,30,1.2,0.08840866447369841,565,We have a few more tests to run but we are pretty sure it is just inflamed.
1204,1,4,25,30,1.2,0.08840866447369841,565,"This piece of paper, which may or may not include a humorous description of your ailment, is on fire."
1204,2,2,26,30,1.2,0.10057307059414874,565,Your x-ray confirms depression and that you need a fire under your ass.
1204,2,2,26,30,1.2,0.10057307059414874,565,"According to your swab, it appears you have advanced triple super-herpes."
1204,1,4,25,30,1.2,0.08840866447369841,565,Try not to take this literally.
1204,1,4,25,30,1.2,0.08840866447369841,565,"No, we don't take TrumpCare either"
1204,0,6,24,30,1.2,0.07427813527082072,565,"Apparently, you've already burned through your deductible."
1204,0,6,24,30,1.2,0.07427813527082072,565,Results show that you need to cut back on the Tex-Mex.
1204,1,4,25,30,1.2,0.08840866447369841,565,Your test results came in... it's inflammation.
1204,1,4,25,30,1.2,0.08840866447369841,565,Looks like you've got the insurance plan from hell!
1204,0,6,24,30,1.2,0.07427813527082072,565,Your test results came back metaphorical.
1204,2,2,26,30,1.2,0.10057307059414874,565,"Well, there's good cholesterol, bad cholesterol, and YOUR cholesterol..."
1204,1,4,25,30,1.2,0.08840866447369841,565,Look at the bright side! Being spontaneous will help your marriage.
1204,0,6,24,30,1.2,0.07427813527082072,565,Don’t worry. It's illegible anyways.
1204,1,4,25,30,1.2,0.08840866447369841,565,The bad news is that you have cancer. The good news is I'm a magician.
1204,2,2,26,30,1.2,0.10057307059414874,565,The burn rate on reimbursements is killing us.
1204,2,2,26,30,1.2,0.10057307059414874,565,Looks like you passed the physical for posing on the firemen's calendar.
1204,1,4,25,30,1.2,0.08840866447369841,565,"You're not alone, Ned. Many of us still feel the Bern"
1204,0,6,24,30,1.2,0.07427813527082072,565,"Unfortunately, your pyro kinesis is no longer in remission."
1204,2,2,26,30,1.2,0.10057307059414874,565,"The good news is you are covered, but I feel like you might not have read the fine print."
1204,1,4,25,30,1.2,0.08840866447369841,565,Your tests show some inflammation.
1204,1,4,25,30,1.2,0.08840866447369841,565,They're incentivizing us to go digital.
1204,1,4,25,30,1.2,0.08840866447369841,565,You really have Heart Burn!
1204,0,6,24,30,1.2,0.07427813527082072,565,I am going to refer you to a combustion specialist!
1204,0,6,24,30,1.2,0.07427813527082072,565,Looks like we'd better get your temperature down.
1204,0,6,24,30,1.2,0.07427813527082072,565,Uh... I'm sure it's nothing to be worried about.
1204,2,2,26,30,1.2,0.10057307059414874,565,Nobody knew that healthcare could be so complicated.
1204,1,4,25,30,1.2,0.08840866447369841,565,Do you want the bad news or the worse news first?
1204,0,6,24,30,1.2,0.07427813527082072,565,It's part of the healthcare system's new privacy policy
1204,2,2,26,30,1.2,0.10057307059414874,565,You have the worst case of heartburn I've seen lately.
1204,1,4,25,30,1.2,0.08840866447369841,565,Now let's play guess-your-diagnosis. Here's your first clue.
1204,2,2,26,30,1.2,0.10057307059414874,565,Here’s your bill for the pyromania treatment.
1204,1,4,25,30,1.2,0.08840866447369841,565,No news is good news.
1204,1,4,25,30,1.2,0.08840866447369841,565,You've got dragon breath.
1204,1,4,25,30,1.2,0.08840866447369841,565,What we have here is a bad flue.
1204,2,2,26,30,1.2,0.10057307059414874,565,"That's a cool magic trick, but you'll still have to have the colonoscopy."
1204,0,6,24,30,1.2,0.07427813527082072,565,Let's try this and hope that your fire insurance covers it.
1204,1,4,25,30,1.2,0.08840866447369841,565,De-identified data isn't
1204,1,4,25,30,1.2,0.08840866447369841,565,You do have heartburn
1204,0,6,24,30,1.2,0.07427813527082072,565,Would you like to guess the results of your STD test?
1204,2,2,26,30,1.2,0.10057307059414874,565,"The prognosis is not good, and the after life looks even worse."
1204,1,4,25,30,1.2,0.08840866447369841,565,And...the defense rests.
1204,1,4,25,30,1.2,0.08840866447369841,565,"Just as I anticipated, where there's smoke--there's fire!"
1204,0,6,24,30,1.2,0.07427813527082072,565,You're better off pretending the test never happened.
1204,1,4,25,30,1.2,0.08840866447369841,565,I asked my new secretary to burn a copy for you.
1204,1,4,25,30,1.2,0.08840866447369841,565,I m trying to understand your burning sensation.
1204,1,4,25,30,1.2,0.08840866447369841,565,Even your chart is inflamed.
1204,2,2,26,30,1.2,0.10057307059414874,565,I'm afraid you'll have to lay off the Mexican food.
1204,0,6,24,30,1.2,0.07427813527082072,565,There's a fire bug going around.
1204,0,6,24,30,1.2,0.07427813527082072,565,You have an inflamed deductible.
1204,0,6,24,30,1.2,0.07427813527082072,565,The test results suggest an inflammation.
1204,1,4,25,30,1.2,0.08840866447369841,565,The burning question is....
1204,2,2,26,30,1.2,0.10057307059414874,565,"We're sorry, sir, but Trumpcare has denied your claim."
1204,1,4,25,30,1.2,0.08840866447369841,565,It's quite serious. You have a severe inflammation on your balance due.
1204,0,6,24,30,1.2,0.07427813527082072,565,Digital records will be cooler.
1204,0,6,24,30,1.2,0.07427813527082072,565,"I'm sorry, but I'm on strict orders to let your health coverage crash and burn."
1204,0,6,24,30,1.2,0.07427813527082072,565,"You are now, officially, a non-entity. Good luck."
1204,1,4,25,30,1.2,0.08840866447369841,565,I'm afraid that Trump fired your health care policy.
1204,0,6,24,30,1.2,0.07427813527082072,565,Take two fire extinguishers and call me in the morning.
1204,1,4,25,30,1.2,0.08840866447369841,565,It's not good news.
1204,1,4,25,30,1.2,0.08840866447369841,565,Everything looks fantastic!!
1204,0,6,24,30,1.2,0.07427813527082072,565,I see you have a preëxisting condition.
1204,0,6,24,30,1.2,0.07427813527082072,565,You may want to cut down on the Sriracha.
1204,1,4,25,30,1.2,0.08840866447369841,565,"Well, Clark, your laser vision seems to be in good shape."
1204,0,6,24,30,1.2,0.07427813527082072,565,"Whoa, we better call Father Karras on this one."
1204,2,2,26,30,1.2,0.10057307059414874,565,Test is conclusive. It's heartburn.
1204,2,2,26,30,1.2,0.10057307059414874,565,Brace yourself.
1204,1,4,25,30,1.2,0.08840866447369841,565,The results are in. It seems like you have a burning case of chlamydia.
1204,1,4,25,30,1.2,0.08840866447369841,565,The good news - Marvel Comics is calling.
1204,1,4,25,30,1.2,0.08840866447369841,565,"Mr. Kent, you have irritable X-ray vision syndrome."
1204,2,2,26,30,1.2,0.10057307059414874,565,Now I see what you mean about the burning sensation.
1204,2,2,26,30,1.2,0.10057307059414874,565,"Well, my first recommendation is that you drink more water."
1204,1,4,25,30,1.2,0.08840866447369841,565,"No, you're fine. The lab results have gonorrhea, though."
1204,2,2,26,30,1.2,0.10057307059414874,565,I think you should see Dr. Fahrenheit. He's in room 451.
1204,0,6,24,30,1.2,0.07427813527082072,565,Have you experienced any burning sensations recently?
1204,1,4,25,30,1.2,0.08840866447369841,565,I'm afraid your pyrolytics are a bit high.
1204,1,4,25,30,1.2,0.08840866447369841,565,I see you have been having some inflammatory problems.
1204,1,4,25,30,1.2,0.08840866447369841,565,Let's ignore the lab results !
1204,1,4,25,30,1.2,0.08840866447369841,565,"Now both of us have a "" burning sensation"" !"
1204,1,4,25,30,1.2,0.08840866447369841,565,And you were never here!
1204,1,4,25,30,1.2,0.08840866447369841,565,"Don't worry, just uploading your records to the cloud""."
1204,1,4,25,30,1.2,0.08840866447369841,565,"It's getting hot in here, so take off all your clothes..."
1204,1,4,25,30,1.2,0.08840866447369841,565,I can inferno conclusions.
1204,1,4,25,30,1.2,0.08840866447369841,565,I just accepted your Mission Impossible case.
1204,2,2,26,30,1.2,0.10057307059414874,565,"Yes, your results are a bit unusual...."
1204,1,4,25,30,1.2,0.08840866447369841,565,"Oh, what's the point?"
1204,0,6,24,30,1.2,0.07427813527082072,565,The test came back positive.
1204,3,0,27,30,1.2,0.1114172029062311,565,Lab report says heartburn.
1204,1,4,25,30,1.2,0.08840866447369841,565,No insurance? No problem...
1204,1,4,25,30,1.2,0.08840866447369841,565,This is a lot faster than waiting to get a denial.
1204,0,6,24,30,1.2,0.07427813527082072,565,"It's not good news, Mr.Dante."
1204,1,4,25,30,1.2,0.08840866447369841,565,"Apparently, your stomach burning is spreading to your chart."
1204,0,6,24,30,1.2,0.07427813527082072,565,Your lab results make me suspect some inflammation.
1204,1,4,25,30,1.2,0.08840866447369841,565,I give you 6 months but I've been wrong 98 percent of the time.
1204,1,4,25,30,1.2,0.08840866447369841,565,Good guess. heartburn it is.
1204,2,2,26,30,1.2,0.10057307059414874,565,I'm destroying the test results. Does that make you feel better?
1204,2,2,26,30,1.2,0.10057307059414874,565,"Playing pranks with our stool samples is not OK, Mr. Johnson."
1204,0,6,24,30,1.2,0.07427813527082072,565,Your insurance has set all deductibles to $666.
1204,1,4,25,30,1.2,0.08840866447369841,565,This is your esophagus on chili.
1204,1,4,25,30,1.2,0.08840866447369841,565,I want to assure you that we are very serious about HIPAA compliance.
1204,0,6,24,30,1.2,0.07427813527082072,565,you should really quit smoking.
1204,0,6,24,30,1.2,0.07427813527082072,565,It's the new insurance code for  'Not Covered'.
1204,1,4,25,30,1.2,0.08840866447369841,565,Here are the results from your nuclear isotope test.
1204,1,4,25,30,1.2,0.08840866447369841,565,You'll probably outlive this prognosis.
1204,3,0,27,30,1.2,0.1114172029062311,565,"Usually, an inflammation wouldn't spread this far."
1204,1,4,25,30,1.2,0.08840866447369841,565,"Liar ,Liar... Your chart's on fire!"
1204,1,4,25,30,1.2,0.08840866447369841,565,I'll even burn my diploma if that's what it takes to say I'm sorry.
1204,2,2,26,30,1.2,0.10057307059414874,565,Let's skip the prostrate exam today
1204,1,4,25,30,1.2,0.08840866447369841,565,He had some burning questions to ask his patient.
1204,1,4,25,30,1.2,0.08840866447369841,565,I've got bad news and I've got worse news...
1204,0,6,24,30,1.2,0.07427813527082072,565,Think of it as an ear candle for constipation.
1204,0,6,24,30,1.2,0.07427813527082072,565,Let’s just keep this our little secret.
1204,1,4,25,30,1.2,0.08840866447369841,565,These new Samsung health records are not working out.
1204,0,6,24,30,1.2,0.07427813527082072,565,Hmm. And you're saying the Zantac didn't work?
1204,1,4,25,30,1.2,0.08840866447369841,565,It's important that you take this prescription with plenty of water.
1204,1,4,25,30,1.2,0.08840866447369841,565,"This will cure it, although it does have one major side effect."
1204,1,4,25,30,1.2,0.08840866447369841,565,"Frankly, I have never seen results this conclusive. Cut back on the spicy foods!"
1204,2,2,26,30,1.2,0.10057307059414874,565,I'd like to follow up on your statement that you're a non-smoker.
1204,2,2,26,30,1.2,0.10057307059414874,565,What malpractice?
1204,1,4,25,30,1.2,0.08840866447369841,565,You may feel a slight burning sensation.
1204,1,4,25,30,1.2,0.08840866447369841,565,Sorry- my assistant thinks April Fools lasts all month.
1204,1,4,25,30,1.2,0.08840866447369841,565,"Do you smoke? Liar, liar, charts on fire."
1204,2,2,26,30,1.2,0.10057307059414874,565,Back in the day I saw this prank only at Halloween--some joker's nasty version of a co-pay.
1204,2,2,26,30,1.2,0.10057307059414874,565,Pyrokinesis is simply not an appropriate response to disappointing test results.
1204,0,6,24,30,1.2,0.07427813527082072,565,We have a hot new treatment for you!
1204,2,2,26,30,1.2,0.10057307059414874,565,"Well, it's not a cold sore."
1204,0,6,24,30,1.2,0.07427813527082072,565,"Hmm, I think your benefits changed."
1204,0,6,24,30,1.2,0.07427813527082072,565,"No, no, it doesn't look bad...why do you ask?"
1204,1,4,25,30,1.2,0.08840866447369841,565,"Where there's stroke, there's fire."
1204,0,6,24,30,1.2,0.07427813527082072,565,You have the worst case of heartburn I have ever seen.
1204,2,2,26,30,1.2,0.10057307059414874,565,"So, tell me more about that burning sensation."
1204,2,2,26,30,1.2,0.10057307059414874,565,I'm sorry Mr. Faust. I can't find an escape clause.
1204,1,4,25,30,1.2,0.08840866447369841,565,You don't want to know.
1204,0,6,24,30,1.2,0.07427813527082072,565,I decided to put your EKG on the back burner.
1204,1,4,25,30,1.2,0.08840866447369841,565,It's confirmed...you are a hunk of burning love.
1204,1,4,25,30,1.2,0.08840866447369841,565,This may burn a little at first.
1204,1,4,25,30,1.2,0.08840866447369841,565,I can't read this doctor's handwriting.
1204,0,6,24,30,1.2,0.07427813527082072,565,"Not to worry, second-hand smoke is the least of your problems."
1204,1,4,25,30,1.2,0.08840866447369841,565,Er....You're probably going to want to seek a second opinion.
1204,1,4,25,30,1.2,0.08840866447369841,565,You may experience a slight burning sensation.
1204,0,6,24,30,1.2,0.07427813527082072,565,"Well, you are running a fever."
1204,0,6,24,30,1.2,0.07427813527082072,565,"Unfortunately, the brimstone treatment, alone, did not work."
1204,1,4,25,30,1.2,0.08840866447369841,565,Now let's test your reflexes....
1204,1,4,25,30,1.2,0.08840866447369841,565,It's lit.
1204,2,2,26,30,1.2,0.10057307059414874,565,"According to the Internet, your results are fine."
1204,0,6,24,30,1.2,0.07427813527082072,565,I'll have to prescribe you some anti-inflammatories.
1204,0,6,24,30,1.2,0.07427813527082072,565,This might sting a bit.
1204,1,4,25,30,1.2,0.08840866447369841,565,"In your case, the consulting specialist really is God."
1204,0,6,24,30,1.2,0.07427813527082072,565,"I am burning up your bill, you won't be around long enough to pay it."
1204,1,4,25,30,1.2,0.08840866447369841,565,This is the only proof that I performed your surgery.
1204,0,6,24,30,1.2,0.07427813527082072,565,"Before we can proceed, we have to reduce your most basic human rights to cinders."
1204,1,4,25,30,1.2,0.08840866447369841,565,It says side effects may include spontaneous human combustion.
1204,0,6,24,30,1.2,0.07427813527082072,565,Does your family have a history of spontaneous combustion?
1204,0,6,24,30,1.2,0.07427813527082072,565,"You were right, you do have a burning issue"
1204,2,2,26,30,1.2,0.10057307059414874,565,"Oddly enough, the results aren't great either."
1204,1,4,25,30,1.2,0.08840866447369841,565,"I wouldn't worry. Yesterday, it was my patient who caught fire."
1204,0,6,24,30,1.2,0.07427813527082072,565,"Yes, it is definitively heartburn."
1204,0,6,24,30,1.2,0.07427813527082072,565,"That's some sneeze, Carl"
1204,1,4,25,30,1.2,0.08840866447369841,565,"These are your lab results, Ralph. Do you still want to claim you're only eating at the Jalapeno Hut once a week?"
1204,1,4,25,30,1.2,0.08840866447369841,565,Let's start by minimizing your intake of Spicer briefings.
1204,0,6,24,30,1.2,0.07427813527082072,565,The prognosis is rapid oxidation.
1204,1,4,25,30,1.2,0.08840866447369841,565,"Oh, I thought you said it burned when you read."
1204,0,6,24,30,1.2,0.07427813527082072,565,Your attorney would have wanted to have this.
1204,0,6,24,30,1.2,0.07427813527082072,565,"Shall I sedate you, first?"
1204,1,4,25,30,1.2,0.08840866447369841,565,It must be a hard copy virus.
1204,0,6,24,30,1.2,0.07427813527082072,565,"Your malady, the treatment and this disposal of your records are, of course, not covered by your insurance."
1204,0,6,24,30,1.2,0.07427813527082072,565,Your high blood pressure is really impressive!
1204,1,4,25,30,1.2,0.08840866447369841,565,I'm afraid you've got dragon breath.
1204,1,4,25,30,1.2,0.08840866447369841,565,This way you know your results are confidential.
1204,1,4,25,30,1.2,0.08840866447369841,565,I'd say they found a way to do away with pre-existing conditions.
1204,2,2,26,30,1.2,0.10057307059414874,565,"So, you must be the Referral From Hell"""
1204,1,4,25,30,1.2,0.08840866447369841,565,The inflammation is worse than we thought.
1204,1,4,25,30,1.2,0.08840866447369841,565,"Removing this should cut down on the burning sensation, but I'm still concerned about the rash."
1204,0,6,24,30,1.2,0.07427813527082072,565,These test results are a bad omen
1204,0,6,24,30,1.2,0.07427813527082072,565,We have found a treatment match for your insurance
1204,0,6,24,30,1.2,0.07427813527082072,565,"So, I see you are still smoking..."
1204,1,4,25,30,1.2,0.08840866447369841,565,Describe your jalapeño pepper diet to me again.
1204,0,6,24,30,1.2,0.07427813527082072,565,"Well Mr. Smith, it would appear you weren't completely honest on this questionnaire..."
1204,1,4,25,30,1.2,0.08840866447369841,565,Sorry to say but you have heat vision.
1204,0,6,24,30,1.2,0.07427813527082072,565,"And I would probably cut back on the jaleapenas, too."
1204,2,2,26,30,1.2,0.10057307059414874,565,It's a threat from a rival HMO!
1204,1,4,25,30,1.2,0.08840866447369841,565,Raging fever!
1204,2,2,26,30,1.2,0.10057307059414874,565,Your blood test indicates a high level of chili pepper.
1204,1,4,25,30,1.2,0.08840866447369841,565,As you can see inflammation is a burning issue here.
1204,1,4,25,30,1.2,0.08840866447369841,565,Your health insurance plan is not worth the paper it's printed on.
1204,1,4,25,30,1.2,0.08840866447369841,565,Your chart indicates an unusual degree of inflammation.
1204,0,6,24,30,1.2,0.07427813527082072,565,It's simply our policy to burn the things you don't want to know.
1204,1,4,25,30,1.2,0.08840866447369841,565,They found another way to torch your healthcare.
1204,2,2,26,30,1.2,0.10057307059414874,565,This was outside the door. I'm guessing your fecal sample is in here.
1468,2,2,27,31,1.1935483870967742,0.09748840392811299,565,I have it on file that you're a smoker.
1468,3,0,28,31,1.1935483870967742,0.10795613245600973,565,Your test results are fine. And your doctor's a pyromaniac.
1468,1,4,26,31,1.1935483870967742,0.08575226682742745,565,You might want to cut back on your sriracha sauce consumption.
1468,0,6,25,31,1.1935483870967742,0.07213122508063836,565,There's no testosterone problem
1468,2,2,27,31,1.1935483870967742,0.09748840392811299,565,"Trumpcare, what can I say?"
1473,0,5,23,28,1.1785714285714286,0.07370704611510596,565,You may still be a little radioactive.
1473,0,5,23,28,1.1785714285714286,0.07370704611510596,565,"I did mention that spontaneous combustion was a possible side effect, right?"
1473,0,5,23,28,1.1785714285714286,0.07370704611510596,565,Your tests came back and they are pretty hot!
1473,2,1,25,28,1.1785714285714286,0.10355546310079275,565,Bad decisions ?
1473,1,3,24,28,1.1785714285714286,0.08987898137227081,565,Your arthritis flare-up could be much worse.
1473,1,3,24,28,1.1785714285714286,0.08987898137227081,565,Take two of these a day and call your insurance agent.
1473,1,3,24,28,1.1785714285714286,0.08987898137227081,565,I wasn't sure you would want to see the results.
1473,0,5,23,28,1.1785714285714286,0.07370704611510596,565,I'll call in something stronger for those occasional flare ups.
1473,2,1,25,28,1.1785714285714286,0.10355546310079275,565,"Well, this is the bad news..."
1473,1,3,24,28,1.1785714285714286,0.08987898137227081,565,"Believe me, it's not as bad as it looks."
1473,0,5,23,28,1.1785714285714286,0.07370704611510596,565,Worst case of hemorrhoids I've ever seen!
1473,0,5,23,28,1.1785714285714286,0.07370704611510596,565,"As doctor for the Immposible Mission Force, he finds it hard to keep a medical history on his patients."
1473,1,3,24,28,1.1785714285714286,0.08987898137227081,565,I've got to stop wearing polyester.
1473,0,5,23,28,1.1785714285714286,0.07370704611510596,565,"Yes, and the worst thing about heartburn is that it can spread."
1473,2,1,25,28,1.1785714285714286,0.10355546310079275,565,"Your health insurance company has sent an ""incendiary"" message concerning your medical coverage."
1473,1,3,24,28,1.1785714285714286,0.08987898137227081,565,Cut back on the wings
1473,0,5,23,28,1.1785714285714286,0.07370704611510596,565,Your sriracha levels are high
1473,1,3,24,28,1.1785714285714286,0.08987898137227081,565,You have chartburn.
1473,1,3,24,28,1.1785714285714286,0.08987898137227081,565,No no. Your test battery is normal. It's the tablet's.
1473,0,5,23,28,1.1785714285714286,0.07370704611510596,565,"Unfortunately, it's not just your pants."
1473,0,5,23,28,1.1785714285714286,0.07370704611510596,565,I take it you're not happy with your numbers.
1473,0,5,23,28,1.1785714285714286,0.07370704611510596,565,Don't think the irony between your flare up and the fact that these charts are on fire has eluded me.
1473,1,3,24,28,1.1785714285714286,0.08987898137227081,565,Because it didn't quite feel like a 10 owl day.
1473,1,3,24,28,1.1785714285714286,0.08987898137227081,565,Any other reactions to the treatment besides the pyrokinesis?
1473,2,1,25,28,1.1785714285714286,0.10355546310079275,565,Looks like some sort of inflammatory response.
1473,2,1,25,28,1.1785714285714286,0.10355546310079275,565,Tell me about your urinary symptoms.
1473,1,3,24,28,1.1785714285714286,0.08987898137227081,565,FDA approval is imminent.
1473,1,3,24,28,1.1785714285714286,0.08987898137227081,565,You have a severe case of inflammation that is extremely contagious.
1473,1,3,24,28,1.1785714285714286,0.08987898137227081,565,That burning sensation is contagious.
1473,2,1,25,28,1.1785714285714286,0.10355546310079275,565,"Not to worry, it's just a flaming case of jock itch."
1473,1,3,24,28,1.1785714285714286,0.08987898137227081,565,New corporate policy. I need to read your lab results in 5 seconds or less.
1473,1,3,24,28,1.1785714285714286,0.08987898137227081,565,i'm afraid it's not just heartburn.
1473,2,1,25,28,1.1785714285714286,0.10355546310079275,565,Your blood pressure is a tad high.
1473,1,3,24,28,1.1785714285714286,0.08987898137227081,565,"""Unfortunately, Mr. Bradbury, your dystopian view of the future may be valid""."
1473,1,3,24,28,1.1785714285714286,0.08987898137227081,565,"Not to worry Mr Phillips, it is just a bad case of heartburn."
1473,1,3,24,28,1.1785714285714286,0.08987898137227081,565,"Good news, you still have some time. Bad news, we know where you'll go."
1473,1,3,24,28,1.1785714285714286,0.08987898137227081,565,You might want to rethink the amount of Habanero in your diet.
1473,2,1,25,28,1.1785714285714286,0.10355546310079275,565,You have a HELL of a case of gonorrhea.
1473,0,5,23,28,1.1785714285714286,0.07370704611510596,565,So I see you've been experiencing some discomfort.
1473,0,5,23,28,1.1785714285714286,0.07370704611510596,565,"Medically speaking, this is where your health is going!"
1473,1,3,24,28,1.1785714285714286,0.08987898137227081,565,"We might as well sing ""Happy Birthday"" now because you aren't going to sing it later!"
1473,2,1,25,28,1.1785714285714286,0.10355546310079275,565,"When did you quit smoking, a minute ago?"
1473,1,3,24,28,1.1785714285714286,0.08987898137227081,565,Cut down on the Siracha!
1473,2,1,25,28,1.1785714285714286,0.10355546310079275,565,You have the first case of Brimstone we've ever seen.
1473,1,3,24,28,1.1785714285714286,0.08987898137227081,565,The government confidentiality laws are becoming a bit excessive..
1473,1,3,24,28,1.1785714285714286,0.08987898137227081,565,I'm sure it's nothing to worry about.
1473,1,3,24,28,1.1785714285714286,0.08987898137227081,565,"Well, if the new health care plan does away with pre-existing conditions, perhaps then you won't think it so odd that we used flash paper to write your diagnosis."
1473,2,1,25,28,1.1785714285714286,0.10355546310079275,565,Let's get started
1473,1,3,24,28,1.1785714285714286,0.08987898137227081,565,Simply put there is no good news
1473,1,3,24,28,1.1785714285714286,0.08987898137227081,565,Let’s talk about your blood pressure and cholesterol.
1473,0,5,23,28,1.1785714285714286,0.07370704611510596,565,The lab results show some inflammation...
1473,0,5,23,28,1.1785714285714286,0.07370704611510596,565,Your fever seems to be worsening.
1473,0,5,23,28,1.1785714285714286,0.07370704611510596,565,"You're fine, Mr. Jones. I just need something to submit to insurance."
1473,0,5,23,28,1.1785714285714286,0.07370704611510596,565,I see you have been through a few doctors.
1473,0,5,23,28,1.1785714285714286,0.07370704611510596,565,Your medical records are private in this office.
1473,1,3,24,28,1.1785714285714286,0.08987898137227081,565,I'm only going to tell you once.
1473,1,3,24,28,1.1785714285714286,0.08987898137227081,565,I thought only Samsung phones spontaneously combusted.
1473,1,3,24,28,1.1785714285714286,0.08987898137227081,565,"So let me be sure, all you are eating are corndogs with tabasco?"
1473,1,3,24,28,1.1785714285714286,0.08987898137227081,565,We've got to get your fever down - stat!
1473,1,3,24,28,1.1785714285714286,0.08987898137227081,565,Evidence!
1473,0,5,23,28,1.1785714285714286,0.07370704611510596,565,I see you're a smoker.
1473,0,5,23,28,1.1785714285714286,0.07370704611510596,565,Your inflammation level is elevated.
1473,0,5,23,28,1.1785714285714286,0.07370704611510596,565,It looks worse than it is.
1473,1,3,24,28,1.1785714285714286,0.08987898137227081,565,"Well, your results came back and your heartburn really is off the charts."
1473,0,5,23,28,1.1785714285714286,0.07370704611510596,565,Apparently it is not a cold after all.
1473,1,3,24,28,1.1785714285714286,0.08987898137227081,565,"According to this, it's just a simple case of heart burn."
1473,1,3,24,28,1.1785714285714286,0.08987898137227081,565,I'm afraid that you may have pyromania by proxy
1473,0,5,23,28,1.1785714285714286,0.07370704611510596,565,We're preparing to go paperless.
1473,0,5,23,28,1.1785714285714286,0.07370704611510596,565,Your test results show that you have a very bad case of heart burn.
1473,0,5,23,28,1.1785714285714286,0.07370704611510596,565,"Your self-destructing medical charts are not helpful, Mr. Hunt."
1473,0,5,23,28,1.1785714285714286,0.07370704611510596,565,No more Habanero peppers for you.
1473,1,3,24,28,1.1785714285714286,0.08987898137227081,565,"As we expected, it's textually transmitted."
1473,2,1,25,28,1.1785714285714286,0.10355546310079275,565,The test result shows your appendix is very inflamed.
1473,1,3,24,28,1.1785714285714286,0.08987898137227081,565,Which do you want first? The good news or the bad news
1473,1,3,24,28,1.1785714285714286,0.08987898137227081,565,I see the inflammation hasn't subsided.
1473,1,3,24,28,1.1785714285714286,0.08987898137227081,565,"So, it's contagious?"
1473,1,3,24,28,1.1785714285714286,0.08987898137227081,565,Looks like we both need to call our insurance companies.
1473,1,3,24,28,1.1785714285714286,0.08987898137227081,565,"Thanks for the $10,000; no more pre-existing condition."
1473,0,5,23,28,1.1785714285714286,0.07370704611510596,565,"You diagnoses, if you choose to accept it..."
1473,0,5,23,28,1.1785714285714286,0.07370704611510596,565,This is pretty much what's happening in your lungs
1473,2,1,25,28,1.1785714285714286,0.10355546310079275,565,I thought I ought to show you what a bleeding ulcer looks like.
1473,0,5,23,28,1.1785714285714286,0.07370704611510596,565,And the X-rays are even worse.
1473,0,5,23,28,1.1785714285714286,0.07370704611510596,565,Your medical record shows severe inflammation.
1473,1,3,24,28,1.1785714285714286,0.08987898137227081,565,You want the good news first?
1473,0,5,23,28,1.1785714285714286,0.07370704611510596,565,Bad news on your heartburn problem!
1473,0,5,23,28,1.1785714285714286,0.07370704611510596,565,Have you recently been exposed to oxygen?
1473,1,3,24,28,1.1785714285714286,0.08987898137227081,565,You have what Mankoff has.
1473,0,5,23,28,1.1785714285714286,0.07370704611510596,565,"Pyromania is a treatable condition, but your case is a bit challenging"
1473,1,3,24,28,1.1785714285714286,0.08987898137227081,565,Told you it burns.
1473,0,5,23,28,1.1785714285714286,0.07370704611510596,565,I'd like a second opinion.
1473,1,3,24,28,1.1785714285714286,0.08987898137227081,565,Physician assisted suicides aren’t my thing but here’s a hot sauce recipe you might like.
1473,0,5,23,28,1.1785714285714286,0.07370704611510596,565,"This may be why selling your soul to the Devil has not been ""FDA-approved""."
1473,1,3,24,28,1.1785714285714286,0.08987898137227081,565,"Believe me, you didn't want to see this."
1473,1,3,24,28,1.1785714285714286,0.08987898137227081,565,I thought you said you never smoked.
1473,0,5,23,28,1.1785714285714286,0.07370704611510596,565,Is there something you forgot to tell me?
1473,1,3,24,28,1.1785714285714286,0.08987898137227081,565,I've never seen chartburn this bad.
1473,2,1,25,28,1.1785714285714286,0.10355546310079275,565,"Look, I didn't vote for him either."
1473,1,3,24,28,1.1785714285714286,0.08987898137227081,565,It IS a non-affordable disease
1473,1,3,24,28,1.1785714285714286,0.08987898137227081,565,"On the plus side, you don't have to worry about paying off your student loans."
1473,0,5,23,28,1.1785714285714286,0.07370704611510596,565,"Your test result has come back, do you have a family history of inflammation?"
1473,1,3,24,28,1.1785714285714286,0.08987898137227081,565,You said it feels like a fire is in your stomach.
1473,1,3,24,28,1.1785714285714286,0.08987898137227081,565,You do have the flu from hell.
1473,1,3,24,28,1.1785714285714286,0.08987898137227081,565,It's our new firewall to protect patient information.
1473,0,5,23,28,1.1785714285714286,0.07370704611510596,565,"Yes, well it appears that your hemorrhoids are even worse than originally diagnosed."
1473,0,5,23,28,1.1785714285714286,0.07370704611510596,565,Why don't we start by taking your temperature?
1473,0,5,23,28,1.1785714285714286,0.07370704611510596,565,"Keep doing whatever you're doing, Mr. Morris. Your lab results are on fire!"
1473,1,3,24,28,1.1785714285714286,0.08987898137227081,565,"Well, your thermography report looks good."
1473,0,5,23,28,1.1785714285714286,0.07370704611510596,565,I suggest you under go exorcism.
1473,1,3,24,28,1.1785714285714286,0.08987898137227081,565,It's definitely heartburn.
1473,1,3,24,28,1.1785714285714286,0.08987898137227081,565,"Rather touchy about my request to give up cigarettes, aren't we?"
1473,0,5,23,28,1.1785714285714286,0.07370704611510596,565,Are you sure there's nothing else you want to tell about that trip to Bangkok?
1473,0,5,23,28,1.1785714285714286,0.07370704611510596,565,"All I said was that you could lose a few pounds, Superman."
1473,2,1,25,28,1.1785714285714286,0.10355546310079275,565,I'm afraid you're going straight to hell.
1473,1,3,24,28,1.1785714285714286,0.08987898137227081,565,Quit smoking!
1473,0,5,23,28,1.1785714285714286,0.07370704611510596,565,What exactly did you 'sell' to have such good health insurance?
1473,2,1,25,28,1.1785714285714286,0.10355546310079275,565,I've never seen anything like this before.
1473,1,3,24,28,1.1785714285714286,0.08987898137227081,565,The new federally mandated record retention system still needs a little tweaking.
1473,1,3,24,28,1.1785714285714286,0.08987898137227081,565,Then this is what will happen to your body.
1473,1,3,24,28,1.1785714285714286,0.08987898137227081,565,I think you might have some sort of inflammation.
1473,1,3,24,28,1.1785714285714286,0.08987898137227081,565,I'm sorry. This happens every time I listen to The Doors.
1473,0,5,23,28,1.1785714285714286,0.07370704611510596,565,Your test results say your health is going to hell
1473,1,3,24,28,1.1785714285714286,0.08987898137227081,565,Your medical records are switching over to digital .
1473,0,5,23,28,1.1785714285714286,0.07370704611510596,565,Your chart indicates chronic heartburn.
1473,1,3,24,28,1.1785714285714286,0.08987898137227081,565,Your burning sensation...I'm afraid it may be contagious.
1473,1,3,24,28,1.1785714285714286,0.08987898137227081,565,Would it be fair to describe it as a burning sensation?
1473,0,5,23,28,1.1785714285714286,0.07370704611510596,565,You should expect some inflammation.
1473,0,5,23,28,1.1785714285714286,0.07370704611510596,565,I take it you disagree with this report debunking your claim of pyrokinesis.
1473,1,3,24,28,1.1785714285714286,0.08987898137227081,565,It's pretty clear you've been going to hell with yourself.
1473,0,5,23,28,1.1785714285714286,0.07370704611510596,565,Our office is going paperless.
1473,0,5,23,28,1.1785714285714286,0.07370704611510596,565,It only hurts when you reach for your credit card.
1473,1,3,24,28,1.1785714285714286,0.08987898137227081,565,I'm telling you to stop smoking.
1473,0,5,23,28,1.1785714285714286,0.07370704611510596,565,"This office doesn't treat anyone without insurance, but I'll offer up your lab report as a sacrifice to the gods, and we'll see if they step in."
1473,0,5,23,28,1.1785714285714286,0.07370704611510596,565,It's the last step in our conversion to electronic medical records.
1473,0,5,23,28,1.1785714285714286,0.07370704611510596,565,Your insurance company is trying to tell you something.
1473,0,5,23,28,1.1785714285714286,0.07370704611510596,565,So first let's symbolically burn your list of pre-existing conditions...
1473,1,3,24,28,1.1785714285714286,0.08987898137227081,565,I'm tripping so hard right now…
1473,0,5,23,28,1.1785714285714286,0.07370704611510596,565,Oy Vey!
1473,2,1,25,28,1.1785714285714286,0.10355546310079275,565,"Yes, yes. A most interesting presentation, but don't say 'Ah' again."
1473,0,5,23,28,1.1785714285714286,0.07370704611510596,565,"After the lab technician took your blood, did he ask you to sign anything?"
1473,1,3,24,28,1.1785714285714286,0.08987898137227081,565,"This is part of our ""what you don't know can't hurt you"" policy."
1473,0,5,23,28,1.1785714285714286,0.07370704611510596,565,It's required by the patient privacy act. We have to burn your test results right after we read them to you.
1473,1,3,24,28,1.1785714285714286,0.08987898137227081,565,It's a really bad case of heartburn. I need to refer you to an exorcist.
1473,0,5,23,28,1.1785714285714286,0.07370704611510596,565,We just learned your insurance won't cover this procedure!
1473,1,3,24,28,1.1785714285714286,0.08987898137227081,565,"In my defense, Alfonse, heart-burn doesn't usually flare up like this."
1473,1,3,24,28,1.1785714285714286,0.08987898137227081,565,"You have ""hottie"" vitals"
1473,1,3,24,28,1.1785714285714286,0.08987898137227081,565,Let's discuss you alcohol consumption.
1473,0,5,23,28,1.1785714285714286,0.07370704611510596,565,"""You may find this a little painful""."
1473,1,3,24,28,1.1785714285714286,0.08987898137227081,565,Your acid reflux test came back abnormally high
1473,2,1,25,28,1.1785714285714286,0.10355546310079275,565,Your X-ray vision is fine. Do you still feel more powerful than a locomotive?
1473,0,5,23,28,1.1785714285714286,0.07370704611510596,565,Sorry. The Freedom Caucus added this provision.
1473,2,1,25,28,1.1785714285714286,0.10355546310079275,565,It's because of a new HIPAA privacy requirement. Just sign it quickly.
1473,0,5,23,28,1.1785714285714286,0.07370704611510596,565,"Its about my smoking, right?"
1473,0,5,23,28,1.1785714285714286,0.07370704611510596,565,Good news first then?
1473,2,1,25,28,1.1785714285714286,0.10355546310079275,565,This medication may cause some inflammation.
1473,0,5,23,28,1.1785714285714286,0.07370704611510596,565,You might have some inflammation.
1473,1,3,24,28,1.1785714285714286,0.08987898137227081,565,"In addition to the burning and itching symptoms, it also appears to be contagious."
1473,2,1,25,28,1.1785714285714286,0.10355546310079275,565,"As you can see, the diagnosis is not good."
1473,1,3,24,28,1.1785714285714286,0.08987898137227081,565,You need to lay off the spicy food.
1473,2,1,25,28,1.1785714285714286,0.10355546310079275,565,"Hmmm, I've heard of this side effect, but this is the first time I've seen it."
1473,0,5,23,28,1.1785714285714286,0.07370704611510596,565,This is the only way to keep your records private.
1473,0,5,23,28,1.1785714285714286,0.07370704611510596,565,Go figure. I'm also having a burning sensation.
1473,0,5,23,28,1.1785714285714286,0.07370704611510596,565,Side effects may include pyromania.
1473,1,3,24,28,1.1785714285714286,0.08987898137227081,565,"I think you've mixed up your appointments James, this is your yearly physical results not your mission impossible."
1473,1,3,24,28,1.1785714285714286,0.08987898137227081,565,In my professional opinion you need to leave.
1473,1,3,24,28,1.1785714285714286,0.08987898137227081,565,"As we suspected, you definitely were attacked by fire ants."
1473,0,5,23,28,1.1785714285714286,0.07370704611510596,565,"Ummm....well, it isn't good news."
1473,0,5,23,28,1.1785714285714286,0.07370704611510596,565,This should help clear your sinuses.
1473,1,3,24,28,1.1785714285714286,0.08987898137227081,565,You're probably going to want a second opinion.
1473,1,3,24,28,1.1785714285714286,0.08987898137227081,565,Nothing matters.
1473,0,5,23,28,1.1785714285714286,0.07370704611510596,565,This is not a good sign.
1473,0,5,23,28,1.1785714285714286,0.07370704611510596,565,This is the lab's cute way of saying that your hemorrhoids are inflamed.
1473,1,3,24,28,1.1785714285714286,0.08987898137227081,565,This is why doctors hesitate to prescribe pyrokenisis medication.
1473,1,3,24,28,1.1785714285714286,0.08987898137227081,565,...and this is your stomach on Mexican food
1473,0,5,23,28,1.1785714285714286,0.07370704611510596,565,The test results show a touch of inflammation.
1473,2,1,25,28,1.1785714285714286,0.10355546310079275,565,Oooh...heartburn! I thought you said chart burn.
1473,1,3,24,28,1.1785714285714286,0.08987898137227081,565,OK I won't document your powers as pre-existing.
1473,0,5,23,28,1.1785714285714286,0.07370704611510596,565,This can't be good.
1473,1,3,24,28,1.1785714285714286,0.08987898137227081,565,"Yes, that correctly describes the burning."
1473,1,3,24,28,1.1785714285714286,0.08987898137227081,565,We're demo-ing a new pilot program to better insure the confidentiality of patient records.
1473,0,5,23,28,1.1785714285714286,0.07370704611510596,565,This medication may have some unusual side-effects.
1473,2,1,25,28,1.1785714285714286,0.10355546310079275,565,You're going to die and go to hell.
1473,0,5,23,28,1.1785714285714286,0.07370704611510596,565,Do you want the good news or the bad news?
1473,0,5,23,28,1.1785714285714286,0.07370704611510596,565,"Would you like to revise your answer to the exercise frequency question, Mr. Blenkinsop?"
1473,2,1,25,28,1.1785714285714286,0.10355546310079275,565,This is our new firewall.
1473,0,5,23,28,1.1785714285714286,0.07370704611510596,565,'Ashes to ashes' ... if you catch my drift.
1473,0,5,23,28,1.1785714285714286,0.07370704611510596,565,We have a donor match for your inflamed liver
1473,0,5,23,28,1.1785714285714286,0.07370704611510596,565,The new president is reflaming the debate about healthcare.
1473,1,3,24,28,1.1785714285714286,0.08987898137227081,565,No I don't give a hoot - but I can sell you one.
1473,2,1,25,28,1.1785714285714286,0.10355546310079275,565,"Blood pressure ok, pulse normal, but your body temperature is really high!"
1473,1,3,24,28,1.1785714285714286,0.08987898137227081,565,"The good news is, there's an ointment for this."
1473,1,3,24,28,1.1785714285714286,0.08987898137227081,565,"You have supplemental insurance, right?"
1473,0,5,23,28,1.1785714285714286,0.07370704611510596,565,I'm going to prescribe an anti-inflammatory.
1473,0,5,23,28,1.1785714285714286,0.07370704611510596,565,It seems that your insurance won't cover it
1473,1,3,24,28,1.1785714285714286,0.08987898137227081,565,We use this to burn the hemorrhoids off your tuches.
1473,1,3,24,28,1.1785714285714286,0.08987898137227081,565,These are your lungs on cigarettes.
1473,2,1,25,28,1.1785714285714286,0.10355546310079275,565,It's Trump's new plan to end Obamacare.
1473,1,3,24,28,1.1785714285714286,0.08987898137227081,565,Any history of pyromania in the family?
1473,0,5,23,28,1.1785714285714286,0.07370704611510596,565,I know we're supposed to go paperless but this is ridiculous.
1473,1,3,24,28,1.1785714285714286,0.08987898137227081,565,So you have chronic heartburn?
1473,1,3,24,28,1.1785714285714286,0.08987898137227081,565,About your blood alcohol level Mr. Smith.
1473,0,5,23,28,1.1785714285714286,0.07370704611510596,565,Worst case of heartburn in the I have ever seen.
1473,1,3,24,28,1.1785714285714286,0.08987898137227081,565,"Well, we've got the answer to your burning questions."
1473,0,5,23,28,1.1785714285714286,0.07370704611510596,565,Remember when a doctor visit meant you received the diagnosis before the bill?
1473,0,5,23,28,1.1785714285714286,0.07370704611510596,565,I'm afraid the billing office has declined your request for a fee reduction.
1473,1,3,24,28,1.1785714285714286,0.08987898137227081,565,Time to cut down on the hot sauce.
1473,0,5,23,28,1.1785714285714286,0.07370704611510596,565,"With you, we surely gotta watch for inflammation."
1473,1,3,24,28,1.1785714285714286,0.08987898137227081,565,"No, only if you show signs of flare vision."
1473,1,3,24,28,1.1785714285714286,0.08987898137227081,565,Would you describe it as a burning sensation?
1473,0,5,23,28,1.1785714285714286,0.07370704611510596,565,"As you can see, your hemorrhoids have not improved."
1473,2,1,25,28,1.1785714285714286,0.10355546310079275,565,Our practice uses the latest in Promethean technology to safeguard patients' medical records.
1473,0,5,23,28,1.1785714285714286,0.07370704611510596,565,Do you happen to be on ObamaCare?
1473,0,5,23,28,1.1785714285714286,0.07370704611510596,565,Looks like you've got inflammation.
1473,1,3,24,28,1.1785714285714286,0.08987898137227081,565,It is part of the revised version of the paperwork reduction act. There are still some bugs to work out but it insures your privacy!
1473,2,1,25,28,1.1785714285714286,0.10355546310079275,565,You're going to have to reduce your jalapeno intake.
1473,1,3,24,28,1.1785714285714286,0.08987898137227081,565,It's better this way.
1473,1,3,24,28,1.1785714285714286,0.08987898137227081,565,I'm afraid you have brimstones.
1473,1,3,24,28,1.1785714285714286,0.08987898137227081,565,"No, your test is fine. I moonlight as a magician."
1473,1,3,24,28,1.1785714285714286,0.08987898137227081,565,"Sure, I understand. A second opinion may be helpful."
1473,1,3,24,28,1.1785714285714286,0.08987898137227081,565,Your fever is quite contagious!
1473,1,3,24,28,1.1785714285714286,0.08987898137227081,565,"Where there's fire, I see a smoker."
1473,1,3,24,28,1.1785714285714286,0.08987898137227081,565,You have something that deserves the very highest standard of confidentiality.
1473,1,3,24,28,1.1785714285714286,0.08987898137227081,565,You are what you are.
1473,1,3,24,28,1.1785714285714286,0.08987898137227081,565,New confidentiality rules. These reports self-destruct in 60 seconds.
1473,1,3,24,28,1.1785714285714286,0.08987898137227081,565,"Your disease, should you choose to accept it..."
1473,0,5,23,28,1.1785714285714286,0.07370704611510596,565,"Don't worry, our medical record firewall is now HIPAA compliant."
1473,0,5,23,28,1.1785714285714286,0.07370704611510596,565,I took an oath to do no harm. The way I see it I'll be breaking it twice if I hand you this bill.
1473,0,5,23,28,1.1785714285714286,0.07370704611510596,565,Have you heard of a shredder??
1473,0,5,23,28,1.1785714285714286,0.07370704611510596,565,Your insurer says they decline coverage.
1473,2,1,25,28,1.1785714285714286,0.10355546310079275,565,It would be best if you never saw this list of Don'ts.
1473,1,3,24,28,1.1785714285714286,0.08987898137227081,565,Ever see this trick before?
1473,0,5,23,28,1.1785714285714286,0.07370704611510596,565,Second opinion?
1473,1,3,24,28,1.1785714285714286,0.08987898137227081,565,"From what I can read, it says 'don't ever eat your wife's jalapeño nachos again.'"
1473,0,5,23,28,1.1785714285714286,0.07370704611510596,565,The Pyrokinesis is definitely back. Have you been reading Stephen King again?
1473,1,3,24,28,1.1785714285714286,0.08987898137227081,565,I didn't think the health care bill was going to LITERALLY self-destruct.
1473,0,5,23,28,1.1785714285714286,0.07370704611510596,565,Are you CIA?
1473,1,3,24,28,1.1785714285714286,0.08987898137227081,565,"Sorry, but this won't change the diagnosis."
1473,1,3,24,28,1.1785714285714286,0.08987898137227081,565,This is the worst case of heart burn we've had on record!
1473,1,3,24,28,1.1785714285714286,0.08987898137227081,565,This type of flatulence requires an experimental treatment.
1473,0,5,23,28,1.1785714285714286,0.07370704611510596,565,It seems all your health issues are related to inflammation.
1473,0,5,23,28,1.1785714285714286,0.07370704611510596,565,Do you have any other form of insurance?
1473,0,5,23,28,1.1785714285714286,0.07370704611510596,565,Would you like a second opinion?
1473,1,3,24,28,1.1785714285714286,0.08987898137227081,565,Here is the answer to your burning question
1473,1,3,24,28,1.1785714285714286,0.08987898137227081,565,Oops! I need to do another round of tests.
1473,0,5,23,28,1.1785714285714286,0.07370704611510596,565,I have some late-breaking news on your hemmorhoids.
1473,0,5,23,28,1.1785714285714286,0.07370704611510596,565,Amazing! It really is exploding.
1473,0,5,23,28,1.1785714285714286,0.07370704611510596,565,I just have one burning question.
1473,0,5,23,28,1.1785714285714286,0.07370704611510596,565,The good news is you can use your Health Savings Account
1473,0,5,23,28,1.1785714285714286,0.07370704611510596,565,You seem to have an extreme case of hot flashes.
1473,0,5,23,28,1.1785714285714286,0.07370704611510596,565,Pay your bill or we put this back in.
1473,0,5,23,28,1.1785714285714286,0.07370704611510596,565,One of your inflammatory markers is elevated.
1473,0,5,23,28,1.1785714285714286,0.07370704611510596,565,I think we can rule out a cold
1473,1,3,24,28,1.1785714285714286,0.08987898137227081,565,It all has to do with that law on not releasing patients information.
1473,1,3,24,28,1.1785714285714286,0.08987898137227081,565,They must have just repealed Obamacare!
1473,1,3,24,28,1.1785714285714286,0.08987898137227081,565,I have good news and bad news. The good news is we received your test results....
1473,1,3,24,28,1.1785714285714286,0.08987898137227081,565,"Under the new healthcare plan, X-rays are not covered. Just stand close to the flame."
1473,1,3,24,28,1.1785714285714286,0.08987898137227081,565,The good news is you won't have to worry about how you'll pay your bill.
1473,2,1,25,28,1.1785714285714286,0.10355546310079275,565,"Judging by the results of your tests, I can tell... you touched this piece of paper before I walked in the room."
1473,2,1,25,28,1.1785714285714286,0.10355546310079275,565,See what I did there? Smoking? Bad for you? No?
1473,1,3,24,28,1.1785714285714286,0.08987898137227081,565,"So, is the burning on urination or just when you fill out insurance?"
1473,2,1,25,28,1.1785714285714286,0.10355546310079275,565,Reviewing your sexual history I can only recommend a condoms from now on.
1473,0,5,23,28,1.1785714285714286,0.07370704611510596,565,Don't be alarmed
1473,2,1,25,28,1.1785714285714286,0.10355546310079275,565,"'Your new and improved insurance compels me to demonstrate your odds of surviving this surgery given that post-op is no longer covered, nor is anesthesia, or well, nothing really but the incision.'"
1473,0,5,23,28,1.1785714285714286,0.07370704611510596,565,Your mother is right. You ARE the son of the Devil.
1473,1,3,24,28,1.1785714285714286,0.08987898137227081,565,"Do you want the good news, first, or the bad news?"
1473,1,3,24,28,1.1785714285714286,0.08987898137227081,565,"Well, that would explain the burning sensation."
1473,0,5,23,28,1.1785714285714286,0.07370704611510596,565,"After reviewing your chart, it could be heartburn but my guess is flaming hemorrhoids"
1473,1,3,24,28,1.1785714285714286,0.08987898137227081,565,Looks like your inflammation is becoming acute.
1473,0,5,23,28,1.1785714285714286,0.07370704611510596,565,It's acid reflux. And apparently contagious.
1473,0,5,23,28,1.1785714285714286,0.07370704611510596,565,"The prognosis, although quite preliminary is a bit inflammatory."
1473,1,3,24,28,1.1785714285714286,0.08987898137227081,565,"Apologies, but our malpractice insurance provider has requested that we burn all medical records immediately after use"
1473,0,5,23,28,1.1785714285714286,0.07370704611510596,565,The results are back and you're burning up
1473,0,5,23,28,1.1785714285714286,0.07370704611510596,565,"You don't need a second opinion, unless it's from a priest."
1473,1,3,24,28,1.1785714285714286,0.08987898137227081,565,This is the only change to Obamacare that Republicans could agree on.
1473,1,3,24,28,1.1785714285714286,0.08987898137227081,565,Which do you want first - the bad news or the really bad news?
1473,2,1,25,28,1.1785714285714286,0.10355546310079275,565,Results are not yet final but it appears to be some kind of inflammation.
1473,0,5,23,28,1.1785714285714286,0.07370704611510596,565,"These test results do indeed, confirm your ""burning sensation""."
1473,1,3,24,28,1.1785714285714286,0.08987898137227081,565,It's a HIPPA thing...
1473,0,5,23,28,1.1785714285714286,0.07370704611510596,565,Feel the burn?
1473,2,1,25,28,1.1785714285714286,0.10355546310079275,565,Your test results confirm you have heartburn.
1473,1,3,24,28,1.1785714285714286,0.08987898137227081,565,Worse case of heartburn I've seen in a while.
1473,1,3,24,28,1.1785714285714286,0.08987898137227081,565,We take HIPAA very seriously.
1473,1,3,24,28,1.1785714285714286,0.08987898137227081,565,An anti-inflammatory should help with your numbers.
1473,2,1,25,28,1.1785714285714286,0.10355546310079275,565,The results indicate a flare up of your inflammatory bowel disease.
1473,0,5,23,28,1.1785714285714286,0.07370704611510596,565,"Here are your lab results, you have heat stroke."
1473,0,5,23,28,1.1785714285714286,0.07370704611510596,565,"Well, I have some good news and bad news."
1473,1,3,24,28,1.1785714285714286,0.08987898137227081,565,"I agree with you, this administration has taken inflammatory language to a whole new level."
1473,0,5,23,28,1.1785714285714286,0.07370704611510596,565,Call me old school if you wish Dan. I still don't trust that darn delete key.
1473,2,1,25,28,1.1785714285714286,0.10355546310079275,565,Now don't be alarmed. Just make sure you pay in cash before leaving the office.
1473,0,5,23,28,1.1785714285714286,0.07370704611510596,565,That’s weird! I’m experiencing a burning sensation too!
1473,0,5,23,28,1.1785714285714286,0.07370704611510596,565,Our voodoo Doctor suggested this.
1473,1,3,24,28,1.1785714285714286,0.08987898137227081,565,Let me consult this copy of the American Health Care Act I pulled from the dumpster fire out back.
1473,1,3,24,28,1.1785714285714286,0.08987898137227081,565,This is our new encryption method.
1473,2,1,25,28,1.1785714285714286,0.10355546310079275,565,"As of now, you have no pre-existing conditions."
1473,0,5,23,28,1.1785714285714286,0.07370704611510596,565,Are you firing me as your doctor?
1473,1,3,24,28,1.1785714285714286,0.08987898137227081,565,I am sorry! Our paper document system is on the fritz today.
1473,0,5,23,28,1.1785714285714286,0.07370704611510596,565,"No, no... the REALLY bad news is quietly slipped under the door while you're tying your shoes."
1473,1,3,24,28,1.1785714285714286,0.08987898137227081,565,"Gosh, they really are getting serious about the electronic health record implementation."
1473,0,5,23,28,1.1785714285714286,0.07370704611510596,565,"Well, the good news is I can no longer give you the bad news."
1473,0,5,23,28,1.1785714285714286,0.07370704611510596,565,It's the worst case of acid indigestion that we've ever seen!
1473,1,3,24,28,1.1785714285714286,0.08987898137227081,565,Highly contagious! Why do you ask?
1473,0,5,23,28,1.1785714285714286,0.07370704611510596,565,There are a few minor side effects..
1473,1,3,24,28,1.1785714285714286,0.08987898137227081,565,"Mr. Phelps, the test results show that you will self-destruct in 15 seconds."
1473,1,3,24,28,1.1785714285714286,0.08987898137227081,565,We don't anticipate any problems unless you want to get better.
1473,1,3,24,28,1.1785714285714286,0.08987898137227081,565,Your test results definitely show some inflammation.
1473,1,3,24,28,1.1785714285714286,0.08987898137227081,565,"Now, about your hemorrhoids..."
1473,1,3,24,28,1.1785714285714286,0.08987898137227081,565,If I tell you I will have to kill you.
1473,1,3,24,28,1.1785714285714286,0.08987898137227081,565,Yes it's the new privacy protocol
1473,1,3,24,28,1.1785714285714286,0.08987898137227081,565,Ordinarily this wouldn't look promising...
1473,1,3,24,28,1.1785714285714286,0.08987898137227081,565,Looks like your lab test came back with its pants on fire.
1473,2,1,25,28,1.1785714285714286,0.10355546310079275,565,"Not only are you transgender, but in menopause."
1473,0,5,23,28,1.1785714285714286,0.07370704611510596,565,I see you have a history of smoking.
1473,1,3,24,28,1.1785714285714286,0.08987898137227081,565,"We're HIPPA compliant, but not OSHA."
1473,1,3,24,28,1.1785714285714286,0.08987898137227081,565,This is your lungs. This is smoking. This is your lungs when you smoke. Any questions?
1473,0,5,23,28,1.1785714285714286,0.07370704611510596,565,This is the new HIPAA firewall.
1473,0,5,23,28,1.1785714285714286,0.07370704611510596,565,"No, these results suggest that the six-months-to-live thing is the least of your worries."
1473,1,3,24,28,1.1785714285714286,0.08987898137227081,565,Good news. No water retention. Come back For another visit if you want us to run some more tests.
1473,1,3,24,28,1.1785714285714286,0.08987898137227081,565,"The Infertility Lab is returning your sperm sample, and they strongly recommend, you should never reproduce."
1473,1,3,24,28,1.1785714285714286,0.08987898137227081,565,Well your urine sample explains that burning sensation!
1473,2,1,25,28,1.1785714285714286,0.10355546310079275,565,"As you can see, it's quite inflamed."
1473,0,5,23,28,1.1785714285714286,0.07370704611510596,565,What did you say about burning calories?
1473,0,5,23,28,1.1785714285714286,0.07370704611510596,565,I think I found the cause of that burning sensation you described.
1473,0,5,23,28,1.1785714285714286,0.07370704611510596,565,I didn't want to catch what you've got.
1473,1,3,24,28,1.1785714285714286,0.08987898137227081,565,The report says 'in flames' but I think should read 'inflamed.'
1473,1,3,24,28,1.1785714285714286,0.08987898137227081,565,Ooops! Obamacare was just repealed.
1473,1,3,24,28,1.1785714285714286,0.08987898137227081,565,My test shows you have the worst case of heartburn I've ever seen
1473,0,5,23,28,1.1785714285714286,0.07370704611510596,565,Your tests are back. Apparently you have heartburn.
1473,2,1,25,28,1.1785714285714286,0.10355546310079275,565,That orgy must have been fantastic!
1473,2,1,25,28,1.1785714285714286,0.10355546310079275,565,Was she hot?
1473,1,3,24,28,1.1785714285714286,0.08987898137227081,565,"Wow, the nurse wasn't kidding about that fever."
1473,0,5,23,28,1.1785714285714286,0.07370704611510596,565,I see your records show a history of inflammation.
1473,2,1,25,28,1.1785714285714286,0.10355546310079275,565,It says your fever is running a little hot.
1473,0,5,23,28,1.1785714285714286,0.07370704611510596,565,"Your urine test was really, really positive."
1473,1,3,24,28,1.1785714285714286,0.08987898137227081,565,It seems both your tests and the state of healthcare show signs of inflammation.
1473,0,5,23,28,1.1785714285714286,0.07370704611510596,565,You may feel a burning sensation.
1473,0,5,23,28,1.1785714285714286,0.07370704611510596,565,"I really do appreciate all this internet research you did about your condition."""
1473,1,3,24,28,1.1785714285714286,0.08987898137227081,565,I'm afraid we have a burning issue.
1473,0,5,23,28,1.1785714285714286,0.07370704611510596,565,This is the worst case of inflammation I've ever seen.
1473,1,3,24,28,1.1785714285714286,0.08987898137227081,565,And how long have you been experiencing this burning sensation?
1473,1,3,24,28,1.1785714285714286,0.08987898137227081,565,The test results of your afterlife screening may be cause for concern.
1473,1,3,24,28,1.1785714285714286,0.08987898137227081,565,Don't ask don't tell
1473,0,5,23,28,1.1785714285714286,0.07370704611510596,565,I'm afraid you have a scorching case of herpes.
1473,1,3,24,28,1.1785714285714286,0.08987898137227081,565,"Well, this explains that burning, itching sensation you described."
1473,1,3,24,28,1.1785714285714286,0.08987898137227081,565,"Yes, your file clearly references that symptom."
1473,0,5,23,28,1.1785714285714286,0.07370704611510596,565,We've just started a burn unit here.
1473,0,5,23,28,1.1785714285714286,0.07370704611510596,565,Your heartburn has gotten worse.
1473,1,3,24,28,1.1785714285714286,0.08987898137227081,565,"Don't look sad, the radiologist said you were hot!"
1473,1,3,24,28,1.1785714285714286,0.08987898137227081,565,It appears to be an out-of-pocket expense.
1473,1,3,24,28,1.1785714285714286,0.08987898137227081,565,Bottom line....I'd probably cancel that golf outing.
1473,1,3,24,28,1.1785714285714286,0.08987898137227081,565,"Trust me, you don't wanna know."
1473,0,5,23,28,1.1785714285714286,0.07370704611510596,565,This is actually a good sign. For me.
1473,0,5,23,28,1.1785714285714286,0.07370704611510596,565,This is courtesy of Trump's new HIPPA regulations.
1473,0,5,23,28,1.1785714285714286,0.07370704611510596,565,"I apologize, the ""You're Fired"" provision of Trumpcare just took effect."
1473,1,3,24,28,1.1785714285714286,0.08987898137227081,565,"Unfortunately, your coverage has almost been extinguished."
1826,0,5,24,29,1.1724137931034482,0.07138609234576081,565,I tried to get her sooner but Trump-care was just approved by Congress.
1826,2,1,26,29,1.1724137931034482,0.10011035188621467,565,I think your jalapeño readings are a little high.
1826,0,5,24,29,1.1724137931034482,0.07138609234576081,565,This chart shows the severity of your hemorrhoids.
1826,1,3,25,29,1.1724137931034482,0.08694267288040786,565,Sorry about this - shedder's still on the blink
1826,2,1,26,29,1.1724137931034482,0.10011035188621467,565,"Well, your HMO plan under the Affordable Care Act is spontaneously combusting, so my diagnosis is that Paul Ryan finally wrangled his House majority."
1826,0,5,24,29,1.1724137931034482,0.07138609234576081,565,"As we suspected, your hemorrhoids will need surgical intervention."
1826,1,3,25,29,1.1724137931034482,0.08694267288040786,565,"Unfortunately, your insurance doesn't cover preexisting conflagrations, Mr. Hotchkiss."
1826,0,5,24,29,1.1724137931034482,0.07138609234576081,565,You've got to lighten up on the Thai food!
1826,1,3,25,29,1.1724137931034482,0.08694267288040786,565,New HIPAA laws. Even I'm not allowed to see your test results.
1826,1,3,25,29,1.1724137931034482,0.08694267288040786,565,That's exactly how it feels!
1826,1,3,25,29,1.1724137931034482,0.08694267288040786,565,"Sorry, new HIPAA regulation."
1826,0,5,24,29,1.1724137931034482,0.07138609234576081,565,You say you go through 100 Viagra pills a week?
1826,1,3,25,29,1.1724137931034482,0.08694267288040786,565,"I'm not only a doctor, I'm also a writer. I'd like your opinion on this. It's called ""Does It Hurt When I Do This."""
1826,1,3,25,29,1.1724137931034482,0.08694267288040786,565,"I'm not an arsonist, but I play one on TV."
1826,0,5,24,29,1.1724137931034482,0.07138609234576081,565,Just a little heartburn.
1826,0,5,24,29,1.1724137931034482,0.07138609234576081,565,The tests confirm that you have heartburn.
1826,1,3,25,29,1.1724137931034482,0.08694267288040786,565,Your chart shows inflammation.
1826,0,5,24,29,1.1724137931034482,0.07138609234576081,565,"It's so contagious, even the report must be sterilized."
1826,2,1,26,29,1.1724137931034482,0.10011035188621467,565,Your hip replacement paid off my mortgage
1826,0,5,24,29,1.1724137931034482,0.07138609234576081,565,I'm not sure if your insurance will cover this
1826,1,3,25,29,1.1724137931034482,0.08694267288040786,565,"I warned you if I caught you cheating on your diet, I would burn your chart."
1826,2,1,26,29,1.1724137931034482,0.10011035188621467,565,We Have a new software to safeguard patient records from hackers.
1826,1,3,25,29,1.1724137931034482,0.08694267288040786,565,About that drug combination you're on
1826,1,3,25,29,1.1724137931034482,0.08694267288040786,565,The test results suggest inflammatory bowel syndrome.
1826,0,5,24,29,1.1724137931034482,0.07138609234576081,565,You're post terminal prognosis is even worse.
1826,0,5,24,29,1.1724137931034482,0.07138609234576081,565,I'm glad they didn't repeal Satancare.
1826,1,3,25,29,1.1724137931034482,0.08694267288040786,565,""" Here is our Patient Privacy Policy""."
1826,1,3,25,29,1.1724137931034482,0.08694267288040786,565,Worst case of heartburn I've ever seen.
1826,2,1,26,29,1.1724137931034482,0.10011035188621467,565,You won't have time to call home. Shall we pray?
1826,0,5,24,29,1.1724137931034482,0.07138609234576081,565,Didn't you listen to the part at the end of the commercial?
1826,1,3,25,29,1.1724137931034482,0.08694267288040786,565,It's our new HIPPA privacy regulations.
1826,2,1,26,29,1.1724137931034482,0.10011035188621467,565,It burns me to tell you that your test results are not looking good.
1826,0,5,24,29,1.1724137931034482,0.07138609234576081,565,"This never happens, I swear."
1826,1,3,25,29,1.1724137931034482,0.08694267288040786,565,I saw this trick on Dr. Oz.
1826,0,5,24,29,1.1724137931034482,0.07138609234576081,565,What really worries me is that your health insurance plan doesn't cover fire.
1826,1,3,25,29,1.1724137931034482,0.08694267288040786,565,I think we double the dose of the anti-inflammatory.
1826,2,1,26,29,1.1724137931034482,0.10011035188621467,565,"Mr. Nason, I think you need something stronger than the purple pill."
1826,0,5,24,29,1.1724137931034482,0.07138609234576081,565,"Trust me, I'm a witch doctor."
1826,0,5,24,29,1.1724137931034482,0.07138609234576081,565,"We'll go over these results in detail, but for now I'm just going to summarize."
1826,0,5,24,29,1.1724137931034482,0.07138609234576081,565,This is just a temporary diagnosis.
1826,1,3,25,29,1.1724137931034482,0.08694267288040786,565,I doubt this is covered by your insurance!
1826,1,3,25,29,1.1724137931034482,0.08694267288040786,565,Based on the results of your colonoscopy you might want to cool it on the Mexican food for a bit.
1826,0,5,24,29,1.1724137931034482,0.07138609234576081,565,We're going to get rid of that canker sore the old-fashioned way!
1826,1,3,25,29,1.1724137931034482,0.08694267288040786,565,Yea. lay off the spicy food for a bit.
1826,0,5,24,29,1.1724137931034482,0.07138609234576081,565,"Nothing to be embarrassed about, Mr. Torch. Just a little super power incontinence."
1826,2,1,26,29,1.1724137931034482,0.10011035188621467,565,"Lowering your cholesterol may be an impossible mission, Mr. Phelps."
1826,0,5,24,29,1.1724137931034482,0.07138609234576081,565,Your lab results have literally burned up the charts.
1826,0,5,24,29,1.1724137931034482,0.07138609234576081,565,It's just the latest protocol from our HIPAA compliance office.
1826,1,3,25,29,1.1724137931034482,0.08694267288040786,565,I think we may have gotten to the bottom of that burning sensation...
1826,1,3,25,29,1.1724137931034482,0.08694267288040786,565,"Mr. Jones, your 3:00 A.M. habit of 4 alarm Chili needs some revision."
1876,1,2,22,25,1.16,0.09451631252505216,565,New lungs test. See if you can blow it out in under 3 seconds. Go!
1876,1,2,22,25,1.16,0.09451631252505216,565,Well this is a first
1876,0,4,21,25,1.16,0.07483314773547882,565,I'd like to refer you to the fire department.
1876,0,4,21,25,1.16,0.07483314773547882,565,What the devil have you been up to?
1876,0,4,21,25,1.16,0.07483314773547882,565,Your Obamacare reimbursement will be a little lighter: Zippo.
1876,0,4,21,25,1.16,0.07483314773547882,565,I've also got a burning sensation!
1876,0,4,21,25,1.16,0.07483314773547882,565,I believe we have a clear indication as to whether your test result exceeds the reference range!
1876,1,2,22,25,1.16,0.09451631252505216,565,I'm burning the evidence so the germs don't know we are onto them.
1876,1,2,22,25,1.16,0.09451631252505216,565,I can tell you've been smoking. Where there's smoke there is fire.
1876,1,2,22,25,1.16,0.09451631252505216,565,"Good luck, Mr. Phelps."
1876,0,4,21,25,1.16,0.07483314773547882,565,It's the worst case of heartburn I've ever seen
1876,0,4,21,25,1.16,0.07483314773547882,565,"Sir, i'm starting to believe you lied about the drug test."
1876,0,4,21,25,1.16,0.07483314773547882,565,Something tells me heartburn.
1876,1,2,22,25,1.16,0.09451631252505216,565,It's pretty clear your hemorrhoids have flared up - I think we can skip the exam.
1876,0,4,21,25,1.16,0.07483314773547882,565,"In my clinical opinion, you are just too hot to handle"
1876,1,2,22,25,1.16,0.09451631252505216,565,It's some kind of inflammation.
1876,1,2,22,25,1.16,0.09451631252505216,565,In accordance with HIPAA ....
1876,0,4,21,25,1.16,0.07483314773547882,565,"You know, it usually isn't this hard to explain what a fever is."
1876,0,4,21,25,1.16,0.07483314773547882,565,Bad news. The inflammation is getting quickly worse.
1876,0,4,21,25,1.16,0.07483314773547882,565,You're going to look right at me and say you can't have pyrokinesis? Wait - no - don't look at me!
1876,0,4,21,25,1.16,0.07483314773547882,565,It says here you have a fever to 451 Farenheit
1876,0,4,21,25,1.16,0.07483314773547882,565,Last chance to put your account online.
1876,0,4,21,25,1.16,0.07483314773547882,565,"Patient privacy is a priority here. Record keeping, not so much."
1876,0,4,21,25,1.16,0.07483314773547882,565,You should probably get a second opinion
1876,0,4,21,25,1.16,0.07483314773547882,565,I think this calls for more than two aspirins.
1876,1,2,22,25,1.16,0.09451631252505216,565,"Goodness, gracious, great balls of fire."
1876,1,2,22,25,1.16,0.09451631252505216,565,"I'm sorry to tell you, Mr. Smith, that spontaneous combustion is not covered by your insurance plan."
1876,1,2,22,25,1.16,0.09451631252505216,565,You can't afford the prescriptions anyway.
1876,0,4,21,25,1.16,0.07483314773547882,565,"My Rx is ""apply heat"""
1876,0,4,21,25,1.16,0.07483314773547882,565,"Sorry, but the new shredder is still on back-order"
1876,0,4,21,25,1.16,0.07483314773547882,565,Here are your lab results. Would you mind leaving by the back door?
1876,1,2,22,25,1.16,0.09451631252505216,565,You have no health insurance? Funny how some patient charts have no fire insurance.
1876,1,2,22,25,1.16,0.09451631252505216,565,Just as I told you. Way too much alcohol in your system.
1876,0,4,21,25,1.16,0.07483314773547882,565,"Clark, we really must work on controlling your heat vision."
1876,0,4,21,25,1.16,0.07483314773547882,565,Your insurance company hell no.
1876,0,4,21,25,1.16,0.07483314773547882,565,I decided you could burn some calories.
1876,1,2,22,25,1.16,0.09451631252505216,565,"From the looks of things, you must be very uncomfortable!"
1876,0,4,21,25,1.16,0.07483314773547882,565,Does it happen only with the bills you should pay?
1876,1,2,22,25,1.16,0.09451631252505216,565,"When I give you these results, you WILL feel a burning sensation."
1876,0,4,21,25,1.16,0.07483314773547882,565,Let's just pretend the biopsy was negative!
1876,1,2,22,25,1.16,0.09451631252505216,565,Take these as ordered. You might experience a little burning sensation.
1876,1,2,22,25,1.16,0.09451631252505216,565,Let's just say we won't be needing this anymore.
1876,1,2,22,25,1.16,0.09451631252505216,565,Some inflammation is normal.
1876,1,2,22,25,1.16,0.09451631252505216,565,"Now watch when we take into account your ""good"" cholesterol."
1876,1,2,22,25,1.16,0.09451631252505216,565,Good luck with your upcoming operation Mr. Phelps. Your test results have self-destructed.
1876,2,0,23,25,1.16,0.11075498483890765,565,Obamacare is gone. Lab results are self-destructing.
1876,0,4,21,25,1.16,0.07483314773547882,565,"When you accepted your healthcare plan, Jim, it self-destructed in five seconds."
1876,1,2,22,25,1.16,0.09451631252505216,565,Heartburn doesn't even begin to describe your diagnosis.
1876,0,4,21,25,1.16,0.07483314773547882,565,I've not seen these kind of hot flashes before. Let's hope the anti-inflammatories do the trick.
1876,1,2,22,25,1.16,0.09451631252505216,565,"Let's just say, your temperature is quite high."
1876,1,2,22,25,1.16,0.09451631252505216,565,I see you’re experiencing some inflammation.
1876,1,2,22,25,1.16,0.09451631252505216,565,Your heart-burn seams to be spreading.
1876,1,2,22,25,1.16,0.09451631252505216,565,This is your healthcare plan on Trump.
1876,0,4,21,25,1.16,0.07483314773547882,565,And when did you realize you HAD his special talent?
1876,1,2,22,25,1.16,0.09451631252505216,565,I recommend the Inflammation Diet.
1876,1,2,22,25,1.16,0.09451631252505216,565,"What can I say, man, you are on FIRE!!!"
1876,0,4,21,25,1.16,0.07483314773547882,565,I'm just making a few recommended edits to the Patients Bill of Rights under the terms of the new Republican-sponsored health care plan.
1876,1,2,22,25,1.16,0.09451631252505216,565,"According to the CAT scan, that burning sensation in your stomach is an actual fire."
1876,0,4,21,25,1.16,0.07483314773547882,565,Your chart indicates you have a fever.
1876,0,4,21,25,1.16,0.07483314773547882,565,"Your diagnosis, Mr. Phelps."
1876,0,4,21,25,1.16,0.07483314773547882,565,"Sorry, your heartburn is terminal"
1876,0,4,21,25,1.16,0.07483314773547882,565,I hope this isn't catching.
1876,0,4,21,25,1.16,0.07483314773547882,565,"I'll be honest, it's not good news."
1876,1,2,22,25,1.16,0.09451631252505216,565,What preexisting conditions?
1876,0,4,21,25,1.16,0.07483314773547882,565,I have your test results. You're flaming.
1876,1,2,22,25,1.16,0.09451631252505216,565,It’s inflamed.
1876,1,2,22,25,1.16,0.09451631252505216,565,Hipaa has really cracked down these days.
1876,0,4,21,25,1.16,0.07483314773547882,565,"For your sake, I really hope you're not allergic to penicillin."
1876,0,4,21,25,1.16,0.07483314773547882,565,"From now on, you can use any bathroom you want."
1876,0,4,21,25,1.16,0.07483314773547882,565,"Ever since we switched from paper to EMR, this keeps happening to our files."
1876,1,2,22,25,1.16,0.09451631252505216,565,I knew I should've read the manual for the 3D printer!
1876,0,4,21,25,1.16,0.07483314773547882,565,Let's try that again...stick your tongue out and say aaah!!!
1876,1,2,22,25,1.16,0.09451631252505216,565,It's the inflammation that concerns me.
1876,0,4,21,25,1.16,0.07483314773547882,565,Hemmorhoids. You've got hemmorhoids
1876,2,0,23,25,1.16,0.11075498483890765,565,"Sorry, our file clerk used to work at Samsung."
1876,0,4,21,25,1.16,0.07483314773547882,565,"Don't worry, it's standard practice after your first law suit."
1876,0,4,21,25,1.16,0.07483314773547882,565,I think you should avoid eating all hot and spicy foods.
1876,1,2,22,25,1.16,0.09451631252505216,565,"Mr. Angel, I'm sorry to report that things are presenting in a downward spiral."
1876,2,0,23,25,1.16,0.11075498483890765,565,"Mr Hughes, unfortunately your belief in creationism angers our god of science."
1876,0,4,21,25,1.16,0.07483314773547882,565,This is more than another flare-up.
1876,2,0,23,25,1.16,0.11075498483890765,565,Looks like it's a hot attack.
1876,1,2,22,25,1.16,0.09451631252505216,565,Our practice is going paperless. In fact we don't keep track of anything.
1876,0,4,21,25,1.16,0.07483314773547882,565,Breath mint?
1876,1,2,22,25,1.16,0.09451631252505216,565,"Don't worry, under the new health care plan it's like this visit never happened."""
1876,1,2,22,25,1.16,0.09451631252505216,565,I'm afraid you're suffering from some sever inflammation....
1876,1,2,22,25,1.16,0.09451631252505216,565,Your prexisting condition is protected.
1876,1,2,22,25,1.16,0.09451631252505216,565,The results confirm 'male menopause'--you had a hot attack!
1876,1,2,22,25,1.16,0.09451631252505216,565,"Heartburn! Yes, my diagnoses have been on fire recently."
1876,1,2,22,25,1.16,0.09451631252505216,565,New patient privacy rules allow me to only read this to you once.
1876,1,2,22,25,1.16,0.09451631252505216,565,"Well, I think we can rule out pneumonia."
1876,1,2,22,25,1.16,0.09451631252505216,565,You test positive for spontaneous combustion.
1876,1,2,22,25,1.16,0.09451631252505216,565,See? Another reason to quit smoking.
1876,1,2,22,25,1.16,0.09451631252505216,565,I'm afraid I have some bad news...
1876,0,4,21,25,1.16,0.07483314773547882,565,We take HIPAA seriously.
1876,1,2,22,25,1.16,0.09451631252505216,565,Apparently global warming is contagious and you've caught it.
1876,1,2,22,25,1.16,0.09451631252505216,565,The lab report indicates that your acid reflux problems are excessively out of control.
1876,0,4,21,25,1.16,0.07483314773547882,565,"Sorry, your health care insurance just went up in flames."
1876,0,4,21,25,1.16,0.07483314773547882,565,"Sorry, you have too many red flags."
1876,0,4,21,25,1.16,0.07483314773547882,565,"So, quickly, tell me your chief complaint....."
1876,0,4,21,25,1.16,0.07483314773547882,565,Oy Vey!
1876,1,2,22,25,1.16,0.09451631252505216,565,Don't worry. It's not contagious.
1876,1,2,22,25,1.16,0.09451631252505216,565,I got your test results hot off the presses.
1876,0,4,21,25,1.16,0.07483314773547882,565,"Nice trick, Clark, but that doesn't change your cholesterol level."
1876,0,4,21,25,1.16,0.07483314773547882,565,Burn after reading
1876,0,4,21,25,1.16,0.07483314773547882,565,"Your test results show you have hemorrhoids. Yes, definitely inflamed hemorrhoids."
1876,0,4,21,25,1.16,0.07483314773547882,565,I have a license to grill.
1876,0,4,21,25,1.16,0.07483314773547882,565,"I don't want to blame it all on Obamacare, but, you know."
1876,1,2,22,25,1.16,0.09451631252505216,565,"Sorry, new privacy rules."
1876,0,4,21,25,1.16,0.07483314773547882,565,It looks like nothing more than a bad case of chart burn.
1876,0,4,21,25,1.16,0.07483314773547882,565,This explains your heartburn
1876,1,2,22,25,1.16,0.09451631252505216,565,"Now no one will ever know about your ED, Mr. President."
1876,0,4,21,25,1.16,0.07483314773547882,565,About that burning sensation you're experiencing.
1876,1,2,22,25,1.16,0.09451631252505216,565,"Yes, you're a dragon Walter."
1876,0,4,21,25,1.16,0.07483314773547882,565,"According to the report, your inflammation is spreading"
1876,1,2,22,25,1.16,0.09451631252505216,565,Temperature a bit high.
1876,0,4,21,25,1.16,0.07483314773547882,565,It's part of our push to ensure HIPAA compliance.
1876,0,4,21,25,1.16,0.07483314773547882,565,I have only one burning question.
1876,0,4,21,25,1.16,0.07483314773547882,565,Yep. Heartburn.
1876,0,4,21,25,1.16,0.07483314773547882,565,A study showed it encourages greater patient change.
1876,0,4,21,25,1.16,0.07483314773547882,565,We're going paperless.
1876,0,4,21,25,1.16,0.07483314773547882,565,This new privacy protocol is a nuisance.
1876,0,4,21,25,1.16,0.07483314773547882,565,The inflammation has gotten a lot worse!
1876,1,2,22,25,1.16,0.09451631252505216,565,It's just smoke and mirrors
1876,2,0,23,25,1.16,0.11075498483890765,565,"Well, your lab results are back."
1876,0,4,21,25,1.16,0.07483314773547882,565,You can't make your co pay go away by magic .
1876,1,2,22,25,1.16,0.09451631252505216,565,Perhaps me setting fire to this file will distract from how bad I am at nose jobs.
1876,0,4,21,25,1.16,0.07483314773547882,565,The results indicate that your burning sensation may be contagious.
1876,1,2,22,25,1.16,0.09451631252505216,565,The long-lasting pain relief of Xanaflex compels you!
1876,0,4,21,25,1.16,0.07483314773547882,565,GERD indeed
1876,1,2,22,25,1.16,0.09451631252505216,565,"OK now, watch what happens when the flames reach my fingers."
1876,1,2,22,25,1.16,0.09451631252505216,565,This must be the repeal phase.
1876,0,4,21,25,1.16,0.07483314773547882,565,"Good morning, Mr. Phelps. Your therapy, should you choose to accept it..."
1876,2,0,23,25,1.16,0.11075498483890765,565,I can assure you it's quite common among men with tiny hands.
1876,1,2,22,25,1.16,0.09451631252505216,565,Nihilistic Medicine
1876,0,4,21,25,1.16,0.07483314773547882,565,This is your burning question?
1876,0,4,21,25,1.16,0.07483314773547882,565,"It's nothing personal, I tell all my patients to stop smoking."
1876,0,4,21,25,1.16,0.07483314773547882,565,You're running a bit of a fever.
1876,2,0,23,25,1.16,0.11075498483890765,565,It's as close as I can get to a diagnosis
1876,1,2,22,25,1.16,0.09451631252505216,565,I have some concerns about your test results
1876,1,2,22,25,1.16,0.09451631252505216,565,I think we can rule out pyrophobia.
1876,0,4,21,25,1.16,0.07483314773547882,565,I'm getting concerned about these flare-ups of yours.
1876,0,4,21,25,1.16,0.07483314773547882,565,I see you have been having some inflammatory problems.
1876,0,4,21,25,1.16,0.07483314773547882,565,I'll need to retake your temperature.
1876,0,4,21,25,1.16,0.07483314773547882,565,You may feel a burning sensation when you pay.
1876,1,2,22,25,1.16,0.09451631252505216,565,No need to be so graphic in the questions about your sex life.
1876,0,4,21,25,1.16,0.07483314773547882,565,You shouldn't have said 'to hell with Obamacare'.
1876,1,2,22,25,1.16,0.09451631252505216,565,"Sorry, our copier's a Samsung."
1876,0,4,21,25,1.16,0.07483314773547882,565,It's the new HIPAA version of SnapChat
1876,0,4,21,25,1.16,0.07483314773547882,565,"Well, I can't say for sure what it is, but it's enflamed."
1876,0,4,21,25,1.16,0.07483314773547882,565,Definitely looks like heartburn.
1876,0,4,21,25,1.16,0.07483314773547882,565,This may burn a bit!
1876,1,2,22,25,1.16,0.09451631252505216,565,Make sure you take this with water
1876,1,2,22,25,1.16,0.09451631252505216,565,Did you experience a burning sensation?
1876,0,4,21,25,1.16,0.07483314773547882,565,Your ulcers are really inflamed!
1876,0,4,21,25,1.16,0.07483314773547882,565,"Sir, you know burning this won't change the results."
1876,0,4,21,25,1.16,0.07483314773547882,565,You're lucky you came to Mt. Sinai.
1876,0,4,21,25,1.16,0.07483314773547882,565,Your records keep self destructing....have you been exposed to any politicians lately?
1876,1,2,22,25,1.16,0.09451631252505216,565,"Yes, I'm afraid it is what your thinking."
1876,2,0,23,25,1.16,0.11075498483890765,565,These results sound like your wife. You are going to burn in Hell!
1876,0,4,21,25,1.16,0.07483314773547882,565,I see you have a history of inflammation.
1876,0,4,21,25,1.16,0.07483314773547882,565,Your inflammation is worse than I thought.
1876,0,4,21,25,1.16,0.07483314773547882,565,"Well, its just a slight bit of inflammation, you see."
1876,1,2,22,25,1.16,0.09451631252505216,565,I better make this quick.
1876,0,4,21,25,1.16,0.07483314773547882,565,You should only come in if it feels like this.
1876,1,2,22,25,1.16,0.09451631252505216,565,Exactly when did these hot flashes begin?
1876,0,4,21,25,1.16,0.07483314773547882,565,I see no evidence of medical malpractice in my management of your care.
1876,1,2,22,25,1.16,0.09451631252505216,565,"Oh, I forgot about the new pop-up lab results we are field testing, and no, that is not good."
1876,0,4,21,25,1.16,0.07483314773547882,565,I'd like to get a second opinion.
1876,1,2,22,25,1.16,0.09451631252505216,565,We have a new prostate procedure... Just kidding!
1876,1,2,22,25,1.16,0.09451631252505216,565,"Well, first, we have to do something about your fever"
1876,1,2,22,25,1.16,0.09451631252505216,565,"I have a written apology regarding our misdiag- Oh, what now?!"
1876,1,2,22,25,1.16,0.09451631252505216,565,There is nothing wrong with your sperm count.
1876,1,2,22,25,1.16,0.09451631252505216,565,Your condition seems to have gone all to hell.
1876,1,2,22,25,1.16,0.09451631252505216,565,"Yes, usually the cure IS worse than the illness."
1876,0,4,21,25,1.16,0.07483314773547882,565,Looks like we both have some unexplained inflammation.
1876,1,2,22,25,1.16,0.09451631252505216,565,The results of your tests are way too hot for me to handle.
1876,0,4,21,25,1.16,0.07483314773547882,565,We're taking Fajita Fridays to the next level.
1876,0,4,21,25,1.16,0.07483314773547882,565,I found the cause of your burning sensation
1876,2,0,23,25,1.16,0.11075498483890765,565,The new HIPAA regulations are very tough.
1876,0,4,21,25,1.16,0.07483314773547882,565,Heartburn is not supposed to be contagious
1876,0,4,21,25,1.16,0.07483314773547882,565,I'm less than thrilled with our new electronic health record system
1876,1,2,22,25,1.16,0.09451631252505216,565,My only guess is you shouldn't have mentioned single payer universal healthcare insurance.
1876,0,4,21,25,1.16,0.07483314773547882,565,"Bad news, it's inflamed."
1876,0,4,21,25,1.16,0.07483314773547882,565,"Obviously, you need to fight inflammation."
1876,0,4,21,25,1.16,0.07483314773547882,565,You were right...its an itching and burning sensation
1876,0,4,21,25,1.16,0.07483314773547882,565,Our shredder is broken...
1876,1,2,22,25,1.16,0.09451631252505216,565,"And finally, your copay"
1876,0,4,21,25,1.16,0.07483314773547882,565,It appears that you have an inflammation of some sort.
1876,0,4,21,25,1.16,0.07483314773547882,565,Can you describe the burning sensation I'm feeling?
1876,0,4,21,25,1.16,0.07483314773547882,565,"According to this, you suffer from severe conflagration."
1876,1,2,22,25,1.16,0.09451631252505216,565,"I've got your test results back, Mr. Hunt."
1876,1,2,22,25,1.16,0.09451631252505216,565,Just complying with the latest HIPAA regulations.
1876,0,4,21,25,1.16,0.07483314773547882,565,Good news ... we've decided not to worry you.
1876,0,4,21,25,1.16,0.07483314773547882,565,So do you feel the burning sensation now?
1876,1,2,22,25,1.16,0.09451631252505216,565,"I'm sorry, Mr. Johnson, but you have reached your insurance cap."
1876,0,4,21,25,1.16,0.07483314773547882,565,Tests confirm your report of a burning sensation.
1876,1,2,22,25,1.16,0.09451631252505216,565,You're going to have to cut back on the Mexican food.
1876,1,2,22,25,1.16,0.09451631252505216,565,Just as I thought: you have paperburn.
1876,0,4,21,25,1.16,0.07483314773547882,565,You have Chartburn. Much worse than heartburn.
1876,0,4,21,25,1.16,0.07483314773547882,565,Would you describe it as a burning sensation?
1876,1,2,22,25,1.16,0.09451631252505216,565,"""You have a serious case of flameatosis and it appears to be spreading rapidly""."
1876,1,2,22,25,1.16,0.09451631252505216,565,Let's just say the diagnosis was specious and the patient showed no trauma as it was brought to light.
1876,0,4,21,25,1.16,0.07483314773547882,565,"I am sorry I have to leave now, but fortunately our burn unit is open until 7."
1876,1,2,22,25,1.16,0.09451631252505216,565,This is for not paying the deductible.
1876,1,2,22,25,1.16,0.09451631252505216,565,"Bad news -- under Trumpcare your health plan is kaput, but the good news is your cholesterol numbers are on fire!"
1876,0,4,21,25,1.16,0.07483314773547882,565,You want a second opinion. Take the ash to a seer.
1876,0,4,21,25,1.16,0.07483314773547882,565,Good news Mr. Phillips. We got the fire out of your belly.
1876,1,2,22,25,1.16,0.09451631252505216,565,The Burning Bush says you have locusts.
1876,0,4,21,25,1.16,0.07483314773547882,565,I hardly know where to begin.
1876,0,4,21,25,1.16,0.07483314773547882,565,"Your prescription, should you choose to accept it."
1876,1,2,22,25,1.16,0.09451631252505216,565,"Your metabolism is not the problem, it's your diet."
1876,0,4,21,25,1.16,0.07483314773547882,565,Blow.
1876,0,4,21,25,1.16,0.07483314773547882,565,The TrumpCare plan prohibits patients from seeing test results which may terrify them into seeking additional medical care.
1876,0,4,21,25,1.16,0.07483314773547882,565,Your tests reveal that you have been eating too many New Mexican chili peppers.
1876,0,4,21,25,1.16,0.07483314773547882,565,"The question is, are they going to name this after your or after me?"
1876,1,2,22,25,1.16,0.09451631252505216,565,You have...(Burn baby burn) Disco Inferno!
1876,1,2,22,25,1.16,0.09451631252505216,565,"You've heard of a 'clean bill of health,' well, it's the opposite of that."
1876,0,4,21,25,1.16,0.07483314773547882,565,I have your test results.
1876,2,0,23,25,1.16,0.11075498483890765,565,The good news is that your kidney function is limiting the flames.
1876,0,4,21,25,1.16,0.07483314773547882,565,"Like I said, it was only heartburn."
1876,0,4,21,25,1.16,0.07483314773547882,565,"Nothing serious, just slight inflammation."
1876,1,2,22,25,1.16,0.09451631252505216,565,Your results are under heated debate.
1876,0,4,21,25,1.16,0.07483314773547882,565,So mich for your bill!
1876,1,2,22,25,1.16,0.09451631252505216,565,When your doctor pulls out your medical records.
1876,0,4,21,25,1.16,0.07483314773547882,565,See? No one will see your medical history here.
1876,2,0,23,25,1.16,0.11075498483890765,565,"No doubt about it, I'm afraid, Mr. DePuy. It's inflammatory bowel disease."
1876,0,4,21,25,1.16,0.07483314773547882,565,"I'd like to revisit your response about ""frequent"" exercise."
1876,0,4,21,25,1.16,0.07483314773547882,565,This way your hazard insurance should cover the visit.
1876,1,2,22,25,1.16,0.09451631252505216,565,Not to worry. It's only a temporary condition.
1876,1,2,22,25,1.16,0.09451631252505216,565,We're still trying to figure out SpicerCare.
1876,0,4,21,25,1.16,0.07483314773547882,565,Diagnosis: inflammation.
1876,1,2,22,25,1.16,0.09451631252505216,565,I told you it's a diagnosis from hell.
1876,1,2,22,25,1.16,0.09451631252505216,565,This diagnosis will self-destruct in 5 seconds.
1876,1,2,22,25,1.16,0.09451631252505216,565,"Mr. Wood, you seem to have a full blown case of as burning love."
1876,0,4,21,25,1.16,0.07483314773547882,565,We might need to adjust your anti-inflammatory prescription.
1876,0,4,21,25,1.16,0.07483314773547882,565,"There is a bright side to all this, but it's even hotter."
1876,1,2,22,25,1.16,0.09451631252505216,565,"I’m sorry, but your health plan doesn’t cover lab reports."
1876,2,0,23,25,1.16,0.11075498483890765,565,Is your Hippa burnin'?
1876,0,4,21,25,1.16,0.07483314773547882,565,Does it burn when you hold this?
1876,1,2,22,25,1.16,0.09451631252505216,565,I'm afraid your results aren't so hot
1876,1,2,22,25,1.16,0.09451631252505216,565,It's highly unusual for males to have hot flashes.
1876,1,2,22,25,1.16,0.09451631252505216,565,You have Trumpitis.
1876,1,2,22,25,1.16,0.09451631252505216,565,"On the good side, it's a very rare condition."
1876,0,4,21,25,1.16,0.07483314773547882,565,The good news is that I don't have much time.
1876,0,4,21,25,1.16,0.07483314773547882,565,"Not to worry, it's just a HIPPA requirement."
1876,0,4,21,25,1.16,0.07483314773547882,565,"I'm sorry sir, but you appear to have a serious case of inflammation."
1876,1,2,22,25,1.16,0.09451631252505216,565,Have you traveled to Mar-a-Lago recently?
1876,0,4,21,25,1.16,0.07483314773547882,565,"Your labs look great, but there appears to be some residual inflammation"
1876,0,4,21,25,1.16,0.07483314773547882,565,"Well, the good news is ... it's just a minor flare-up."
1876,0,4,21,25,1.16,0.07483314773547882,565,"I'll take that urine sample immediately, if you don't mind."
1876,1,2,22,25,1.16,0.09451631252505216,565,THIS is what happens if you cant afford the co-pay!
1876,1,2,22,25,1.16,0.09451631252505216,565,"Uh, your lab report confirms that it's a flaming case..."
1876,2,0,23,25,1.16,0.11075498483890765,565,What privacy issues?
1876,0,4,21,25,1.16,0.07483314773547882,565,"When you got fired, so did your health plan!"
1876,2,0,23,25,1.16,0.11075498483890765,565,Wow -- never seen someone's health insurance literally go up in flames!
1876,0,4,21,25,1.16,0.07483314773547882,565,"Well, Pete, you are literally burning up."
1876,0,4,21,25,1.16,0.07483314773547882,565,"Hmm, you do have a fever after all."
1876,0,4,21,25,1.16,0.07483314773547882,565,I'm afraid you have some inflammation.
1876,0,4,21,25,1.16,0.07483314773547882,565,Your health insurance has set the
1876,0,4,21,25,1.16,0.07483314773547882,565,The burning sensation is not normal.
1876,0,4,21,25,1.16,0.07483314773547882,565,I'm afraid your insurance coverage has spontaneously combusted.
1876,0,4,21,25,1.16,0.07483314773547882,565,"Your lab results give a whole new meaning to ""does it tinkle when you pee"""
1876,0,4,21,25,1.16,0.07483314773547882,565,"Thanks Doc, now what's the bad news?"
1876,1,2,22,25,1.16,0.09451631252505216,565,Your fecal occult blood test is concerning.
1876,0,4,21,25,1.16,0.07483314773547882,565,"Well, I did tell you there was a chance this would flare up again."
1876,0,4,21,25,1.16,0.07483314773547882,565,I see that you checked 'fever' on your intake form.
1876,1,2,22,25,1.16,0.09451631252505216,565,"""Don't look so down. These test results should fire you up."
1876,0,4,21,25,1.16,0.07483314773547882,565,"Well, at the very least, you've also burnt some calories."
1876,0,4,21,25,1.16,0.07483314773547882,565,This is your prognosis. Are you a religious man?
1876,0,4,21,25,1.16,0.07483314773547882,565,"Sorry, wrong prescription."
1876,0,4,21,25,1.16,0.07483314773547882,565,You never can be too safe
1876,0,4,21,25,1.16,0.07483314773547882,565,"Ok, Bruce, if you don't stop eating that chipotle sauce, this is what your g.i. tract will feel like."
1876,0,4,21,25,1.16,0.07483314773547882,565,You need to cut down on the spicy food.
1876,0,4,21,25,1.16,0.07483314773547882,565,"Hello, Bill, about your bill."
1876,1,2,22,25,1.16,0.09451631252505216,565,Obamacare Light
1876,1,2,22,25,1.16,0.09451631252505216,565,Drink this -- it will settle your stomach.
1876,0,4,21,25,1.16,0.07483314773547882,565,Cursed magic! I said 'I'll send you to home' not 'incendio tome'.
1876,1,2,22,25,1.16,0.09451631252505216,565,"A 'burning sensation,' you say?"
1876,2,0,23,25,1.16,0.11075498483890765,565,Your blood test results indicate inflammation may be an issue.
1876,1,2,22,25,1.16,0.09451631252505216,565,It's a new HIPAA requirement.
1876,1,2,22,25,1.16,0.09451631252505216,565,We put confidentiality ahead of sound medicine.
1876,0,4,21,25,1.16,0.07483314773547882,565,So under the Republican plan we just burn everything down.
1876,0,4,21,25,1.16,0.07483314773547882,565,We guarantee confidentiality.
1876,1,2,22,25,1.16,0.09451631252505216,565,"Yes, it is contagious."
1876,0,4,21,25,1.16,0.07483314773547882,565,This usually will clear large noses.
1876,0,4,21,25,1.16,0.07483314773547882,565,"After consulting with my colleagues, we all agree that your prognosis is highly volatile."
1876,0,4,21,25,1.16,0.07483314773547882,565,So tell me more about this burning sensation you've been having.
1876,1,2,22,25,1.16,0.09451631252505216,565,About that heartburn you've been ignoring.....
1876,1,2,22,25,1.16,0.09451631252505216,565,I wouldn't read too into this.
1876,1,2,22,25,1.16,0.09451631252505216,565,Don't be alarmed. This is Trump's HIPAA.
1876,0,4,21,25,1.16,0.07483314773547882,565,It's just a bit of inflammation.
1876,1,2,22,25,1.16,0.09451631252505216,565,"No need to worry, it's just a little inflamed."
1876,0,4,21,25,1.16,0.07483314773547882,565,We take HIPAA very seriously here.
1876,0,4,21,25,1.16,0.07483314773547882,565,Are you a smoker?
1876,1,2,22,25,1.16,0.09451631252505216,565,your treatment plan will self-destruct in 30 seconds.
1876,0,4,21,25,1.16,0.07483314773547882,565,Looks like you're running a fever.
1876,1,2,22,25,1.16,0.09451631252505216,565,It's part of our stop smoking campaign.
1876,0,4,21,25,1.16,0.07483314773547882,565,I'm a little concerned about your chart.
1876,0,4,21,25,1.16,0.07483314773547882,565,I'm going to have to ask you to cut back on the habaneros.
1876,0,4,21,25,1.16,0.07483314773547882,565,Let's wait and see what happens.
1876,0,4,21,25,1.16,0.07483314773547882,565,The results suggest you are dehydrated.
1876,0,4,21,25,1.16,0.07483314773547882,565,Talk about inflammation.
1876,1,2,22,25,1.16,0.09451631252505216,565,"Sorry but until the new health plan is established, I think we should destroy the findings."
1876,0,4,21,25,1.16,0.07483314773547882,565,"And, do you feel a burning sensation?"
1876,1,2,22,25,1.16,0.09451631252505216,565,Disco Fever is still a thing?
1876,1,2,22,25,1.16,0.09451631252505216,565,Your condition shows a serious inflammation.
1876,1,2,22,25,1.16,0.09451631252505216,565,Brace yourself...It's hemorrhoids.
1876,0,4,21,25,1.16,0.07483314773547882,565,"I said I wasn't infallible, not inflammable."
1876,1,2,22,25,1.16,0.09451631252505216,565,I see you've made a pact with medical insurance.
1876,0,4,21,25,1.16,0.07483314773547882,565,Man! Do you have hemoroids!
1876,0,4,21,25,1.16,0.07483314773547882,565,It means your health is in flames.
1876,1,2,22,25,1.16,0.09451631252505216,565,Cut down on the burritos.
1876,1,2,22,25,1.16,0.09451631252505216,565,"Oops, I must need a breath mint"
1876,0,4,21,25,1.16,0.07483314773547882,565,Have you ever smoked?
1876,0,4,21,25,1.16,0.07483314773547882,565,"Hmmm, unfortunately, the diagnosis is stage IV liar, liar, pants on fire."
1876,0,4,21,25,1.16,0.07483314773547882,565,Your diagnosis will self-destruct in 10 seconds.
1876,1,2,22,25,1.16,0.09451631252505216,565,"Oh, we are experimenting with mindful consultation."
1876,1,2,22,25,1.16,0.09451631252505216,565,"You're hot-blooded, check it and see. You've got a fever of one-hundred and three!"
1876,0,4,21,25,1.16,0.07483314773547882,565,Some people view our new protocols as incendiary.
1876,1,2,22,25,1.16,0.09451631252505216,565,It says that your temperature is a bit high.
1876,1,2,22,25,1.16,0.09451631252505216,565,What do you say we pretend your bloodwork never happened?
1876,0,4,21,25,1.16,0.07483314773547882,565,The test confirms it. You suffer from incurable burning desire.
1876,1,2,22,25,1.16,0.09451631252505216,565,Please don't open your mouth again until we can diagnose your condition.
1876,0,4,21,25,1.16,0.07483314773547882,565,You might feel a slight burning sensation
1876,1,2,22,25,1.16,0.09451631252505216,565,"More carotene, less kerosene."
1876,0,4,21,25,1.16,0.07483314773547882,565,I guess this was the untruth diagnosis.
1876,0,4,21,25,1.16,0.07483314773547882,565,"Inflammation, off the charts!"
1876,1,2,22,25,1.16,0.09451631252505216,565,Your lab findings suggest that you may have a touch of Spontaneous Combustion Syndrome.
1876,1,2,22,25,1.16,0.09451631252505216,565,"Look, what's done is done... and besides, you have no insurance."
1876,1,2,22,25,1.16,0.09451631252505216,565,"There's something odd about this urine sample, Mr Jones."
1876,1,2,22,25,1.16,0.09451631252505216,565,I revolutionize patient care by combining state-of-the-art western medicine and ancient Chinese gunpowder
1876,1,2,22,25,1.16,0.09451631252505216,565,"Unfortunately, the test shows you're positive for a very bad case of spontaneous combustion"
1876,0,4,21,25,1.16,0.07483314773547882,565,The cause of the inflammation is too many General Tsao's spicey chicken dinners.
1876,1,2,22,25,1.16,0.09451631252505216,565,Let's just say the prognosis isn't good.
1876,0,4,21,25,1.16,0.07483314773547882,565,Looks like it's more contagious than we thought.
1876,0,4,21,25,1.16,0.07483314773547882,565,And I'd cut back on the spicy food.
1876,0,4,21,25,1.16,0.07483314773547882,565,looks like your temperature is slightly elevated
1876,0,4,21,25,1.16,0.07483314773547882,565,"Yes, your temperature is high..."
1876,0,4,21,25,1.16,0.07483314773547882,565,Your x-ray was a shade overexposed.
1876,1,2,22,25,1.16,0.09451631252505216,565,Got your hemorrhoid test back.
1876,0,4,21,25,1.16,0.07483314773547882,565,"Sorry, I've got a slight fever."
1876,1,2,22,25,1.16,0.09451631252505216,565,The good news is you don't have cancer. The bad news is this Ketamine is kicking in much sooner than I had anticipated.
1876,0,4,21,25,1.16,0.07483314773547882,565,The new Prince of Darkness Healthcare Plan doesn't cover illness caused by life.
1876,0,4,21,25,1.16,0.07483314773547882,565,Feel free to get a second opinion.
2220,1,2,23,26,1.1538461538461537,0.09101661204768642,565,You have a bad case of shingles...even your diagnosis is burning.
2220,1,2,23,26,1.1538461538461537,0.09101661204768642,565,It says here you have a temperature of fahrenheit 451.
2220,0,4,22,26,1.1538461538461537,0.07216024245882201,565,"I'm sorry, this darn Samsung Galaxy Patient Chart is acting up again."
2220,1,2,23,26,1.1538461538461537,0.09101661204768642,565,My witch doctor colleague recommends this cure.
2220,0,4,22,26,1.1538461538461537,0.07216024245882201,565,"Your results are in. Worst case of heartburn, ever!"
2220,0,4,22,26,1.1538461538461537,0.07216024245882201,565,I am pretty sure spontaneous combustion isn't covered by your insurance
2220,1,2,23,26,1.1538461538461537,0.09101661204768642,565,"Under the circumstances, we'd like you to pay first."
2220,2,0,24,26,1.1538461538461537,0.10658774200423862,565,Or would you prefer the good news first?
2220,1,2,23,26,1.1538461538461537,0.09101661204768642,565,"Yes, I would say you're contagious"
2220,0,4,22,26,1.1538461538461537,0.07216024245882201,565,You think I need your chart to diagnose chlamydia?
2220,1,2,23,26,1.1538461538461537,0.09101661204768642,565,"Before I read this, please remember this is only one doctor's opinion."
2220,0,4,22,26,1.1538461538461537,0.07216024245882201,565,But you don't have any symptoms?
2220,0,4,22,26,1.1538461538461537,0.07216024245882201,565,"Yes, it's fatal, and I think Satan wants you"
2220,0,4,22,26,1.1538461538461537,0.07216024245882201,565,They won't give up on Obamacare.
2220,0,4,22,26,1.1538461538461537,0.07216024245882201,565,"Yep, it's hemmerhoids."
2220,1,2,23,26,1.1538461538461537,0.09101661204768642,565,We take HIPAA very seriously.
2220,0,4,22,26,1.1538461538461537,0.07216024245882201,565,"Yes, I'd say the inflamation has definitely spread."
2220,0,4,22,26,1.1538461538461537,0.07216024245882201,565,I've found many patients won't begin eating healthier until there's a fire under their butt.
2220,0,4,22,26,1.1538461538461537,0.07216024245882201,565,I recommend you lay off the chili peppers.
2220,1,2,23,26,1.1538461538461537,0.09101661204768642,565,How'd you know it was heartburn?
2220,1,2,23,26,1.1538461538461537,0.09101661204768642,565,Your answer 'two drinks per week' is a lie.
2220,0,4,22,26,1.1538461538461537,0.07216024245882201,565,Hmmm.... I'm not sure you want to see the results.
2220,2,0,24,26,1.1538461538461537,0.10658774200423862,565,"Apparently, Mr. Hunt, your health report will self-destruct in five seconds."
2220,2,0,24,26,1.1538461538461537,0.10658774200423862,565,I'm sorry -- I'll give you these results in 2 secs -- what did you say about not making a co-payment?
2220,0,4,22,26,1.1538461538461537,0.07216024245882201,565,"We don't have a lot of time left, so..."
2220,1,2,23,26,1.1538461538461537,0.09101661204768642,565,HIPPA rules prevent me from sharing your test results with you.
2220,1,2,23,26,1.1538461538461537,0.09101661204768642,565,It's one of the downsides of Trumpcare.
2220,1,2,23,26,1.1538461538461537,0.09101661204768642,565,Your condition is most inflammatory.
2220,0,4,22,26,1.1538461538461537,0.07216024245882201,565,"Your heartburn's back, Jim, at least it looks that way on paper."
2220,0,4,22,26,1.1538461538461537,0.07216024245882201,565,Your policy doesn't cover it anyway.
2220,1,2,23,26,1.1538461538461537,0.09101661204768642,565,"I'm sorry but I am prohibited from telling you the truth about your diagnosis due to potential liability concerns. Consider this a metaphor for the ""C"" word."
2220,0,4,22,26,1.1538461538461537,0.07216024245882201,565,"We'd better call Jake, from State Farm."
2220,1,2,23,26,1.1538461538461537,0.09101661204768642,565,The devil's in the detail
2220,0,4,22,26,1.1538461538461537,0.07216024245882201,565,"Any questions, Mr.Phelps?"
2220,0,4,22,26,1.1538461538461537,0.07216024245882201,565,Test results on your heartburn.
2220,0,4,22,26,1.1538461538461537,0.07216024245882201,565,"Frankly, your test results were not exactly what we were hoping for."
2220,0,4,22,26,1.1538461538461537,0.07216024245882201,565,I'm sorry.The office is going paperless.
2220,2,0,24,26,1.1538461538461537,0.10658774200423862,565,The preauthorization went about as well as expected.
2220,1,2,23,26,1.1538461538461537,0.09101661204768642,565,"I see no cause for concern, it's just a little inflammation."
2220,0,4,22,26,1.1538461538461537,0.07216024245882201,565,"My apologies, my assistant has a strange sense of humor."
2220,2,0,24,26,1.1538461538461537,0.10658774200423862,565,Two to one odds your chart outlasts you.
2220,0,4,22,26,1.1538461538461537,0.07216024245882201,565,You worked for the Clintons?
2220,1,2,23,26,1.1538461538461537,0.09101661204768642,565,Take two aspirin and call the fire department
2220,0,4,22,26,1.1538461538461537,0.07216024245882201,565,I don't think changing providers is an option
2220,1,2,23,26,1.1538461538461537,0.09101661204768642,565,I'm afraid you've got some pretty bad heartburn.
2220,1,2,23,26,1.1538461538461537,0.09101661204768642,565,"Don't worry about your health insurance, you no more have precondition"
2220,0,4,22,26,1.1538461538461537,0.07216024245882201,565,Take this but don't call me unless it works.
2220,0,4,22,26,1.1538461538461537,0.07216024245882201,565,"Your oxygen is great, but you do have a temperature."
2220,1,2,23,26,1.1538461538461537,0.09101661204768642,565,Many patients experience a burning sensation when reviewing the American Health Care Act.
2220,0,4,22,26,1.1538461538461537,0.07216024245882201,565,"Just a guess, but I'd say your fever is about 451°"
2220,0,4,22,26,1.1538461538461537,0.07216024245882201,565,There's bad news and worse news.
2220,0,4,22,26,1.1538461538461537,0.07216024245882201,565,I am complying with your wish to not share your medical records.
2220,1,2,23,26,1.1538461538461537,0.09101661204768642,565,It's a new mandate to safeguard health information.
2220,0,4,22,26,1.1538461538461537,0.07216024245882201,565,"Oh, for Pete's sake!"
2220,0,4,22,26,1.1538461538461537,0.07216024245882201,565,It's a form of inflammation.
2220,1,2,23,26,1.1538461538461537,0.09101661204768642,565,The test results suggest your tonsils are inflamed.
2220,1,2,23,26,1.1538461538461537,0.09101661204768642,565,I'm afraid your test results are highly inflammitory. . .
2220,0,4,22,26,1.1538461538461537,0.07216024245882201,565,I'll just go ahead and add pyrokinesis to the list of side effects.
2220,0,4,22,26,1.1538461538461537,0.07216024245882201,565,It says you have burning indigestion.
2220,1,2,23,26,1.1538461538461537,0.09101661204768642,565,It's a prescription for the purple pill.
2220,0,4,22,26,1.1538461538461537,0.07216024245882201,565,It appears your symptoms are flaring up again.
2220,0,4,22,26,1.1538461538461537,0.07216024245882201,565,Our patient privacy policy has been tightened .
2220,0,4,22,26,1.1538461538461537,0.07216024245882201,565,"Sorry, your health care coverage just went up in smoke!"
2220,0,4,22,26,1.1538461538461537,0.07216024245882201,565,"Try water, it's over the counter."
2220,1,2,23,26,1.1538461538461537,0.09101661204768642,565,Your book's appendix was inflamed so I had to remove it.
2220,1,2,23,26,1.1538461538461537,0.09101661204768642,565,"You know that I would be a liar, if was to say to you, your bills just couldn't get much higher, so then Doc I'll light my fire."
2220,0,4,22,26,1.1538461538461537,0.07216024245882201,565,"In view of the fact that you have no money, we'll just burn your XRAYS and pretend you are ok."
2220,1,2,23,26,1.1538461538461537,0.09101661204768642,565,It appears that your diet is adding fuel to the fire.
2220,1,2,23,26,1.1538461538461537,0.09101661204768642,565,Looks like you have a slight fever.
2220,0,4,22,26,1.1538461538461537,0.07216024245882201,565,I'm going to recommend cold medicine
2220,1,2,23,26,1.1538461538461537,0.09101661204768642,565,No heart attack. But your heartburn's on fire!
2220,0,4,22,26,1.1538461538461537,0.07216024245882201,565,"Stop, drop, roll and drink plenty of fluids."
2220,1,2,23,26,1.1538461538461537,0.09101661204768642,565,"Not to worry, what you don't know can't kill you."
2220,0,4,22,26,1.1538461538461537,0.07216024245882201,565,"It seems that your inflammatory symptoms are contagious, sir."
2220,0,4,22,26,1.1538461538461537,0.07216024245882201,565,Looks like you have some inflammation.
2220,0,4,22,26,1.1538461538461537,0.07216024245882201,565,Your gastrointestinal inflammation has apparently taken a turn to inflammatory.
2220,1,2,23,26,1.1538461538461537,0.09101661204768642,565,Sorry I had diablo sauce for lunch.
2220,0,4,22,26,1.1538461538461537,0.07216024245882201,565,You should cut down on the Thai food.
2220,1,2,23,26,1.1538461538461537,0.09101661204768642,565,I'd classify this as a third-degree bill.
2220,1,2,23,26,1.1538461538461537,0.09101661204768642,565,Well your drug test came back and ... I think it's safe to say you most definitely were lit.
2220,2,0,24,26,1.1538461538461537,0.10658774200423862,565,This diagnosis will self-destruct in five seconds.
2220,0,4,22,26,1.1538461538461537,0.07216024245882201,565,HIPAA compliance!
2220,1,2,23,26,1.1538461538461537,0.09101661204768642,565,The results of your arson-ectomy aren't encouraging.
2220,0,4,22,26,1.1538461538461537,0.07216024245882201,565,According to your test results the devil is the cause of your diverticulitis.
2220,0,4,22,26,1.1538461538461537,0.07216024245882201,565,Looks like inflammation to me.
2220,1,2,23,26,1.1538461538461537,0.09101661204768642,565,We've found out what's causing that burning sensation.
2220,0,4,22,26,1.1538461538461537,0.07216024245882201,565,Tests results came back. You have hot flashes.
2220,0,4,22,26,1.1538461538461537,0.07216024245882201,565,Looks like your insurance won't authorize that test.
2220,0,4,22,26,1.1538461538461537,0.07216024245882201,565,"Finally, I wave my hands and count to three. You have mono."
2220,0,4,22,26,1.1538461538461537,0.07216024245882201,565,"I suppose it wouldn't technically be a lie if I told your wife the results were ""inconclusive""..."
2220,1,2,23,26,1.1538461538461537,0.09101661204768642,565,"Well Mr. Wheeler, your test results came back, and I'm afraid I've got some bad news."
2220,0,4,22,26,1.1538461538461537,0.07216024245882201,565,Mr. Kent burning the bill with your x-ray vision doesn't make it go away
2220,1,2,23,26,1.1538461538461537,0.09101661204768642,565,Would you by any chance mind redoing your colonoscopy?
2220,0,4,22,26,1.1538461538461537,0.07216024245882201,565,How long have you been smoking?
2220,1,2,23,26,1.1538461538461537,0.09101661204768642,565,Congress changed your coverage rules again.
2220,0,4,22,26,1.1538461538461537,0.07216024245882201,565,Your insurer denied coverage in no uncertain terms.
2220,1,2,23,26,1.1538461538461537,0.09101661204768642,565,Is there anything else you'd like to tell me?
2220,1,2,23,26,1.1538461538461537,0.09101661204768642,565,Obamacare was just abolished.
2220,1,2,23,26,1.1538461538461537,0.09101661204768642,565,"See, your daughter's nose, chin, and lipo jobs, alone, burned my mortgage. I feel guilty charging you for this."
2220,1,2,23,26,1.1538461538461537,0.09101661204768642,565,"To get your medical records, you will have to sign this release-of-information form."
2220,0,4,22,26,1.1538461538461537,0.07216024245882201,565,Your heartburn seems to be getting worse.
2220,1,2,23,26,1.1538461538461537,0.09101661204768642,565,Please tell me that is the bill.
2220,0,4,22,26,1.1538461538461537,0.07216024245882201,565,Your cholesterol is fine...but it appears your combustibles are very high
2220,1,2,23,26,1.1538461538461537,0.09101661204768642,565,Your prognosis doesn't look good.
2220,0,4,22,26,1.1538461538461537,0.07216024245882201,565,"Well, I can see how this pyrokinesis can be a problem for you, sir."
2220,0,4,22,26,1.1538461538461537,0.07216024245882201,565,You'll get results in six to eight weeks but there are some early warning signs.
2220,0,4,22,26,1.1538461538461537,0.07216024245882201,565,The good news is I now have no bad news to give you.
2220,1,2,23,26,1.1538461538461537,0.09101661204768642,565,The report says it's a severe case of heartburn.
2220,1,2,23,26,1.1538461538461537,0.09101661204768642,565,You still want to maintain my pyrokinesis is psychosomatic?
2220,0,4,22,26,1.1538461538461537,0.07216024245882201,565,You mentioned you had sex with an old flame.
2220,0,4,22,26,1.1538461538461537,0.07216024245882201,565,"Stanley, we've got back the results of the results of your hemorrhoid biopsy."
2220,0,4,22,26,1.1538461538461537,0.07216024245882201,565,"After we lost internet privacy, this is the new firewall for medical records."
2220,1,2,23,26,1.1538461538461537,0.09101661204768642,565,"Yes, I am familiar with the research but you really need to rethink the size of your capsaicin patch."
2220,1,2,23,26,1.1538461538461537,0.09101661204768642,565,Looks like too much hot sauce on your Pad Thai.
2220,0,4,22,26,1.1538461538461537,0.07216024245882201,565,Your chart is alarming
2220,0,4,22,26,1.1538461538461537,0.07216024245882201,565,HIPAA doesn't allow me to keep paper records.
2220,2,0,24,26,1.1538461538461537,0.10658774200423862,565,You definitely need to take this with a full glass of water.
2220,2,0,24,26,1.1538461538461537,0.10658774200423862,565,"Sorry, these new patient confidentiality rules still need some tweaking."
2220,0,4,22,26,1.1538461538461537,0.07216024245882201,565,This may singe.
2220,0,4,22,26,1.1538461538461537,0.07216024245882201,565,I want you to ease off on the high metabolism diet.
2220,1,2,23,26,1.1538461538461537,0.09101661204768642,565,"Can't wait to see ""replace""!"
2220,1,2,23,26,1.1538461538461537,0.09101661204768642,565,The nurse said your temperature seemed a little high.
2220,0,4,22,26,1.1538461538461537,0.07216024245882201,565,I recommended a stronger anti-inflammatory.
2220,1,2,23,26,1.1538461538461537,0.09101661204768642,565,"This is a bad omen, Jerry; do you have an advance directive?"
2220,1,2,23,26,1.1538461538461537,0.09101661204768642,565,"You are healthy again, I am burning your medical records!"
2220,0,4,22,26,1.1538461538461537,0.07216024245882201,565,"I'm guessing that ""replace"" won't be nearly as dramatic as ""repeal."""
2220,1,2,23,26,1.1538461538461537,0.09101661204768642,565,We really need to bring your fever down.
2220,1,2,23,26,1.1538461538461537,0.09101661204768642,565,Please urgently help me put out this fire. I am going to get into trouble if the fire alarm goes off.
2220,0,4,22,26,1.1538461538461537,0.07216024245882201,565,I think we need to cut back on your fiber.
2220,1,2,23,26,1.1538461538461537,0.09101661204768642,565,"My staff really, really wants me to go paperless."
2220,0,4,22,26,1.1538461538461537,0.07216024245882201,565,Possible side effects include a burning sensation.
2220,1,2,23,26,1.1538461538461537,0.09101661204768642,565,We found what's been causing your heartburn.
2220,1,2,23,26,1.1538461538461537,0.09101661204768642,565,"The smoke on your previous tests were,obviously, quite accurate."
2220,1,2,23,26,1.1538461538461537,0.09101661204768642,565,It's part of managements new efficiency drive to see more patients.
2220,1,2,23,26,1.1538461538461537,0.09101661204768642,565,Hell of a chart you've got here.
2220,0,4,22,26,1.1538461538461537,0.07216024245882201,565,We have noted a slight inflamation.
2220,0,4,22,26,1.1538461538461537,0.07216024245882201,565,"Good thing you're sitting down, Mr. Morningstar."
2220,1,2,23,26,1.1538461538461537,0.09101661204768642,565,Does this LOOK like a benign diagnosis?
2220,1,2,23,26,1.1538461538461537,0.09101661204768642,565,I like to think of myself as the Jimi Hendrix of medicine.
2220,0,4,22,26,1.1538461538461537,0.07216024245882201,565,You're covered under the Affordable Char Act
2220,1,2,23,26,1.1538461538461537,0.09101661204768642,565,As your doctor I recommend against carrying an old flame.
2220,1,2,23,26,1.1538461538461537,0.09101661204768642,565,"You may not be burning in hell, but your lab results are."
2220,1,2,23,26,1.1538461538461537,0.09101661204768642,565,You have to cut out the Carolina Reapers.
2220,0,4,22,26,1.1538461538461537,0.07216024245882201,565,We're doing a trial run of the Libertarian replacement plan for the ACA.
2220,0,4,22,26,1.1538461538461537,0.07216024245882201,565,Maybe radiation from the sun?
2220,0,4,22,26,1.1538461538461537,0.07216024245882201,565,Are you experiencing a burning sensation?
2220,0,4,22,26,1.1538461538461537,0.07216024245882201,565,Your records appear to indicate some inflammation.
2220,2,0,24,26,1.1538461538461537,0.10658774200423862,565,"I see your coverage has spontaneously cumbusted, but my assistant will be happy to work out a payment plan for you."
2220,1,2,23,26,1.1538461538461537,0.09101661204768642,565,It seems your test results are classified.
2220,1,2,23,26,1.1538461538461537,0.09101661204768642,565,"I have your results, but under Trumpcare I'm required to burn them."
2220,0,4,22,26,1.1538461538461537,0.07216024245882201,565,Looks like possession to me.
2220,0,4,22,26,1.1538461538461537,0.07216024245882201,565,"I'm sorry. The test is definite for ""emission impossible""."
2220,1,2,23,26,1.1538461538461537,0.09101661204768642,565,This pharm is on fire!
2220,2,0,24,26,1.1538461538461537,0.10658774200423862,565,You may have contracted this in 2016
2220,1,2,23,26,1.1538461538461537,0.09101661204768642,565,These new HIPAA privacy regulations are getting out of control.
2220,1,2,23,26,1.1538461538461537,0.09101661204768642,565,Your lab tests show a high level of inflammation.
2220,1,2,23,26,1.1538461538461537,0.09101661204768642,565,Nice try Mr. We are still able to bill you.
2220,1,2,23,26,1.1538461538461537,0.09101661204768642,565,Consumption.
2220,0,4,22,26,1.1538461538461537,0.07216024245882201,565,We take confidentiality very seriously
2220,1,2,23,26,1.1538461538461537,0.09101661204768642,565,The Flammable Care Act.
2220,1,2,23,26,1.1538461538461537,0.09101661204768642,565,i'm afraid it's not just heartburn.
2220,1,2,23,26,1.1538461538461537,0.09101661204768642,565,Are you sure that nothing has changed in your diet?
2220,0,4,22,26,1.1538461538461537,0.07216024245882201,565,I'm afraid there's nothing we can do. This contract was signed in your blood.
2220,0,4,22,26,1.1538461538461537,0.07216024245882201,565,Wow! Nobody knew how complex health care is! Wow - Nobody knew how complex health care is!
2220,2,0,24,26,1.1538461538461537,0.10658774200423862,565,It appears your insurance company has decided not to pre certify your knee surgery
2220,0,4,22,26,1.1538461538461537,0.07216024245882201,565,"Sure, it's not all good news . . ."
2220,0,4,22,26,1.1538461538461537,0.07216024245882201,565,Soooooo...apparently that conference after party you attended was lit.
2220,1,2,23,26,1.1538461538461537,0.09101661204768642,565,Well...Somethings inflamed that's for sure.
2388,1,2,24,27,1.1481481481481481,0.08776593618660604,565,"I'm sorry, but your insurance doesn't cover heat vision."
2388,1,2,24,27,1.1481481481481481,0.08776593618660604,565,Okay. but getting rid of today's test results won't change the fact that it is still a pre-existing condition.
2390,0,3,20,23,1.1304347826086956,0.07180198468215397,565,It says you have Inflammatory Vowel Disease
2390,0,3,20,23,1.1304347826086956,0.07180198468215397,565,"It's true -- your eyes shoot deadly laser beams. On the upside, you have 20/20 vision."
2390,0,3,20,23,1.1304347826086956,0.07180198468215397,565,"I ordered X-rays, not X-ray eyes."
2390,0,3,20,23,1.1304347826086956,0.07180198468215397,565,THE REPORT IS BOTH FLAMMABLE AND INFLAMMABLE.
2390,1,1,21,23,1.1304347826086956,0.09543633571264536,565,Spontaneous combustion. It's a new HIPPA protocol.
2390,0,3,20,23,1.1304347826086956,0.07180198468215397,565,As a control I had the lab test your blood for demonic possession. You'll be happy to know you don't have any STD's.
2390,0,3,20,23,1.1304347826086956,0.07180198468215397,565,Burning news on the results!
2390,0,3,20,23,1.1304347826086956,0.07180198468215397,565,You really need to cut out spicy foods!
2390,0,3,20,23,1.1304347826086956,0.07180198468215397,565,"Please let me read you the results, and if time permits I'll take questions."
2390,1,1,21,23,1.1304347826086956,0.09543633571264536,565,We need to add more phosphate to your diet.
2390,0,3,20,23,1.1304347826086956,0.07180198468215397,565,It's not such bad news.
2390,1,1,21,23,1.1304347826086956,0.09543633571264536,565,You're running a fever.
2390,0,3,20,23,1.1304347826086956,0.07180198468215397,565,You're going to Hell
2390,0,3,20,23,1.1304347826086956,0.07180198468215397,565,It's time we reconsider the standing desk.
2390,1,1,21,23,1.1304347826086956,0.09543633571264536,565,"Yes, I suppose it is better than self-immolation."
2390,0,3,20,23,1.1304347826086956,0.07180198468215397,565,Sorry. Obamacare was just repealed.
2390,0,3,20,23,1.1304347826086956,0.07180198468215397,565,"Your test results are in, Mr. Butterworth, and I'm afraid they're not good."
2390,0,3,20,23,1.1304347826086956,0.07180198468215397,565,I've got good news and bad news.
2390,0,3,20,23,1.1304347826086956,0.07180198468215397,565,When did you start eating Mexican food?
2390,0,3,20,23,1.1304347826086956,0.07180198468215397,565,I think the referral is being denied.
2390,1,1,21,23,1.1304347826086956,0.09543633571264536,565,"Your angst is now considered a pre-existing condition!"" ""Nope, no coverage for anything less than death!"
2390,0,3,20,23,1.1304347826086956,0.07180198468215397,565,"I burn your file, which means one less malpractice suit, and then your insurance rates go down."
2390,0,3,20,23,1.1304347826086956,0.07180198468215397,565,Your diagnosis is you got a hunk-a hunk-a burning love
2390,0,3,20,23,1.1304347826086956,0.07180198468215397,565,So you think I'm a better pyrotechnician?
2390,0,3,20,23,1.1304347826086956,0.07180198468215397,565,I have your test results here in my hot little hands.
2390,0,3,20,23,1.1304347826086956,0.07180198468215397,565,Blow it out and make a wish—you won't be having a birthday this year.
2390,0,3,20,23,1.1304347826086956,0.07180198468215397,565,Test results definitely suggest hemmorhoids.
2390,0,3,20,23,1.1304347826086956,0.07180198468215397,565,I recommend you lay off spicy foods for six months and drink lots of water.
2390,0,3,20,23,1.1304347826086956,0.07180198468215397,565,??????????????
2390,1,1,21,23,1.1304347826086956,0.09543633571264536,565,"Now that you've seen your test results, privacy laws require me to destroy them."
2390,1,1,21,23,1.1304347826086956,0.09543633571264536,565,Bad day to give up drinking.
2390,0,3,20,23,1.1304347826086956,0.07180198468215397,565,Here's a prescription for Lucifrex. Side effects may include…
2390,0,3,20,23,1.1304347826086956,0.07180198468215397,565,And this is only step 3 of their effort to force us to switch to online patient records.
2390,0,3,20,23,1.1304347826086956,0.07180198468215397,565,Your blood pressure is a little high.
2390,1,1,21,23,1.1304347826086956,0.09543633571264536,565,Its official your going to Hell.
2390,0,3,20,23,1.1304347826086956,0.07180198468215397,565,"Well, Mr. Donahue, it looks like you have an advanced case of COE (cocktail-olive eyes). And it's contagious. Not sure what these flames or leaves or tentacles are emanating from your report, but that's neither here nor there."
2390,1,1,21,23,1.1304347826086956,0.09543633571264536,565,Your tests indicate a self destructive lifestyle.
2390,1,1,21,23,1.1304347826086956,0.09543633571264536,565,"So, your results are less positive than we weee hoping for..."
2390,0,3,20,23,1.1304347826086956,0.07180198468215397,565,"Trust me, the bill will be worse."
2390,1,1,21,23,1.1304347826086956,0.09543633571264536,565,"Your temperature is high, Mr. Bradbury. Fahrenheit 451."
2390,1,1,21,23,1.1304347826086956,0.09543633571264536,565,"Well, we got a clear result back."
2390,1,1,21,23,1.1304347826086956,0.09543633571264536,565,We forgot to pay the heating bill.
2390,0,3,20,23,1.1304347826086956,0.07180198468215397,565,"Well, clearly it's severe heartburn!"
2390,0,3,20,23,1.1304347826086956,0.07180198468215397,565,Now I understand why you have that burning feeling in your stomach!
2390,0,3,20,23,1.1304347826086956,0.07180198468215397,565,Heartburn
2390,0,3,20,23,1.1304347826086956,0.07180198468215397,565,"It's getting hot in here, so take off all your clothes..."
2390,0,3,20,23,1.1304347826086956,0.07180198468215397,565,You have a case of spontaneous combustion.
2390,0,3,20,23,1.1304347826086956,0.07180198468215397,565,Your insurance doesn't cover pre-existing conditions.
2390,1,1,21,23,1.1304347826086956,0.09543633571264536,565,Let me get this sraaight. You signed a contract with a guy with pointy ears and a pitchfork .?
2390,0,3,20,23,1.1304347826086956,0.07180198468215397,565,This is fine.
2390,0,3,20,23,1.1304347826086956,0.07180198468215397,565,This is all that TrumpCare would allow.
2390,0,3,20,23,1.1304347826086956,0.07180198468215397,565,I see you've been busy since your last check-up.
2390,1,1,21,23,1.1304347826086956,0.09543633571264536,565,Your scoville levels are off the charts.
2390,1,1,21,23,1.1304347826086956,0.09543633571264536,565,HIPAA compliance is going to be hell when we switch to electronic records.
2390,0,3,20,23,1.1304347826086956,0.07180198468215397,565,"Nothing to be embarrassed about, Mr. Torch. Just a little super power incontinence."
2390,1,1,21,23,1.1304347826086956,0.09543633571264536,565,"Your HIV test came back positive, eveything's great again."
2390,0,3,20,23,1.1304347826086956,0.07180198468215397,565,"A nasty computer virus has infected your test results, and you are not insured."
2390,0,3,20,23,1.1304347826086956,0.07180198468215397,565,...and this is your gut on pizza.
2390,0,3,20,23,1.1304347826086956,0.07180198468215397,565,"Say ""ooooohhhh"""
2390,1,1,21,23,1.1304347826086956,0.09543633571264536,565,The lab report is remarkable for inflammatory parameters.
2390,0,3,20,23,1.1304347826086956,0.07180198468215397,565,This is from your health care provider -- they're denying coverage.
2390,0,3,20,23,1.1304347826086956,0.07180198468215397,565,According to our records you're running a very high fever.
2390,0,3,20,23,1.1304347826086956,0.07180198468215397,565,"Relax; it's just a letter from my wife's lawyer."""
2390,1,1,21,23,1.1304347826086956,0.09543633571264536,565,Your dietary plan is going up in smoke.
2390,0,3,20,23,1.1304347826086956,0.07180198468215397,565,"A second opinion? No, I'm reasonably sure it's heartburn."
2390,0,3,20,23,1.1304347826086956,0.07180198468215397,565,"First, I'll start with what the Internet told you was wrong."
2390,1,1,21,23,1.1304347826086956,0.09543633571264536,565,"OK, but tell me what you really think."
2390,1,1,21,23,1.1304347826086956,0.09543633571264536,565,I'm afraid you have inflammatory vowel disease.
2390,0,3,20,23,1.1304347826086956,0.07180198468215397,565,Not a suitable diagnosis for the updated insurance coverage.
2390,1,1,21,23,1.1304347826086956,0.09543633571264536,565,And I thought your tendonitis was inflamed.
2390,0,3,20,23,1.1304347826086956,0.07180198468215397,565,I'm trying to develop a warmer bedside manner.
2390,0,3,20,23,1.1304347826086956,0.07180198468215397,565,Our handling of your data is robust against post-processing and adaptive composition.
2390,1,1,21,23,1.1304347826086956,0.09543633571264536,565,"I'm sorry about your results, but this is President Trump's way of repealing the Affordable Care Act."
2390,0,3,20,23,1.1304347826086956,0.07180198468215397,565,Your esophageal pH monitor results are in...
2390,1,1,21,23,1.1304347826086956,0.09543633571264536,565,"Ahh, I see you have a deal with the devil."
2390,0,3,20,23,1.1304347826086956,0.07180198468215397,565,"According to the chart, your temperature is extremely high."
2390,0,3,20,23,1.1304347826086956,0.07180198468215397,565,"Yes, we take medical record privacy quite seriously."
2390,0,3,20,23,1.1304347826086956,0.07180198468215397,565,The good news is we won't have to do an MRI.
2390,0,3,20,23,1.1304347826086956,0.07180198468215397,565,We got the results back on your mixtape.
2390,0,3,20,23,1.1304347826086956,0.07180198468215397,565,Let's go with a bland diet.
2390,0,3,20,23,1.1304347826086956,0.07180198468215397,565,Is this what your hemorrhoids feel like?
2390,1,1,21,23,1.1304347826086956,0.09543633571264536,565,"I'm sorry mister Vey, it seems health insurance is allergic to you."
2390,0,3,20,23,1.1304347826086956,0.07180198468215397,565,My handwriting was too legible.
2390,0,3,20,23,1.1304347826086956,0.07180198468215397,565,"Well, Mr. Carver, given those symptoms it might very well be contagious."
2390,0,3,20,23,1.1304347826086956,0.07180198468215397,565,WOW!! This is a really super-hot diagnosis!!
2390,0,3,20,23,1.1304347826086956,0.07180198468215397,565,This is how I make my handwriting even more illegible.
2390,1,1,21,23,1.1304347826086956,0.09543633571264536,565,Now we'll feed the fever.
2390,0,3,20,23,1.1304347826086956,0.07180198468215397,565,I'm sorry but your HMO has just notified me to extinguish your policy.
2390,0,3,20,23,1.1304347826086956,0.07180198468215397,565,"I'm afraid your condition in no longer considered ""smoldering""."
2390,0,3,20,23,1.1304347826086956,0.07180198468215397,565,Will you be needing to see me again?
2390,0,3,20,23,1.1304347826086956,0.07180198468215397,565,Your inflammation may be contagious.
2390,0,3,20,23,1.1304347826086956,0.07180198468215397,565,"Well, we were warned that medical records were becoming an increasingly hot topic."
2390,0,3,20,23,1.1304347826086956,0.07180198468215397,565,I'm thinking maybe a new statin.
2390,1,1,21,23,1.1304347826086956,0.09543633571264536,565,Your lab results are somewhat alarming.
2390,1,1,21,23,1.1304347826086956,0.09543633571264536,565,The good news is that I know what's wrong with you. The bad news is that I no longer take your insurance.
2390,1,1,21,23,1.1304347826086956,0.09543633571264536,565,your insurance doesn't cover pulmonary testing equipment- see if you can blow this out
2390,0,3,20,23,1.1304347826086956,0.07180198468215397,565,"Well, your inflammation test results are a little alarming."
2390,0,3,20,23,1.1304347826086956,0.07180198468215397,565,"I'm duty-bound to warn you that this bill may cause a burning sensation, heart palpitations, and dry mouth."
2390,1,1,21,23,1.1304347826086956,0.09543633571264536,565,Do you feel a burning sensation? Because I do.
2390,0,3,20,23,1.1304347826086956,0.07180198468215397,565,Hugh Hefner would be jealous.
2390,0,3,20,23,1.1304347826086956,0.07180198468215397,565,Samsung should really recall these clipboards.
2390,0,3,20,23,1.1304347826086956,0.07180198468215397,565,Your testosterone numbers are off the chart. NOTE: I SUBMITTED THIS EARLIER UNDER MY OWN NAME (DAVE EITEL) BY MISTAKE. THIS CAPTION IS BY MIKE HEALY (INFO BELOW) PLEASE DISREGARD MY ERRONEOUS ENTRY.
2390,0,3,20,23,1.1304347826086956,0.07180198468215397,565,Unfortunately it's more than just heartburn.
2390,0,3,20,23,1.1304347826086956,0.07180198468215397,565,This urine sample looks like a new STD.
2390,1,1,21,23,1.1304347826086956,0.09543633571264536,565,"As you see, we preserve your privacy."
2390,1,1,21,23,1.1304347826086956,0.09543633571264536,565,I'm afraid your condition will require a stronger anti-inflammatory medication.
2390,0,3,20,23,1.1304347826086956,0.07180198468215397,565,"This is your prescription should you choose to accept it. As always, if it causes your death we will deny any knowledge of your actions. This paper will self-destruct in - whoops, too late."
2390,1,1,21,23,1.1304347826086956,0.09543633571264536,565,"Mr. Jones, you have the worst case of heartburn I have EVER seen!"
2390,1,1,21,23,1.1304347826086956,0.09543633571264536,565,Your test results indicate that you are at risk of spontaneous combustion.
2390,0,3,20,23,1.1304347826086956,0.07180198468215397,565,"No, '-itis' means inflammation, not '-osis'."
2390,0,3,20,23,1.1304347826086956,0.07180198468215397,565,These results suggest it's a little worse than a cold.
2390,0,3,20,23,1.1304347826086956,0.07180198468215397,565,We take HIPPA seriously in our office.
2390,0,3,20,23,1.1304347826086956,0.07180198468215397,565,Then you say the fire incantation and you'll be fine!
2390,1,1,21,23,1.1304347826086956,0.09543633571264536,565,"Well look at that, Mr. Ryan! Healthcare really is exploding."
2390,1,1,21,23,1.1304347826086956,0.09543633571264536,565,"I'm sorry sir, your policy doesn't cover storage of your medical record and I wouldn't want it to get into the wrong hands."
2390,0,3,20,23,1.1304347826086956,0.07180198468215397,565,The polyps are the least of it.
2390,1,1,21,23,1.1304347826086956,0.09543633571264536,565,It's your blood pressure: 200/100.
2390,0,3,20,23,1.1304347826086956,0.07180198468215397,565,"I may feel a burning sensation, but nothing to be concerned about."
2390,1,1,21,23,1.1304347826086956,0.09543633571264536,565,"I'd like to see your inflammation numbers come down a bit, Mr. Henderson."
2390,0,3,20,23,1.1304347826086956,0.07180198468215397,565,"Apparently, we don't take your insurance..."
2390,1,1,21,23,1.1304347826086956,0.09543633571264536,565,I think you should cut back on the spicy food.
2390,0,3,20,23,1.1304347826086956,0.07180198468215397,565,Your health care has been repealed.
2390,0,3,20,23,1.1304347826086956,0.07180198468215397,565,"Well Mr. Johnson, let's just say your heartburn results are off the charts!"
2390,0,3,20,23,1.1304347826086956,0.07180198468215397,565,Well I'm feeling a burning sensation.
2390,0,3,20,23,1.1304347826086956,0.07180198468215397,565,Your lab results are fine. These are your insurance forms.
2390,0,3,20,23,1.1304347826086956,0.07180198468215397,565,"Why, yes Mr. Hunt. Your lab results always self-destruct within five seconds."
2390,1,1,21,23,1.1304347826086956,0.09543633571264536,565,Your heartburn is obviously contagious.
2390,1,1,21,23,1.1304347826086956,0.09543633571264536,565,Oops! I guess I'll give you another six months.
2390,0,3,20,23,1.1304347826086956,0.07180198468215397,565,"Good morning Mr. Phelps. Your mission, should you choose to accept it, is to restore Obamacare. This message will self-destruct in five seconds."""
2390,0,3,20,23,1.1304347826086956,0.07180198468215397,565,"No worries, I have experience in stop, drop, and rolling paper"
2390,0,3,20,23,1.1304347826086956,0.07180198468215397,565,"You don't want to see the results, believe me."
2390,0,3,20,23,1.1304347826086956,0.07180198468215397,565,This is necessary to claim Medicare benefits.
2390,0,3,20,23,1.1304347826086956,0.07180198468215397,565,Test results fresh out the oven.
2390,1,1,21,23,1.1304347826086956,0.09543633571264536,565,It burns when I pee.
2390,1,1,21,23,1.1304347826086956,0.09543633571264536,565,This way we'll both get a fresh start.
2390,0,3,20,23,1.1304347826086956,0.07180198468215397,565,Your test results indicate heartburn.
2390,0,3,20,23,1.1304347826086956,0.07180198468215397,565,Trump's HIPPA.
2390,0,3,20,23,1.1304347826086956,0.07180198468215397,565,You're hot-blooded...check it and see.
2390,1,1,21,23,1.1304347826086956,0.09543633571264536,565,It's the new low tech Note from Samsung.
2390,0,3,20,23,1.1304347826086956,0.07180198468215397,565,"There's a bit of good news in these results, Mr. Smith. You won't be needing a follow-up appointment."
2390,1,1,21,23,1.1304347826086956,0.09543633571264536,565,Your records indicate you're a hot mess.
2390,0,3,20,23,1.1304347826086956,0.07180198468215397,565,It's your Obama Care . . . self-destructing . . . .
2390,0,3,20,23,1.1304347826086956,0.07180198468215397,565,Your insurance coverage is a little toasty.
2390,0,3,20,23,1.1304347826086956,0.07180198468215397,565,Your previous doctor noted a burning sensation.
2390,0,3,20,23,1.1304347826086956,0.07180198468215397,565,Some hot issues in your new policy here.
2390,1,1,21,23,1.1304347826086956,0.09543633571264536,565,"Okay, setting your lab results on fire won't make them go away,"
2390,1,1,21,23,1.1304347826086956,0.09543633571264536,565,Bad news or good news first?
2390,1,1,21,23,1.1304347826086956,0.09543633571264536,565,I'm afraid you're evil.
2390,0,3,20,23,1.1304347826086956,0.07180198468215397,565,Your acid reflux is flaring up again.
2390,0,3,20,23,1.1304347826086956,0.07180198468215397,565,It's a prescription for Antacids.
2390,0,3,20,23,1.1304347826086956,0.07180198468215397,565,"... and in accordance with medical privacy laws, these test results will self-destruct in 5 ... 4 ... 3 ..."
2390,0,3,20,23,1.1304347826086956,0.07180198468215397,565,I'd like to run some more tests on your mental telepathy.
2390,0,3,20,23,1.1304347826086956,0.07180198468215397,565,Tell me again for how long you've felt feverish.
2390,0,3,20,23,1.1304347826086956,0.07180198468215397,565,All signs point to heartburn.
2390,0,3,20,23,1.1304347826086956,0.07180198468215397,565,"As a medical student, I can see that your chart is on fire...but I'm just not sure what that means."
2390,0,3,20,23,1.1304347826086956,0.07180198468215397,565,They say what you don't know can't kill you.
2390,0,3,20,23,1.1304347826086956,0.07180198468215397,565,Our records indicate you have Obamacare.
2390,0,3,20,23,1.1304347826086956,0.07180198468215397,565,Now I'll test your reflexes.
2390,1,1,21,23,1.1304347826086956,0.09543633571264536,565,Your charts indicate that you received a fuel injection.
2390,1,1,21,23,1.1304347826086956,0.09543633571264536,565,HIPAA schmipaa! We prefer our old-fashioned methods of ensuring our patients' confidentiality.
2390,1,1,21,23,1.1304347826086956,0.09543633571264536,565,You're right...you've got a fever hot enough to set paper on fire.
2390,0,3,20,23,1.1304347826086956,0.07180198468215397,565,After this butns we can move on to the prostate exam.
2390,0,3,20,23,1.1304347826086956,0.07180198468215397,565,"Well, your insurance wasn't going to cover it anyway."
2390,1,1,21,23,1.1304347826086956,0.09543633571264536,565,"Mr. Miller, Your test results indicate that you're a possible candidate for spontaneous human combustion."
2390,0,3,20,23,1.1304347826086956,0.07180198468215397,565,"Setting fire to your diagnosis doesn't make it go away, you know."
2390,0,3,20,23,1.1304347826086956,0.07180198468215397,565,I am now required to ensure you have complete freedom to make your own healthcare decisions
2390,0,3,20,23,1.1304347826086956,0.07180198468215397,565,Your test result was lit.
2390,1,1,21,23,1.1304347826086956,0.09543633571264536,565,"Sorry, when the inflammation has spread this far, there's little I can do."
2390,0,3,20,23,1.1304347826086956,0.07180198468215397,565,"These results are too hot for me, here's a specialist you should see."
2390,1,1,21,23,1.1304347826086956,0.09543633571264536,565,"""Trust me. Your insurance reimbursement never happened."
2390,0,3,20,23,1.1304347826086956,0.07180198468215397,565,Guess who has gonorrhea ?
2390,0,3,20,23,1.1304347826086956,0.07180198468215397,565,I thought these were your pants
2390,0,3,20,23,1.1304347826086956,0.07180198468215397,565,This is the last paternity test I am going to burn for you. After this you're on your own.
2390,1,1,21,23,1.1304347826086956,0.09543633571264536,565,The good new is it's an outflamation
2390,0,3,20,23,1.1304347826086956,0.07180198468215397,565,Your temperature is completely off the chart!
2390,0,3,20,23,1.1304347826086956,0.07180198468215397,565,I told you there'd be hell to pay.
2390,1,1,21,23,1.1304347826086956,0.09543633571264536,565,"Yes, when your blood pressure number becomes flammable, it is an indication of a cause for concern."
2390,1,1,21,23,1.1304347826086956,0.09543633571264536,565,"...and the disease will consume your body, just as the fire consumes this piece of paper. But you needn't worry --- I have plenty of paper."
2390,0,3,20,23,1.1304347826086956,0.07180198468215397,565,"I don't want to jump to conclusions but, well, when you add matches to tinder..."
2390,0,3,20,23,1.1304347826086956,0.07180198468215397,565,I still don't think it's inflammation.
2390,0,3,20,23,1.1304347826086956,0.07180198468215397,565,I'm uploading your file to the cloud.
2390,0,3,20,23,1.1304347826086956,0.07180198468215397,565,But I doubt you want to hear the good news anyway.
2390,1,1,21,23,1.1304347826086956,0.09543633571264536,565,"Your fine, but I'm afraid your health insurance isn't."
2390,0,3,20,23,1.1304347826086956,0.07180198468215397,565,You're going to die and then go to hell.
2390,0,3,20,23,1.1304347826086956,0.07180198468215397,565,We're transitioning to pyrotechnic medical records.
2390,1,1,21,23,1.1304347826086956,0.09543633571264536,565,This may be a bit uncomfortable.
2390,0,3,20,23,1.1304347826086956,0.07180198468215397,565,"Henry, the lab work indicates your heartburn is pretty severe."
2390,0,3,20,23,1.1304347826086956,0.07180198468215397,565,Your heartburn is much worse than I thought.
2390,1,1,21,23,1.1304347826086956,0.09543633571264536,565,Maybe you should get a second opinion.
2390,0,3,20,23,1.1304347826086956,0.07180198468215397,565,"Your biopsy is fine, but there's a problem with your insurance."
2390,0,3,20,23,1.1304347826086956,0.07180198468215397,565,Bad news or good news first?
2390,1,1,21,23,1.1304347826086956,0.09543633571264536,565,Our newest medical algorithms suggest you have 45 seconds to live.
2390,0,3,20,23,1.1304347826086956,0.07180198468215397,565,This is your chart. This is your chart on fire.
2390,1,1,21,23,1.1304347826086956,0.09543633571264536,565,It appears to just be some chart burn.
2390,1,1,21,23,1.1304347826086956,0.09543633571264536,565,You have the medical bill match plan.
2390,0,3,20,23,1.1304347826086956,0.07180198468215397,565,This doesn't mean I'm not confident in the diagnosis.
2390,1,1,21,23,1.1304347826086956,0.09543633571264536,565,"Although Johnny Storm left the world of superheroes to study, go to medical school and become a doctor; he often found that he couldn't escape his younger alter ego."
2390,1,1,21,23,1.1304347826086956,0.09543633571264536,565,"""Your test results show elevated acid re-flux levels""!"
2390,1,1,21,23,1.1304347826086956,0.09543633571264536,565,Not sure I like the new Snapchat app.
2390,1,1,21,23,1.1304347826086956,0.09543633571264536,565,"The new HIPPA regulations protect your privacy, of course......"
2390,1,1,21,23,1.1304347826086956,0.09543633571264536,565,"As we suspected, a hot appendix."
2390,0,3,20,23,1.1304347826086956,0.07180198468215397,565,The main thing is not too over-react.
2390,1,1,21,23,1.1304347826086956,0.09543633571264536,565,"Uhh, the diagnostic shows your heart burn might be more severe than we thought..."
2390,0,3,20,23,1.1304347826086956,0.07180198468215397,565,Your records indicate the worst case if inflammation I have ever seen.
2390,1,1,21,23,1.1304347826086956,0.09543633571264536,565,I would suggest calling Joe Bornstein.
2390,1,1,21,23,1.1304347826086956,0.09543633571264536,565,This info-sheet should help you better understand your panic disorder.
2390,1,1,21,23,1.1304347826086956,0.09543633571264536,565,"Sorry, Charlie, your Devils Food Cake days are over."
2390,1,1,21,23,1.1304347826086956,0.09543633571264536,565,"""Oh dear….I see you didn't pay your concierge fees…..:"
2390,0,3,20,23,1.1304347826086956,0.07180198468215397,565,"Do you want to hear the bad news or the worse news--hurry, time's a wast'n."
2390,1,1,21,23,1.1304347826086956,0.09543633571264536,565,Worst case of hemorrhoids I've ever seen!
2390,0,3,20,23,1.1304347826086956,0.07180198468215397,565,From our record to God's ear!
2390,1,1,21,23,1.1304347826086956,0.09543633571264536,565,This is yet one more example of the dangers of smoking.
2390,1,1,21,23,1.1304347826086956,0.09543633571264536,565,"It says ""Your disease is totally psychosomatic, you must leave this office and never return. These instructions will self-destruct in thirty seconds"".... oops."
2390,0,3,20,23,1.1304347826086956,0.07180198468215397,565,You're probably not going to like this.....
2390,1,1,21,23,1.1304347826086956,0.09543633571264536,565,You're either having hot flashes or your pants are on fire. Our tests were inconclusive.
2390,0,3,20,23,1.1304347826086956,0.07180198468215397,565,Your temperature is rather high.
2390,1,1,21,23,1.1304347826086956,0.09543633571264536,565,Your perscrition is on fire (doctor).
2390,1,1,21,23,1.1304347826086956,0.09543633571264536,565,"It appears, Mr. Cash, that you've fallen in to a burning ring of fire."
2390,1,1,21,23,1.1304347826086956,0.09543633571264536,565,It's time we took the next step. There is a Preparation J.
2390,0,3,20,23,1.1304347826086956,0.07180198468215397,565,"How did you do that, Mr. Green?"
2390,1,1,21,23,1.1304347826086956,0.09543633571264536,565,"Medical Marijuana's final hurdle: Zeus, god of lightning."
2390,0,3,20,23,1.1304347826086956,0.07180198468215397,565,I want to assure you that your personal information will not be compromised
2390,0,3,20,23,1.1304347826086956,0.07180198468215397,565,I've never seen this before...
2390,1,1,21,23,1.1304347826086956,0.09543633571264536,565,This has a 70% success rate among fire swallowers.
2390,0,3,20,23,1.1304347826086956,0.07180198468215397,565,We'll just tell your wife the results of your HIV test were inconclusive.
2390,1,1,21,23,1.1304347826086956,0.09543633571264536,565,"Well I’ll be darned, he was right. Obamacare just exploded."
2390,1,1,21,23,1.1304347826086956,0.09543633571264536,565,Crappy news Mrs. Smith.
2390,0,3,20,23,1.1304347826086956,0.07180198468215397,565,My diagnosis is Spontaneous Combustion Syndrome which is caused by inflated medical charges.
2390,0,3,20,23,1.1304347826086956,0.07180198468215397,565,Is the burning in your stomach like this ?
2390,0,3,20,23,1.1304347826086956,0.07180198468215397,565,"No, you don't have a fever. It's just hot in here."
2390,0,3,20,23,1.1304347826086956,0.07180198468215397,565,I am waiting for Congress to act before I create a new bill.
2390,1,1,21,23,1.1304347826086956,0.09543633571264536,565,"No one said getting old would be easy, Superman. You still have to pay your bill."
2390,1,1,21,23,1.1304347826086956,0.09543633571264536,565,There's too much evil in your diet.
2390,0,3,20,23,1.1304347826086956,0.07180198468215397,565,You're a wizard Harry!
2390,0,3,20,23,1.1304347826086956,0.07180198468215397,565,I think we know where you heat rash is coming from.
2390,0,3,20,23,1.1304347826086956,0.07180198468215397,565,Your lab report indicates hot flashes...
2390,0,3,20,23,1.1304347826086956,0.07180198468215397,565,"I see it as kind of biblical -- not religious, just kind of biblical. But no, it's definitely not good."
2390,1,1,21,23,1.1304347826086956,0.09543633571264536,565,"As I was saying, the second form of halitosis can be more difficult to treat."
2390,0,3,20,23,1.1304347826086956,0.07180198468215397,565,We're still working out the kinks of our new system.
2390,1,1,21,23,1.1304347826086956,0.09543633571264536,565,You definitely don't want the Russians getting their hands on this.
2390,0,3,20,23,1.1304347826086956,0.07180198468215397,565,On the other hand you're going someplace warm
2390,0,3,20,23,1.1304347826086956,0.07180198468215397,565,"Not the usual consent form, Mr. Phelps."
2390,0,3,20,23,1.1304347826086956,0.07180198468215397,565,This is why we will soon be switching to digital records.
2390,0,3,20,23,1.1304347826086956,0.07180198468215397,565,"And for my next trick, I'm going to ask you to not go like that."
2390,0,3,20,23,1.1304347826086956,0.07180198468215397,565,Your fever is off the charts!
2390,0,3,20,23,1.1304347826086956,0.07180198468215397,565,"So sorry, but it looks like your Obamacare has just been repealed and replaced with Trumpcare."
2390,1,1,21,23,1.1304347826086956,0.09543633571264536,565,Our lab techs are quite flamboyant.
2390,0,3,20,23,1.1304347826086956,0.07180198468215397,565,The diagnosis is confirmed. Inflamed hemorrhoids.
2390,0,3,20,23,1.1304347826086956,0.07180198468215397,565,Just leave this with the receptionist. She'll forward the ashes to President Trump.
2390,0,3,20,23,1.1304347826086956,0.07180198468215397,565,You'll be dead before I can finish reading this.
2390,0,3,20,23,1.1304347826086956,0.07180198468215397,565,"Sorry, new HIPAA rules, I can only read your lab results out of a burning piece of paper"
2390,1,1,21,23,1.1304347826086956,0.09543633571264536,565,The only thing to worry about now is HIPPA.
2390,0,3,20,23,1.1304347826086956,0.07180198468215397,565,I'm afraid you have dragon breath
2390,0,3,20,23,1.1304347826086956,0.07180198468215397,565,This is what happens when you don't stop smoking.
2390,1,1,21,23,1.1304347826086956,0.09543633571264536,565,Your tumor may present malignant effects.
2390,1,1,21,23,1.1304347826086956,0.09543633571264536,565,It appears that your Chartburn has flared up again
2390,1,1,21,23,1.1304347826086956,0.09543633571264536,565,What do you want it to be? Your bill? Or your diagnosis?
2390,0,3,20,23,1.1304347826086956,0.07180198468215397,565,"It's our implementation of HIPAA, nobody is going to see your medical records."
2390,1,1,21,23,1.1304347826086956,0.09543633571264536,565,I'd only worry if it explodes.
2390,0,3,20,23,1.1304347826086956,0.07180198468215397,565,I think these results explain why you're experiencing a burning sensation.
2390,0,3,20,23,1.1304347826086956,0.07180198468215397,565,You're gonna need to put ice on this
2390,0,3,20,23,1.1304347826086956,0.07180198468215397,565,Your healthcare plan will self-destruct in 3...2...1...
2390,0,3,20,23,1.1304347826086956,0.07180198468215397,565,I also request you not breath on the other staff members.
2390,1,1,21,23,1.1304347826086956,0.09543633571264536,565,"As you can see, your numbers are flying off the charts."
2390,1,1,21,23,1.1304347826086956,0.09543633571264536,565,How are you alive?
2390,0,3,20,23,1.1304347826086956,0.07180198468215397,565,Now you know why our hand writing is so notoriously bad.
2390,0,3,20,23,1.1304347826086956,0.07180198468215397,565,"No, your insurance policy does not cover that."
2390,0,3,20,23,1.1304347826086956,0.07180198468215397,565,"I thought you said lazy eye, not laser eye."
2390,1,1,21,23,1.1304347826086956,0.09543633571264536,565,"Med school was fine, but my dream was always the fire academy."
2390,0,3,20,23,1.1304347826086956,0.07180198468215397,565,"We were told our old reflex test wasn't ""engaging"" enough."
2390,1,1,21,23,1.1304347826086956,0.09543633571264536,565,Well looks like we know where you're going.
2390,0,3,20,23,1.1304347826086956,0.07180198468215397,565,"""Needless to say, some antibiotics will be in order""."
2390,1,1,21,23,1.1304347826086956,0.09543633571264536,565,You're not sick....you're just burned out.
2390,0,3,20,23,1.1304347826086956,0.07180198468215397,565,I'll bet you love asking these burning questions as you hold that clipboard in your hot little hands.
2390,0,3,20,23,1.1304347826086956,0.07180198468215397,565,It's irreversible.
2390,0,3,20,23,1.1304347826086956,0.07180198468215397,565,Your urine is 80 proof.
2390,0,3,20,23,1.1304347826086956,0.07180198468215397,565,This test proves you are a flaming queen.
2390,0,3,20,23,1.1304347826086956,0.07180198468215397,565,Your acid reflux isn't your only burning issue.
2390,0,3,20,23,1.1304347826086956,0.07180198468215397,565,"I'll admit, this latest medical record privacy requirement does seem extreme."
2390,0,3,20,23,1.1304347826086956,0.07180198468215397,565,"Whoa, it looks like your telekinesis levels are off the charts!"
2390,1,1,21,23,1.1304347826086956,0.09543633571264536,565,"Well, you're not the father, but I REALLY need to speak with the man who is."
2390,0,3,20,23,1.1304347826086956,0.07180198468215397,565,Positive for hemorrhoids.
2390,0,3,20,23,1.1304347826086956,0.07180198468215397,565,It seems your testosterone level is a tad too high.
2390,0,3,20,23,1.1304347826086956,0.07180198468215397,565,Only you can prevent forest fires
2390,0,3,20,23,1.1304347826086956,0.07180198468215397,565,I've got good news and bad news. BP is OK but your fever has gotten worse.
2390,1,1,21,23,1.1304347826086956,0.09543633571264536,565,"Sorry, it's a HIPAA requirement."
2390,1,1,21,23,1.1304347826086956,0.09543633571264536,565,"Your diagnosis, should you decide to accept it..."
2390,1,1,21,23,1.1304347826086956,0.09543633571264536,565,"Good morning, Mr. Phelps. Your diagnosis, should you decide to accept it, is....oh, crap."
2390,1,1,21,23,1.1304347826086956,0.09543633571264536,565,I'm writing you a new prescription. Make sure to take it with plenty of water.
2390,0,3,20,23,1.1304347826086956,0.07180198468215397,565,- There is your heartburn. We removed it from your history file.
2390,1,1,21,23,1.1304347826086956,0.09543633571264536,565,"If you accept this mission, the bad news is the enemy is inside you."
2390,1,1,21,23,1.1304347826086956,0.09543633571264536,565,"Your temperature appears here as 451 degrees, Fahrenheit."
2390,0,3,20,23,1.1304347826086956,0.07180198468215397,565,"Honestly, things don't look great."
2390,0,3,20,23,1.1304347826086956,0.07180198468215397,565,The test is conclusive - too many chilies in your diet.
2390,0,3,20,23,1.1304347826086956,0.07180198468215397,565,"Let's see: Heart Burn, Inflamed Bowels, Burning Fever,Firery Rash and Health Care Up in Smoke. It's not good George!"
2390,0,3,20,23,1.1304347826086956,0.07180198468215397,565,I suggest you cut back on the Sriracha sauce
2390,1,1,21,23,1.1304347826086956,0.09543633571264536,565,It's simply routine to burn everything you might have touched.
2390,1,1,21,23,1.1304347826086956,0.09543633571264536,565,It's not exactly good news...
2390,0,3,20,23,1.1304347826086956,0.07180198468215397,565,Our medical records office has just installed a new patient security system.
2390,1,1,21,23,1.1304347826086956,0.09543633571264536,565,Your fever seems to be contagious.
2390,0,3,20,23,1.1304347826086956,0.07180198468215397,565,I think I left yours on my desk.
2390,0,3,20,23,1.1304347826086956,0.07180198468215397,565,"Have you visited any foreign ""Hot Spots"" recently?"
2390,1,1,21,23,1.1304347826086956,0.09543633571264536,565,"Blood sugar OK; cholesterol is fine. But my god man, your capsaicin is through the roof!"
2390,0,3,20,23,1.1304347826086956,0.07180198468215397,565,Superman! I understand your frustration but using your Heat Vision superpower to destroy your ED diagnosis report won't help!
2390,0,3,20,23,1.1304347826086956,0.07180198468215397,565,"Before we discuss your lab results, how about a little magic trick to lighten the-- dammit!"
2390,0,3,20,23,1.1304347826086956,0.07180198468215397,565,Do you mind holding this for a minute while I check your blood pressure?
2390,1,1,21,23,1.1304347826086956,0.09543633571264536,565,You should see the women's charts.
2390,1,1,21,23,1.1304347826086956,0.09543633571264536,565,"So, you want the bad news or a marshmellow?"
2390,0,3,20,23,1.1304347826086956,0.07180198468215397,565,"Needless to say, your test results are burning up the charts."
2390,0,3,20,23,1.1304347826086956,0.07180198468215397,565,Any recent heartburn?
2390,0,3,20,23,1.1304347826086956,0.07180198468215397,565,"I'll need to send your labs to a specialist to review, but nothing to be concerned about until then."
2390,0,3,20,23,1.1304347826086956,0.07180198468215397,565,The inflammation has jumped a level of abstraction.
2390,0,3,20,23,1.1304347826086956,0.07180198468215397,565,"Well Joe, the results are in... looks like you have a particularly severe case of Inflammatory Bowel Syndrome...."
2390,0,3,20,23,1.1304347826086956,0.07180198468215397,565,This new treatment procedure is really catching fire!
2390,0,3,20,23,1.1304347826086956,0.07180198468215397,565,Let's not worry about that for now. Let's just focus on getting you better.
2390,1,1,21,23,1.1304347826086956,0.09543633571264536,565,I'm not convinced it's inflammation. Let's order more tests.
2390,0,3,20,23,1.1304347826086956,0.07180198468215397,565,"I'd love to show you your results but as you can see, they're on fire."
2390,1,1,21,23,1.1304347826086956,0.09543633571264536,565,"Open your mouth and say, ""Arrgghhhhh!!"""
2390,0,3,20,23,1.1304347826086956,0.07180198468215397,565,The only treatment I am permitted to offer under your current insurance is to read out the bible quotation on this piece of paper whilst setting it on fire.
2390,1,1,21,23,1.1304347826086956,0.09543633571264536,565,It's called The Mother Of All Health Care Plans
2390,0,3,20,23,1.1304347826086956,0.07180198468215397,565,To ensure patient privacy all test results are sent via an App that self-destructs within two minutes after reading.
2390,0,3,20,23,1.1304347826086956,0.07180198468215397,565,Congratulations Bob! You've been selected as our first Clinical Trial participant!
2390,1,1,21,23,1.1304347826086956,0.09543633571264536,565,I think we should try a statin.
2390,0,3,20,23,1.1304347826086956,0.07180198468215397,565,Let's up your dose of anti-oxidants.
2390,1,1,21,23,1.1304347826086956,0.09543633571264536,565,"Your diagnosis is telekinesis. Mr. Donovan, you are a fire starter."
2390,0,3,20,23,1.1304347826086956,0.07180198468215397,565,"If treated, your insurance company will disavow any knowledge of you"
2390,0,3,20,23,1.1304347826086956,0.07180198468215397,565,"You're fine. But your Trumpcare plan, not so good."
2390,0,3,20,23,1.1304347826086956,0.07180198468215397,565,Have you been feeling unusually warm?
2390,0,3,20,23,1.1304347826086956,0.07180198468215397,565,Let's give it a couple of days and see if it spreads.
2390,0,3,20,23,1.1304347826086956,0.07180198468215397,565,"It's your prostate results, but don't worry. Obamacare will pay for the test."
2390,0,3,20,23,1.1304347826086956,0.07180198468215397,565,"I got your lab results back from Mount Sinai, it says ""thou hast a tubular adenoma, thou mayst not eat of the flesh of beasts, I am the LORD."""
2390,0,3,20,23,1.1304347826086956,0.07180198468215397,565,"Let's just say, we'll expect payment in full before you leave."
2390,0,3,20,23,1.1304347826086956,0.07180198468215397,565,It's clear from the test results that your gallblader is inflamed
2390,0,3,20,23,1.1304347826086956,0.07180198468215397,565,Your hemmoroid tests are in
2390,0,3,20,23,1.1304347826086956,0.07180198468215397,565,I'm afraid it's more serious than heartburn.
2390,0,3,20,23,1.1304347826086956,0.07180198468215397,565,And this is your bill on drugs.
2390,0,3,20,23,1.1304347826086956,0.07180198468215397,565,Your inflamed colon seems to be spreading.
2390,0,3,20,23,1.1304347826086956,0.07180198468215397,565,Your health insurance expired.
2390,0,3,20,23,1.1304347826086956,0.07180198468215397,565,My Congressman has been warning me that the ACA would soon self destruct.
2390,1,1,21,23,1.1304347826086956,0.09543633571264536,565,This is your esophagus on spicy foods...any questions?
2390,1,1,21,23,1.1304347826086956,0.09543633571264536,565,It's our new sure-fire method for avoiding HIPAA violations.
2390,1,1,21,23,1.1304347826086956,0.09543633571264536,565,We've just started using Samsung for all our record keeping.
2390,1,1,21,23,1.1304347826086956,0.09543633571264536,565,New breakthrough treatment to burn cals fast!
2390,0,3,20,23,1.1304347826086956,0.07180198468215397,565,"Oh, so it actually burns when you pee..."
2390,0,3,20,23,1.1304347826086956,0.07180198468215397,565,Don't worry Mr. Smith this happens when I bill the insurance company.
2390,0,3,20,23,1.1304347826086956,0.07180198468215397,565,"I'm sorry, I pulled satan's file by mistake."
2390,0,3,20,23,1.1304347826086956,0.07180198468215397,565,This is what happens when your blood pressure's higher than your credit rating.
2390,0,3,20,23,1.1304347826086956,0.07180198468215397,565,Have you experienced many days when strange things occur?
2390,1,1,21,23,1.1304347826086956,0.09543633571264536,565,"This diagnosis, should you choose to accept it …"
2390,0,3,20,23,1.1304347826086956,0.07180198468215397,565,"Man, I really hate when this happens!"
2390,0,3,20,23,1.1304347826086956,0.07180198468215397,565,It's a new HIPAA precaution.
2390,1,1,21,23,1.1304347826086956,0.09543633571264536,565,I'm worried about these CO2 levels.
2390,1,1,21,23,1.1304347826086956,0.09543633571264536,565,"Ask yourself, 'Are you lucky?'"
2390,0,3,20,23,1.1304347826086956,0.07180198468215397,565,Any smoke getting in your eyes?
2390,0,3,20,23,1.1304347826086956,0.07180198468215397,565,Take this and don't call me in the morning!
2390,1,1,21,23,1.1304347826086956,0.09543633571264536,565,'You're Off the Charts now.'
2390,0,3,20,23,1.1304347826086956,0.07180198468215397,565,This is going to burn a bit.....
2390,0,3,20,23,1.1304347826086956,0.07180198468215397,565,liar!Liar! Pot's on fire.
2390,1,1,21,23,1.1304347826086956,0.09543633571264536,565,"My God, man, how many habanero poppers did you eat?"
2390,0,3,20,23,1.1304347826086956,0.07180198468215397,565,"So, you're feeling a burning sensation? That's funny, so am I."
2750,0,3,21,24,1.125,0.06895966054592131,565,Your new exercise regimen is going down in flames.
2750,1,1,22,24,1.125,0.0915348195410129,565,I'm working on anger management.
2750,1,1,22,24,1.125,0.0915348195410129,565,We've completed all the tests but I'm prohibited from discussing the treatment plan since coverage has been denied by your health insurer.
2750,0,3,21,24,1.125,0.06895966054592131,565,All you need is an anti-inflammatory.
2754,1,0,19,20,1.1,0.1,565,We're gradually converting to a paperless medical record system.
2754,0,2,18,20,1.1,0.06882472016116854,565,Your acid reflux is flaring up again.
2754,0,2,18,20,1.1,0.06882472016116854,565,Yes. I think heartburn might be part of your problem!
2754,0,2,18,20,1.1,0.06882472016116854,565,"Your health is fine, but your healthcare plan is weak, infected and seems to be running a very high fever."
2754,0,2,18,20,1.1,0.06882472016116854,565,So it looks like there's still a bit of inflammation.
2754,0,2,18,20,1.1,0.06882472016116854,565,just because the doctor says something it doesn't mean its true
2754,0,2,18,20,1.1,0.06882472016116854,565,"We're not sure just what it is, but we can say it's highly combustible."
2754,0,2,18,20,1.1,0.06882472016116854,565,I see that the Viagra worked out fine.
2754,1,0,19,20,1.1,0.1,565,I see you're indicating the hemorrhoid symptoms have gotten worse.
2754,0,2,18,20,1.1,0.06882472016116854,565,"First word ""heart"". Second word ... ?"
2754,0,2,18,20,1.1,0.06882472016116854,565,That's the worst case of heartburn I've seen!
2754,0,2,18,20,1.1,0.06882472016116854,565,I'm going to start you on some anti-inflammatory medication.
2754,1,0,19,20,1.1,0.1,565,I see here that your rectal burning has flared up.
2754,0,2,18,20,1.1,0.06882472016116854,565,Your chart indicates a history of smoking.
2754,0,2,18,20,1.1,0.06882472016116854,565,We were rooked!
2754,0,2,18,20,1.1,0.06882472016116854,565,"It's the latest version of Trumpcare, we burn the diagnosis and advise you to try harder not to be sick."
2754,1,0,19,20,1.1,0.1,565,Is my bedside manner warm enough for you?
2754,0,2,18,20,1.1,0.06882472016116854,565,This is your hemorrhoids on wasabi potato chips. S
2754,0,2,18,20,1.1,0.06882472016116854,565,Your Obamacare insurance seems to be going up in smoke.
2754,0,2,18,20,1.1,0.06882472016116854,565,Your insurance company requires us to burn your CT scan in triplicate.
2754,0,2,18,20,1.1,0.06882472016116854,565,""" It's a new respiratory test. Blow."
2754,0,2,18,20,1.1,0.06882472016116854,565,"Well, it isn't hypothermia."
2754,0,2,18,20,1.1,0.06882472016116854,565,"Drink a lot of water every day, avoid oil wells, and come back in a week."
2754,0,2,18,20,1.1,0.06882472016116854,565,"After reading your report, this is the worst case of heartburn, I have ever seen."
2754,0,2,18,20,1.1,0.06882472016116854,565,"Really sir, I thought we'd spoken about your outbursts!"
2754,0,2,18,20,1.1,0.06882472016116854,565,"It's the new Trump-o-care. If the lab test is negative, we just burn it."
2754,0,2,18,20,1.1,0.06882472016116854,565,"You're right, It ain't good."
2754,0,2,18,20,1.1,0.06882472016116854,565,"Don't worry, it is only our new ""MI"" security. All records self-destruct after 60 seconds."
2754,0,2,18,20,1.1,0.06882472016116854,565,Looks like a case of severe inflammation.
2754,1,0,19,20,1.1,0.1,565,The say it's holistic.
2754,0,2,18,20,1.1,0.06882472016116854,565,"I'm so sorry, the news was so bad, it decided on it's own to burst into flames, instead of you chucking it into a fire, like you would've if you knew."
2754,0,2,18,20,1.1,0.06882472016116854,565,We do this to protect your privacy.
2754,0,2,18,20,1.1,0.06882472016116854,565,"I have to admit, at first I thought you were exaggerating. But you've got some badass heartburn."
2754,0,2,18,20,1.1,0.06882472016116854,565,I'm sure it's just smoke.
2754,0,2,18,20,1.1,0.06882472016116854,565,This is our newest method for keeping your medical records private.
2754,0,2,18,20,1.1,0.06882472016116854,565,I'm burning you test results. Yo won't be needing them any more.
2754,0,2,18,20,1.1,0.06882472016116854,565,"Sorry, CDC requirement for this diagnosis, but we've sent you a copy via Snapchat."
2754,0,2,18,20,1.1,0.06882472016116854,565,"Oh my! Are you sure you answered that question about smoking, honestly?"
2754,0,2,18,20,1.1,0.06882472016116854,565,Your test results show an extremely high hot blood cell count.
2754,0,2,18,20,1.1,0.06882472016116854,565,Your lab results indicate a high fever.
2754,1,0,19,20,1.1,0.1,565,Your benefits are whatever's legible after exstinguishing the fire.
2754,0,2,18,20,1.1,0.06882472016116854,565,"Your gastritis should be fine, if you can just lay off the habaneros."
2754,0,2,18,20,1.1,0.06882472016116854,565,I want a second opinion.
2754,0,2,18,20,1.1,0.06882472016116854,565,"Due to lack of insurance, the board has directed me to decline this assignment."
2754,0,2,18,20,1.1,0.06882472016116854,565,"With new healthcare proposed, we take all precautions to keep insurance from knowing about your previous conditions."
2754,0,2,18,20,1.1,0.06882472016116854,565,Your colon's inflamed.
2754,0,2,18,20,1.1,0.06882472016116854,565,"We're going to need another sample. This time, just leave the paper in the water."
2754,0,2,18,20,1.1,0.06882472016116854,565,I'm not sure there is any way to sugarcoat this...you're dead.
2754,0,2,18,20,1.1,0.06882472016116854,565,"So, good news and bad news..."
2754,0,2,18,20,1.1,0.06882472016116854,565,I think we should do the urine test right now.
2754,0,2,18,20,1.1,0.06882472016116854,565,We have this new system for keeping medical records confidential.
2754,0,2,18,20,1.1,0.06882472016116854,565,"Sorry, this is part of the new Republican plan."
2754,0,2,18,20,1.1,0.06882472016116854,565,It's The New Yorker! Mankoff left us off the Cliche List!
2754,0,2,18,20,1.1,0.06882472016116854,565,You have an abnormal amount of sulfur .
2754,0,2,18,20,1.1,0.06882472016116854,565,That's not how 'burning it down for the insurance money' works.
2754,0,2,18,20,1.1,0.06882472016116854,565,The lab report says there's too much methane in your fecal fluff.
2754,0,2,18,20,1.1,0.06882472016116854,565,It's definitely a severe case of heartburn.
2754,0,2,18,20,1.1,0.06882472016116854,565,"Take this twice a day for two weeks. If you are still alive, please schedule a follow-up appointment for three weeks from now."
2754,0,2,18,20,1.1,0.06882472016116854,565,I've decided to replace and repeal your diagnosis
2754,1,0,19,20,1.1,0.1,565,It's a fever like none I've seen before.
2754,0,2,18,20,1.1,0.06882472016116854,565,"""Your breath does seem a bit warm""."
2754,0,2,18,20,1.1,0.06882472016116854,565,"Sorry, they denied coverage."
2754,0,2,18,20,1.1,0.06882472016116854,565,This lab report indicates you need to cut back on the Viagra.
2754,0,2,18,20,1.1,0.06882472016116854,565,"your results are back from Hades, sir, and we've seen worse."
2754,0,2,18,20,1.1,0.06882472016116854,565,"Quick, sign and date this! The Freedom Caucus is voting!"
2754,0,2,18,20,1.1,0.06882472016116854,565,"Your diagnosis, should you choose to accept it, is bad."
2754,1,0,19,20,1.1,0.1,565,"Really doc, the frozen shoulder is not that bad."
2754,0,2,18,20,1.1,0.06882472016116854,565,You do realize HIPAA regulations cover an ED diagnosis?
2754,0,2,18,20,1.1,0.06882472016116854,565,Which do you want first? The good news or the bad news
2754,0,2,18,20,1.1,0.06882472016116854,565,"Don't worry, your fever is all in the mind."
2754,0,2,18,20,1.1,0.06882472016116854,565,Looks like another hemorrhoid flare-up!
2754,0,2,18,20,1.1,0.06882472016116854,565,Is this your idea of a stool sample?
2754,0,2,18,20,1.1,0.06882472016116854,565,"Your inflammation is over the top!"""
2754,0,2,18,20,1.1,0.06882472016116854,565,"Good, good, your pupils are dilating nicely."
2754,0,2,18,20,1.1,0.06882472016116854,565,It's the mother of all bills
2754,0,2,18,20,1.1,0.06882472016116854,565,We're calling it male menopause.
2754,0,2,18,20,1.1,0.06882472016116854,565,"A risky new treatment, yes. But spectacular."
2754,0,2,18,20,1.1,0.06882472016116854,565,I'm repealing and replacing your medical past. It's the new cure.
2754,0,2,18,20,1.1,0.06882472016116854,565,You're running a slight fever.
2754,0,2,18,20,1.1,0.06882472016116854,565,Your fake diet hot off the enemy press.
2754,1,0,19,20,1.1,0.1,565,What your insurance doesn't know won't hurt you.
2754,0,2,18,20,1.1,0.06882472016116854,565,"No, no. This won't hurt a bit."
2754,0,2,18,20,1.1,0.06882472016116854,565,This prescription will self destruct in five seconds.
2754,0,2,18,20,1.1,0.06882472016116854,565,"Yes, you could say your inflammation is spreading."
2754,0,2,18,20,1.1,0.06882472016116854,565,I'm going to increase your dose of that anti-inflammatory drug.
2754,0,2,18,20,1.1,0.06882472016116854,565,I'm afraid the response from your health care provider on whether they'll cover the procedure is not what we were hoping.
2754,0,2,18,20,1.1,0.06882472016116854,565,I sent your test results to the 3D printer.
2754,0,2,18,20,1.1,0.06882472016116854,565,I suggest you lay off the jalapenos for a while.
2754,0,2,18,20,1.1,0.06882472016116854,565,The results of your prostate exam aren't worth the paper they're printed on.
2754,1,0,19,20,1.1,0.1,565,It appears they finally have the votes to repeal Obamacare
2754,0,2,18,20,1.1,0.06882472016116854,565,"I'm sorry, but the test results felt self-immolation was preferable."
2754,0,2,18,20,1.1,0.06882472016116854,565,"Now, we'll just test your reflexes."
2754,0,2,18,20,1.1,0.06882472016116854,565,Your inflammation has gotten worse. I don't know what the hell is going on.
2754,1,0,19,20,1.1,0.1,565,What's more important is how you FEEL about the diagnosis.
2754,0,2,18,20,1.1,0.06882472016116854,565,Your lab results are inconclusive.
2754,0,2,18,20,1.1,0.06882472016116854,565,They're all trained killers with built in GPS and no empathy.
2754,0,2,18,20,1.1,0.06882472016116854,565,These new HIPAA rules seem a bit extreme.
2754,0,2,18,20,1.1,0.06882472016116854,565,Apparently your insurance company's 'force majeure' clause won't cover that kind of elective surgery.
2754,0,2,18,20,1.1,0.06882472016116854,565,Your records indicate a history of inflammation.
2754,0,2,18,20,1.1,0.06882472016116854,565,Your chart says it's a severe case of heartburn.
2754,0,2,18,20,1.1,0.06882472016116854,565,And this just your bill for the waiting room.
2754,0,2,18,20,1.1,0.06882472016116854,565,You really need to stop smoking.
2754,0,2,18,20,1.1,0.06882472016116854,565,Well look at bright side...it's only heart burn.
2754,0,2,18,20,1.1,0.06882472016116854,565,Court summons for medical malpractice burn baby burn.
2754,0,2,18,20,1.1,0.06882472016116854,565,Modern medicine can not help you. Have you heard heard of the Hawai'an goddess Pele?
2754,1,0,19,20,1.1,0.1,565,"Well, Mr. Bradbury, it's official, you're the first living person whose temperature is 451 degrees."
2754,0,2,18,20,1.1,0.06882472016116854,565,We find our patients aren't satisfied with our mere suggestion to let a condition to simply its course. We've decided to provide you with our enhanced treatment plan which we've taken to calling a prescribed burn.
2754,0,2,18,20,1.1,0.06882472016116854,565,I like to call it Snapchat for Surgery.
2754,0,2,18,20,1.1,0.06882472016116854,565,It wasn't a heart attack. It was just heartburn.
2754,0,2,18,20,1.1,0.06882472016116854,565,It appears that you have a case of fulminant idiopathic ennui.
2754,0,2,18,20,1.1,0.06882472016116854,565,It's required by HIPAA.
2754,0,2,18,20,1.1,0.06882472016116854,565,Lab says your kidneys are inflamed.
2754,0,2,18,20,1.1,0.06882472016116854,565,"We've tried everything Mr. Webb, all that's left is the old Hindu fire treatment!"
2754,1,0,19,20,1.1,0.1,565,There have been a few documentation changes since TrumpCare came into effect.
2754,0,2,18,20,1.1,0.06882472016116854,565,It’s the worst case of acid reflux I’ve ever seen!
2754,1,0,19,20,1.1,0.1,565,Your urine sample confirms that you are still feeling the Bern.
2754,1,0,19,20,1.1,0.1,565,"Yeah, you'll still have to pay this bill."
2754,0,2,18,20,1.1,0.06882472016116854,565,"Fred, you've got to cut back on the Sichuan cuisine."
2754,1,0,19,20,1.1,0.1,565,And who is your primary beneficiary?
2754,0,2,18,20,1.1,0.06882472016116854,565,Your heartburn is off the charts.
2754,0,2,18,20,1.1,0.06882472016116854,565,"Well, I can see what's causing that burning sensation."
2754,1,0,19,20,1.1,0.1,565,This prescription may cause burning.
2754,0,2,18,20,1.1,0.06882472016116854,565,The preliminary tests seem to indicate you're a hunk of burning love.
2754,0,2,18,20,1.1,0.06882472016116854,565,Your life is in ashes!
2754,0,2,18,20,1.1,0.06882472016116854,565,I'll get to the chilling news in a moment.
2754,1,0,19,20,1.1,0.1,565,"I, too, feel a burning sensation."
2754,0,2,18,20,1.1,0.06882472016116854,565,"Let's see, it says here you're a pyromaniac...."
2754,0,2,18,20,1.1,0.06882472016116854,565,Studies have shown that burning a bill in front of the patient works better than antibiotics
2754,0,2,18,20,1.1,0.06882472016116854,565,"It says here , It burns when you pee ?"
2754,0,2,18,20,1.1,0.06882472016116854,565,What can I say ... it's inflammatory.
2754,1,0,19,20,1.1,0.1,565,It appears to be an inflammation.
2754,0,2,18,20,1.1,0.06882472016116854,565,"For heartburn, I believe in fighting fire with fire"
2754,0,2,18,20,1.1,0.06882472016116854,565,This is nothing compared to your rash.
2754,0,2,18,20,1.1,0.06882472016116854,565,"The past is history, the future is mystery, the present is a gift."
2754,0,2,18,20,1.1,0.06882472016116854,565,How often would you say you light up?
2754,1,0,19,20,1.1,0.1,565,It's toasted.
2754,0,2,18,20,1.1,0.06882472016116854,565,That temperature looks a little high.
2754,0,2,18,20,1.1,0.06882472016116854,565,I've seen worse - yesterday one blew-up.
2754,0,2,18,20,1.1,0.06882472016116854,565,Your blood work shows signs of inflammation.
2754,1,0,19,20,1.1,0.1,565,"Let see, we are treating you for heat-burn?"
2754,0,2,18,20,1.1,0.06882472016116854,565,"Sometimes when I say ""enflamed"" the nurse hears ""in flames."""
2754,0,2,18,20,1.1,0.06882472016116854,565,"Wow, I've never seen such a severe case of heart burn."
2754,0,2,18,20,1.1,0.06882472016116854,565,Severe inflammation. Medical records is using a 3D printer now.
2754,1,0,19,20,1.1,0.1,565,"Hmm... This can't be right, according to your lab report, you have hot flashes Mr Smith."
2754,0,2,18,20,1.1,0.06882472016116854,565,"so, maybe we should start with your medical history..."
2754,0,2,18,20,1.1,0.06882472016116854,565,"I'm sorry, but your health insurance policy doesn't cover fire extinguishers."
2754,0,2,18,20,1.1,0.06882472016116854,565,I would just chalk it up to just having one hell of a day.
2754,0,2,18,20,1.1,0.06882472016116854,565,You have serious heartburn.
2754,0,2,18,20,1.1,0.06882472016116854,565,You should have told me it burns when you pee.
2754,0,2,18,20,1.1,0.06882472016116854,565,We've moved to a paperless office.
2754,0,2,18,20,1.1,0.06882472016116854,565,"I'm sorry sir, nobody knew that health care could be so complicated."
2754,0,2,18,20,1.1,0.06882472016116854,565,"I'm sorry, under the new health care system we're required to do this with your preexisting condition."
2754,0,2,18,20,1.1,0.06882472016116854,565,"Well, it looks like inflammation, but we'all need more tests."
2754,0,2,18,20,1.1,0.06882472016116854,565,I'm afraid your diagnosis is classified.
2754,0,2,18,20,1.1,0.06882472016116854,565,I'm going to guess it's inflammation of some kind.
2754,0,2,18,20,1.1,0.06882472016116854,565,"On the bright side, we're going paperless next month."
2754,1,0,19,20,1.1,0.1,565,I have you breath results from the lab...
2754,0,2,18,20,1.1,0.06882472016116854,565,"You are fine but your paper, well it has a fever of about 451 degrees Fahrenheit!"
2754,0,2,18,20,1.1,0.06882472016116854,565,You've got a serious case of St. Elmo's Fire. I prescribe drinking lots of water.
2754,0,2,18,20,1.1,0.06882472016116854,565,I've just read about a hot new drug.
2754,0,2,18,20,1.1,0.06882472016116854,565,You have severe heartburn.
2754,1,0,19,20,1.1,0.1,565,The tests seem to confirm that you have a critically high fever.
2754,0,2,18,20,1.1,0.06882472016116854,565,"No money, no diagnosis. Welcome to Trumpcare, you poor, sick bastard!"
2754,0,2,18,20,1.1,0.06882472016116854,565,Your insurance company has denied the claim.
2754,0,2,18,20,1.1,0.06882472016116854,565,Dr. Carson said this worked for him.
2754,0,2,18,20,1.1,0.06882472016116854,565,Your inflamation seems to be a tiny bit worse.
2754,0,2,18,20,1.1,0.06882472016116854,565,St Elmo's billing system gets me every time.
2754,0,2,18,20,1.1,0.06882472016116854,565,"If it's of any consolation, I'm also cremating my original diagnosis."
2754,0,2,18,20,1.1,0.06882472016116854,565,"Good afternoon Mr. Jones, we have your results. You have chlamydia."
2754,0,2,18,20,1.1,0.06882472016116854,565,Your chart indicates a serious change.
2754,0,2,18,20,1.1,0.06882472016116854,565,Get ready for some prescription-strength ear candling.
2754,0,2,18,20,1.1,0.06882472016116854,565,What could possibly be the bad news?
2754,0,2,18,20,1.1,0.06882472016116854,565,"It’s Carrie White’s record, she reluctantly came in with Stephen King."
2754,0,2,18,20,1.1,0.06882472016116854,565,My new billing system has gone to hell!
2754,0,2,18,20,1.1,0.06882472016116854,565,I'll bill you electronically Mr. Kreskin.
2754,0,2,18,20,1.1,0.06882472016116854,565,You have a slight fever I would say.
2754,0,2,18,20,1.1,0.06882472016116854,565,It's the New Medicine. We burn the diagnosis and the illness doesn't exist.
2754,0,2,18,20,1.1,0.06882472016116854,565,The good news is your test results are excellent. The bad news is this building is on fire.
2754,0,2,18,20,1.1,0.06882472016116854,565,Your records are having a burning sensation
2754,0,2,18,20,1.1,0.06882472016116854,565,"It's a new HIPAA requirement ala ""Mission Impossible"""
2754,0,2,18,20,1.1,0.06882472016116854,565,Looks like you had a hot time in the old town last night.
2754,0,2,18,20,1.1,0.06882472016116854,565,"Monday, June 16 at 2:35 PM. It was a humid 75 degrees with light rain. The doctor bill was the last straw for Mr. Gorshin. It was at that precise moment when he decided it was time to make the bold statement he had waited for all his life."
2754,1,0,19,20,1.1,0.1,565,I found a use for your web diagnosis.
2754,0,2,18,20,1.1,0.06882472016116854,565,I'm practicing burning my Hippocratic oath in case Trump takes healthcare hostage.
2754,0,2,18,20,1.1,0.06882472016116854,565,She wasn't kidding when she called you hot stuff.
2754,0,2,18,20,1.1,0.06882472016116854,565,You're rather hot blooded!
2754,0,2,18,20,1.1,0.06882472016116854,565,"Let me ask you, do you have a burning sensation?"
2754,1,0,19,20,1.1,0.1,565,"As for the good news, I am at a loss for words"
2754,0,2,18,20,1.1,0.06882472016116854,565,Let me guess--you're feeling a burning sensation.
2754,0,2,18,20,1.1,0.06882472016116854,565,It stops burning when it gets to my fee.
2754,0,2,18,20,1.1,0.06882472016116854,565,First fire then the smell of brimstone!
2754,0,2,18,20,1.1,0.06882472016116854,565,I'm going to recommend a bland diet for a week or two.
2754,0,2,18,20,1.1,0.06882472016116854,565,It's the new Hipaa privacy rule. We have to burn your records before you leave the office.
2754,0,2,18,20,1.1,0.06882472016116854,565,Would you say it was more of a burning sensation?
2754,0,2,18,20,1.1,0.06882472016116854,565,"This may sound redundant looking at your last bill, but go ahead and bend over."
2754,1,0,19,20,1.1,0.1,565,This doesn't help you avoid the co-pay.
2754,0,2,18,20,1.1,0.06882472016116854,565,"We can do more tests, but it's probably just chart burn."
2754,0,2,18,20,1.1,0.06882472016116854,565,"I have your lab report here., Mr. Johnson. I think we can cut back some on your testosterone injections."
2754,0,2,18,20,1.1,0.06882472016116854,565,"So, now you don't want it in layman's terms?"
2754,0,2,18,20,1.1,0.06882472016116854,565,Your lab test is positive for inflammation.
2754,0,2,18,20,1.1,0.06882472016116854,565,Looks like you might have a slight inflammation.
2754,1,0,19,20,1.1,0.1,565,You got too much acidity.
2754,0,2,18,20,1.1,0.06882472016116854,565,Any billing disputes you might have should be taken to accounting.
2754,0,2,18,20,1.1,0.06882472016116854,565,It's worse than I thought.
2754,1,0,19,20,1.1,0.1,565,I'm afraid you have a severe case of hemorrhoids.
2754,1,0,19,20,1.1,0.1,565,"Oh, it's a new HIPAA regulation."
2754,0,2,18,20,1.1,0.06882472016116854,565,"Good news, Mr. Smith, I am postponing your scheduled hemorrhoidectomy!"
2754,0,2,18,20,1.1,0.06882472016116854,565,This WAS a sure-fire prescription!
2754,0,2,18,20,1.1,0.06882472016116854,565,"Your results are in, hot off the press!"
2754,0,2,18,20,1.1,0.06882472016116854,565,"This Trumpcare Mission Impossible Diagnosis will self-destruction in ten, nine, eight..."
2754,1,0,19,20,1.1,0.1,565,"That's fine, Mr. Kent, now let's just move on to the eye chart, shall we?"
2754,1,0,19,20,1.1,0.1,565,Wanna toast some marshmallows?
2754,1,0,19,20,1.1,0.1,565,A diagnosis of heartburn was quite obvious.
2754,0,2,18,20,1.1,0.06882472016116854,565,The good news is you're still alive
2754,0,2,18,20,1.1,0.06882472016116854,565,"So, your latest lab results suggest that you might want to cut back a bit on the habaneros."
2754,0,2,18,20,1.1,0.06882472016116854,565,"""May I suggest buying that new life insurance policy before we take a closer look at these ""preexisting conditions""."
2754,1,0,19,20,1.1,0.1,565,See this. That's what your stomach looks like. Stop eating that stuff!
2754,0,2,18,20,1.1,0.06882472016116854,565,How long does this burning sensation usually last?
2754,0,2,18,20,1.1,0.06882472016116854,565,"First the good news, I'm getting a new car."
2754,0,2,18,20,1.1,0.06882472016116854,565,Your referral notes suggest the infection is active. Sound about right?
2754,0,2,18,20,1.1,0.06882472016116854,565,My prognosis just got shot down in flames.
2754,1,0,19,20,1.1,0.1,565,This is your bill from hell. Any questions?
2754,0,2,18,20,1.1,0.06882472016116854,565,GERD your loins?
2754,0,2,18,20,1.1,0.06882472016116854,565,Your blood tests indicate demonic possession.
2754,1,0,19,20,1.1,0.1,565,Mr. Lou Cypher relax. We'll wait on the prostate exam.
2754,0,2,18,20,1.1,0.06882472016116854,565,You indicated you're feeling a burning sensation...
2754,0,2,18,20,1.1,0.06882472016116854,565,Have you changed your diet recently?
2754,0,2,18,20,1.1,0.06882472016116854,565,Here at the Visual Graphics Institute Infirmary we like to do more than just talk about your test results.
2754,0,2,18,20,1.1,0.06882472016116854,565,"No, no, no. It's a good thing. It means you're on fire."
2754,0,2,18,20,1.1,0.06882472016116854,565,Your test for haberno came back positive.
2754,0,2,18,20,1.1,0.06882472016116854,565,The test results show that it is a really bad case of heartburn
2754,0,2,18,20,1.1,0.06882472016116854,565,"Yes, your flare-ups can be contagious."
2754,0,2,18,20,1.1,0.06882472016116854,565,"I'm sorry Bill, you're a hot mess."
2754,0,2,18,20,1.1,0.06882472016116854,565,Is this what you mean by burning sensation?
2754,0,2,18,20,1.1,0.06882472016116854,565,Hot off the charts...!
2754,0,2,18,20,1.1,0.06882472016116854,565,"I would recommend that, twice a day, before a meal, you turn down the sensors of the fire alarm in your home."
2754,0,2,18,20,1.1,0.06882472016116854,565,"Well, Donald, your test results just went from ""All Positive"" to ""Smokin' Hot""!"
2754,1,0,19,20,1.1,0.1,565,"So, you're telling me there's no smoking history?"
2754,0,2,18,20,1.1,0.06882472016116854,565,Heartburn. Drink lots of water and stay cool.
2754,0,2,18,20,1.1,0.06882472016116854,565,This is going to sting a little.
2754,1,0,19,20,1.1,0.1,565,The results seem to be aligned with your symptoms.
2754,0,2,18,20,1.1,0.06882472016116854,565,"I don't want to alarm you, but ..."
2754,1,0,19,20,1.1,0.1,565,Your diagnosis is so hot I can not say it out loud !
2754,0,2,18,20,1.1,0.06882472016116854,565,Test results confirm a burning sensation as you urinate.
2754,0,2,18,20,1.1,0.06882472016116854,565,I'll have to keep this briefer than usual.
2754,0,2,18,20,1.1,0.06882472016116854,565,"Your pants, sir."
2754,0,2,18,20,1.1,0.06882472016116854,565,"You're burning up, literally."
2754,0,2,18,20,1.1,0.06882472016116854,565,"No Insurance? That's ok, just sign on the bottom and Lucifer will cover it."
2754,0,2,18,20,1.1,0.06882472016116854,565,It's part of the replacement for Obama Care.
2754,0,2,18,20,1.1,0.06882472016116854,565,It was your colonoscopy report.
2754,0,2,18,20,1.1,0.06882472016116854,565,Your insurance company said no.
2754,0,2,18,20,1.1,0.06882472016116854,565,You did ask for a visual of the side effects
2754,0,2,18,20,1.1,0.06882472016116854,565,I'm not exactly sure what the side effects will be...
2754,0,2,18,20,1.1,0.06882472016116854,565,Your test results are off the charts.
2754,0,2,18,20,1.1,0.06882472016116854,565,We have received a firey report
2754,0,2,18,20,1.1,0.06882472016116854,565,"If you think this is inflamed, just wait till I read you your test results."
2754,0,2,18,20,1.1,0.06882472016116854,565,I think I found the source of that burning sensation.
2754,0,2,18,20,1.1,0.06882472016116854,565,I guess I don't need to take tour temperature
2754,0,2,18,20,1.1,0.06882472016116854,565,I think I'm closer to what's going on.
2754,0,2,18,20,1.1,0.06882472016116854,565,"Sorry, I forgot that today is our deadline to move to electronic records"
2754,0,2,18,20,1.1,0.06882472016116854,565,You may experience a burning sensation...
2754,0,2,18,20,1.1,0.06882472016116854,565,We take your privacy seriously.
2754,0,2,18,20,1.1,0.06882472016116854,565,"Man, have you got halitosis!"
2754,0,2,18,20,1.1,0.06882472016116854,565,You need to lay off the jalepeno's!
2754,0,2,18,20,1.1,0.06882472016116854,565,"I recommend sleeping in a water bed, and a fire extinguisher in every room."
2754,0,2,18,20,1.1,0.06882472016116854,565,"It's conclusive, you're gay."
2754,0,2,18,20,1.1,0.06882472016116854,565,I have some bad news and no good news.
2754,0,2,18,20,1.1,0.06882472016116854,565,"The note here says ""Quit smoking."""
2754,0,2,18,20,1.1,0.06882472016116854,565,It says on your chart that you have been experiencing a burning sensation for over a year now?
2754,1,0,19,20,1.1,0.1,565,"We'll get you new glasses right away, Mr. Cyclops. Now could you please close your eyes?"
2754,0,2,18,20,1.1,0.06882472016116854,565,"Charley, you got some splaining to do."
2754,0,2,18,20,1.1,0.06882472016116854,565,"Tell me, do you feel any Burning sensations anywhere?"
2754,0,2,18,20,1.1,0.06882472016116854,565,I'm afraid your lab results are a bit inconclusive
2754,1,0,19,20,1.1,0.1,565,So much for your pre-existing condition. I will take your insurance.
2754,0,2,18,20,1.1,0.06882472016116854,565,I learned this trick from watching the opening sequence of Mission impossible.
2754,0,2,18,20,1.1,0.06882472016116854,565,Spontaneous Combustion - Dissociative Type
2754,0,2,18,20,1.1,0.06882472016116854,565,You said you felt a burning sensation?
2754,0,2,18,20,1.1,0.06882472016116854,565,Wow! This is going to be painful for both of us.
2754,1,0,19,20,1.1,0.1,565,"Symptoms may include: Burning, over charging of healthcare, oily discharge."
2754,0,2,18,20,1.1,0.06882472016116854,565,I was wrong. It seems hemmorhoids ARE the least of your problems.
2754,0,2,18,20,1.1,0.06882472016116854,565,"Some days are better than others, Mr. Bannon."
2754,0,2,18,20,1.1,0.06882472016116854,565,Your lab results are alarming.
2754,0,2,18,20,1.1,0.06882472016116854,565,Our new lab works for the NSA.
2754,0,2,18,20,1.1,0.06882472016116854,565,It's just gas
2754,0,2,18,20,1.1,0.06882472016116854,565,"Doc, I didn't touch it!"
2754,0,2,18,20,1.1,0.06882472016116854,565,Sit on this for 10 minutes three times a day. That will dry up your hemorrhoids.
2754,0,2,18,20,1.1,0.06882472016116854,565,You should have no trouble qualifying for health insurance now!
2754,0,2,18,20,1.1,0.06882472016116854,565,Your acute heart burn is getting worse.
2754,0,2,18,20,1.1,0.06882472016116854,565,You must be out of network.
2754,0,2,18,20,1.1,0.06882472016116854,565,Your test results seem to confirm you're suffering from a firebug.
2754,0,2,18,20,1.1,0.06882472016116854,565,And what did you say you had for lunch?
2754,0,2,18,20,1.1,0.06882472016116854,565,"It appears you are going through the change of life, Mr. Schwartz."
2754,0,2,18,20,1.1,0.06882472016116854,565,The test results indicate the worst hemmeroids possible!!
2754,0,2,18,20,1.1,0.06882472016116854,565,I feel your pain.
2754,0,2,18,20,1.1,0.06882472016116854,565,Losing the Affordable Care Act coverage should not cause a burning sensation in your penis.
2754,0,2,18,20,1.1,0.06882472016116854,565,Your disease is so contagious we have to burn the results!
2754,0,2,18,20,1.1,0.06882472016116854,565,Your triglycerides are flaring up again.
2754,0,2,18,20,1.1,0.06882472016116854,565,Have you been experiencing a burning sensation?
2754,0,2,18,20,1.1,0.06882472016116854,565,"If I were you, I'd do everything I can to live a long life."
2754,0,2,18,20,1.1,0.06882472016116854,565,Aha! this is why the FBI guys told me that I have just ten seconds to tell you about the disease you have.
2754,1,0,19,20,1.1,0.1,565,"If this makes you angry, you may have Frankenstein Monster Syndrome."
2754,0,2,18,20,1.1,0.06882472016116854,565,Looks like severe heartburn.
2754,0,2,18,20,1.1,0.06882472016116854,565,I'd say more 'has never existed' than 'pre-existing.'
2754,0,2,18,20,1.1,0.06882472016116854,565,Looks like your provider is no longer with the marketplace.
2754,0,2,18,20,1.1,0.06882472016116854,565,You have pyrokinesis.
2754,0,2,18,20,1.1,0.06882472016116854,565,It says that a consult with Dr. Faustus is indicated.
2754,0,2,18,20,1.1,0.06882472016116854,565,Haven't you seen the latest ads for this? You're going to LOVE it.
2754,0,2,18,20,1.1,0.06882472016116854,565,How many flames do you see?
2754,1,0,19,20,1.1,0.1,565,You temperature is off the charts.
2754,0,2,18,20,1.1,0.06882472016116854,565,The good news is we've got it 75% contained.
2754,0,2,18,20,1.1,0.06882472016116854,565,I've got some bad news.
2754,0,2,18,20,1.1,0.06882472016116854,565,"Yes, George, it could be just another shingles flare up."
2754,0,2,18,20,1.1,0.06882472016116854,565,You should have come in sooner.
2754,0,2,18,20,1.1,0.06882472016116854,565,It's our most effective cure of a pre-existing condition.
2754,0,2,18,20,1.1,0.06882472016116854,565,"According to the lab report, it's just a bad case of heartburn."
2754,0,2,18,20,1.1,0.06882472016116854,565,"Mr. Weems, I'm happy to tell you that you're cancer free. Now for some more of what we doctors call ""medical magic""."
2754,1,0,19,20,1.1,0.1,565,It appears your heartburn has significantly increased.
2754,0,2,18,20,1.1,0.06882472016116854,565,"Well, the good news is they got me your STD labs in record time..."
2754,1,0,19,20,1.1,0.1,565,I hate second opinions.
2754,0,2,18,20,1.1,0.06882472016116854,565,Because I'm the night manager and I hire whoever I want.
2754,0,2,18,20,1.1,0.06882472016116854,565,"We do not share your confidential information with anyone, including you."
2754,0,2,18,20,1.1,0.06882472016116854,565,You have Szechuan food syndrome
2754,0,2,18,20,1.1,0.06882472016116854,565,I'm afraid 'take two aspirin' won't help this time.
2754,0,2,18,20,1.1,0.06882472016116854,565,"Which would you like first, your diagnosis or your bill?"
2754,0,2,18,20,1.1,0.06882472016116854,565,I should warn you that we may not get the results back before our healthcare system implodes.
2754,0,2,18,20,1.1,0.06882472016116854,565,"Oh, yes...a burning sensation....now I understand."
2754,0,2,18,20,1.1,0.06882472016116854,565,"So, when did you first notice the burning sensation?"
2754,0,2,18,20,1.1,0.06882472016116854,565,"As you can see, your test results came back positive for spontaneous combustion"
2754,0,2,18,20,1.1,0.06882472016116854,565,Cheer up. At least your cholesterol is lower than last time.
2754,0,2,18,20,1.1,0.06882472016116854,565,You have a fire in the hole.
2754,0,2,18,20,1.1,0.06882472016116854,565,"We'll have to repeat the tests, and this time no spicy food after midnight."
2754,0,2,18,20,1.1,0.06882472016116854,565,I see you're suffering from heartburn
2754,0,2,18,20,1.1,0.06882472016116854,565,"Apparently, Mr. Jones, you failed to secure pre-approval for this appointment."
2754,0,2,18,20,1.1,0.06882472016116854,565,"Sorry, you didn't pay the shredding premium."
2754,0,2,18,20,1.1,0.06882472016116854,565,"""Forget Trump or ObamaCare. I see you've got the 'Burn'ie plan'"
2754,0,2,18,20,1.1,0.06882472016116854,565,According to your chart you have a raging case of heartburn.
2754,0,2,18,20,1.1,0.06882472016116854,565,"Very good, Donald Trump is the president. Now, what am I holding in my hands?"
2754,0,2,18,20,1.1,0.06882472016116854,565,Good news! We think we've found the cause of your burning sensation.
2754,0,2,18,20,1.1,0.06882472016116854,565,"Looks like heartburn, but it's a pretty severe case."
2754,0,2,18,20,1.1,0.06882472016116854,565,Says here you voted for Trump.
2754,0,2,18,20,1.1,0.06882472016116854,565,Your insurance doesn't cover burns to your diagnosis.
2754,0,2,18,20,1.1,0.06882472016116854,565,It seems your medical history is a little on the wild side.
2754,0,2,18,20,1.1,0.06882472016116854,565,Those beans you've been eating are showing in your charts!
2754,0,2,18,20,1.1,0.06882472016116854,565,Is this what you're feeling in your stomach?
2754,0,2,18,20,1.1,0.06882472016116854,565,"Just to warn you, some patients have reported a slight burning sensation when doing this test."
2754,1,0,19,20,1.1,0.1,565,I thought you felt warm.
2754,0,2,18,20,1.1,0.06882472016116854,565,"Mr. Jones, it appears that your problem goes beyond ordinary halitosis."
2754,1,0,19,20,1.1,0.1,565,"Mr. Smith, your lab results indicate your inflamed hemorrhoids are far worse than we initially thought."
2754,0,2,18,20,1.1,0.06882472016116854,565,"I'll put it this way, even your diagnosis is running a fever."
2754,0,2,18,20,1.1,0.06882472016116854,565,I thought you'd be happy I found a match.
2754,0,2,18,20,1.1,0.06882472016116854,565,"Well, it looks like Obamacare is officially repealed. Damn political wildfires."
2754,0,2,18,20,1.1,0.06882472016116854,565,"We are sorry Mr. Johnson but Chipotle can't explain your hemorrhoids. You did, however, test positive for the Satan gene."
2754,0,2,18,20,1.1,0.06882472016116854,565,I'm not gonna sugar coat it.
2754,0,2,18,20,1.1,0.06882472016116854,565,"If you don't really need the surgery, may Prometheus set my files on fire."
2754,1,0,19,20,1.1,0.1,565,Your stomach really is on fire.
2754,0,2,18,20,1.1,0.06882472016116854,565,"Telekinesis aside, you'll still have to pay your bill."
2754,0,2,18,20,1.1,0.06882472016116854,565,"Hot off the press, latest research diagnosed you with Gerd"
2754,1,0,19,20,1.1,0.1,565,Your condition may be too hot for us to handle here.
2754,0,2,18,20,1.1,0.06882472016116854,565,Your fever is so high it's gonna burn the whole place down!
2754,0,2,18,20,1.1,0.06882472016116854,565,"According to Trump's new health care plan, you have exceeded your coverage."
2754,0,2,18,20,1.1,0.06882472016116854,565,"Agreed, you need something other than antibiotics and ointment, have you tried stop, drop, and roll?"
2754,0,2,18,20,1.1,0.06882472016116854,565,"Sir, I don't think you're being honest about your medical history - but a least you're not wearing pants..."
2754,0,2,18,20,1.1,0.06882472016116854,565,"""Burning sensation"" may have been accurate after all"
2754,0,2,18,20,1.1,0.06882472016116854,565,We don't use rubber gloves anymore.
2754,1,0,19,20,1.1,0.1,565,You're going to need to go on a low-chili diet.
2754,0,2,18,20,1.1,0.06882472016116854,565,At least you'll outlive this report.
2754,0,2,18,20,1.1,0.06882472016116854,565,"There! 'Confidential', it is."
2754,0,2,18,20,1.1,0.06882472016116854,565,Well this is a first
2754,0,2,18,20,1.1,0.06882472016116854,565,Diagnosis: Heartburn.
2754,0,2,18,20,1.1,0.06882472016116854,565,There's no charge!
2754,0,2,18,20,1.1,0.06882472016116854,565,"To state the obvious, it can spread like wildfire."
2754,0,2,18,20,1.1,0.06882472016116854,565,"""You have a record inflammation""."
2754,0,2,18,20,1.1,0.06882472016116854,565,There's a 66.6 percent chance it's nothing.
2754,0,2,18,20,1.1,0.06882472016116854,565,"It looks like your metabolism is overheated, for some reason. Nothing we can't handle."
2754,0,2,18,20,1.1,0.06882472016116854,565,This prescription isn't easy to take.
2754,1,0,19,20,1.1,0.1,565,Mr. Stevens....I think you might have omitted a few things in your medical history.
2754,1,0,19,20,1.1,0.1,565,We have a third party that can take care of your bill.
2754,0,2,18,20,1.1,0.06882472016116854,565,Your results came back positive flambé.
2754,0,2,18,20,1.1,0.06882472016116854,565,"Though we can't diagnose your condition, I can tell you your insurance won't cover it."
2754,0,2,18,20,1.1,0.06882472016116854,565,We are proud of our patient confidentiality. No one will ever know anything about you ever again!
2754,0,2,18,20,1.1,0.06882472016116854,565,"It's a ""burn notice"" from your insurer"
2754,0,2,18,20,1.1,0.06882472016116854,565,I think your cholesterol is on the high side
2754,0,2,18,20,1.1,0.06882472016116854,565,Liquids would not be contraindicated.
2754,0,2,18,20,1.1,0.06882472016116854,565,You test positive for the newest form of gonorrhea
2754,0,2,18,20,1.1,0.06882472016116854,565,I've removed your heartburn. Would you like to take it home with you?
2754,0,2,18,20,1.1,0.06882472016116854,565,Is that a bad sign?
2754,0,2,18,20,1.1,0.06882472016116854,565,"Right now, just a one alarm."
2754,0,2,18,20,1.1,0.06882472016116854,565,"Sir, I think you may have had a little more than a flare up."
2754,0,2,18,20,1.1,0.06882472016116854,565,"Now Satan, I can't win a blinking contest if you insist on cheating. Here's your bill."
2754,1,0,19,20,1.1,0.1,565,Your inflammation numbers are off the charts.
2754,0,2,18,20,1.1,0.06882472016116854,565,Your inflammation may be a little hard to handle
2754,1,0,19,20,1.1,0.1,565,I'm not sure your plan covers nostalgia.
2754,0,2,18,20,1.1,0.06882472016116854,565,Such a shame your policy is set to expire soon.
2754,1,0,19,20,1.1,0.1,565,"Now, I can trust you to deliver your wife's report on her hot flashes?"
2754,0,2,18,20,1.1,0.06882472016116854,565,Your medical history does show quite a bit of inflammation...
2754,0,2,18,20,1.1,0.06882472016116854,565,Take a deep breath and cough.
2754,0,2,18,20,1.1,0.06882472016116854,565,Your test results look like hell!
2754,0,2,18,20,1.1,0.06882472016116854,565,Your results are in and just as I suspected you have ice water in your veins.
2754,0,2,18,20,1.1,0.06882472016116854,565,Your tests confirm some minor inflammation.
2754,0,2,18,20,1.1,0.06882472016116854,565,"Well, your lab results are back."
2754,0,2,18,20,1.1,0.06882472016116854,565,Your test results clearly indicate that your condition has flared up again
2754,0,2,18,20,1.1,0.06882472016116854,565,This takes care of your past. Now let's have a fresh start!
2754,0,2,18,20,1.1,0.06882472016116854,565,"Do I have your attention, Mr Purcill?"
2754,0,2,18,20,1.1,0.06882472016116854,565,Looks like you have one of those new policies that self destructs after you've paid the deductible.
2754,1,0,19,20,1.1,0.1,565,Your tested positive for fake news.
2754,1,0,19,20,1.1,0.1,565,"No, I'm afraid it's not heartburn..."
2754,0,2,18,20,1.1,0.06882472016116854,565,Tums might not be strong enough for you.
2754,0,2,18,20,1.1,0.06882472016116854,565,I take it you don't want me to discuss this diagnosis with your wife?
2754,0,2,18,20,1.1,0.06882472016116854,565,"So, you've chosen not to accept your results Mr. Phelps."
2754,0,2,18,20,1.1,0.06882472016116854,565,"I't's your chart, it self destructs five minutes after you accept the charges."
2754,0,2,18,20,1.1,0.06882472016116854,565,It appears you're insurer won't let me read your results.
2754,0,2,18,20,1.1,0.06882472016116854,565,After reviewing your echocardiogram I have to caution you to curb your obsession with hot and spicy food.
2754,0,2,18,20,1.1,0.06882472016116854,565,"Wow, your fever's gotten a bit high!"
2754,0,2,18,20,1.1,0.06882472016116854,565,I'm afraid the results of your lab tests are too hot to handle.
2754,1,0,19,20,1.1,0.1,565,I think we found out why your penis is burning.
2754,0,2,18,20,1.1,0.06882472016116854,565,You'll have to ask Billing if we cover deals with the devil.
2754,0,2,18,20,1.1,0.06882472016116854,565,I suggest you cut back on the hot sauce.
2754,0,2,18,20,1.1,0.06882472016116854,565,Your colonoscopy results point to a lifetime diet of hot Cheetos. This message will self-destruct.
2754,0,2,18,20,1.1,0.06882472016116854,565,I believe you're having sympathy hot flashes.
2754,0,2,18,20,1.1,0.06882472016116854,565,Your care wasn't affordable anyway.
2754,0,2,18,20,1.1,0.06882472016116854,565,I'm afraid it's your insurance!
2754,0,2,18,20,1.1,0.06882472016116854,565,"Whoa! Sorry, I have to change your prognosis this is way beyond heartburn!"
2754,0,2,18,20,1.1,0.06882472016116854,565,Your test results came back - it's hemorrhoids.
2754,0,2,18,20,1.1,0.06882472016116854,565,The burning question is....
2754,0,2,18,20,1.1,0.06882472016116854,565,You must be on the affordable burn in hell before we pay plan.
2754,0,2,18,20,1.1,0.06882472016116854,565,Looks like Obamacare really is going down in flames.
2754,0,2,18,20,1.1,0.06882472016116854,565,"...and for my next trick,.."
2754,0,2,18,20,1.1,0.06882472016116854,565,Luckily you are covered for fire.
2754,1,0,19,20,1.1,0.1,565,This looks like pretty bad heartburn.
2754,0,2,18,20,1.1,0.06882472016116854,565,"So, the new hemorrhoid medication not working?"
2754,1,0,19,20,1.1,0.1,565,"Don't panic, this won't hurt a bit."
2754,0,2,18,20,1.1,0.06882472016116854,565,Your heartburn is more severe than we thought
2754,1,0,19,20,1.1,0.1,565,"There weren't many donors, but we found a match."
2754,0,2,18,20,1.1,0.06882472016116854,565,"""I always wanted to be a fireman but mom said no.'"
2754,0,2,18,20,1.1,0.06882472016116854,565,You may experience a little burning in your wallet area.
2754,1,0,19,20,1.1,0.1,565,"I'm sorry, Mr. Phelps, but what was supposed to be a simple procedure has apparently escalated into a Mission Impossible!"
2754,0,2,18,20,1.1,0.06882472016116854,565,"As you see, we value your privacy."
2754,0,2,18,20,1.1,0.06882472016116854,565,Did you want to donate the organ to science or to Benihana?
2754,1,0,19,20,1.1,0.1,565,Tell me about that heartburn again?
2754,0,2,18,20,1.1,0.06882472016116854,565,"Last chance, you double the bill and I tell you what's in the lab report"
2754,0,2,18,20,1.1,0.06882472016116854,565,"I'm not sure I see how Mr. Obama is responsible for your ulcer, Mr. Christie."
2754,0,2,18,20,1.1,0.06882472016116854,565,Do you want the bad news first? Or the worse news?
2754,0,2,18,20,1.1,0.06882472016116854,565,Whatever you have seems to be spreading.
2754,0,2,18,20,1.1,0.06882472016116854,565,"Apparently, your hemorrhoids are inflamed once again."
2754,0,2,18,20,1.1,0.06882472016116854,565,"How bad is it Doc?""  ""Eh...Let's just say it's going to burn more than this paper...."
2754,0,2,18,20,1.1,0.06882472016116854,565,"Drop your drawers, spread your cheeks and we'll see if we can find that little bugger."
2754,0,2,18,20,1.1,0.06882472016116854,565,the test results are back confirming you have chronic heartburn.
2754,0,2,18,20,1.1,0.06882472016116854,565,It is the real vaccine for the final inferno.
2754,0,2,18,20,1.1,0.06882472016116854,565,"I'll be quick, your policy is about to go up in smoke."
2754,0,2,18,20,1.1,0.06882472016116854,565,"Oops, Tom, did you have another copy of the mission?"
2754,0,2,18,20,1.1,0.06882472016116854,565,I am prescribing an anti-inflammatory.
2754,0,2,18,20,1.1,0.06882472016116854,565,Tell them I can read it perfectly.
2754,0,2,18,20,1.1,0.06882472016116854,565,"The bad news is, it's not covered by your insurance."
2754,0,2,18,20,1.1,0.06882472016116854,565,It appears your electronic medical record has spiked a fever.
2754,0,2,18,20,1.1,0.06882472016116854,565,I think I understand that burning sensation you're feeling.
2754,0,2,18,20,1.1,0.06882472016116854,565,We're gonna need your copay up front.
2754,0,2,18,20,1.1,0.06882472016116854,565,"Yeah, I'm still working on my magic tricks."
2754,0,2,18,20,1.1,0.06882472016116854,565,I’m afraid it isn’t good.
2754,0,2,18,20,1.1,0.06882472016116854,565,"No worries, next week I'll get another copy of your results on that terminal cancer."
2754,0,2,18,20,1.1,0.06882472016116854,565,"""Normally I'd call your wife........but this IS from your wife""."
2754,0,2,18,20,1.1,0.06882472016116854,565,You need to cut back on the jalapeño dip.
2754,0,2,18,20,1.1,0.06882472016116854,565,"Hmm, I see you are a smoker"
2754,0,2,18,20,1.1,0.06882472016116854,565,From what I can see everything looks normal; I'll just guess about the rest.
2754,0,2,18,20,1.1,0.06882472016116854,565,M.I. 6 sent over your records and I just read them.
2754,1,0,19,20,1.1,0.1,565,I've never seen a hemorrhoid report this bad!
2754,0,2,18,20,1.1,0.06882472016116854,565,Your spontaneous combustion test came back and it looks good.
3220,0,1,16,17,1.0588235294117647,0.06063390625908324,565,"Well, it looks like you actually did catch hell."
3220,0,1,16,17,1.0588235294117647,0.06063390625908324,565,You may feel some discomfort.
3220,0,1,16,17,1.0588235294117647,0.06063390625908324,565,Your chart indicates an inflammation.
3220,0,1,16,17,1.0588235294117647,0.06063390625908324,565,It's just inflammation.
3220,0,1,16,17,1.0588235294117647,0.06063390625908324,565,I'm concerned it might metastasize into a dumpster fire.
3220,0,1,16,17,1.0588235294117647,0.06063390625908324,565,I need you to sign this consent form
3220,0,1,16,17,1.0588235294117647,0.06063390625908324,565,I'm afraid your temperature is about 350° above normal.
3220,0,1,16,17,1.0588235294117647,0.06063390625908324,565,"I don't want to call it quite yet, but it's safe to say you're going to hell."
3220,0,1,16,17,1.0588235294117647,0.06063390625908324,565,No need to worry...its just a little chart burn.
3220,0,1,16,17,1.0588235294117647,0.06063390625908324,565,I recommend a Living Will.
3220,0,1,16,17,1.0588235294117647,0.06063390625908324,565,"Don't Miss ""HMO FIRESTARTER."""
3220,0,1,16,17,1.0588235294117647,0.06063390625908324,565,According to this report your burning up with fever.
3220,0,1,16,17,1.0588235294117647,0.06063390625908324,565,Your ulcer concerns me.
3220,0,1,16,17,1.0588235294117647,0.06063390625908324,565,I'll get right to the point. You have an inflamed deductible.
3220,0,1,16,17,1.0588235294117647,0.06063390625908324,565,Says here you're suffering from extreme inflammation.
3220,0,1,16,17,1.0588235294117647,0.06063390625908324,565,Doc: So that itching and burning you mentioned...
3220,0,1,16,17,1.0588235294117647,0.06063390625908324,565,Excellent pyrokinesis reflex.
3220,0,1,16,17,1.0588235294117647,0.06063390625908324,565,You have the worst case of explosive verbal diarrhea I've seen in years.
3220,0,1,16,17,1.0588235294117647,0.06063390625908324,565,I find this in your pants and you wonder why I didn't believe you?
3220,0,1,16,17,1.0588235294117647,0.06063390625908324,565,I may have diagnosed the burning sensation.
3220,0,1,16,17,1.0588235294117647,0.06063390625908324,565,Your doctor will be in to see you shortly
3220,0,1,16,17,1.0588235294117647,0.06063390625908324,565,Your acid reflux is off the charts
3220,0,1,16,17,1.0588235294117647,0.06063390625908324,565,"Your prostate, Larry. Saw Palmetto just won't be enough this time."
3220,0,1,16,17,1.0588235294117647,0.06063390625908324,565,"..... according to the lab results, that burning in your stomach is real."
3220,0,1,16,17,1.0588235294117647,0.06063390625908324,565,No idea....shall we phone-a-friend?
3220,0,1,16,17,1.0588235294117647,0.06063390625908324,565,You might want a second opinion.
3220,0,1,16,17,1.0588235294117647,0.06063390625908324,565,"You had a hot time in the old town, huh?"
3220,0,1,16,17,1.0588235294117647,0.06063390625908324,565,Your wife suspects that the fire has left your relationship.
3220,0,1,16,17,1.0588235294117647,0.06063390625908324,565,This is your butt.
3220,0,1,16,17,1.0588235294117647,0.06063390625908324,565,As you can see there could be side effects.
3220,0,1,16,17,1.0588235294117647,0.06063390625908324,565,God I miss Obamacare.
3220,0,1,16,17,1.0588235294117647,0.06063390625908324,565,"According to this chart, you're burning up."
3220,0,1,16,17,1.0588235294117647,0.06063390625908324,565,Shall I give you the good news first?
3220,0,1,16,17,1.0588235294117647,0.06063390625908324,565,"I have some good news and some bad news. Your open heart surgery was successful, but the deductible on your catastrophic insurance policy may cause a relapse."
3220,0,1,16,17,1.0588235294117647,0.06063390625908324,565,"Mr. Bond, I have your test results..."
3220,0,1,16,17,1.0588235294117647,0.06063390625908324,565,I hate it when that happens.
3220,0,1,16,17,1.0588235294117647,0.06063390625908324,565,"Alrighty, let's see if that big ol' prostate's affecting your urine stream."
3220,0,1,16,17,1.0588235294117647,0.06063390625908324,565,"Go on, guess the diagnosis before it burns. You can't do this with Google!"
3220,0,1,16,17,1.0588235294117647,0.06063390625908324,565,"Yes, it IS bad news. I've picked up my bank statement by mistake."
3220,0,1,16,17,1.0588235294117647,0.06063390625908324,565,Have you been taking your anti-inflammatory?
3220,0,1,16,17,1.0588235294117647,0.06063390625908324,565,"Fever? Yea, I'd say so."
3220,0,1,16,17,1.0588235294117647,0.06063390625908324,565,I'm burning your calorie sheet.
3220,0,1,16,17,1.0588235294117647,0.06063390625908324,565,I'll prescribe something for inflammation.
3220,0,1,16,17,1.0588235294117647,0.06063390625908324,565,Thank you for filling out our patient satisfaction survey
3220,0,1,16,17,1.0588235294117647,0.06063390625908324,565,"So......they legalized pot in Canada!. or Well, I'd say it's definitely heart burn."
3220,0,1,16,17,1.0588235294117647,0.06063390625908324,565,Your toxology report doesn't look good
3220,0,1,16,17,1.0588235294117647,0.06063390625908324,565,"Well, there goes your preexisting condition."
3220,0,1,16,17,1.0588235294117647,0.06063390625908324,565,You might need to go to a specialty pharmacy for this.
3220,0,1,16,17,1.0588235294117647,0.06063390625908324,565,"You say cloud, I say cloud of smoke. Either way your records remain private."
3220,0,1,16,17,1.0588235294117647,0.06063390625908324,565,I should have sent the results to your phone.
3220,0,1,16,17,1.0588235294117647,0.06063390625908324,565,Seems you had a hot urine!
3220,0,1,16,17,1.0588235294117647,0.06063390625908324,565,The results of your colonoscopy are conclusive-- you ARE a flaming asshole!
3220,0,1,16,17,1.0588235294117647,0.06063390625908324,565,The lab report shows a problem...
3220,0,1,16,17,1.0588235294117647,0.06063390625908324,565,Mr Moses I'm afraid it's an inherited condition
3220,0,1,16,17,1.0588235294117647,0.06063390625908324,565,You have an inflammation.
3220,0,1,16,17,1.0588235294117647,0.06063390625908324,565,I have your Lot Six test results here.
3220,0,1,16,17,1.0588235294117647,0.06063390625908324,565,Have you tried an anti-inflammatory?
3220,0,1,16,17,1.0588235294117647,0.06063390625908324,565,I suppose you could guess the diagnosis isn't encouraging.
3220,0,1,16,17,1.0588235294117647,0.06063390625908324,565,This is the worst case of heartburn I've ever seen.
3220,0,1,16,17,1.0588235294117647,0.06063390625908324,565,"So, the nurse told me you're going with the bad news first."
3220,0,1,16,17,1.0588235294117647,0.06063390625908324,565,I hope you have insurance.
3220,0,1,16,17,1.0588235294117647,0.06063390625908324,565,It’s the worst case of acid reflux I’ve ever seen!
3220,0,1,16,17,1.0588235294117647,0.06063390625908324,565,"Now, I've devised a new reflex test. One, two..."
3220,0,1,16,17,1.0588235294117647,0.06063390625908324,565,I'm really not sure why i'm still holding this.
3220,0,1,16,17,1.0588235294117647,0.06063390625908324,565,Your rectum's on fire...I mean--record's!
3220,0,1,16,17,1.0588235294117647,0.06063390625908324,565,We take doctor-patient confidentiality very seriously here.
3220,0,1,16,17,1.0588235294117647,0.06063390625908324,565,For how long would you say that you've been experiencing symptoms of heartburn?
3220,0,1,16,17,1.0588235294117647,0.06063390625908324,565,Maybe the 'Mission Impossible' theme should be rethought for the pre-op instructions for a colonoscopy
3220,0,1,16,17,1.0588235294117647,0.06063390625908324,565,"You were right, Mr. Pyre, it's heartburn and inflammation"
3220,0,1,16,17,1.0588235294117647,0.06063390625908324,565,We'll have your analysis in about five days.
3220,0,1,16,17,1.0588235294117647,0.06063390625908324,565,And that is how heat vision works.
3220,0,1,16,17,1.0588235294117647,0.06063390625908324,565,"You said you had a cold, right?"
3220,0,1,16,17,1.0588235294117647,0.06063390625908324,565,"If I let you see this bill, you're dead."
3220,0,1,16,17,1.0588235294117647,0.06063390625908324,565,It's contagious!
3220,0,1,16,17,1.0588235294117647,0.06063390625908324,565,"Apparently, this treatment plan isn't covered by your insurance."
3220,0,1,16,17,1.0588235294117647,0.06063390625908324,565,Worst case of acid reflux I've ever seen.
3220,0,1,16,17,1.0588235294117647,0.06063390625908324,565,Have you traveled recently?
3220,0,1,16,17,1.0588235294117647,0.06063390625908324,565,Is it just me or is it getting a little hot in here?
3220,0,1,16,17,1.0588235294117647,0.06063390625908324,565,"I'm sorry Senator, you might want to stand up for this."
3220,0,1,16,17,1.0588235294117647,0.06063390625908324,565,"When I say you have an inflammation, I mean it."
3220,0,1,16,17,1.0588235294117647,0.06063390625908324,565,I'm also a fire healer.
3220,0,1,16,17,1.0588235294117647,0.06063390625908324,565,What preexisting conditions?
3220,0,1,16,17,1.0588235294117647,0.06063390625908324,565,I'm afraid it's bad news.
3220,0,1,16,17,1.0588235294117647,0.06063390625908324,565,Your Trump-Care didn't help you so now we can't help you.
3220,0,1,16,17,1.0588235294117647,0.06063390625908324,565,Your medical results weren't so hot.
3220,0,1,16,17,1.0588235294117647,0.06063390625908324,565,I think we've identified your burning sensation.
3220,0,1,16,17,1.0588235294117647,0.06063390625908324,565,"As you can see, there are some problems with your test results."
3220,0,1,16,17,1.0588235294117647,0.06063390625908324,565,"It's hot at first, then you get used to it!"
3220,0,1,16,17,1.0588235294117647,0.06063390625908324,565,"Wise, sir? They've never said an objective thing."
3220,0,1,16,17,1.0588235294117647,0.06063390625908324,565,Let's just say your blood pressure is off the charts.
3220,0,1,16,17,1.0588235294117647,0.06063390625908324,565,I see from your chart you have a burning fever.
3220,0,1,16,17,1.0588235294117647,0.06063390625908324,565,"Hell, yeah, I'll say you're running a temperature."
3220,0,1,16,17,1.0588235294117647,0.06063390625908324,565,"Among other things, you do have a fever."
3220,0,1,16,17,1.0588235294117647,0.06063390625908324,565,"You're going to need to cut that out immediately, for one."
3220,0,1,16,17,1.0588235294117647,0.06063390625908324,565,"Well, the labwork confirms your stomach really is on fire."
3220,0,1,16,17,1.0588235294117647,0.06063390625908324,565,I'm gonna need another sample. You're gonna need to see a specialist.
3220,0,1,16,17,1.0588235294117647,0.06063390625908324,565,Your test results came back and — as you can see — are burning up the charts.
3220,0,1,16,17,1.0588235294117647,0.06063390625908324,565,We have to do this to maintain our HIPAA confidentiality agreement.
3220,0,1,16,17,1.0588235294117647,0.06063390625908324,565,I'm not sure you'll be able to handle this.
3220,0,1,16,17,1.0588235294117647,0.06063390625908324,565,If things don't work out.
3220,0,1,16,17,1.0588235294117647,0.06063390625908324,565,Your wife called and wants to know if the osmosis experiment is working.
3220,0,1,16,17,1.0588235294117647,0.06063390625908324,565,I see you're still smoking.
3220,0,1,16,17,1.0588235294117647,0.06063390625908324,565,"Your liver is inflamed, and your health insurance is in flames."
3220,0,1,16,17,1.0588235294117647,0.06063390625908324,565,Your heart burn is the highest level ever recorded.
3220,0,1,16,17,1.0588235294117647,0.06063390625908324,565,"Damn, your prostate results are off the charts!"
3220,0,1,16,17,1.0588235294117647,0.06063390625908324,565,Your test results indicate both gas and heartburn.
3220,0,1,16,17,1.0588235294117647,0.06063390625908324,565,The tests confirm it's a boil.
3220,0,1,16,17,1.0588235294117647,0.06063390625908324,565,Stay right there. I'll get an anti-inflammatory for you.
3220,0,1,16,17,1.0588235294117647,0.06063390625908324,565,I'd like to tell you everything is OK but....
3220,0,1,16,17,1.0588235294117647,0.06063390625908324,565,"...the secretary will disavow any knowledge of your actions. Good luck, Jim."
3220,0,1,16,17,1.0588235294117647,0.06063390625908324,565,"Pain, burning or itching may occur in rare cases."
3220,0,1,16,17,1.0588235294117647,0.06063390625908324,565,Well that would explain the inflammation.
3220,0,1,16,17,1.0588235294117647,0.06063390625908324,565,I just got your blood alcohol results back from the lab...
3220,0,1,16,17,1.0588235294117647,0.06063390625908324,565,I'm diagnosing you with inflammation of the test results.
3220,0,1,16,17,1.0588235294117647,0.06063390625908324,565,You've got a rare case of pyromania.
3220,0,1,16,17,1.0588235294117647,0.06063390625908324,565,Good news! It's not the prostate.
3220,0,1,16,17,1.0588235294117647,0.06063390625908324,565,"So, you say you're having trouble passing urine? Let's try the Gulliver test."
3220,0,1,16,17,1.0588235294117647,0.06063390625908324,565,Your blood pressure is a little high.
3220,0,1,16,17,1.0588235294117647,0.06063390625908324,565,"Mr. Kent, using your heat vision won't make the problem go away"
3220,0,1,16,17,1.0588235294117647,0.06063390625908324,565,"No, this is not a method frequently used, but the fact that you want 4 toes is not a case frequently seen."
3220,0,1,16,17,1.0588235294117647,0.06063390625908324,565,"Jack, we need to talk. I'm worried about your numbers."
3220,0,1,16,17,1.0588235294117647,0.06063390625908324,565,Your lab report is melting my nose!
3220,0,1,16,17,1.0588235294117647,0.06063390625908324,565,"Well, your laser vision is 20/20 but you're going to need progressives."
3220,0,1,16,17,1.0588235294117647,0.06063390625908324,565,We do have a reputation for the hottest new medical technology.
3220,0,1,16,17,1.0588235294117647,0.06063390625908324,565,I'll cut to the chase...
3220,0,1,16,17,1.0588235294117647,0.06063390625908324,565,Your heart if fine. It's like an extreme case of heartburn.
3220,0,1,16,17,1.0588235294117647,0.06063390625908324,565,Your tests reveal more widespread inflammation than we first surmised.
3220,0,1,16,17,1.0588235294117647,0.06063390625908324,565,"Believe me, it's better this way."
3220,0,1,16,17,1.0588235294117647,0.06063390625908324,565,"I'm sorry Mister Trepes, but when we exposed your file to direct sunlight, it burst into flames."
3220,0,1,16,17,1.0588235294117647,0.06063390625908324,565,Your test results suggest a burning sensation.
3220,0,1,16,17,1.0588235294117647,0.06063390625908324,565,Quick. Drink this giant hot toddy.
3220,0,1,16,17,1.0588235294117647,0.06063390625908324,565,"If the smoke turns white, your insurance will cover the treatment."
3220,0,1,16,17,1.0588235294117647,0.06063390625908324,565,"It's just a hard copy, reverend. We can print another."
3220,0,1,16,17,1.0588235294117647,0.06063390625908324,565,"Sick burn, Doc."
3220,0,1,16,17,1.0588235294117647,0.06063390625908324,565,This copy is being sent in advance to my future home.
3220,0,1,16,17,1.0588235294117647,0.06063390625908324,565,This is the worst case of inflammatory bowel disease I've ever seen.
3220,0,1,16,17,1.0588235294117647,0.06063390625908324,565,This is the worst case of inflammatory bowel disease I've ever seen.
3220,0,1,16,17,1.0588235294117647,0.06063390625908324,565,"Don't worry, this won't hurt a bit"
3220,0,1,16,17,1.0588235294117647,0.06063390625908324,565,There are a few burning issues with your health that we should discuss.
3220,0,1,16,17,1.0588235294117647,0.06063390625908324,565,The burning of medical records is a cleansing and healing technique I learned at the University of Timbuktu medical school.
3220,0,1,16,17,1.0588235294117647,0.06063390625908324,565,You're fired.
3220,0,1,16,17,1.0588235294117647,0.06063390625908324,565,Your description of your burning sensation leaps of the page.
3220,0,1,16,17,1.0588235294117647,0.06063390625908324,565,"Calm down, overheated testosterone levels are not all bad news!"
3220,0,1,16,17,1.0588235294117647,0.06063390625908324,565,Apparently the treatment they recommend for you is cremation.
3220,0,1,16,17,1.0588235294117647,0.06063390625908324,565,"Get off Cialis , TODAY !!"
3220,0,1,16,17,1.0588235294117647,0.06063390625908324,565,"Um...sir, it's your credit score."
3220,0,1,16,17,1.0588235294117647,0.06063390625908324,565,I could give you the diagnosis but then I'd have to kill you.
3220,0,1,16,17,1.0588235294117647,0.06063390625908324,565,We just went live with a new paperless EMR.
3220,0,1,16,17,1.0588235294117647,0.06063390625908324,565,"So, I've got some good news and some en fuego news."
3220,0,1,16,17,1.0588235294117647,0.06063390625908324,565,"With your insurance, we could only perform laser surgery on this eye chart"
3220,0,1,16,17,1.0588235294117647,0.06063390625908324,565,You appear to be running a slight temperature.
3220,0,1,16,17,1.0588235294117647,0.06063390625908324,565,Ah! Carcinogens!
3220,0,1,16,17,1.0588235294117647,0.06063390625908324,565,"I have your lab results back and....well, they're on fire."
3220,0,1,16,17,1.0588235294117647,0.06063390625908324,565,You have 30 seconds to live.
3220,0,1,16,17,1.0588235294117647,0.06063390625908324,565,"Hemorroids, severe hemorroids."
3220,0,1,16,17,1.0588235294117647,0.06063390625908324,565,looks like your cholesterol is a little high
3220,0,1,16,17,1.0588235294117647,0.06063390625908324,565,Quick! Here's your prescription for the inflammation.
3220,0,1,16,17,1.0588235294117647,0.06063390625908324,565,The tests show that you're done to perfection.
3220,0,1,16,17,1.0588235294117647,0.06063390625908324,565,I'll show you whose nose is out of joint!
3220,0,1,16,17,1.0588235294117647,0.06063390625908324,565,"Well Mr. Jefferies, I can tell you know that I have never seen such an inflamed appendix!"
3220,0,1,16,17,1.0588235294117647,0.06063390625908324,565,Your numbers are off the chart.
3220,0,1,16,17,1.0588235294117647,0.06063390625908324,565,New HIPAA rules - No one can see them
3220,0,1,16,17,1.0588235294117647,0.06063390625908324,565,I've got good new and bad new. They both are going up in smoke.
3220,0,1,16,17,1.0588235294117647,0.06063390625908324,565,Hot dogs for lunch.
3220,0,1,16,17,1.0588235294117647,0.06063390625908324,565,"Well, you can't say the new HIPAA privacy rules aren't effective!"
3220,0,1,16,17,1.0588235294117647,0.06063390625908324,565,"For purposes of confidentiality, your lab results will self-destruct in ten seconds."
3220,0,1,16,17,1.0588235294117647,0.06063390625908324,565,That's more serious heartburn thanI thought.
3220,0,1,16,17,1.0588235294117647,0.06063390625908324,565,"Your insurance policy doesn’t cover pre-existing conditions, but it does cover accidental death by fire during a physical exam."
3220,0,1,16,17,1.0588235294117647,0.06063390625908324,565,"You seem to be running a chronic, moderate grade fever."
3220,0,1,16,17,1.0588235294117647,0.06063390625908324,565,"So, any changes since you've been on the Viagra-chili pepper diet?"
3220,0,1,16,17,1.0588235294117647,0.06063390625908324,565,You have GOT to stop eating spicy food.
3220,0,1,16,17,1.0588235294117647,0.06063390625908324,565,"We are going digital, by the end of this sentence."
3220,0,1,16,17,1.0588235294117647,0.06063390625908324,565,Nothing would be covered under TrumpCare anyhow.
3220,0,1,16,17,1.0588235294117647,0.06063390625908324,565,Your health insurance is cancelled.
3220,0,1,16,17,1.0588235294117647,0.06063390625908324,565,You will die once this report turns to ashes.
3220,0,1,16,17,1.0588235294117647,0.06063390625908324,565,"Here's the burning question, do you have insurance?"
3220,0,1,16,17,1.0588235294117647,0.06063390625908324,565,"Well, the good news is that I haven't burned my hands yet."
3220,0,1,16,17,1.0588235294117647,0.06063390625908324,565,"Well that is quite the fever you have there, Mr. Jenkins."
3220,0,1,16,17,1.0588235294117647,0.06063390625908324,565,It's a recommendation for your calorie intake.
3220,0,1,16,17,1.0588235294117647,0.06063390625908324,565,Say 911
3220,0,1,16,17,1.0588235294117647,0.06063390625908324,565,Are you having too much Mexican food?
3220,0,1,16,17,1.0588235294117647,0.06063390625908324,565,It's more than heartburn.
3220,0,1,16,17,1.0588235294117647,0.06063390625908324,565,The diagnosis is fairly combustible
3220,0,1,16,17,1.0588235294117647,0.06063390625908324,565,Any burning sensation?
3220,0,1,16,17,1.0588235294117647,0.06063390625908324,565,Oh!Oh!This chart tells me your a smoker
3220,0,1,16,17,1.0588235294117647,0.06063390625908324,565,"Given the limits of your new plan, you won't be around long enough for these medical records to have any future use."
3220,0,1,16,17,1.0588235294117647,0.06063390625908324,565,it's just heartburn.
3220,0,1,16,17,1.0588235294117647,0.06063390625908324,565,Your labs seem to indicate an acute case of heart burn.
3220,0,1,16,17,1.0588235294117647,0.06063390625908324,565,So I have some bad news from your insurance company ...
3220,0,1,16,17,1.0588235294117647,0.06063390625908324,565,"These tests confirm, you're going to Hell. Can I validate your parking?"
3220,0,1,16,17,1.0588235294117647,0.06063390625908324,565,Wow....it's worse than we thought!
3220,0,1,16,17,1.0588235294117647,0.06063390625908324,565,Hmmm...maybe I'd better not renew your oxycontin prescription!!
3220,0,1,16,17,1.0588235294117647,0.06063390625908324,565,Like my mortgage I hope Doc
3220,0,1,16,17,1.0588235294117647,0.06063390625908324,565,Do you have a 'burning' sensation?
3220,0,1,16,17,1.0588235294117647,0.06063390625908324,565,"Today, your blood work finally became Presidential."
3220,0,1,16,17,1.0588235294117647,0.06063390625908324,565,"You blood test results came back, and it is lit."
3220,0,1,16,17,1.0588235294117647,0.06063390625908324,565,It's not as bad as it looks.
3220,0,1,16,17,1.0588235294117647,0.06063390625908324,565,Better safe than sorry; your insurance doesn't cover pre-existing conditions.
3220,0,1,16,17,1.0588235294117647,0.06063390625908324,565,These lab results explain your high fever.
3220,0,1,16,17,1.0588235294117647,0.06063390625908324,565,Bad news on the Hemorrhoids.
3220,0,1,16,17,1.0588235294117647,0.06063390625908324,565,"If I told you, I would have to kill you."
3220,0,1,16,17,1.0588235294117647,0.06063390625908324,565,I call it a 'well-usion'.
3220,0,1,16,17,1.0588235294117647,0.06063390625908324,565,"In my estimation, you've got inflammation of information."
3220,0,1,16,17,1.0588235294117647,0.06063390625908324,565,We cannot determine yet what your disease is but I think you should thoroughly check your Insurance policy while lying down.
3220,0,1,16,17,1.0588235294117647,0.06063390625908324,565,You have been scheduled for a spontaneous combustionectomy on Monday.
3220,0,1,16,17,1.0588235294117647,0.06063390625908324,565,Just some inflammation.
3220,0,1,16,17,1.0588235294117647,0.06063390625908324,565,"Don't worry, it's a slightly scorched Universal Health Care plan they call the Pheonix..."
3220,0,1,16,17,1.0588235294117647,0.06063390625908324,565,It seems that your blood pressure is off the charts.
3220,0,1,16,17,1.0588235294117647,0.06063390625908324,565,That's quite the urinary tract infection.
3220,0,1,16,17,1.0588235294117647,0.06063390625908324,565,"No, no. I said burn after [after is underlined or italics] reading!"
3220,0,1,16,17,1.0588235294117647,0.06063390625908324,565,I'm sorry sir but it seems you have a fire-crotch.
3220,0,1,16,17,1.0588235294117647,0.06063390625908324,565,Tell me more about this burning sensation.
3220,0,1,16,17,1.0588235294117647,0.06063390625908324,565,You gotta watch out for these burns.
3220,0,1,16,17,1.0588235294117647,0.06063390625908324,565,Your heartburn has spread.
3220,0,1,16,17,1.0588235294117647,0.06063390625908324,565,When they said Obamacare was exploding I didn't realize they were being literal.
3220,0,1,16,17,1.0588235294117647,0.06063390625908324,565,You're right about running high fevers
3220,0,1,16,17,1.0588235294117647,0.06063390625908324,565,I see you have a history of inflammation.
3220,0,1,16,17,1.0588235294117647,0.06063390625908324,565,Wanna hear my slam poetry?
3220,0,1,16,17,1.0588235294117647,0.06063390625908324,565,According to your questionnaire - you get WHAT when you urinate?
3220,0,1,16,17,1.0588235294117647,0.06063390625908324,565,Shall I start with the good news or the bad news?
3220,0,1,16,17,1.0588235294117647,0.06063390625908324,565,I think I found the source of your burning sensation.
3220,0,1,16,17,1.0588235294117647,0.06063390625908324,565,"Your tests look fine, but is there something you'd like to tell me about your immortal soul?"
3220,0,1,16,17,1.0588235294117647,0.06063390625908324,565,I take my misdiagnoses seriously.
3220,0,1,16,17,1.0588235294117647,0.06063390625908324,565,S.H.H.!! It's very rare Marvin. S-pontaneous H-uman H-emorrhoids!
3220,0,1,16,17,1.0588235294117647,0.06063390625908324,565,It says your advance directive to enter Heaven is declined.
3220,0,1,16,17,1.0588235294117647,0.06063390625908324,565,Muy caliente. Any chance of a second date?
3220,0,1,16,17,1.0588235294117647,0.06063390625908324,565,It appears you would like a second opinion.
3220,0,1,16,17,1.0588235294117647,0.06063390625908324,565,This is what your HMO said.
3220,0,1,16,17,1.0588235294117647,0.06063390625908324,565,Your test results show you do have a very bad case of heartburn.
3220,0,1,16,17,1.0588235294117647,0.06063390625908324,565,"""Great Bob. I can see that you have a burning desire to be in good health""."
3220,0,1,16,17,1.0588235294117647,0.06063390625908324,565,Yours is the worst case of burn out I've ever seen.
3220,0,1,16,17,1.0588235294117647,0.06063390625908324,565,You might want to skip burning man this year.
3220,0,1,16,17,1.0588235294117647,0.06063390625908324,565,This prescription for impotence is really hot.
3220,0,1,16,17,1.0588235294117647,0.06063390625908324,565,I'm afraid you have pyromyalgia.
3220,0,1,16,17,1.0588235294117647,0.06063390625908324,565,Sir: this rubbish bin represents the health insurance industry. The flaming garbage inside is your current policy.
3220,0,1,16,17,1.0588235294117647,0.06063390625908324,565,Go easy on the hot sauce.
3220,0,1,16,17,1.0588235294117647,0.06063390625908324,565,"To insure your privacy, I will also eat the ashes."
3220,0,1,16,17,1.0588235294117647,0.06063390625908324,565,Looks like we're both dealing with a burning sensation.
3220,0,1,16,17,1.0588235294117647,0.06063390625908324,565,"Business is slow, drink this."
3220,0,1,16,17,1.0588235294117647,0.06063390625908324,565,I'D STAY AWAY FROM SZECHUAN FOR AWHILE.
3220,0,1,16,17,1.0588235294117647,0.06063390625908324,565,I think we should reconsider an anti-inflammatory.
3220,0,1,16,17,1.0588235294117647,0.06063390625908324,565,You might want a second opinion.
3220,0,1,16,17,1.0588235294117647,0.06063390625908324,565,My response to your malpractice suit.
3220,0,1,16,17,1.0588235294117647,0.06063390625908324,565,You have the worst case of secondary inflammation I've ever seen.
3220,0,1,16,17,1.0588235294117647,0.06063390625908324,565,I don't take medicare!
3220,0,1,16,17,1.0588235294117647,0.06063390625908324,565,You've got one squirrely case of acid reflux.
3220,0,1,16,17,1.0588235294117647,0.06063390625908324,565,It's just four years. Take three antacids and call me in the morning.
3220,0,1,16,17,1.0588235294117647,0.06063390625908324,565,"I see, and do you have any relevant family history?"
3220,0,1,16,17,1.0588235294117647,0.06063390625908324,565,how long have you been experiencing this burning sensation?
3220,0,1,16,17,1.0588235294117647,0.06063390625908324,565,So here's the burning issue.
3220,0,1,16,17,1.0588235294117647,0.06063390625908324,565,Have you been experiencing any issues with heartburn?
3220,0,1,16,17,1.0588235294117647,0.06063390625908324,565,First case I've ever seen of contagious acute inflammation.
3220,0,1,16,17,1.0588235294117647,0.06063390625908324,565,"Well, this is a new one. You're sex is 'on fire'?"
3220,0,1,16,17,1.0588235294117647,0.06063390625908324,565,Let's just say the results were negative.
3220,0,1,16,17,1.0588235294117647,0.06063390625908324,565,"Trust me, you do not need to know this."
3220,0,1,16,17,1.0588235294117647,0.06063390625908324,565,I assume you want your cholesterol results the same way Chili's delivers your fajitas?
3220,0,1,16,17,1.0588235294117647,0.06063390625908324,565,Looks like the repeal part passed
3220,0,1,16,17,1.0588235294117647,0.06063390625908324,565,Did you ask for a second opinion?
3220,0,1,16,17,1.0588235294117647,0.06063390625908324,565,"You can burn your chart all you want, Superman. We're still doing the prostate exam."
3220,0,1,16,17,1.0588235294117647,0.06063390625908324,565,"It's heartburn again, huh?"
3220,0,1,16,17,1.0588235294117647,0.06063390625908324,565,This is why I can't tell you how much today's visit will cost.
3220,0,1,16,17,1.0588235294117647,0.06063390625908324,565,"Well, we got the hemeroid analysis back..."
3220,0,1,16,17,1.0588235294117647,0.06063390625908324,565,"Your mission, if you choose to accept it, is as follows......"
3220,0,1,16,17,1.0588235294117647,0.06063390625908324,565,"You have gone and eaten those chili's again, haven't you Mr. Perkins."
3220,0,1,16,17,1.0588235294117647,0.06063390625908324,565,"Sorry, your telling me this is the new Trump medical plan, inconclusive results?"
3220,0,1,16,17,1.0588235294117647,0.06063390625908324,565,It's the insurance company's way of saying your coverage has gone up in flames.
3220,0,1,16,17,1.0588235294117647,0.06063390625908324,565,Blow out your results and get a surprise medical bill.
3220,0,1,16,17,1.0588235294117647,0.06063390625908324,565,"Mr. Jones, I think we're going to need to run some more tests before I can make a diagnosis."
3220,0,1,16,17,1.0588235294117647,0.06063390625908324,565,Well... there seems to be a problem with your AHCA insurance.
3220,0,1,16,17,1.0588235294117647,0.06063390625908324,565,Your pyromania medication needs adjustment!
3220,0,1,16,17,1.0588235294117647,0.06063390625908324,565,"If you would focus your psychic powers on the disease instead of my diagnosis, then we might make some headway."
3220,0,1,16,17,1.0588235294117647,0.06063390625908324,565,"Sorry, our new treaty with China requires us to try their “fire therapy” first."
3220,0,1,16,17,1.0588235294117647,0.06063390625908324,565,Just standard part of the arbitration clause.
3220,0,1,16,17,1.0588235294117647,0.06063390625908324,565,Your testosterone results.
3220,0,1,16,17,1.0588235294117647,0.06063390625908324,565,"Dammit! I said, nothing after midnight."
3220,0,1,16,17,1.0588235294117647,0.06063390625908324,565,I suggest more exercise.
3220,0,1,16,17,1.0588235294117647,0.06063390625908324,565,"Well, everything looks good on my end."
3220,0,1,16,17,1.0588235294117647,0.06063390625908324,565,"You're just giving EVERYONE your dick, aren't ya!"
3220,0,1,16,17,1.0588235294117647,0.06063390625908324,565,Listen carefully. Privacy law enforcement provides just one glimpse to read this.
3220,0,1,16,17,1.0588235294117647,0.06063390625908324,565,The good news is that your malady cannot be hacked.
3220,0,1,16,17,1.0588235294117647,0.06063390625908324,565,"Don't read into this, but you should get a second opinion."
3220,0,1,16,17,1.0588235294117647,0.06063390625908324,565,"Mr. Jones, the good news is it's not contagious. The bad news is you have the worst heartburn we've ever seen."
3220,0,1,16,17,1.0588235294117647,0.06063390625908324,565,Any burning sensation?
3220,0,1,16,17,1.0588235294117647,0.06063390625908324,565,We've found self-destructing records are HIPAA compliant.
3220,0,1,16,17,1.0588235294117647,0.06063390625908324,565,"To become HIPPA compliant, we have started burning patient records."
3220,0,1,16,17,1.0588235294117647,0.06063390625908324,565,Your cholesterol so high it's burning up the chart.
3220,0,1,16,17,1.0588235294117647,0.06063390625908324,565,All I did was add a silly old zero!
3220,0,1,16,17,1.0588235294117647,0.06063390625908324,565,I'm trying a new therapeutic treatment. It's all the rage in hell.
3220,0,1,16,17,1.0588235294117647,0.06063390625908324,565,"Blood's OK, but Your heartburn is back!"
3220,0,1,16,17,1.0588235294117647,0.06063390625908324,565,Fire in the hole!
3220,0,1,16,17,1.0588235294117647,0.06063390625908324,565,"Well, you'll live a long life if you stay away from fires."
3220,0,1,16,17,1.0588235294117647,0.06063390625908324,565,"And this is the lab report on your, let's call it, 'social-disease'."
3220,0,1,16,17,1.0588235294117647,0.06063390625908324,565,Second opinion. It happens every time.
3220,0,1,16,17,1.0588235294117647,0.06063390625908324,565,"Since I started a concierge practice, I get the damnedest requests."
3220,0,1,16,17,1.0588235294117647,0.06063390625908324,565,I understand you're here about a burning sensation.
3220,0,1,16,17,1.0588235294117647,0.06063390625908324,565,"We took it from your butt, so it should relieve the burning."
3220,0,1,16,17,1.0588235294117647,0.06063390625908324,565,You really need to stop smoking.
3220,0,1,16,17,1.0588235294117647,0.06063390625908324,565,We're going digital.
3220,0,1,16,17,1.0588235294117647,0.06063390625908324,565,"... Not funny, Prometheus."
3220,0,1,16,17,1.0588235294117647,0.06063390625908324,565,It's the hottest new drug.
3220,0,1,16,17,1.0588235294117647,0.06063390625908324,565,"According to this chart, your fever has spiked at Fahrenheit 451.6."
3220,0,1,16,17,1.0588235294117647,0.06063390625908324,565,Your heartburn numbers are off the charts.
3220,0,1,16,17,1.0588235294117647,0.06063390625908324,565,I'm not crazy about your urine sample.
3220,0,1,16,17,1.0588235294117647,0.06063390625908324,565,Are you curious about your afterlife should this operation go south?
3220,0,1,16,17,1.0588235294117647,0.06063390625908324,565,"Here are your lab results, hot off the press."
3220,0,1,16,17,1.0588235294117647,0.06063390625908324,565,You see Steve this medical file is like your hemmoroidal tissue.
3220,0,1,16,17,1.0588235294117647,0.06063390625908324,565,Burning and itching? Or just burning?
3220,0,1,16,17,1.0588235294117647,0.06063390625908324,565,We could start by cutting back on Thai food.
3220,0,1,16,17,1.0588235294117647,0.06063390625908324,565,Your test results show that your inflammation levels are extremely high.
3220,0,1,16,17,1.0588235294117647,0.06063390625908324,565,Smoke 'em if you got 'em.
3220,0,1,16,17,1.0588235294117647,0.06063390625908324,565,"How long have you had a burning sensation, Doctor?"
3220,0,1,16,17,1.0588235294117647,0.06063390625908324,565,Maury Provich will be in shortly to tell you the results!
3220,0,1,16,17,1.0588235294117647,0.06063390625908324,565,Four out of five of my colleagues recommended it.
3220,0,1,16,17,1.0588235294117647,0.06063390625908324,565,This is the worst case of GERD I have ever seen!!
3220,0,1,16,17,1.0588235294117647,0.06063390625908324,565,Your test results just got back from the lab
3220,0,1,16,17,1.0588235294117647,0.06063390625908324,565,I recommend a taco-free diet.
3220,0,1,16,17,1.0588235294117647,0.06063390625908324,565,Have you given immolation a thought?
3220,0,1,16,17,1.0588235294117647,0.06063390625908324,565,"Whoa, Mr. Martin! Simmer down now."
3220,0,1,16,17,1.0588235294117647,0.06063390625908324,565,The laboratory report confirms a flare-up of your inflammatory bowel disease.
3220,0,1,16,17,1.0588235294117647,0.06063390625908324,565,Darn! Your heartburn is giving me a sunburn.
3220,0,1,16,17,1.0588235294117647,0.06063390625908324,565,Looks like someone hasn't been taking his anti-inflammatories.
3220,0,1,16,17,1.0588235294117647,0.06063390625908324,565,"Side effects may include hot flashes, inflammation, or a burning sensation."
3220,0,1,16,17,1.0588235294117647,0.06063390625908324,565,But you said my test results weren't so hot.
3220,0,1,16,17,1.0588235294117647,0.06063390625908324,565,"Oh, it's nothing to worry about you just have minor heartburn."
3220,0,1,16,17,1.0588235294117647,0.06063390625908324,565,Looks like you have a fever.
3220,0,1,16,17,1.0588235294117647,0.06063390625908324,565,Your inflammation is spreading quickly!
3220,0,1,16,17,1.0588235294117647,0.06063390625908324,565,Ink-blot analysis shows that you have a predisposition for demonic behaviors.
3220,0,1,16,17,1.0588235294117647,0.06063390625908324,565,I'd recommend a course of anti-inflammatories.
3220,0,1,16,17,1.0588235294117647,0.06063390625908324,565,"A REPORT AS BAD AS THIS, WE JUST BURN IT"
3220,0,1,16,17,1.0588235294117647,0.06063390625908324,565,No! I am not Uri Geller's son!
3220,0,1,16,17,1.0588235294117647,0.06063390625908324,565,My nurse is hot!
3220,0,1,16,17,1.0588235294117647,0.06063390625908324,565,Yours is the first case of burning mouth syndrome that ever proved contagious.
3220,0,1,16,17,1.0588235294117647,0.06063390625908324,565,"""Pants-on-Fire"" fact checking has arrived to assist patients' understanding of their consultant's report."
3220,0,1,16,17,1.0588235294117647,0.06063390625908324,565,I'm not sure why you wanted a second opinion??
3220,0,1,16,17,1.0588235294117647,0.06063390625908324,565,I believe you had one too many jalapeño peppers.
3220,0,1,16,17,1.0588235294117647,0.06063390625908324,565,Trump Care delivers your test results by Snapchat and we forward them by Firefly.
3220,0,1,16,17,1.0588235294117647,0.06063390625908324,565,The good new is your weight is down.
3220,0,1,16,17,1.0588235294117647,0.06063390625908324,565,Take one of these for heartburn as needed.
3220,0,1,16,17,1.0588235294117647,0.06063390625908324,565,Give it to me straight doc. Is it pyrokenesis?
3220,0,1,16,17,1.0588235294117647,0.06063390625908324,565,"Well, I guess there are some side affects."
3220,0,1,16,17,1.0588235294117647,0.06063390625908324,565,Side effects?
3220,0,1,16,17,1.0588235294117647,0.06063390625908324,565,the treatment plan self-destructs when there is no response from the patient after 30 seconds
3220,0,1,16,17,1.0588235294117647,0.06063390625908324,565,It appears to be a bad case of heartburn.
3220,0,1,16,17,1.0588235294117647,0.06063390625908324,565,Your test results indicate a flare-up.
3220,0,1,16,17,1.0588235294117647,0.06063390625908324,565,"Did I mention, I don't take insurance?"
3220,0,1,16,17,1.0588235294117647,0.06063390625908324,565,I'm sorry to tell you that your diagnosis is highly contagious.
3220,0,1,16,17,1.0588235294117647,0.06063390625908324,565,What have you been eating? I've never seen a sample spontaneously combust like this!
3220,0,1,16,17,1.0588235294117647,0.06063390625908324,565,"Sir, we're going to have to cauterize that bloody nose immediately."
3220,0,1,16,17,1.0588235294117647,0.06063390625908324,565,Just how many pills did you take?
3220,0,1,16,17,1.0588235294117647,0.06063390625908324,565,"Yes, your test results do show a high degree of inflammation."
3220,0,1,16,17,1.0588235294117647,0.06063390625908324,565,I'm afraid this may be an impossible mission.
3220,0,1,16,17,1.0588235294117647,0.06063390625908324,565,This is the worst case of gonorrhea I've ever seen.
3220,0,1,16,17,1.0588235294117647,0.06063390625908324,565,You need to chill
3220,0,1,16,17,1.0588235294117647,0.06063390625908324,565,"Well when you signed up for paperless billing, what did you expect?"
3220,0,1,16,17,1.0588235294117647,0.06063390625908324,565,I don't think Beano is going to help.
3220,0,1,16,17,1.0588235294117647,0.06063390625908324,565,The test results show... you don't want to know.
3220,0,1,16,17,1.0588235294117647,0.06063390625908324,565,"OK, this says heartburn. Luckily, not irritable bowel syndrome."
3220,0,1,16,17,1.0588235294117647,0.06063390625908324,565,"Whoops, I pulled David Byrne's file accidentally."
3220,0,1,16,17,1.0588235294117647,0.06063390625908324,565,"Ironically, your lab results are not so hot."
3220,0,1,16,17,1.0588235294117647,0.06063390625908324,565,No worries. Your loved ones are on their way.
3220,0,1,16,17,1.0588235294117647,0.06063390625908324,565,I'd like to start with the results of your stool sample.
3220,0,1,16,17,1.0588235294117647,0.06063390625908324,565,You really do have a case of heartburn.
3220,0,1,16,17,1.0588235294117647,0.06063390625908324,565,This should take care of your pre-existing condition.
3220,0,1,16,17,1.0588235294117647,0.06063390625908324,565,This report indicates acute inflammation.
3220,0,1,16,17,1.0588235294117647,0.06063390625908324,565,This test measures your perception of pain
3220,0,1,16,17,1.0588235294117647,0.06063390625908324,565,"Don't worry, you're not exactly hot stuff."
3220,0,1,16,17,1.0588235294117647,0.06063390625908324,565,Says here something about a burning sensation...
3220,0,1,16,17,1.0588235294117647,0.06063390625908324,565,. . . do you want the good news first?
3220,0,1,16,17,1.0588235294117647,0.06063390625908324,565,I think you have inflammatory vowel syndrome
3220,0,1,16,17,1.0588235294117647,0.06063390625908324,565,Would you prefer a hot pack or an ice pack.
3220,0,1,16,17,1.0588235294117647,0.06063390625908324,565,Your test results are back.
3220,0,1,16,17,1.0588235294117647,0.06063390625908324,565,"If you think this will make you hot, wait till you see my bill."
3220,0,1,16,17,1.0588235294117647,0.06063390625908324,565,Are you having another hallucination?
3220,0,1,16,17,1.0588235294117647,0.06063390625908324,565,You won't be needing these.
3220,0,1,16,17,1.0588235294117647,0.06063390625908324,565,You may want to think about kicking back on the sriracha in your oatmeal.
3220,0,1,16,17,1.0588235294117647,0.06063390625908324,565,"Now wait a second, Ed. This isn't as bad as it looks."
3220,0,1,16,17,1.0588235294117647,0.06063390625908324,565,Did you buy this policy on an Obamacare exchange?
3220,0,1,16,17,1.0588235294117647,0.06063390625908324,565,The inflammation is even worse than I thought.
3220,0,1,16,17,1.0588235294117647,0.06063390625908324,565,On the bright side you're not cooked yet.
3220,0,1,16,17,1.0588235294117647,0.06063390625908324,565,"So, I see you've been having hot flashes."
3220,0,1,16,17,1.0588235294117647,0.06063390625908324,565,The side effects may include inflammation.
3220,0,1,16,17,1.0588235294117647,0.06063390625908324,565,The results appear conclusive… you’re fired up and ready to go!
3220,0,1,16,17,1.0588235294117647,0.06063390625908324,565,"Whoa, extreme inflammatory response!"
3220,0,1,16,17,1.0588235294117647,0.06063390625908324,565,"Well, Bob, your heartburn seems to have spread to everything else in your lab reports."
3220,0,1,16,17,1.0588235294117647,0.06063390625908324,565,"...but it could be a data entry error, so I wouldn't worry"
3220,0,1,16,17,1.0588235294117647,0.06063390625908324,565,Your labs are showing a slight inflamation.
3220,0,1,16,17,1.0588235294117647,0.06063390625908324,565,The common cure.
3220,0,1,16,17,1.0588235294117647,0.06063390625908324,565,So on a scale of 1 to 10...
3220,0,1,16,17,1.0588235294117647,0.06063390625908324,565,"From now on, wrap it up."
3220,0,1,16,17,1.0588235294117647,0.06063390625908324,565,"Nothing to be alarmed about . Do you want the good news first, or the other?"
3220,0,1,16,17,1.0588235294117647,0.06063390625908324,565,"For my next trick, I'm going to make your tumor disappear."
3220,0,1,16,17,1.0588235294117647,0.06063390625908324,565,Hmmm....it looks like you're suffering from a case of general inflammation
3220,0,1,16,17,1.0588235294117647,0.06063390625908324,565,I'm thinking you need to change your diet Mr. Finch.
3220,0,1,16,17,1.0588235294117647,0.06063390625908324,565,I guess you get the big picture.
3220,0,1,16,17,1.0588235294117647,0.06063390625908324,565,The inflammation has now gotten to the flambé stage
3220,0,1,16,17,1.0588235294117647,0.06063390625908324,565,We share the building with the Fire Department.
3220,0,1,16,17,1.0588235294117647,0.06063390625908324,565,You have the worst case of heartburn I've ever encountered.
3220,0,1,16,17,1.0588235294117647,0.06063390625908324,565,Your ego is only slightly bruised but your id is definitely inflamed.
3220,0,1,16,17,1.0588235294117647,0.06063390625908324,565,So which do you want first -- the good news or the bad news?
3220,0,1,16,17,1.0588235294117647,0.06063390625908324,565,Nothing to worry about--it's just a little inflammation.
3220,0,1,16,17,1.0588235294117647,0.06063390625908324,565,I'm thinking of a bowel disease.
3220,0,1,16,17,1.0588235294117647,0.06063390625908324,565,There's no other possibility for a cure...and I've heard it used to work for cavemen.
3220,0,1,16,17,1.0588235294117647,0.06063390625908324,565,Your rash is going to get much worse.
3220,0,1,16,17,1.0588235294117647,0.06063390625908324,565,"Considering your diagnosis, I think this is the best possible treatment."
3220,0,1,16,17,1.0588235294117647,0.06063390625908324,565,Don't worry. It's just heartburn.
3220,0,1,16,17,1.0588235294117647,0.06063390625908324,565,This is your mother in laws country doctor's hot toddy.
3220,0,1,16,17,1.0588235294117647,0.06063390625908324,565,"This may help your frozen shoulder, Mr Smith"
3220,0,1,16,17,1.0588235294117647,0.06063390625908324,565,If I tell you why then I'll have to kill you.
3220,0,1,16,17,1.0588235294117647,0.06063390625908324,565,Did you say heartburn?
3220,0,1,16,17,1.0588235294117647,0.06063390625908324,565,"The good new is, we found out what happened to your liver."
3220,0,1,16,17,1.0588235294117647,0.06063390625908324,565,Your time is running out.
3220,0,1,16,17,1.0588235294117647,0.06063390625908324,565,Perhaps your homeowner's fire insurance will cover this?
3220,0,1,16,17,1.0588235294117647,0.06063390625908324,565,"The results are in, your heartburn's out of control!"
3220,0,1,16,17,1.0588235294117647,0.06063390625908324,565,"Well Mr. William, oddly enough your fire insurance does cover your particular aliment."
3220,0,1,16,17,1.0588235294117647,0.06063390625908324,565,"Mmm, does it burn when you pee?"
3220,0,1,16,17,1.0588235294117647,0.06063390625908324,565,Cheer up! Your testosterone levels are great.
3220,0,1,16,17,1.0588235294117647,0.06063390625908324,565,I'm sorry. No more Disabled Parking permits.
3220,0,1,16,17,1.0588235294117647,0.06063390625908324,565,HIPPA!
3220,0,1,16,17,1.0588235294117647,0.06063390625908324,565,I'd give your diagnosis maybe 15-30 seconds.
3220,0,1,16,17,1.0588235294117647,0.06063390625908324,565,I'm afraid your susceptibility to paper cuts has deteriorated. Are you drinking enough water?
3220,0,1,16,17,1.0588235294117647,0.06063390625908324,565,"You may have already guessed, it’s not good news."
3220,0,1,16,17,1.0588235294117647,0.06063390625908324,565,You can see that you clearly have an inflammatory disease.
3220,0,1,16,17,1.0588235294117647,0.06063390625908324,565,...and you say you're sure there's no family history of projective pyromania?
3220,0,1,16,17,1.0588235294117647,0.06063390625908324,565,I thought this would better than swallowing these results
3220,0,1,16,17,1.0588235294117647,0.06063390625908324,565,It appears you have a severe inflammation of the semicolon.
3220,0,1,16,17,1.0588235294117647,0.06063390625908324,565,Which would you like first; the good news or the bad news?
3220,0,1,16,17,1.0588235294117647,0.06063390625908324,565,Shall we try that stronger anti-inflammatory now?
3220,0,1,16,17,1.0588235294117647,0.06063390625908324,565,It appears your heartburn is real.
3220,0,1,16,17,1.0588235294117647,0.06063390625908324,565,I've got your test results ...
3220,0,1,16,17,1.0588235294117647,0.06063390625908324,565,"Gesundheit, Mr. Beelzebub."
3220,0,1,16,17,1.0588235294117647,0.06063390625908324,565,"At this rate, your heart burn is going to kill us all"
3220,0,1,16,17,1.0588235294117647,0.06063390625908324,565,"It's too bad you're not a singer, because you're burning up the charts."
3220,0,1,16,17,1.0588235294117647,0.06063390625908324,565,We're having trouble with our laser printer.
3220,0,1,16,17,1.0588235294117647,0.06063390625908324,565,My prognosis doesn't look good; perhaps it's time to find a new doctor!
3220,0,1,16,17,1.0588235294117647,0.06063390625908324,565,My reviews on RateMDs.com are much better now that I warm my hands before an examination.
3220,0,1,16,17,1.0588235294117647,0.06063390625908324,565,No more reliable than a smartphone.
3220,0,1,16,17,1.0588235294117647,0.06063390625908324,565,"Wow, your heart burn is up there."
3220,0,1,16,17,1.0588235294117647,0.06063390625908324,565,It appears the lab sent your Personality Profile rather than your blood work.
3220,0,1,16,17,1.0588235294117647,0.06063390625908324,565,You temperature is a little high.
3220,0,1,16,17,1.0588235294117647,0.06063390625908324,565,it appears you have an inflamed thyroid.
3220,0,1,16,17,1.0588235294117647,0.06063390625908324,565,You tested positive for flaming chart syndrome.
3220,0,1,16,17,1.0588235294117647,0.06063390625908324,565,My wife warned me about eating all those spicy tacos!!
3220,0,1,16,17,1.0588235294117647,0.06063390625908324,565,The devil awaits.
3220,0,1,16,17,1.0588235294117647,0.06063390625908324,565,Here's your bill from the burn unit.
3220,0,1,16,17,1.0588235294117647,0.06063390625908324,565,The heartburn test results came back.
3220,0,1,16,17,1.0588235294117647,0.06063390625908324,565,Not to worry -- just heart burn.
3220,0,1,16,17,1.0588235294117647,0.06063390625908324,565,Now this may hurt a little.
3220,0,1,16,17,1.0588235294117647,0.06063390625908324,565,Just like that. No pre-existing conditions.
3220,0,1,16,17,1.0588235294117647,0.06063390625908324,565,You're fired.
3220,0,1,16,17,1.0588235294117647,0.06063390625908324,565,You're dying.
3220,0,1,16,17,1.0588235294117647,0.06063390625908324,565,Your hand-basket is just outside.
3220,0,1,16,17,1.0588235294117647,0.06063390625908324,565,"Well, you are making good progress controlling your self-immolation thoughts!"
3220,0,1,16,17,1.0588235294117647,0.06063390625908324,565,Normally I'd recommend a gynecologist.
3220,0,1,16,17,1.0588235294117647,0.06063390625908324,565,I see increasing inflammation.
3220,0,1,16,17,1.0588235294117647,0.06063390625908324,565,Burning up all those 'bad things' you did will keep you from your love of guilt!
3220,0,1,16,17,1.0588235294117647,0.06063390625908324,565,I've got your sexual history here...
3220,0,1,16,17,1.0588235294117647,0.06063390625908324,565,Nothing to worry about - you'll be fine in a couple of days!
3220,0,1,16,17,1.0588235294117647,0.06063390625908324,565,"Doctor: ""Um... I think you need to see a specialist next."""
3220,0,1,16,17,1.0588235294117647,0.06063390625908324,565,You should have told me she was this hot!
3220,0,1,16,17,1.0588235294117647,0.06063390625908324,565,Your test results show some tissue inflammation.
3220,0,1,16,17,1.0588235294117647,0.06063390625908324,565,Your insurance denied the claim -- and there goes my ski lodge!
3220,0,1,16,17,1.0588235294117647,0.06063390625908324,565,Next time I'll show you a picture of my ex-wife instead of my kids when making small-talk.
3220,0,1,16,17,1.0588235294117647,0.06063390625908324,565,How about we start with where aren't you experiencing inflammation?
3220,0,1,16,17,1.0588235294117647,0.06063390625908324,565,You could have just asked us to repeat the tests
3220,0,1,16,17,1.0588235294117647,0.06063390625908324,565,What's wrong with you is REALLY a burning question!
3220,0,1,16,17,1.0588235294117647,0.06063390625908324,565,I think you should avoid spicy food.
3220,0,1,16,17,1.0588235294117647,0.06063390625908324,565,I'm afraid all your good intentions have sealed your fate.
3220,0,1,16,17,1.0588235294117647,0.06063390625908324,565,"I have some bad news, and some really bad news."
3220,0,1,16,17,1.0588235294117647,0.06063390625908324,565,It's called M.I. paper. We only use it for the most difficult cases.
3220,0,1,16,17,1.0588235294117647,0.06063390625908324,565,You must wait to drink it until the flames have subsided
3220,0,1,16,17,1.0588235294117647,0.06063390625908324,565,Hell if I know . . .
3220,0,1,16,17,1.0588235294117647,0.06063390625908324,565,"Accounts Receivable is offering a procedure called ""we don't take your insurance."""
3220,0,1,16,17,1.0588235294117647,0.06063390625908324,565,Your case was stamped...... Mission Impossible
3220,0,1,16,17,1.0588235294117647,0.06063390625908324,565,"Sorry about the wait, sir. I just got your urinalysis results back from the lab. Any chance the burning pain you feel is flammable?"
3220,0,1,16,17,1.0588235294117647,0.06063390625908324,565,"I see your hemorrhoids have flared up again, Mr. Nelson."
3220,0,1,16,17,1.0588235294117647,0.06063390625908324,565,"Your health history is rather..... graphic, sir"
3220,0,1,16,17,1.0588235294117647,0.06063390625908324,565,I was told my bedside manner lacked warmth.
3220,0,1,16,17,1.0588235294117647,0.06063390625908324,565,It's nothing to be alarmed about.
3220,0,1,16,17,1.0588235294117647,0.06063390625908324,565,"On the bright side, it's nothing to be 5-alarmed about."
3220,0,1,16,17,1.0588235294117647,0.06063390625908324,565,"No need for concern, but the first tests came back inconclusive"
3220,0,1,16,17,1.0588235294117647,0.06063390625908324,565,This is the most contagious case of gonorrhea I have ever seen.
3220,0,1,16,17,1.0588235294117647,0.06063390625908324,565,"As you can see, your heartburn results are worse than I expected."
3220,0,1,16,17,1.0588235294117647,0.06063390625908324,565,This is one helluva lab report !
3220,0,1,16,17,1.0588235294117647,0.06063390625908324,565,"According to this lab report, you have a temperature of 451 Fahrenheit."
3220,0,1,16,17,1.0588235294117647,0.06063390625908324,565,It was a heated discussion but here are your results
3220,0,1,16,17,1.0588235294117647,0.06063390625908324,565,It's definitely hemorrhoids.
3220,0,1,16,17,1.0588235294117647,0.06063390625908324,565,"This might help explain the burning sensation you've been experiencing."""
3220,0,1,16,17,1.0588235294117647,0.06063390625908324,565,So your policy from the ACA exchange must be expired. It just self-destructed.
3220,0,1,16,17,1.0588235294117647,0.06063390625908324,565,Your self-diagnosis was correct. You are a twisted firestarter.
3220,0,1,16,17,1.0588235294117647,0.06063390625908324,565,"Before we review your results, can we confirm your insurance coverage?"
3220,0,1,16,17,1.0588235294117647,0.06063390625908324,565,"Don't worry, it's only Global Warming!"
3220,0,1,16,17,1.0588235294117647,0.06063390625908324,565,I'm afraid your insurance company has denied your coverage...
3220,0,1,16,17,1.0588235294117647,0.06063390625908324,565,It's Trumpcare's way of saying you have six months to live.
3220,0,1,16,17,1.0588235294117647,0.06063390625908324,565,You have the worst case of heartburn ever recorded.
3220,0,1,16,17,1.0588235294117647,0.06063390625908324,565,Your test results have set off some alarms.
3220,0,1,16,17,1.0588235294117647,0.06063390625908324,565,"Based on your test results, Mr. Smith, it's clear that I need to quit smoking."
3220,0,1,16,17,1.0588235294117647,0.06063390625908324,565,You have the worst case of Inflammatory Bowel Syndrome I've ever seen.
3220,0,1,16,17,1.0588235294117647,0.06063390625908324,565,"Well, looks like I'll be notifying the CDC and the EPA."
3220,0,1,16,17,1.0588235294117647,0.06063390625908324,565,This is what happens when you go on Tinder.
3220,0,1,16,17,1.0588235294117647,0.06063390625908324,565,You're gay.
3220,0,1,16,17,1.0588235294117647,0.06063390625908324,565,Your last E.K.G. heart rhythm's are burning up the charts.
3220,0,1,16,17,1.0588235294117647,0.06063390625908324,565,"Sorry sir, looks like congress just repealed Obamacare"
3220,0,1,16,17,1.0588235294117647,0.06063390625908324,565,This is what happens to your records when you refuse to sign the HIPAA form.
3220,0,1,16,17,1.0588235294117647,0.06063390625908324,565,"Sulking won’t help, Superman."
3220,0,1,16,17,1.0588235294117647,0.06063390625908324,565,Our lab is getting so emotional
3220,0,1,16,17,1.0588235294117647,0.06063390625908324,565,It's the smoke you have to worry about.
3220,0,1,16,17,1.0588235294117647,0.06063390625908324,565,Your insurance company promised a quick reply if you submitted your request on their flash paper.
3220,0,1,16,17,1.0588235294117647,0.06063390625908324,565,"""I did suggest you get another opinion, I did not say you had to follow it""."
3220,0,1,16,17,1.0588235294117647,0.06063390625908324,565,It will take more than a simple anti inflammatory to clear this up.
3220,0,1,16,17,1.0588235294117647,0.06063390625908324,565,Put this where the sun don't shine.
3220,0,1,16,17,1.0588235294117647,0.06063390625908324,565,How's that acid reflux doing?
3220,0,1,16,17,1.0588235294117647,0.06063390625908324,565,Life in the fast lane
3220,0,1,16,17,1.0588235294117647,0.06063390625908324,565,I think it's time to stop eating hot and spicey food.
3220,0,1,16,17,1.0588235294117647,0.06063390625908324,565,Now we will test your sense of touch.
3220,0,1,16,17,1.0588235294117647,0.06063390625908324,565,About that burning sensation you were feeling...
3220,0,1,16,17,1.0588235294117647,0.06063390625908324,565,I'm advising my patients not to sign the HIPAA disclaimer.
3220,0,1,16,17,1.0588235294117647,0.06063390625908324,565,Your lab results are a little high. You have to cut back on something.
3220,0,1,16,17,1.0588235294117647,0.06063390625908324,565,These results are no reason for you to burn your chart frank
3220,0,1,16,17,1.0588235294117647,0.06063390625908324,565,Your hemorrhoid test is in...
3220,0,1,16,17,1.0588235294117647,0.06063390625908324,565,"I'm afraid I have some bad news for you, Mr. Maga. Our office just got a call from Congress about your treatment plan. . . ."
3220,0,1,16,17,1.0588235294117647,0.06063390625908324,565,Your test results seem to be inflamed!
3220,0,1,16,17,1.0588235294117647,0.06063390625908324,565,I don't think your colonoscopy is going to take care of your flatulence.
3220,0,1,16,17,1.0588235294117647,0.06063390625908324,565,Your diagnosis is like burning in Hell.
3220,0,1,16,17,1.0588235294117647,0.06063390625908324,565,I see you have been eating hot cheetos again
3220,0,1,16,17,1.0588235294117647,0.06063390625908324,565,About that heartburn....
3220,0,1,16,17,1.0588235294117647,0.06063390625908324,565,I have the results of your STD tests.
3220,0,1,16,17,1.0588235294117647,0.06063390625908324,565,Your test results are very telling.
3220,0,1,16,17,1.0588235294117647,0.06063390625908324,565,We protect your privacy with our combustible filing system.
3220,0,1,16,17,1.0588235294117647,0.06063390625908324,565,Your tests show that you can't tolerate Jalapeno peppers without ingesting a Margarita.
3220,0,1,16,17,1.0588235294117647,0.06063390625908324,565,Some call it the diet from Hell...
3220,0,1,16,17,1.0588235294117647,0.06063390625908324,565,Sorry...it's just another HIPAA regulation.
3220,0,1,16,17,1.0588235294117647,0.06063390625908324,565,Your prognosis: Eternal Fire.
3220,0,1,16,17,1.0588235294117647,0.06063390625908324,565,Are you sure you have heartburn?
3220,0,1,16,17,1.0588235294117647,0.06063390625908324,565,Obama care has been repealed.
3220,0,1,16,17,1.0588235294117647,0.06063390625908324,565,I have your second opinion.
3220,0,1,16,17,1.0588235294117647,0.06063390625908324,565,"Don't worry, it's just the Hippocratic Oath."
3220,0,1,16,17,1.0588235294117647,0.06063390625908324,565,HIPAA requires it.
3220,0,1,16,17,1.0588235294117647,0.06063390625908324,565,"well on the positive side, where there is temperature, there is usually temptation"
3220,0,1,16,17,1.0588235294117647,0.06063390625908324,565,I think someone put a spell on you.
3220,0,1,16,17,1.0588235294117647,0.06063390625908324,565,Your colonoscopy results strongly suggest a case of Inflammatory Bowel Disease.
3220,0,1,16,17,1.0588235294117647,0.06063390625908324,565,Didn't we agree ... for you to stop eating spicy foods!
3220,0,1,16,17,1.0588235294117647,0.06063390625908324,565,"Turns out, burns are not an essential benefit."
3220,0,1,16,17,1.0588235294117647,0.06063390625908324,565,No need to worry; it's covered.
3220,0,1,16,17,1.0588235294117647,0.06063390625908324,565,Exercise and lose 10 pounds. And by the way here's a script with the working title 'Torch Song Biopsy.'
3220,0,1,16,17,1.0588235294117647,0.06063390625908324,565,We tested for cause of your cancer. The result is smoking.
3220,0,1,16,17,1.0588235294117647,0.06063390625908324,565,Our tests indicate your temperature is 451.
3220,0,1,16,17,1.0588235294117647,0.06063390625908324,565,Seems your premium is going up FAST!
3220,0,1,16,17,1.0588235294117647,0.06063390625908324,565,Your stomach would like to have a talk with you.
3220,0,1,16,17,1.0588235294117647,0.06063390625908324,565,This confirms the heartburn. And I think we'll skip the prostrate exam this year.
3220,0,1,16,17,1.0588235294117647,0.06063390625908324,565,It's the hottest thing in medical science at the moment
3220,0,1,16,17,1.0588235294117647,0.06063390625908324,565,New HIPAA rule. You won't believe what that match just cost you.
3220,0,1,16,17,1.0588235294117647,0.06063390625908324,565,Your HMO has ordered a new coarse of treatment.
3220,0,1,16,17,1.0588235294117647,0.06063390625908324,565,Your lab results are significantly less than cool.
3220,0,1,16,17,1.0588235294117647,0.06063390625908324,565,Does it burn when you pee?
3220,0,1,16,17,1.0588235294117647,0.06063390625908324,565,We're totally serious about electronic records.
3220,0,1,16,17,1.0588235294117647,0.06063390625908324,565,Sadly you wife saw how much this surgery costs
3220,0,1,16,17,1.0588235294117647,0.06063390625908324,565,"I'd tell you your test results, but then I'd have to kill you."
3220,0,1,16,17,1.0588235294117647,0.06063390625908324,565,How long have you had this burning sensation?
3220,0,1,16,17,1.0588235294117647,0.06063390625908324,565,No uncontested jumpers for the next two weeks.
3220,0,1,16,17,1.0588235294117647,0.06063390625908324,565,Good news! It's not your genitals on fire!
3220,0,1,16,17,1.0588235294117647,0.06063390625908324,565,"I'm your new internist, Dr. Faustus."
3220,0,1,16,17,1.0588235294117647,0.06063390625908324,565,Incendiary Medical Record are the latest wave in healthcare information systems; they eliminate pre-existing conditions.
3220,0,1,16,17,1.0588235294117647,0.06063390625908324,565,"Umm, your fortune cookie was wrong!"
3220,0,1,16,17,1.0588235294117647,0.06063390625908324,565,I wish it were a birthday card
3220,0,1,16,17,1.0588235294117647,0.06063390625908324,565,"For starters, cut down on the spicy food."
3220,0,1,16,17,1.0588235294117647,0.06063390625908324,565,"Next time, please spell the sensation."
3220,0,1,16,17,1.0588235294117647,0.06063390625908324,565,So you say it's like a burning feeling
3220,0,1,16,17,1.0588235294117647,0.06063390625908324,565,Bad news - I think your electronic medical records short-circuited.
3220,0,1,16,17,1.0588235294117647,0.06063390625908324,565,In order to save time with patients we burn through these reports....
3220,0,1,16,17,1.0588235294117647,0.06063390625908324,565,Why don't you get this? You have to stop smoking.
3220,0,1,16,17,1.0588235294117647,0.06063390625908324,565,It looks like your medical insurance is running out.
3220,0,1,16,17,1.0588235294117647,0.06063390625908324,565,I suggest you save money and skip the lab work-up.
3220,0,1,16,17,1.0588235294117647,0.06063390625908324,565,You have burning health issues.
3220,0,1,16,17,1.0588235294117647,0.06063390625908324,565,The tests would suggest heartburn.
3220,0,1,16,17,1.0588235294117647,0.06063390625908324,565,What X-MEN character do you play in real life Mr. Jones?
3220,0,1,16,17,1.0588235294117647,0.06063390625908324,565,"Yes, I'm sorry to say, inflamed."
3796,0,1,17,18,1.0555555555555556,0.05716619504750295,565,"For this breathing test under the new health care bill, inhale then exhale as fast as you can."
3796,0,1,17,18,1.0555555555555556,0.05716619504750295,565,"I used to set my pants on fire to tell patients they have nothing to worry about, but burning the lab report saves money."
3796,0,1,17,18,1.0555555555555556,0.05716619504750295,565,I am referring you to a pyro-specialist.
3796,0,1,17,18,1.0555555555555556,0.05716619504750295,565,How long since you last had fire in your belly?
3796,0,1,17,18,1.0555555555555556,0.05716619504750295,565,"yes, it is HCCUIF: Health Care Coverage up in Flames"
3796,0,1,17,18,1.0555555555555556,0.05716619504750295,565,"Well Jim, it looks like your hemorrhoid screen has come back positive."
3796,0,1,17,18,1.0555555555555556,0.05716619504750295,565,"Question, does this happen EVERY time you choose to accept?"
3796,0,1,17,18,1.0555555555555556,0.05716619504750295,565,"Actually we've seen this quite a bit with patients who report they ""Felt the bern."" prior to November 8, 2016."
3796,0,1,17,18,1.0555555555555556,0.05716619504750295,565,"I'm sorry, they just passed Trumpcare. We are required to do this."
3796,0,1,17,18,1.0555555555555556,0.05716619504750295,565,I'm sorry. You're insurance doesn't cover actual results.
3796,0,1,17,18,1.0555555555555556,0.05716619504750295,565,You feel OK? Right?
3796,0,1,17,18,1.0555555555555556,0.05716619504750295,565,"Better stand up, it's not heartburn"
3796,0,1,17,18,1.0555555555555556,0.05716619504750295,565,"Firest, the bad news."
3796,0,1,17,18,1.0555555555555556,0.05716619504750295,565,a few of your lab tests are abnormal
3796,0,1,17,18,1.0555555555555556,0.05716619504750295,565,"Unfortunately, your HSA is more of a Has Satan Account."
3796,0,1,17,18,1.0555555555555556,0.05716619504750295,565,"Well you've had a rough weekend, Ed."
3796,0,1,17,18,1.0555555555555556,0.05716619504750295,565,It's a rare ex-hippie condition called 'spontaneous self-immolation.' Do you have a swimming pool?
3796,0,1,17,18,1.0555555555555556,0.05716619504750295,565,Too many hot peppers in your diet
3796,0,1,17,18,1.0555555555555556,0.05716619504750295,565,Your lab results are back and you have some real issues.
3796,0,1,17,18,1.0555555555555556,0.05716619504750295,565,"Believe me, this hurts me more than it’s going to hurt you."
3796,0,1,17,18,1.0555555555555556,0.05716619504750295,565,It depends on what you mean by positive.
3796,0,1,17,18,1.0555555555555556,0.05716619504750295,565,The nurse caught it before it spread.
3796,0,1,17,18,1.0555555555555556,0.05716619504750295,565,"Remember, don't take this with grapefruit juice."
3796,0,1,17,18,1.0555555555555556,0.05716619504750295,565,What are you all fired up about?
3796,0,1,17,18,1.0555555555555556,0.05716619504750295,565,"Pyrokenisis is serious, but aquatic therapy should help."
3796,0,1,17,18,1.0555555555555556,0.05716619504750295,565,It looks as if you're going to hell.
3796,0,1,17,18,1.0555555555555556,0.05716619504750295,565,Your stomach inflammation concerns me.
3796,0,1,17,18,1.0555555555555556,0.05716619504750295,565,Where does it burn?
3796,0,1,17,18,1.0555555555555556,0.05716619504750295,565,"Yes, your condition is definitely inflamed."
3796,0,1,17,18,1.0555555555555556,0.05716619504750295,565,Let's never speak of this again.
3796,0,1,17,18,1.0555555555555556,0.05716619504750295,565,I'm sorry to tell you that you seem to have caught the new Trump Lying Disease.
3796,0,1,17,18,1.0555555555555556,0.05716619504750295,565,"""Not to worry. You'll make it to the weekend""."
3796,0,1,17,18,1.0555555555555556,0.05716619504750295,565,It's just how we deal with flatulence prior to your colonoscopy.
3796,0,1,17,18,1.0555555555555556,0.05716619504750295,565,Our records showed you paid with a hot check your last visit.
3796,0,1,17,18,1.0555555555555556,0.05716619504750295,565,Your inflammation is off the chart
3796,0,1,17,18,1.0555555555555556,0.05716619504750295,565,The new law requires medical records to deny climate change.
3796,0,1,17,18,1.0555555555555556,0.05716619504750295,565,I'd really like to drag you off an airplane.
3796,0,1,17,18,1.0555555555555556,0.05716619504750295,565,The tests show that your inflammation is spreading rapidly.
3796,0,1,17,18,1.0555555555555556,0.05716619504750295,565,I warned you it's dangerous to have a wet dream under an electric blanket!
3796,0,1,17,18,1.0555555555555556,0.05716619504750295,565,Quick...place this outside the door over that and knock as loud as you can!!
3796,0,1,17,18,1.0555555555555556,0.05716619504750295,565,This is your brain without drugs.
3796,0,1,17,18,1.0555555555555556,0.05716619504750295,565,"Before we can do anything Bill, we'll need to give you something for that fever."
3796,0,1,17,18,1.0555555555555556,0.05716619504750295,565,Given these results I'm surprised to still see you among us.
3796,0,1,17,18,1.0555555555555556,0.05716619504750295,565,Is it good news or bad?
3796,0,1,17,18,1.0555555555555556,0.05716619504750295,565,Worst report of heartburn I've ever seen.
3796,0,1,17,18,1.0555555555555556,0.05716619504750295,565,"It's time we talk about your ""good intentions"" to be healthy."
3796,0,1,17,18,1.0555555555555556,0.05716619504750295,565,You're the one who described his acid reflux as a 'ten'.
3796,0,1,17,18,1.0555555555555556,0.05716619504750295,565,"You see, burning up your bill never really pays."
3796,0,1,17,18,1.0555555555555556,0.05716619504750295,565,"Yes, this is your bill from hell but at least you aren't there paying for it!"
3796,0,1,17,18,1.0555555555555556,0.05716619504750295,565,"I'm not sure exactly what it does, but it's covered, so think of it as an amuse bouche."
3796,0,1,17,18,1.0555555555555556,0.05716619504750295,565,You may experience some side effects
3796,0,1,17,18,1.0555555555555556,0.05716619504750295,565,No! Your extremely high Test Results is Not caused by Global Warming!
3796,0,1,17,18,1.0555555555555556,0.05716619504750295,565,Malpractice lawyers hate me.
3796,0,1,17,18,1.0555555555555556,0.05716619504750295,565,I think we need to do more tests.
3796,0,1,17,18,1.0555555555555556,0.05716619504750295,565,I've got some burning questions
3796,0,1,17,18,1.0555555555555556,0.05716619504750295,565,Don't worry. There's no pre-existing condition.
3796,0,1,17,18,1.0555555555555556,0.05716619504750295,565,Hot off the office printer insurance provider precscription rejection letter.
3796,0,1,17,18,1.0555555555555556,0.05716619504750295,565,Mercury is totally in retrograde. Good vibes only.
3796,0,1,17,18,1.0555555555555556,0.05716619504750295,565,The biopsy of your liver is indicative of an excess of hot toddies
3796,0,1,17,18,1.0555555555555556,0.05716619504750295,565,"I, too, suffer from immolation syndrome."
3796,0,1,17,18,1.0555555555555556,0.05716619504750295,565,Your test results might be a cause for some concern.
3796,0,1,17,18,1.0555555555555556,0.05716619504750295,565,This is your brain on drugs.
3796,0,1,17,18,1.0555555555555556,0.05716619504750295,565,"No more ghost peppers, Mr. Henderson."
3796,0,1,17,18,1.0555555555555556,0.05716619504750295,565,It's an inflamed Appendix.
3796,0,1,17,18,1.0555555555555556,0.05716619504750295,565,Please don't believe everything you read online.
3796,0,1,17,18,1.0555555555555556,0.05716619504750295,565,I'd use s lot more sunblock.
3796,0,1,17,18,1.0555555555555556,0.05716619504750295,565,"Don't worry, it's just inflamemation."
3796,0,1,17,18,1.0555555555555556,0.05716619504750295,565,not exactly the hot sheets I was talking about
3796,0,1,17,18,1.0555555555555556,0.05716619504750295,565,This is the worst case of gonorrhea I've ever seen.
3796,0,1,17,18,1.0555555555555556,0.05716619504750295,565,"No, sir, I asked you if you've been ""feeling the Bern."""
3796,0,1,17,18,1.0555555555555556,0.05716619504750295,565,The lab results suggest that the inflamation has increased significantly since your last visit.
3796,0,1,17,18,1.0555555555555556,0.05716619504750295,565,Privacy rules.
3796,0,1,17,18,1.0555555555555556,0.05716619504750295,565,How long have you had heartburn?
3796,0,1,17,18,1.0555555555555556,0.05716619504750295,565,Here's the co-pay.
3796,0,1,17,18,1.0555555555555556,0.05716619504750295,565,Hold this while I get a fire extinguisher.
3796,0,1,17,18,1.0555555555555556,0.05716619504750295,565,I can state unequivocally you're as astonishingly healthy as a 70-year-old man with orange skin.
3796,0,1,17,18,1.0555555555555556,0.05716619504750295,565,"Mr. Flambeau, when did you first become aware of your kinetic powers?"
3796,0,1,17,18,1.0555555555555556,0.05716619504750295,565,"I'm sorry Sir, Medicaid doesn't cover what you have."
3796,0,1,17,18,1.0555555555555556,0.05716619504750295,565,This acid reflux prescription is guaranteed to work!
3796,0,1,17,18,1.0555555555555556,0.05716619504750295,565,"Well, it says you don't have a cold."
3796,0,1,17,18,1.0555555555555556,0.05716619504750295,565,It's definitely en-flamed chartburn.
3796,0,1,17,18,1.0555555555555556,0.05716619504750295,565,Caption winners are rigged!
3796,0,1,17,18,1.0555555555555556,0.05716619504750295,565,You have a slight fever. Your temperature is 451 degrees.
3796,0,1,17,18,1.0555555555555556,0.05716619504750295,565,"Immolation is suggested as an alternative treatment, Sir. Are you ready?"
3796,0,1,17,18,1.0555555555555556,0.05716619504750295,565,The privacy and security of patient health information is our top priority.
3796,0,1,17,18,1.0555555555555556,0.05716619504750295,565,The lab report is too hot to handle.
3796,0,1,17,18,1.0555555555555556,0.05716619504750295,565,"Wow, your hormone levels are off the charts!"
3796,0,1,17,18,1.0555555555555556,0.05716619504750295,565,Say
3796,0,1,17,18,1.0555555555555556,0.05716619504750295,565,I've written you a prescription for 5 gallons of carbon dioxide.
3796,0,1,17,18,1.0555555555555556,0.05716619504750295,565,The biopsy came back - it's a hunka-hunka burnin' love.
3796,0,1,17,18,1.0555555555555556,0.05716619504750295,565,The inflammation has spread!
3796,0,1,17,18,1.0555555555555556,0.05716619504750295,565,This hurts me more than it hurts you.
3796,0,1,17,18,1.0555555555555556,0.05716619504750295,565,Your levels are on fire.
3796,0,1,17,18,1.0555555555555556,0.05716619504750295,565,I’ve arranged for a second opinion from the Fire Marshall.
3796,0,1,17,18,1.0555555555555556,0.05716619504750295,565,I'm afraid there's no cure for a superpower.
3796,0,1,17,18,1.0555555555555556,0.05716619504750295,565,I'm not trained as a fire-eater.
3796,0,1,17,18,1.0555555555555556,0.05716619504750295,565,I don't suppose you're on Medicare yet...
3796,0,1,17,18,1.0555555555555556,0.05716619504750295,565,That IS a high fever.
3796,0,1,17,18,1.0555555555555556,0.05716619504750295,565,Yep! You have the worst case of heartburn I've seen.
3796,0,1,17,18,1.0555555555555556,0.05716619504750295,565,Let me get right to the point.
3796,0,1,17,18,1.0555555555555556,0.05716619504750295,565,This happens when there's an inflammation diagnosis. Our new 3-D printer likes to show off.
3796,0,1,17,18,1.0555555555555556,0.05716619504750295,565,The devil's in the detail
3796,0,1,17,18,1.0555555555555556,0.05716619504750295,565,How long have you noticed the burning sensation?
3796,0,1,17,18,1.0555555555555556,0.05716619504750295,565,We're testing to increase the urgency of the results.
3796,0,1,17,18,1.0555555555555556,0.05716619504750295,565,"We were just notified by your employer on your pre-approval estimate and they said ""you're fired"""
3796,0,1,17,18,1.0555555555555556,0.05716619504750295,565,And how long have you been working for Mr. Brannon?
3796,0,1,17,18,1.0555555555555556,0.05716619504750295,565,That's actually not where I usually feel the burning sensation.
3796,0,1,17,18,1.0555555555555556,0.05716619504750295,565,"OK, who did I refer you to for those new contacts?"
3796,0,1,17,18,1.0555555555555556,0.05716619504750295,565,I'm new at prescribing marijuana.
3796,0,1,17,18,1.0555555555555556,0.05716619504750295,565,This has helped my other clients too. Patients are more asymptomatic when they walk out of here without the hard copy of the bill.
3796,0,1,17,18,1.0555555555555556,0.05716619504750295,565,The hospital's really getting serious about converting to digital.
3796,0,1,17,18,1.0555555555555556,0.05716619504750295,565,Thank you for the stool sample....Mexican food last night???
3796,0,1,17,18,1.0555555555555556,0.05716619504750295,565,... uh ... rash?
3796,0,1,17,18,1.0555555555555556,0.05716619504750295,565,It's to ensure the privacy of your information
3796,0,1,17,18,1.0555555555555556,0.05716619504750295,565,It burns when I pee.
3796,0,1,17,18,1.0555555555555556,0.05716619504750295,565,...checking over your Trump-RyanCare coverage...
3796,0,1,17,18,1.0555555555555556,0.05716619504750295,565,"It's auto-da-fe syndrome, but don't look like such a martyr."
3796,0,1,17,18,1.0555555555555556,0.05716619504750295,565,Are you sure you like the doctor?
3796,0,1,17,18,1.0555555555555556,0.05716619504750295,565,It's contraindicated.
3796,0,1,17,18,1.0555555555555556,0.05716619504750295,565,Professor Xavier said this might happen if you had to get a shot
3796,0,1,17,18,1.0555555555555556,0.05716619504750295,565,Mind paying in advance?
3796,0,1,17,18,1.0555555555555556,0.05716619504750295,565,"Let's treat for chlamydia just to be safe, but I'm also recommending a reputable psychoanalyst to help us get a handle on the pyrokinesis."
3796,0,1,17,18,1.0555555555555556,0.05716619504750295,565,You'll need to take a chill pill...
3796,0,1,17,18,1.0555555555555556,0.05716619504750295,565,Its a privacy thing
3796,0,1,17,18,1.0555555555555556,0.05716619504750295,565,I think you have an inflamed medical bill!
3796,0,1,17,18,1.0555555555555556,0.05716619504750295,565,The good news is that you probably won't die today7
3796,0,1,17,18,1.0555555555555556,0.05716619504750295,565,You're going to need the Mother of all Balms.
3796,0,1,17,18,1.0555555555555556,0.05716619504750295,565,I did ask your HMO if this procedure is covered...
3796,0,1,17,18,1.0555555555555556,0.05716619504750295,565,The tests confirm my diagnosis of extreme burn-out.
3796,0,1,17,18,1.0555555555555556,0.05716619504750295,565,"The good news is I'm going to burn the results before anyone else sees. The bad news is..."""
3796,0,1,17,18,1.0555555555555556,0.05716619504750295,565,But the good news is...
3796,0,1,17,18,1.0555555555555556,0.05716619504750295,565,Seems you're about to no longer have a preexisting condition.
3796,0,1,17,18,1.0555555555555556,0.05716619504750295,565,Looks like inflammation of the HIPAA.
3796,0,1,17,18,1.0555555555555556,0.05716619504750295,565,Oops! I grabbed the wrong pen!
3796,0,1,17,18,1.0555555555555556,0.05716619504750295,565,Your burning sensation is starting to make sense.
3796,0,1,17,18,1.0555555555555556,0.05716619504750295,565,Are you sure your family history doesn't include cravings for baked Alaska?
3796,0,1,17,18,1.0555555555555556,0.05716619504750295,565,It's more than a diagnosis; it's your prognosis.
3796,0,1,17,18,1.0555555555555556,0.05716619504750295,565,You have an inflammation that is contagious on paper
3796,0,1,17,18,1.0555555555555556,0.05716619504750295,565,You're eating way too much Sriracha.
3796,0,1,17,18,1.0555555555555556,0.05716619504750295,565,Discontinue the heating pad.
3796,0,1,17,18,1.0555555555555556,0.05716619504750295,565,"Okay, maybe heat vision does exist."
3796,0,1,17,18,1.0555555555555556,0.05716619504750295,565,"If it burns, it means it's working."
3796,0,1,17,18,1.0555555555555556,0.05716619504750295,565,So you're saying the burning sensation is a 100 on the standard 1 to 10 pain scale.
3796,0,1,17,18,1.0555555555555556,0.05716619504750295,565,Your test results suggest a deficit in anti-inflammatories.
3796,0,1,17,18,1.0555555555555556,0.05716619504750295,565,I apologize. This happens every time the electronic medical records representative stops by.
3796,0,1,17,18,1.0555555555555556,0.05716619504750295,565,I`m afraid you`re generating more energy than you`re using.
3796,0,1,17,18,1.0555555555555556,0.05716619504750295,565,"""Your test results indicate your're dehydrated""!"
3796,0,1,17,18,1.0555555555555556,0.05716619504750295,565,Your test results indicate heartburn.
3796,0,1,17,18,1.0555555555555556,0.05716619504750295,565,You'll need to take a chill pill...
3796,0,1,17,18,1.0555555555555556,0.05716619504750295,565,Don't worry! The smoke won't make your cancer any worse!
3796,0,1,17,18,1.0555555555555556,0.05716619504750295,565,Your records indicate a long history if recurrent fever.
3796,0,1,17,18,1.0555555555555556,0.05716619504750295,565,"Looks bad, Mr. Smith, biopsy report shows inflamed appendix!"
3796,0,1,17,18,1.0555555555555556,0.05716619504750295,565,Says here you suffer from heartburn.
3796,0,1,17,18,1.0555555555555556,0.05716619504750295,565,You have a very bad case of heartburn.
3796,0,1,17,18,1.0555555555555556,0.05716619504750295,565,"The good news is that it's just your health care reform bill, Speaker Ryan."
3796,0,1,17,18,1.0555555555555556,0.05716619504750295,565,"Whoa, your temputure is burning up"
3796,0,1,17,18,1.0555555555555556,0.05716619504750295,565,Tell me more about that burning sensation you mentioned.
3796,0,1,17,18,1.0555555555555556,0.05716619504750295,565,We left you in the MRI too long
3796,0,1,17,18,1.0555555555555556,0.05716619504750295,565,The test results indicate an enflamed nestegg.
3796,0,1,17,18,1.0555555555555556,0.05716619504750295,565,"Not to worry, the burning sensation will go away on its own."
3796,0,1,17,18,1.0555555555555556,0.05716619504750295,565,"I'm sorry, this is how we've been told to dispose of Ryancare cards."
3796,0,1,17,18,1.0555555555555556,0.05716619504750295,565,Now we both know how it feels to have our shit on blast.
3796,0,1,17,18,1.0555555555555556,0.05716619504750295,565,I have your test results.
3796,0,1,17,18,1.0555555555555556,0.05716619504750295,565,"Mexican, Indian--and, now, Thai food! I TOLD you to stay away from the spices..."
3796,0,1,17,18,1.0555555555555556,0.05716619504750295,565,Its says here you’re a flaming cis white male.
3796,0,1,17,18,1.0555555555555556,0.05716619504750295,565,"Believe it or not, yours isn't the worst case of GERD I've seen."
3796,0,1,17,18,1.0555555555555556,0.05716619504750295,565,It appears you have a severe case of pyromania.
3796,0,1,17,18,1.0555555555555556,0.05716619504750295,565,"I apologize, we're having some glitches with going paperless."
3796,0,1,17,18,1.0555555555555556,0.05716619504750295,565,Take a deep breath .
3796,0,1,17,18,1.0555555555555556,0.05716619504750295,565,You need to reconsider attending the Burning Man Festival again this year.
3796,0,1,17,18,1.0555555555555556,0.05716619504750295,565,Seems you DO have hemmoroids.
3796,0,1,17,18,1.0555555555555556,0.05716619504750295,565,"Apparently, your heart's not healthy enough for sex."
3796,0,1,17,18,1.0555555555555556,0.05716619504750295,565,Your X-rays show some minor inflammation.
3796,0,1,17,18,1.0555555555555556,0.05716619504750295,565,I see here you're experiencing some chart burn.
3796,0,1,17,18,1.0555555555555556,0.05716619504750295,565,Etodolac. It's an anti-inflammatory.
3796,0,1,17,18,1.0555555555555556,0.05716619504750295,565,I see from you chart that your experiencing a burning sensation . . .
3796,0,1,17,18,1.0555555555555556,0.05716619504750295,565,I just have to insert this flame in your heart to fill you with desire.
3796,0,1,17,18,1.0555555555555556,0.05716619504750295,565,It says in your chart that it burns.
3796,0,1,17,18,1.0555555555555556,0.05716619504750295,565,You're all fired up and ready to go
3796,0,1,17,18,1.0555555555555556,0.05716619504750295,565,Please let me know when my expression matches your pain level.
3796,0,1,17,18,1.0555555555555556,0.05716619504750295,565,Those damn Republicans.
3796,0,1,17,18,1.0555555555555556,0.05716619504750295,565,You may only have one itching desire But the AMA discourages the use of fire.
3796,0,1,17,18,1.0555555555555556,0.05716619504750295,565,Seems you're running a fever
3796,0,1,17,18,1.0555555555555556,0.05716619504750295,565,Sorry to keep you waiting.
3796,0,1,17,18,1.0555555555555556,0.05716619504750295,565,"All your tests came back negative, however I suggest you lay off the spicy food!"
3796,0,1,17,18,1.0555555555555556,0.05716619504750295,565,"You usually walk barefoot across hot coals, don't you?"
3796,0,1,17,18,1.0555555555555556,0.05716619504750295,565,The results of your sperm count are in
3796,0,1,17,18,1.0555555555555556,0.05716619504750295,565,"So, our charges have gone up a bit .."
3796,0,1,17,18,1.0555555555555556,0.05716619504750295,565,Your stool sample suggests spicy foods may be the cause of the problem.
3796,0,1,17,18,1.0555555555555556,0.05716619504750295,565,These tests indicate that you have pyromaniac tendencies.
3796,0,1,17,18,1.0555555555555556,0.05716619504750295,565,It's my little way of protesting electronic medical records
3796,0,1,17,18,1.0555555555555556,0.05716619504750295,565,Looks like the Affordable Care Act just went up in flames.
3796,0,1,17,18,1.0555555555555556,0.05716619504750295,565,Another hot topic in health care
3796,0,1,17,18,1.0555555555555556,0.05716619504750295,565,Not to worry! It's just a little chart burn.
3796,0,1,17,18,1.0555555555555556,0.05716619504750295,565,Do you want to hear the good news first?
3796,0,1,17,18,1.0555555555555556,0.05716619504750295,565,"Well, looks like your hemorrhoids aren't the only things burning..."
3796,0,1,17,18,1.0555555555555556,0.05716619504750295,565,"Once this is all ash, you should be completely healthy."
3796,0,1,17,18,1.0555555555555556,0.05716619504750295,565,"Yes, I'd say you have a very high fever."
3796,0,1,17,18,1.0555555555555556,0.05716619504750295,565,The privacy laws are getting very strict.
3796,0,1,17,18,1.0555555555555556,0.05716619504750295,565,"The good news is you are not going to die. The bad news is, these results also predict where you are headed when you do."
3796,0,1,17,18,1.0555555555555556,0.05716619504750295,565,Severe heartburn is the only way that I can interpret your lab report.
3796,0,1,17,18,1.0555555555555556,0.05716619504750295,565,"Wow, you have some history."
3796,0,1,17,18,1.0555555555555556,0.05716619504750295,565,"I said I'd retire if I ever won the New Yorker caption contest. Well, I won!"
3796,0,1,17,18,1.0555555555555556,0.05716619504750295,565,Your tests confirm you have wandering heart burn.
3796,0,1,17,18,1.0555555555555556,0.05716619504750295,565,I'm seeing some slight inflammation.
3796,0,1,17,18,1.0555555555555556,0.05716619504750295,565,"Well, the results aren't good."
3796,0,1,17,18,1.0555555555555556,0.05716619504750295,565,I have your acid reflux lab report right here.
3796,0,1,17,18,1.0555555555555556,0.05716619504750295,565,"We're pinning it down, Mr. Granvold. It's either your health or our computer system."
3796,0,1,17,18,1.0555555555555556,0.05716619504750295,565,I pronounce you cured of your tax problem and fit to run for public office.
3796,0,1,17,18,1.0555555555555556,0.05716619504750295,565,This is going to be expensive.
3796,0,1,17,18,1.0555555555555556,0.05716619504750295,565,Side effects may include a burning sensation.
3796,0,1,17,18,1.0555555555555556,0.05716619504750295,565,"Well, the good news is you d Well, the good news is there's no need to see a specialist....."
3796,0,1,17,18,1.0555555555555556,0.05716619504750295,565,I know I said your test results weren't SO hot...
3796,0,1,17,18,1.0555555555555556,0.05716619504750295,565,Our new filing system can't be hacked. It's the hottest thing on the market.
3796,0,1,17,18,1.0555555555555556,0.05716619504750295,565,"Unfortunately, you set more than just the night on fire."
3796,0,1,17,18,1.0555555555555556,0.05716619504750295,565,Here's a prescription for the hottest new drug on the market.
3796,0,1,17,18,1.0555555555555556,0.05716619504750295,565,"The number was so large, the printer started on fire."
3796,0,1,17,18,1.0555555555555556,0.05716619504750295,565,"We'll be more explicit in the future; fasting includes not hot sauce, you see>"
3796,0,1,17,18,1.0555555555555556,0.05716619504750295,565,"No, no, you'll need more than Tums for this I'm afraid."
3796,0,1,17,18,1.0555555555555556,0.05716619504750295,565,"the flame test on your dip-sheet suggest that you ought to order that ""meso book"""
3796,0,1,17,18,1.0555555555555556,0.05716619504750295,565,"Mr. Phelps, it would appear the burning question at hand of your indigestion test results also have my attention."
3796,0,1,17,18,1.0555555555555556,0.05716619504750295,565,I need to prescribe you a water pill.
3796,0,1,17,18,1.0555555555555556,0.05716619504750295,565,The CIA called--your condition is top secret.
3796,0,1,17,18,1.0555555555555556,0.05716619504750295,565,"Sorry, got it too close to the Bunsen burner."
3796,0,1,17,18,1.0555555555555556,0.05716619504750295,565,It's definitely inflammation of some sort.
3796,0,1,17,18,1.0555555555555556,0.05716619504750295,565,We should go digital.
3796,0,1,17,18,1.0555555555555556,0.05716619504750295,565,I found this list of your symptoms in a medical dictionary. - Looks like an inflamed appendix.
3796,0,1,17,18,1.0555555555555556,0.05716619504750295,565,"obanacare, you bitch...lol"
3796,0,1,17,18,1.0555555555555556,0.05716619504750295,565,oh there always fun Timmy ...... but you could burn down the house with this girl ....
3796,0,1,17,18,1.0555555555555556,0.05716619504750295,565,"Well, Mr. Bielenbick... The lab results are conclusive. You either have multiple inflammations... or you're about to get fired."
3796,0,1,17,18,1.0555555555555556,0.05716619504750295,565,"Mr. Kent, I really wish you would stop trying to read your chart."
3796,0,1,17,18,1.0555555555555556,0.05716619504750295,565,I see you're suffering from a burning sensation.
3796,0,1,17,18,1.0555555555555556,0.05716619504750295,565,"If you get it filled before it self-destructs, your insurance covers it."
3796,0,1,17,18,1.0555555555555556,0.05716619504750295,565,Have you been eating Mexican food lately?
3796,0,1,17,18,1.0555555555555556,0.05716619504750295,565,I told you an A1c higher than 7 is playing with fire!
3796,0,1,17,18,1.0555555555555556,0.05716619504750295,565,HIPAA compliance!
3796,0,1,17,18,1.0555555555555556,0.05716619504750295,565,Your gall bladder is fine. It's your Obamacare plan that's toast.
3796,0,1,17,18,1.0555555555555556,0.05716619504750295,565,Say
3796,0,1,17,18,1.0555555555555556,0.05716619504750295,565,Try harder and come back in three months. We'll pretend we never saw these labs.
3796,0,1,17,18,1.0555555555555556,0.05716619504750295,565,You have the worst heartburn I've ever seen.
3796,0,1,17,18,1.0555555555555556,0.05716619504750295,565,Trumpcare.
3796,0,1,17,18,1.0555555555555556,0.05716619504750295,565,"No, no, it's the printer."
3796,0,1,17,18,1.0555555555555556,0.05716619504750295,565,Surprise! Our Office is going paperless.
3796,0,1,17,18,1.0555555555555556,0.05716619504750295,565,"And you're sure you aren't exaggerating when you say it's a ""burning sensation""?"
3796,0,1,17,18,1.0555555555555556,0.05716619504750295,565,Not to worry--heartburn always does that.
3796,0,1,17,18,1.0555555555555556,0.05716619504750295,565,I've got some good news and some hot news
3796,0,1,17,18,1.0555555555555556,0.05716619504750295,565,I'm prescribing a fire extinguisher for your heartburn.
3796,0,1,17,18,1.0555555555555556,0.05716619504750295,565,"Surprisingly, the tests point to menopause."
3796,0,1,17,18,1.0555555555555556,0.05716619504750295,565,Your test results are off the charts.
3796,0,1,17,18,1.0555555555555556,0.05716619504750295,565,Your insurance coverage will self-destruct in five seconds.
3796,0,1,17,18,1.0555555555555556,0.05716619504750295,565,"For the one with owls ""I know who's on first. Tell them I need to know who's on second."""
3796,0,1,17,18,1.0555555555555556,0.05716619504750295,565,The report is conclusive. Your banana split diet does not exactly lower your cholesterol.
3796,0,1,17,18,1.0555555555555556,0.05716619504750295,565,A cold will cure what your labs indicate you have.
3796,0,1,17,18,1.0555555555555556,0.05716619504750295,565,Or are your hemorrhoids more like this?
3796,0,1,17,18,1.0555555555555556,0.05716619504750295,565,"If a crow caws twice at dusk, you'll have to come back for more tests."
3796,0,1,17,18,1.0555555555555556,0.05716619504750295,565,"I'm sorry, your insurance doesn't cover chart burn"
3796,0,1,17,18,1.0555555555555556,0.05716619504750295,565,Inflammatory bowel syndrome !
3796,0,1,17,18,1.0555555555555556,0.05716619504750295,565,"You haven't been taking your antacids, I see"
3796,0,1,17,18,1.0555555555555556,0.05716619504750295,565,It might just be heartburn
3796,0,1,17,18,1.0555555555555556,0.05716619504750295,565,This may burn a little going down
3796,0,1,17,18,1.0555555555555556,0.05716619504750295,565,How many years have you been smoking?
3796,0,1,17,18,1.0555555555555556,0.05716619504750295,565,Worst case of X-ray vision I've seen.
3796,0,1,17,18,1.0555555555555556,0.05716619504750295,565,How long is this stress test going to last?
3796,0,1,17,18,1.0555555555555556,0.05716619504750295,565,Looks as if the markers in your blood profile are off the charts.
3796,0,1,17,18,1.0555555555555556,0.05716619504750295,565,This is your brain on fire.
3796,0,1,17,18,1.0555555555555556,0.05716619504750295,565,I'm afraid she says she's leaving you and this was the flame in your heart.
3796,0,1,17,18,1.0555555555555556,0.05716619504750295,565,You are suffering from flamebosis
3796,0,1,17,18,1.0555555555555556,0.05716619504750295,565,Your chart indicates an inflammatory condition.
3796,0,1,17,18,1.0555555555555556,0.05716619504750295,565,"According to my daughter your test results are ""Lit""."
3796,0,1,17,18,1.0555555555555556,0.05716619504750295,565,You're fine. Please leave now.
3796,0,1,17,18,1.0555555555555556,0.05716619504750295,565,I believe you when you say that heartburn bothers you.
3796,0,1,17,18,1.0555555555555556,0.05716619504750295,565,Your prognosis from the lab speaks for itself.
3796,0,1,17,18,1.0555555555555556,0.05716619504750295,565,Unfortunately you're not covered for spontaneous combustion.
3796,0,1,17,18,1.0555555555555556,0.05716619504750295,565,"Its so infectious, well, your next!"
3796,0,1,17,18,1.0555555555555556,0.05716619504750295,565,Your heartburn is off the charts.
3796,0,1,17,18,1.0555555555555556,0.05716619504750295,565,"Not to worry, it's just your healthcare plan."
3796,0,1,17,18,1.0555555555555556,0.05716619504750295,565,"You have no danger of a heart attack,but your heartburn is critical."
3796,0,1,17,18,1.0555555555555556,0.05716619504750295,565,Your test shows that the inflammation has spread.
3796,0,1,17,18,1.0555555555555556,0.05716619504750295,565,"When you first swallow it, there may be a slight burning sensation."
3796,0,1,17,18,1.0555555555555556,0.05716619504750295,565,So you're dragon #3 on Game of Thrones
3796,0,1,17,18,1.0555555555555556,0.05716619504750295,565,"Yes, you can have ice cream after."
3796,0,1,17,18,1.0555555555555556,0.05716619504750295,565,First we treat the fever
3796,0,1,17,18,1.0555555555555556,0.05716619504750295,565,I'm afraid to report your prognosis is extremely ominous.
3796,0,1,17,18,1.0555555555555556,0.05716619504750295,565,You've got a high temperature.
3796,0,1,17,18,1.0555555555555556,0.05716619504750295,565,"...multiple languages, these Ten Commandments, flames; it's early, but you definitely have Pentecostalitis."
3796,0,1,17,18,1.0555555555555556,0.05716619504750295,565,This is your malpractice suit. Now let me take a look at you.
3796,0,1,17,18,1.0555555555555556,0.05716619504750295,565,Your choice is either bring down these numbers or we install a sprinkler system.
3796,0,1,17,18,1.0555555555555556,0.05716619504750295,565,We've found that burning your medical bill is twice as effective as any treatment we have.
3796,0,1,17,18,1.0555555555555556,0.05716619504750295,565,Not to worry. We're trying to go paperless in this office.
3796,0,1,17,18,1.0555555555555556,0.05716619504750295,565,The good news is it's only gas.
3796,0,1,17,18,1.0555555555555556,0.05716619504750295,565,I always get fired up during evaluations
3796,0,1,17,18,1.0555555555555556,0.05716619504750295,565,The diagnosis is confirmed. You really do have flaming hemorrhoids!
3796,0,1,17,18,1.0555555555555556,0.05716619504750295,565,I think the best course of action is to first address your fever.
3796,0,1,17,18,1.0555555555555556,0.05716619504750295,565,This is a metaphor for how sick you are.
3796,0,1,17,18,1.0555555555555556,0.05716619504750295,565,Here's your prognosis. Hot off the press.
3796,0,1,17,18,1.0555555555555556,0.05716619504750295,565,"Umm...okay, now please IN-hale."
3796,0,1,17,18,1.0555555555555556,0.05716619504750295,565,Your chart indicates you are prone to spontaneous human combustion.
3796,0,1,17,18,1.0555555555555556,0.05716619504750295,565,"Mr. Phelps, you have 30 seconds to find a cure before your diagnosis self-destructs."
3796,0,1,17,18,1.0555555555555556,0.05716619504750295,565,Your lab results? I'll get to those in a second.
3796,0,1,17,18,1.0555555555555556,0.05716619504750295,565,"I'm Dr. Miller, the hot mess specialist."
3796,0,1,17,18,1.0555555555555556,0.05716619504750295,565,I'm afraid the signs aren't good.
3796,0,1,17,18,1.0555555555555556,0.05716619504750295,565,Dr. Moses was appointed by God to lead the patients out the land of illness.
3796,0,1,17,18,1.0555555555555556,0.05716619504750295,565,I must say your heartburn is the most acute case I have seen.
3796,0,1,17,18,1.0555555555555556,0.05716619504750295,565,I take it you're a chef. It's hyperactive flambé syndrome.
3796,0,1,17,18,1.0555555555555556,0.05716619504750295,565,My specialty is pyromania.
3796,0,1,17,18,1.0555555555555556,0.05716619504750295,565,My nurse tells me your passing gas has worsened since we last saw you.
3796,0,1,17,18,1.0555555555555556,0.05716619504750295,565,I found this to be a much more effective way for testing reflexes. Catch!
3796,0,1,17,18,1.0555555555555556,0.05716619504750295,565,Your acid indigestion is nothing like we have seen before
3796,0,1,17,18,1.0555555555555556,0.05716619504750295,565,"I have to say, there's a strong indication of acute inflammation."
3796,0,1,17,18,1.0555555555555556,0.05716619504750295,565,The test came back positive for pyromania.
3796,0,1,17,18,1.0555555555555556,0.05716619504750295,565,"I was asking about your cholesterol, not combustible."
3796,0,1,17,18,1.0555555555555556,0.05716619504750295,565,Obviously a severe case of active Hypyrocondriaism. Use two fire extinguishers before bed and call me in the morning.
3796,0,1,17,18,1.0555555555555556,0.05716619504750295,565,Just checking if you're really dehydrated.
3796,0,1,17,18,1.0555555555555556,0.05716619504750295,565,Those Proton Pump Inhibitors have declared war.
3796,0,1,17,18,1.0555555555555556,0.05716619504750295,565,A liquid diet seems the way to go.
3796,0,1,17,18,1.0555555555555556,0.05716619504750295,565,Your scan showed a few hot spots.
3796,0,1,17,18,1.0555555555555556,0.05716619504750295,565,I hope that you are ready for the hot results.
3796,0,1,17,18,1.0555555555555556,0.05716619504750295,565,Looks like a case of spontaneous congestion.
3796,0,1,17,18,1.0555555555555556,0.05716619504750295,565,"Our attorney advises, we give you your test results, make a wish and poof, no liability!"
3796,0,1,17,18,1.0555555555555556,0.05716619504750295,565,"You are running a fever of 451 Fahrenheit"""
3796,0,1,17,18,1.0555555555555556,0.05716619504750295,565,Your results are back and it suggests you go on a bland diet.
3796,0,1,17,18,1.0555555555555556,0.05716619504750295,565,"X-rays don't lie, Chef Battali. If you want to keep your health, Get out of the kitchen."
3796,0,1,17,18,1.0555555555555556,0.05716619504750295,565,This was the good news.
3796,0,1,17,18,1.0555555555555556,0.05716619504750295,565,It appears that your benzene levels are at the upper limit.
3796,0,1,17,18,1.0555555555555556,0.05716619504750295,565,A cold case this is not.
3796,0,1,17,18,1.0555555555555556,0.05716619504750295,565,At least I'm moving forward.
3796,0,1,17,18,1.0555555555555556,0.05716619504750295,565,Pre-existing condition? What pre-existing condition?
3796,0,1,17,18,1.0555555555555556,0.05716619504750295,565,"Mr. Finkleman, consider this a metaphor for your digestive tract."
3796,0,1,17,18,1.0555555555555556,0.05716619504750295,565,It’s not covered by new Affordable HellCare Act. Nothing is.
3796,0,1,17,18,1.0555555555555556,0.05716619504750295,565,You've got something very hot.
3796,0,1,17,18,1.0555555555555556,0.05716619504750295,565,I knew your joints were inflamed but this is nuts.
3796,0,1,17,18,1.0555555555555556,0.05716619504750295,565,We've got a hell of a problem.
3796,0,1,17,18,1.0555555555555556,0.05716619504750295,565,"On the plus side, it does appear you'll die soon."
3796,0,1,17,18,1.0555555555555556,0.05716619504750295,565,"But, Doc, can the inflammation be put out?"
3796,0,1,17,18,1.0555555555555556,0.05716619504750295,565,A Case of Myeloma with Flaming Plasma Cells but no Significant M-compound in Serum
3796,0,1,17,18,1.0555555555555556,0.05716619504750295,565,Welcome to Mission Impossible Hospital
3796,0,1,17,18,1.0555555555555556,0.05716619504750295,565,"Hm, it looks like your records indicate a burning sensation."
3796,0,1,17,18,1.0555555555555556,0.05716619504750295,565,"Bad news, it's inflammatory."
3796,0,1,17,18,1.0555555555555556,0.05716619504750295,565,We found 3D printing as such a time saver in explaining test results.
4135,0,1,18,19,1.0526315789473684,0.05407380704358751,565,"Oh, and, how'd I miss that? You are showing some signs of inflammation."
4135,0,1,18,19,1.0526315789473684,0.05407380704358751,565,This is what I call the burning urgency of your diagnosis
4135,0,1,18,19,1.0526315789473684,0.05407380704358751,565,"I'm sorry, Mr. Weaver, but the test results indicate that your inflammation has spread."
4135,0,1,18,19,1.0526315789473684,0.05407380704358751,565,Your tests are in and yes you do have a bad case of heart burn.
4135,0,1,18,19,1.0526315789473684,0.05407380704358751,565,"So just stick out your tongue, say ahhh, and we'll throw some light on what's irritating the back of your throat."
4135,0,1,18,19,1.0526315789473684,0.05407380704358751,565,I have the results of your urinalysis...the burning sensation you described is off the charts!
4135,0,1,18,19,1.0526315789473684,0.05407380704358751,565,"I'm sorry, this is Trump's prognosis."
4135,0,1,18,19,1.0526315789473684,0.05407380704358751,565,We are just complying with the new changes to the Health Insurance Portability and Accountability Act.
4135,0,1,18,19,1.0526315789473684,0.05407380704358751,565,"I must say, I have never seen test results so bad that they spontaneously combust."
4135,0,1,18,19,1.0526315789473684,0.05407380704358751,565,You might want to reconsider your devil-may-care attitude about cholesterol.
4135,0,1,18,19,1.0526315789473684,0.05407380704358751,565,Yep. Heartburn.
4135,0,1,18,19,1.0526315789473684,0.05407380704358751,565,Sure fire cold remedy.
4135,0,1,18,19,1.0526315789473684,0.05407380704358751,565,Are you still smoking?
4135,0,1,18,19,1.0526315789473684,0.05407380704358751,565,YOUR SCAN IS BACK AND IT'S ALARMING
4135,0,1,18,19,1.0526315789473684,0.05407380704358751,565,You have pyromania.
4135,0,1,18,19,1.0526315789473684,0.05407380704358751,565,That's the most contagious case of heartburn I've ever seen.
4135,0,1,18,19,1.0526315789473684,0.05407380704358751,565,You'll need a couple of TUMS after this.
4135,0,1,18,19,1.0526315789473684,0.05407380704358751,565,"You were right, test results show a flare-up."
4135,0,1,18,19,1.0526315789473684,0.05407380704358751,565,"Unfortunately, God is saying ""you're fired"""
4135,0,1,18,19,1.0526315789473684,0.05407380704358751,565,"Ok,ok,mutants don't pay!"
4135,0,1,18,19,1.0526315789473684,0.05407380704358751,565,Now you may feel a slight burning sensation.
4135,0,1,18,19,1.0526315789473684,0.05407380704358751,565,"When your health insurance is repealed and replaced in a single tweet: ""You're fired"""
4135,0,1,18,19,1.0526315789473684,0.05407380704358751,565,I'm seeing some incendiary information in your history...
4135,0,1,18,19,1.0526315789473684,0.05407380704358751,565,The ointment might burn a little.
4135,0,1,18,19,1.0526315789473684,0.05407380704358751,565,You really need to see a doctor right away.
4135,0,1,18,19,1.0526315789473684,0.05407380704358751,565,"Silly, I invited you for 'high tea' and biscuits."
4135,0,1,18,19,1.0526315789473684,0.05407380704358751,565,Your deductible must be overdue.
4135,0,1,18,19,1.0526315789473684,0.05407380704358751,565,Your health is on fire.
4135,0,1,18,19,1.0526315789473684,0.05407380704358751,565,"Now, this prescription might smart a bit."
4135,0,1,18,19,1.0526315789473684,0.05407380704358751,565,I've seen worse.
4135,0,1,18,19,1.0526315789473684,0.05407380704358751,565,The Good News is You Still Have ObamaCare....
4135,0,1,18,19,1.0526315789473684,0.05407380704358751,565,Looks like the purchasing department decided to stay with Samsung.
4135,0,1,18,19,1.0526315789473684,0.05407380704358751,565,And have you recently been swimming in any South American rivers?
4135,0,1,18,19,1.0526315789473684,0.05407380704358751,565,"Just a guess, I'd say boils or a severe heat rash."
4135,0,1,18,19,1.0526315789473684,0.05407380704358751,565,Your blood pressure report is a touch concerning .
4135,0,1,18,19,1.0526315789473684,0.05407380704358751,565,It's confirmed. Worse case of heart burn I've ever seen.
4135,0,1,18,19,1.0526315789473684,0.05407380704358751,565,It's our new system's way of providing both light and heat......
4135,0,1,18,19,1.0526315789473684,0.05407380704358751,565,"You don't really want to know what we found from your colonoscopy, Mr. Williams."
4135,0,1,18,19,1.0526315789473684,0.05407380704358751,565,Clearly you have an inflammation of some sort.
4135,0,1,18,19,1.0526315789473684,0.05407380704358751,565,I recommend cutting back on the spicy food.
4135,0,1,18,19,1.0526315789473684,0.05407380704358751,565,It would appear that you have a slight fever!
4135,0,1,18,19,1.0526315789473684,0.05407380704358751,565,There's absolutely nothing here to sweat.
4135,0,1,18,19,1.0526315789473684,0.05407380704358751,565,"The good news, it appears you won't have to worry about insuring it as a pre-existing condition ..."
4135,0,1,18,19,1.0526315789473684,0.05407380704358751,565,This is the hottest stool sample we have ever had!!
4135,0,1,18,19,1.0526315789473684,0.05407380704358751,565,Dump plenty of water and call me in the morning.
4135,0,1,18,19,1.0526315789473684,0.05407380704358751,565,Your testosterone levels are the highest that I've ever seen Mr. Schwartzman.
4135,0,1,18,19,1.0526315789473684,0.05407380704358751,565,The lab results are pretty definitive. You're about to spontaneously combust.
4135,0,1,18,19,1.0526315789473684,0.05407380704358751,565,"As you can see, the results of your Zika test are self-limiting."
4135,0,1,18,19,1.0526315789473684,0.05407380704358751,565,I have the report on your hemorrhoids.
4135,0,1,18,19,1.0526315789473684,0.05407380704358751,565,"Well, on the bright side, I think I've identified where the sulfur smell is coming from ..."
4135,0,1,18,19,1.0526315789473684,0.05407380704358751,565,I'm just gonna ask: so when you say your wife is a devil in the sack...
4135,0,1,18,19,1.0526315789473684,0.05407380704358751,565,You’re right. It is an insurance rejection letter.
4135,0,1,18,19,1.0526315789473684,0.05407380704358751,565,This is not what I thought they meant when they said that The Chainsmokers were buring up the charts.
4135,0,1,18,19,1.0526315789473684,0.05407380704358751,565,"Lab report should've been in Fahrenheit, not celsius!"
4135,0,1,18,19,1.0526315789473684,0.05407380704358751,565,This should clear up any preexisting conditions.
4135,0,1,18,19,1.0526315789473684,0.05407380704358751,565,"No, it's not a Samsung. I think you are pyrokinetic!"
4135,0,1,18,19,1.0526315789473684,0.05407380704358751,565,Should you choose to accept this diagnosis you will die.
4135,0,1,18,19,1.0526315789473684,0.05407380704358751,565,You're hot-blooded.
4135,0,1,18,19,1.0526315789473684,0.05407380704358751,565,We find that this helps motivate us to switch our patient charts over to an all-digital format.
4135,0,1,18,19,1.0526315789473684,0.05407380704358751,565,This is your brain on drugs.
4135,0,1,18,19,1.0526315789473684,0.05407380704358751,565,"If it would help, we do keep sugar-free marshmallows, vegan chocolate, and gluten-sensitive graham crackers on hand."
4135,0,1,18,19,1.0526315789473684,0.05407380704358751,565,I really don't know how to tell you this.
4135,0,1,18,19,1.0526315789473684,0.05407380704358751,565,Cortisone is sooo 2016......!
4135,0,1,18,19,1.0526315789473684,0.05407380704358751,565,"I see what you mean by it burns when you ""P"""
4135,0,1,18,19,1.0526315789473684,0.05407380704358751,565,I am sorry you have a rare case of male hot flashes
4135,0,1,18,19,1.0526315789473684,0.05407380704358751,565,"Now, normally, Bill, men don't get hot flashes ..."
4135,0,1,18,19,1.0526315789473684,0.05407380704358751,565,Your partner still has to be told..
4135,0,1,18,19,1.0526315789473684,0.05407380704358751,565,Looks like we found a donor match.
4135,0,1,18,19,1.0526315789473684,0.05407380704358751,565,The lab results indicate we may need to adjust your meds.
4135,0,1,18,19,1.0526315789473684,0.05407380704358751,565,"Paperless, shmaperless! It hurts no matter how you do it!"
4135,0,1,18,19,1.0526315789473684,0.05407380704358751,565,"Sorry but anything I touch lately seems to burst into fllames. Now, take off your clothes."
4135,0,1,18,19,1.0526315789473684,0.05407380704358751,565,Bad news. The inflammation has expanded dramatically.
4135,0,1,18,19,1.0526315789473684,0.05407380704358751,565,Your lab report confirms burnout.
4135,0,1,18,19,1.0526315789473684,0.05407380704358751,565,"Please don't shoot the messenger. Now put your pants back on before you see Debra at at the front desk checkout. Literally and figuratively speaking, son. (Under breathe, I should have been a lawyer)"
4135,0,1,18,19,1.0526315789473684,0.05407380704358751,565,The good news is there's no more evidence of cancer.
4135,0,1,18,19,1.0526315789473684,0.05407380704358751,565,Bottom line is you'd better do the rubber glove exam yourself.
4135,0,1,18,19,1.0526315789473684,0.05407380704358751,565,"Yes, Mr. Smith, hemorrhoids certainly can cause a burning sensation."
4135,0,1,18,19,1.0526315789473684,0.05407380704358751,565,"I recommend you see a ""Burning Sensation"" specialist."
4135,0,1,18,19,1.0526315789473684,0.05407380704358751,565,"I know it doesn't look good, but the devil is in the details"
4135,0,1,18,19,1.0526315789473684,0.05407380704358751,565,We tend to discourage patients from requesting copies.
4135,0,1,18,19,1.0526315789473684,0.05407380704358751,565,These laboratory results are from Hell.
4135,0,1,18,19,1.0526315789473684,0.05407380704358751,565,I am not going to treat the Mission Impossible team anymore
4135,0,1,18,19,1.0526315789473684,0.05407380704358751,565,Damned medical files. We really need to find a new paper supplier.
4135,0,1,18,19,1.0526315789473684,0.05407380704358751,565,The tests on your heartburn appear to be fairly conclusive.
4135,0,1,18,19,1.0526315789473684,0.05407380704358751,565,"I know it sounds bad, but look on the bright side..."
4135,0,1,18,19,1.0526315789473684,0.05407380704358751,565,"I'll take that as a ""no"" on our privacy agreement then."
4135,0,1,18,19,1.0526315789473684,0.05407380704358751,565,These are the lab results from hell.
4135,0,1,18,19,1.0526315789473684,0.05407380704358751,565,Trumpcare really is mission impossible! Your insurer just disavowed any knowledge of your existence.
4135,0,1,18,19,1.0526315789473684,0.05407380704358751,565,You have until the flame goes down
4135,0,1,18,19,1.0526315789473684,0.05407380704358751,565,"Looks like Conchita's, ""Anal Ecstasy,"" was the culprit."
4225,0,1,19,20,1.05,0.051298917604257706,565,We should've changed to electronic records when we had the chance
4225,0,1,19,20,1.05,0.051298917604257706,565,"Yes sir, I'm afraid that all tests confirm, you have Flaming Hemorrhoids."
4225,0,1,19,20,1.05,0.051298917604257706,565,Hot tip from my bookmaker ...
4225,0,1,19,20,1.05,0.051298917604257706,565,What health insurance?
4225,0,1,19,20,1.05,0.051298917604257706,565,"I've tried, but words cannot explain your physical exam. This is the only way I can show and tell."
4225,0,1,19,20,1.05,0.051298917604257706,565,I recommend you quit smoking.
4225,0,1,19,20,1.05,0.051298917604257706,565,Now this prescription can burn your stomach so make sure to take it with food and water.
4225,0,1,19,20,1.05,0.051298917604257706,565,So ... would you like the good news first?
4225,0,1,19,20,1.05,0.051298917604257706,565,"Our radiologist likes to do ""hot takes"" of all the X-rays."
4225,0,1,19,20,1.05,0.051298917604257706,565,"You numbers are so high, they spontaneously combusted."
4225,0,1,19,20,1.05,0.051298917604257706,565,"I am sorry, but your test results are from hell."
4225,0,1,19,20,1.05,0.051298917604257706,565,"You say you want more privacy in your medical records? OK, here!!!"
4225,0,1,19,20,1.05,0.051298917604257706,565,Need I remind you that the prep for your colonoscopy did not include Flessie's Five Alarm chili down at the diner.
4225,0,1,19,20,1.05,0.051298917604257706,565,"Good news on the kidney transplant, we found a match!"
4225,0,1,19,20,1.05,0.051298917604257706,565,"You are my 10,000th patient. Now I can burn my student loan note for medical school."
4225,0,1,19,20,1.05,0.051298917604257706,565,The nurse tells me your hemorrhoids are acting up.
4241,0,0,13,13,1.0,0.08006407690254357,565,"Aw, snap! This new TrumpCare keeps flaming out."
4241,0,0,13,13,1.0,0.08006407690254357,565,These new HIPAA regulations are now going too far!
4241,0,0,13,13,1.0,0.08006407690254357,565,Your test results are showing some abnormal inflammation.
4241,0,0,13,13,1.0,0.08006407690254357,565,We're taking patient privacy to a new level.
4241,0,0,13,13,1.0,0.08006407690254357,565,"Well, Doc, I keep singing, ""Keeper of the Flame"" in the shower ..."
4241,0,0,13,13,1.0,0.08006407690254357,565,So we need to talk about your stool sample .
4241,0,0,13,13,1.0,0.08006407690254357,565,"Well, I suppose this qualifies as your chart coming back negative..."
4241,0,0,13,13,1.0,0.08006407690254357,565,These are all my caption submissions you rejected. Now drop your pants and Mankoff.
4241,0,0,13,13,1.0,0.08006407690254357,565,Feeling tired? Let me put a fire under your butt.
4241,0,0,13,13,1.0,0.08006407690254357,565,"Sure, we can fix it. However, your retirement savings will look like this."
4241,0,0,13,13,1.0,0.08006407690254357,565,No... this isn't administered orally.
4241,0,0,13,13,1.0,0.08006407690254357,565,.....then Dr. Georgie would make the fire light
4241,0,0,13,13,1.0,0.08006407690254357,565,Your metabolic rate is on fire!
4241,0,0,13,13,1.0,0.08006407690254357,565,You did request to be cremated!
4241,0,0,13,13,1.0,0.08006407690254357,565,I see you have ObamaCare.
4241,0,0,13,13,1.0,0.08006407690254357,565,"Eye of newt, toe of frog, fillet of a fenny snake, . . . [Note: deliberately misquoted for brevity.]"
4241,0,0,13,13,1.0,0.08006407690254357,565,But the good news is the smoke detector hasn't worked in weeks.
4241,0,0,13,13,1.0,0.08006407690254357,565,This is the only way to effectively guard patient privacy!
4241,0,0,13,13,1.0,0.08006407690254357,565,I see you don't agree with my diagnosis.
4241,0,0,13,13,1.0,0.08006407690254357,565,So much for breaking the news gently.
4241,0,0,13,13,1.0,0.08006407690254357,565,It started right after horse riding with the Six Million Dollar Man.
4241,0,0,13,13,1.0,0.08006407690254357,565,Can we lighten up a bit now? I just set your diagnosis on fire.
4241,0,0,13,13,1.0,0.08006407690254357,565,"I am an excellent doctor, but I have this strange desire to burn sheets of paper."
4241,0,0,13,13,1.0,0.08006407690254357,565,You don't want to know.
4241,0,0,13,13,1.0,0.08006407690254357,565,Some startling results just came to light.
4241,0,0,13,13,1.0,0.08006407690254357,565,Mr. Jones you really do have heart burn.
4241,0,0,13,13,1.0,0.08006407690254357,565,"Preliminary...but is the ACA vote at a literal ""crossroads"" congressman, or was that a figure of speech?"
4241,0,0,13,13,1.0,0.08006407690254357,565,Your heartburn results are back.
4241,0,0,13,13,1.0,0.08006407690254357,565,Good news: you're a match !
4241,0,0,13,13,1.0,0.08006407690254357,565,It's definitely gonorrhea Mr. Clark.
4241,0,0,13,13,1.0,0.08006407690254357,565,"Well Mr. Flash, it seems you have some inflammation in your flammiferous gland."
4241,0,0,13,13,1.0,0.08006407690254357,565,Nothing is ever covered under Oburnacare.
4241,0,0,13,13,1.0,0.08006407690254357,565,Now take this and let me know if you get the same burning sensation
4241,0,0,13,13,1.0,0.08006407690254357,565,You're a flaming disaster!
4241,0,0,13,13,1.0,0.08006407690254357,565,"Dammit, Lyle---this is EXACTLY what it feels like! Oh, and I almost forgot---really bad itching as well."
4241,0,0,13,13,1.0,0.08006407690254357,565,"Mr. Inferno, your DNA tests came back and you're still a hunk of burning LOVE. Can I ask for your wife to come in now to tell her the good news!"
4241,0,0,13,13,1.0,0.08006407690254357,565,"well it's a type of inflammation, patently....."
4241,0,0,13,13,1.0,0.08006407690254357,565,Time to go to plaid -- I’m prescribing Ultimatium®
4241,0,0,13,13,1.0,0.08006407690254357,565,"Mr. Smith, you have no other option but to stop smoking. You have developed Dragon Breath."
4241,0,0,13,13,1.0,0.08006407690254357,565,Dr. Schwartz had only dreamed of experiencing the thrill of spontaneous combustion.
4241,0,0,13,13,1.0,0.08006407690254357,565,"I got to tell you, it's a very complicated diagnosis."
4241,0,0,13,13,1.0,0.08006407690254357,565,It's inflamed and expensive.
4241,0,0,13,13,1.0,0.08006407690254357,565,"No thanks, doc. I'll go with the laser approach."
4241,0,0,13,13,1.0,0.08006407690254357,565,Abracadabra.
4241,0,0,13,13,1.0,0.08006407690254357,565,I think you're hot.
4241,0,0,13,13,1.0,0.08006407690254357,565,There's a problem with the insurance papers.
4241,0,0,13,13,1.0,0.08006407690254357,565,"The truth, the truth, the truth is on fire..."
4241,0,0,13,13,1.0,0.08006407690254357,565,Your lab tests indicate signs of burnout!
4241,0,0,13,13,1.0,0.08006407690254357,565,Your triglyceride levels are...en fuego.
4241,0,0,13,13,1.0,0.08006407690254357,565,I think I've found the cause of your in-flame-ation.
4241,0,0,13,13,1.0,0.08006407690254357,565,Trump issued an Executive Order requiring us to burn these records. I will return in a minute with your alternative medical chart.
4241,0,0,13,13,1.0,0.08006407690254357,565,And what was it that you thought we did with all those HIPAA forms?
4241,0,0,13,13,1.0,0.08006407690254357,565,"Sorry, Obamacare has just been repealed. Burning your insurance."
4241,0,0,13,13,1.0,0.08006407690254357,565,"sorry, what's the problem sir?"" ""451 degree fever"
4241,0,0,14,14,1.0,0.07412493166611012,565,I.T. recently updated the security of our patient confidentiality software.
4241,0,0,13,13,1.0,0.08006407690254357,565,Looks like your insurance doesn't cover it.
4241,0,0,13,13,1.0,0.08006407690254357,565,It says here that you have been experiencing a burning sensation
4241,0,0,13,13,1.0,0.08006407690254357,565,"My diagnosis? You seem to be suffering from ""Trump Tax-Returnitis."""
4241,0,0,13,13,1.0,0.08006407690254357,565,Still too heavy on the opiates Bill; I'm firing you
4241,0,0,13,13,1.0,0.08006407690254357,565,Trying to comply with all the new HIPAA regulations is administratively challenging
4241,0,0,13,13,1.0,0.08006407690254357,565,Your tests are fine – it's your Affordable Health Care I'm worried about.
4241,0,0,13,13,1.0,0.08006407690254357,565,And I wanted a lollipop.
4241,0,0,14,14,1.0,0.07412493166611012,565,Your testosterone level came back OK.
4241,0,0,13,13,1.0,0.08006407690254357,565,"Sorry, but the government just now repealed your health insurance policy."
4241,0,0,13,13,1.0,0.08006407690254357,565,I'm going to write you a prescription for Preparation Z
4241,0,0,13,13,1.0,0.08006407690254357,565,We strongly believe in utmost confidentiality.
4241,0,0,13,13,1.0,0.08006407690254357,565,This is one of the worst cases of the Chipotle guts I have ever seen.
4241,0,0,13,13,1.0,0.08006407690254357,565,"As you may have heard, we're transitioning to electronic records."
4241,0,0,13,13,1.0,0.08006407690254357,565,Trump couldn't get congress to end Obanacare. Putin must have taught him spontaneous combustion!
4241,0,0,13,13,1.0,0.08006407690254357,565,"Well first, I'm sorry you had to wait so long....."
4241,0,0,13,13,1.0,0.08006407690254357,565,My advice? Avoid the wasabi.
4241,0,0,13,13,1.0,0.08006407690254357,565,"We have your results, Mr. Montag."
4241,0,0,13,13,1.0,0.08006407690254357,565,I think this is best for both of us.
4241,0,0,13,13,1.0,0.08006407690254357,565,"Yes it's true the diagnosis was ""he's going down in flames!"
4241,0,0,13,13,1.0,0.08006407690254357,565,"Well, Mr. Drucker, I've got good news and bad- hold on, correction. Mr. Drucker, I'm afraid the news is not good."
4241,0,0,13,13,1.0,0.08006407690254357,565,"Now Kenneth, pyrokinesis will not change your prognosis."
4241,0,0,14,14,1.0,0.07412493166611012,565,This is your stomach on a thick-crust-everything-plus-extra-jalapeños-pepperoni-sausage-and-meatballs pizza.
4241,0,0,13,13,1.0,0.08006407690254357,565,Physical exams are in the past now that I have the oracle.
4241,0,0,13,13,1.0,0.08006407690254357,565,Your STD report is rather explicit.
4241,0,0,13,13,1.0,0.08006407690254357,565,The copy machine has been on the blink.
4241,0,0,13,13,1.0,0.08006407690254357,565,Vitals look good. Your temp is slightly above average though.
4241,0,0,14,14,1.0,0.07412493166611012,565,"Now, about your high temperature test. Oops."
4241,0,0,13,13,1.0,0.08006407690254357,565,"On the brighter side, it's trending"
4241,0,0,13,13,1.0,0.08006407690254357,565,Your test results tell me you have heartburn.
4241,0,0,13,13,1.0,0.08006407690254357,565,"Yes, we have labs in hell."
4241,0,0,13,13,1.0,0.08006407690254357,565,Was your card the Ace of Clubs?
4241,0,0,13,13,1.0,0.08006407690254357,565,You're very contagious.
4241,0,0,13,13,1.0,0.08006407690254357,565,I just have a couple of routine burning questions.
4241,0,0,13,13,1.0,0.08006407690254357,565,It's definitely inflammatory.
4241,0,0,13,13,1.0,0.08006407690254357,565,"When I say confidential, I mean confidential."
4241,0,0,14,14,1.0,0.07412493166611012,565,"You've made your point, Mr. -El. Don't make me get out the kryptonite."
4241,0,0,13,13,1.0,0.08006407690254357,565,You're test results came back: you're inflamed.
4241,0,0,13,13,1.0,0.08006407690254357,565,My specialty is burn victims. You're next.
4241,0,0,13,13,1.0,0.08006407690254357,565,"You need to lay off the red meat, Lucifer."
4241,0,0,13,13,1.0,0.08006407690254357,565,If lab report unpaid will self-destroy...
4241,0,0,13,13,1.0,0.08006407690254357,565,Our confidentiality guidelines are the strictest in the medical field.
4241,0,0,13,13,1.0,0.08006407690254357,565,Destroying the lab results will not change the facts: you have 3 months to live before becoming an invisible middle aged white male.
4241,0,0,13,13,1.0,0.08006407690254357,565,To say that your test results indicate an inflamed prostate might be an umderstatement.
4241,0,0,13,13,1.0,0.08006407690254357,565,Are you sure you want me to define 'dementia'?
4241,0,0,14,14,1.0,0.07412493166611012,565,This report explains why you have such a healthy glow.
4241,0,0,13,13,1.0,0.08006407690254357,565,Being intubated is a fun thing.
4241,0,0,13,13,1.0,0.08006407690254357,565,"Dr. Mel Zeus is happy to bequeath to his patient, Phil Prometheus, full responsibility for his healthcare."
4241,0,0,13,13,1.0,0.08006407690254357,565,"Fire of Prometheus, magical caisson of phlogiston, vessel of rapid oxidation, incandescent rage of molecular incongruity - your thyroid is a little low."
4241,0,0,13,13,1.0,0.08006407690254357,565,"Mr. Phelps, should you accept it, your diagnosis will self-destruct in 5...4...3...2...1..."
4241,0,0,13,13,1.0,0.08006407690254357,565,"Here in Las Vegas, we mean it when we say ""it stays here."""
4241,0,0,13,13,1.0,0.08006407690254357,565,"In my professional opinion, it’s not your Syphilis causing the burning; it’s your copay."
4241,0,0,13,13,1.0,0.08006407690254357,565,Your insurance plan is being re-accommodated by congress...
4241,0,0,13,13,1.0,0.08006407690254357,565,Was just trying to be hip with the new assistant-told her your results were fire...
4241,0,0,13,13,1.0,0.08006407690254357,565,My broker recommended a hot new drug for you.
4241,0,0,13,13,1.0,0.08006407690254357,565,"Firest, the bad news."
4241,0,0,13,13,1.0,0.08006407690254357,565,"""I'm going to test your reflexes, please place your hand over the flame""."
4241,0,0,13,13,1.0,0.08006407690254357,565,"You mean it says something else besides ""I'm the healthiest individual ever""."
4241,0,0,13,13,1.0,0.08006407690254357,565,I see your hemorrhoids have been flaring up again.
4241,0,0,13,13,1.0,0.08006407690254357,565,Swallow the flame and your brain will be fixed completely.
4241,0,0,13,13,1.0,0.08006407690254357,565,Don't worry: I've seen worse.
4241,0,0,13,13,1.0,0.08006407690254357,565,"It says here you have a temperature, but it's not life threatening."
4241,0,0,13,13,1.0,0.08006407690254357,565,"Senator, your medical history will inflame your opponent's wrath."
4241,0,0,13,13,1.0,0.08006407690254357,565,I'm sorry but your insurance doesn't cover electrical lights anymore
4241,0,0,13,13,1.0,0.08006407690254357,565,Your DNA test shows a tendency toward Satanic worship.
4241,0,0,13,13,1.0,0.08006407690254357,565,"I've seen cases like yours before, but only in a horror movies."
4241,0,0,13,13,1.0,0.08006407690254357,565,Your tests results are on fire! I didn't read them yet!
4241,0,0,13,13,1.0,0.08006407690254357,565,In my view these new interactive diagnosis forms went too far in the hemorrhoid check box.
4241,0,0,13,13,1.0,0.08006407690254357,565,"I'm sorry, it seems that you had a Samsung i phone battery in your electronic health records"
4241,0,0,13,13,1.0,0.08006407690254357,565,I'm glad you're sitting down...I have some bad news.
4241,0,0,13,13,1.0,0.08006407690254357,565,"Well, give the Devil his due..."
4241,0,0,13,13,1.0,0.08006407690254357,565,"Sorry, but your case is too hot to handle."
4241,0,0,13,13,1.0,0.08006407690254357,565,Do you have a high deductable plan?
4241,0,0,13,13,1.0,0.08006407690254357,565,"Yup, the tonsils are a bit inflamed. Now, let's check that prostrate of yours to see what's going on there."
4241,0,0,13,13,1.0,0.08006407690254357,565,Looks as though you will be sent to an isolation room.
4241,0,0,13,13,1.0,0.08006407690254357,565,You are better off without her.
4241,0,0,13,13,1.0,0.08006407690254357,565,Is it a burning sensation like this?
4241,0,0,13,13,1.0,0.08006407690254357,565,I'm afraid the prognosis is that you're going to burn in hell.
4241,0,0,13,13,1.0,0.08006407690254357,565,You got phlagm on your chart.
4241,0,0,13,13,1.0,0.08006407690254357,565,"Not terminal, for you!"
4241,0,0,13,13,1.0,0.08006407690254357,565,You'll have to have a do-over on all these tests.
4241,0,0,13,13,1.0,0.08006407690254357,565,"When you appeal a claim, it kind of sets off the healthcare insurers."
4241,0,0,13,13,1.0,0.08006407690254357,565,About your policy ... Obamacare's been repealed.
4241,0,0,13,13,1.0,0.08006407690254357,565,As your family witch-doctor I must inform you that this ritual does not have the FDA's approval yet.
4241,0,0,13,13,1.0,0.08006407690254357,565,I'm doing this for HIPPA !
4241,0,0,13,13,1.0,0.08006407690254357,565,"Your cholesterol is a bit high. Hey, does my ass look fat in this lab coat?"
4241,0,0,13,13,1.0,0.08006407690254357,565,This paper describes treatment for your Bunsen burner allergy.
4241,0,0,13,13,1.0,0.08006407690254357,565,"The test results suggest you should stop,drop and roll."
4241,0,0,13,13,1.0,0.08006407690254357,565,You should feel better once we put this flame under your ass.
4241,0,0,13,13,1.0,0.08006407690254357,565,You may feel a warm sensation.
4241,0,0,13,13,1.0,0.08006407690254357,565,Your report says you're a hot mess
4241,0,0,13,13,1.0,0.08006407690254357,565,Your lab results are lit
4241,0,0,13,13,1.0,0.08006407690254357,565,"Hmm that's weird, your chat's on fire. Anyway, you have hemorrhoids."
4241,0,0,13,13,1.0,0.08006407690254357,565,You've got to lighten up on the Thai food!
4241,0,0,13,13,1.0,0.08006407690254357,565,Things are looking up.
4241,0,0,13,13,1.0,0.08006407690254357,565,Put it this way - your follow-up appointment is going to be on a much much lower floor.
4241,0,0,13,13,1.0,0.08006407690254357,565,The *good* news is you have eternal life. . .
4241,0,0,13,13,1.0,0.08006407690254357,565,"Doctor, I really think you ought to quit smoking."
4241,0,0,13,13,1.0,0.08006407690254357,565,The surgery would be a mission impossible.
4241,0,0,13,13,1.0,0.08006407690254357,565,"You know that it would be untrue. You know that I would be a liar. If I were to say to you; ""your test results have caught on fire."""
4241,0,0,13,13,1.0,0.08006407690254357,565,Congratulations--you have one of the hottest new conditions!
4241,0,0,13,13,1.0,0.08006407690254357,565,You temperature is a little high.
4241,0,0,13,13,1.0,0.08006407690254357,565,Please fill this out again and only singe above the dotted line.
4241,0,0,13,13,1.0,0.08006407690254357,565,We're still not sure the source of your fever.
4241,0,0,13,13,1.0,0.08006407690254357,565,Your condition has flared up again.
4241,0,0,14,14,1.0,0.07412493166611012,565,No one will know there's never been anything wrong.
4241,0,0,13,13,1.0,0.08006407690254357,565,"I'm sorry, Trump cut the budget for HIPPA so now we just burn everything."
4241,0,0,13,13,1.0,0.08006407690254357,565,I suggest we prepare for the worst and hope for the best
4241,0,0,13,13,1.0,0.08006407690254357,565,"I know you said it burns when you pee, but this is ridiculous."
4241,0,0,13,13,1.0,0.08006407690254357,565,"You have a severe case of Dragon Breath, Mr. Smith...."
4241,0,0,13,13,1.0,0.08006407690254357,565,Now there is good news left.
4241,0,0,14,14,1.0,0.07412493166611012,565,Tom's fears are realized when his doctor confirms the diagnosis: acute heartburn.
4241,0,0,13,13,1.0,0.08006407690254357,565,"If this gets out, you'll never get insurance again."
4241,0,0,13,13,1.0,0.08006407690254357,565,The good news is****
4241,0,0,13,13,1.0,0.08006407690254357,565,I decided to cauterize the lab results.
4241,0,0,13,13,1.0,0.08006407690254357,565,"Mr. Diablo, your annual physical results are negative, see you in a year!"
4241,0,0,13,13,1.0,0.08006407690254357,565,Sorry. It's the Affordable Care Act.
4241,0,0,13,13,1.0,0.08006407690254357,565,Your healthcare plan is inflamed.
4241,0,0,13,13,1.0,0.08006407690254357,565,"Ok, I've got good news and bad news. The good news is you're fine. The bad news is we have to re-do the checkup."
4241,0,0,13,13,1.0,0.08006407690254357,565,It seems like a case of acute inflammation.
4241,0,0,13,13,1.0,0.08006407690254357,565,To-wit to-wit to-woo
4241,0,0,13,13,1.0,0.08006407690254357,565,"You seem doubtful , Mr. Jones, but unfortunately your electronic medical record has indeed been hacked by the Holy Ghost."
4241,0,0,13,13,1.0,0.08006407690254357,565,"I know this may not be very professional of me to say this, but I think you're hot."
4241,0,0,13,13,1.0,0.08006407690254357,565,"Since you can't afford the treatments, I decided to burn the lab report."
4241,0,0,13,13,1.0,0.08006407690254357,565,The results show your old trouble has flared up again.
4241,0,0,13,13,1.0,0.08006407690254357,565,It appears you have... one second to live.
4241,0,0,13,13,1.0,0.08006407690254357,565,So the ointment hasn't helped the burning sensation?
4241,0,0,13,13,1.0,0.08006407690254357,565,"Now, about that odorless emission. . . ."
4241,0,0,13,13,1.0,0.08006407690254357,565,"I don't know, but your chart is telling me, ""It's time to fight fire with fire!"""
4241,0,0,13,13,1.0,0.08006407690254357,565,"I need to protect your health information, but unfortunately the shredder is broken."
4241,0,0,13,13,1.0,0.08006407690254357,565,"Sir it looks like you have the sim tones ""Sir, it seems you have inflammatory bowel disease."
4241,0,0,13,13,1.0,0.08006407690254357,565,It's herpes.
4241,0,0,13,13,1.0,0.08006407690254357,565,. . . and this is your bill on drugs. Any questions?
4241,0,0,14,14,1.0,0.07412493166611012,565,I have your test results hot off the press!
4241,0,0,13,13,1.0,0.08006407690254357,565,"Burn, baby ... burn!!"
4241,0,0,13,13,1.0,0.08006407690254357,565,Would you say that you're in pain this much?
4241,0,0,13,13,1.0,0.08006407690254357,565,The horror...the horror
4241,0,0,13,13,1.0,0.08006407690254357,565,I'm sorry to report there is a fire and your medical records are being destroyed.
4241,0,0,13,13,1.0,0.08006407690254357,565,"Mr. Storm, you cannot fix everything with fire here."
4241,0,0,14,14,1.0,0.07412493166611012,565,I'm afraid your cholesterol's still 451.
4241,0,0,13,13,1.0,0.08006407690254357,565,I can't diagnose this paper's problem until I verify its insurance.
4241,0,0,13,13,1.0,0.08006407690254357,565,Your test results suggest you have a burning sensation.
4241,0,0,13,13,1.0,0.08006407690254357,565,"So, planning any trips this summer?"
4241,0,0,13,13,1.0,0.08006407690254357,565,I'm afraid you have a case of Samsungitis.
4241,0,0,13,13,1.0,0.08006407690254357,565,The lab said it's a raging malingnancy.
4241,0,0,14,14,1.0,0.07412493166611012,565,Looks like your coverage is up in flames too!
4241,0,0,13,13,1.0,0.08006407690254357,565,This disease is a devil to treat!
4241,0,0,13,13,1.0,0.08006407690254357,565,Our medical records use Snapchat.
4241,0,0,13,13,1.0,0.08006407690254357,565,Sorry George. This has been happening ever since they passed the American Combustible Health Care Act.
4241,0,0,13,13,1.0,0.08006407690254357,565,The individual mandate went up in smoke with Trumpcare
4241,0,0,13,13,1.0,0.08006407690254357,565,Go easy on the Tabasco
4241,0,0,13,13,1.0,0.08006407690254357,565,It appears your cancer is spreading like wildfire.
4241,0,0,13,13,1.0,0.08006407690254357,565,Everything looks good.
4241,0,0,14,14,1.0,0.07412493166611012,565,The results of yourlast test no longer exist
4241,0,0,13,13,1.0,0.08006407690254357,565,I honestly don't know if it's your smoking or your immigration status.
4241,0,0,13,13,1.0,0.08006407690254357,565,"Dr. Kay explains the newest technique for drawing ear wax out of out of reluctant patient, Bob."
4241,0,0,13,13,1.0,0.08006407690254357,565,Can we not share this information with my Health Insurance?
4241,0,0,13,13,1.0,0.08006407690254357,565,"If I were speaking in tongues, you'd see the flames over my head"
4241,0,0,13,13,1.0,0.08006407690254357,565,It's tied to the House Bill.
4241,0,0,13,13,1.0,0.08006407690254357,565,Here's the referral for that specialist in Pompeii
4241,0,0,13,13,1.0,0.08006407690254357,565,It says here that it does burn when you pee.
4241,0,0,13,13,1.0,0.08006407690254357,565,"Soooo, your chart indicates that your heartburn has gotten worse."
4241,0,0,14,14,1.0,0.07412493166611012,565,The good news is at least your gall bladder isn't enflamed.
4241,0,0,13,13,1.0,0.08006407690254357,565,The results are back. It's heartburn.
4241,0,0,13,13,1.0,0.08006407690254357,565,What makes you think I'm lying about your diagnosis?
4241,0,0,13,13,1.0,0.08006407690254357,565,I hate it when my electronic medical record shorts out.
4241,0,0,13,13,1.0,0.08006407690254357,565,But the good news is your earth and wind levels came back very normal
4241,0,0,13,13,1.0,0.08006407690254357,565,Nothing seems to account for the burning sensation you describe.
4241,0,0,13,13,1.0,0.08006407690254357,565,Sorry...your coverage just ran out
4241,0,0,13,13,1.0,0.08006407690254357,565,Looks like this medication isn't covered by your insurance.
4241,0,0,13,13,1.0,0.08006407690254357,565,"Yes, this is how hell opens up to receive new arrivals."
4241,0,0,13,13,1.0,0.08006407690254357,565,"Good news, I have the results of your herpes test."
4241,0,0,13,13,1.0,0.08006407690254357,565,I'd like to get a second opinion from Satan
4241,0,0,13,13,1.0,0.08006407690254357,565,Now I understand the asbestos TP.
4241,0,0,13,13,1.0,0.08006407690254357,565,The paper shredder? It got promoted to management.
4241,0,0,13,13,1.0,0.08006407690254357,565,"MR. PRESIDENT ,YOUR BRAIN SCAN CAME BACK""ITS A WONDER YOUR ALIVE"" !"
4241,0,0,14,14,1.0,0.07412493166611012,565,"Say ""Yikes!""."
4241,0,0,13,13,1.0,0.08006407690254357,565,"Well, the results are back and the good news is that it isn't hemorrhoids..."
4241,0,0,13,13,1.0,0.08006407690254357,565,You probably don't want to see the chart with the bad news.
4241,0,0,13,13,1.0,0.08006407690254357,565,And this chart here shows your insurance coverage.
4241,0,0,13,13,1.0,0.08006407690254357,565,We are passionate about patient confidentiality.
4241,0,0,13,13,1.0,0.08006407690254357,565,"Ignatius, your burning sensation with urination, pyrexia, heat exhaustion, burning mouth syndrome and now heat rash! Your medical file simply can't tolerate this anymore!"
4241,0,0,13,13,1.0,0.08006407690254357,565,"The election is over. Yet, we still feel the Bern!"
4241,0,0,13,13,1.0,0.08006407690254357,565,"Oh crap, my X-Ray vision is back!"
4241,0,0,13,13,1.0,0.08006407690254357,565,Let me be clear about what you have: It's heartburn.
4241,0,0,13,13,1.0,0.08006407690254357,565,We're burning your records because we don't see any hope.
4241,0,0,13,13,1.0,0.08006407690254357,565,"Now, now. Telekinesis won't erase your medical bills."
4241,0,0,13,13,1.0,0.08006407690254357,565,So much for therapeutic incense. I knew I should have splurged for acupuncture.
4241,0,0,13,13,1.0,0.08006407690254357,565,This prescription was one of Jim Morrison's favorites;
4241,0,0,13,13,1.0,0.08006407690254357,565,About your test results. . .
4241,0,0,13,13,1.0,0.08006407690254357,565,"Yes, you were right. The diagnosis is serious heartburn."
4241,0,0,13,13,1.0,0.08006407690254357,565,Your testosterone numbers are off the chart.
4241,0,0,13,13,1.0,0.08006407690254357,565,"Sir, I'm sorry to say this, but you've been diagnosed with heat vision."
4241,0,0,13,13,1.0,0.08006407690254357,565,The new Hipaa law: Your test results self-destruct in 30 seconds.
4241,0,0,13,13,1.0,0.08006407690254357,565,There's no way to give this a positive spin.
4241,0,0,13,13,1.0,0.08006407690254357,565,"Sorry, our paper shredder is no longer covered by Obamacare."
4241,0,0,13,13,1.0,0.08006407690254357,565,"Your blood pressure is normal, but your insurance carrier is the hot area of focus."
4241,0,0,13,13,1.0,0.08006407690254357,565,My dear Mr. Moses - this was an image of your heart.
4241,0,0,13,13,1.0,0.08006407690254357,565,"""WE WARNED YOU TO GO GREEN"" HaHaHa Haaaaaa!"
4241,0,0,13,13,1.0,0.08006407690254357,565,How many fingers am I burning up?
4241,0,0,13,13,1.0,0.08006407690254357,565,You are definitely contagious
4241,0,0,13,13,1.0,0.08006407690254357,565,Its a bit early to tell... but the diagnosis appears to be your eternal damnation
4241,0,0,13,13,1.0,0.08006407690254357,565,I've left Western medicine and gone on to tongues of fire.
4241,0,0,13,13,1.0,0.08006407690254357,565,"'Well this is a first..who's your Dad, by the way?'"
4241,0,0,13,13,1.0,0.08006407690254357,565,"""Bill Flambé"" burns off the embarrassing itemizations, but keeps the total cost at the bottom."
4241,0,0,13,13,1.0,0.08006407690254357,565,Here you go. Your symptoms lacked this burning sensation.
4241,0,0,13,13,1.0,0.08006407690254357,565,I have your lab results.
4241,0,0,13,13,1.0,0.08006407690254357,565,Three Testicles?! Can't let this little doozy get out!
4241,0,0,13,13,1.0,0.08006407690254357,565,"Uh oh, they must have just passed Trumpcare."
4241,0,0,13,13,1.0,0.08006407690254357,565,I guess we should take him literally.
4241,0,0,13,13,1.0,0.08006407690254357,565,This a severe case of heartburn.
4241,0,0,13,13,1.0,0.08006407690254357,565,"We'll, I won't lie to you. It's not good."
4241,0,0,13,13,1.0,0.08006407690254357,565,Since the operation was unsuccessful this is the best I can do.
4241,0,0,13,13,1.0,0.08006407690254357,565,Apply a little heat to your chest and your cold will disappear immediately.
4241,0,0,13,13,1.0,0.08006407690254357,565,"Apparently, you're really hot."
4241,0,0,13,13,1.0,0.08006407690254357,565,take this with two asprin and call me in the morning
4241,0,0,13,13,1.0,0.08006407690254357,565,I am afraid you have the same disease as Alicia Keys
4241,0,0,13,13,1.0,0.08006407690254357,565,It appears to be quite contagious.
4241,0,0,13,13,1.0,0.08006407690254357,565,Our chief of staff is a real stickler for HIPAA compliance.
4241,0,0,13,13,1.0,0.08006407690254357,565,"This is bigger than any checkup, Mr. Thompson. You see, in mere moments this entire hospital will be emptied, and that lobby candy will be all mine."
4241,0,0,13,13,1.0,0.08006407690254357,565,"And as Family Doctor, may I burn like this medical bill if I betray The Family..."
4241,0,0,13,13,1.0,0.08006407690254357,565,I'm afraid you have pyromyalgia.
4241,0,0,13,13,1.0,0.08006407690254357,565,"We extracted this from your esophagus, so yeah I think I know the cause of your heartburn."
4241,0,0,13,13,1.0,0.08006407690254357,565,Let's both pretend we never saw that test result.
4241,0,0,13,13,1.0,0.08006407690254357,565,We can extinguish your worst anxieties.
4241,0,0,13,13,1.0,0.08006407690254357,565,Bad news: You have an inflamed CT Scan.
4241,0,0,13,13,1.0,0.08006407690254357,565,"Ok, I'm impressed. I'll also give you anything you want if you will do this to my mother-in-law's bra at the family Easter egg hunt. Please..."
4241,0,0,13,13,1.0,0.08006407690254357,565,Now don't take your eyes off your medical records........
4241,0,0,13,13,1.0,0.08006407690254357,565,and for the last time you're sure there's no burning when you pee?
4241,0,0,13,13,1.0,0.08006407690254357,565,No burning sensation? You sure?
4241,0,0,14,14,1.0,0.07412493166611012,565,Very confidential...Burn before reading.
4241,0,0,13,13,1.0,0.08006407690254357,565,"In the spirit of your return from Burning Man, this is the best way to deliver your diagnosis."
4241,0,0,13,13,1.0,0.08006407690254357,565,"'Sorry, Mr. Reynolds, but I'm afraid that your urine sample is hot.'"
4241,0,0,13,13,1.0,0.08006407690254357,565,It's a massive UTI.
4241,0,0,13,13,1.0,0.08006407690254357,565,"Your ""Burn-down"" chart is on fire because of ObamaCare Repeal."
4241,0,0,13,13,1.0,0.08006407690254357,565,Your stool sample shows a history of Mexican food.
4241,0,0,13,13,1.0,0.08006407690254357,565,Your'e burned out beyond belief !
4241,0,0,13,13,1.0,0.08006407690254357,565,"Hmm, relative to covering pre-existing conditions, your insurance says the government fixed that issue."
4241,0,0,13,13,1.0,0.08006407690254357,565,451 is way too high!
4241,0,0,13,13,1.0,0.08006407690254357,565,"According to your HIPAA agreement, I'm not allow to read it."
4241,0,0,13,13,1.0,0.08006407690254357,565,Oops. There goes your insurance. Thanks Mr. Trump.
4241,0,0,13,13,1.0,0.08006407690254357,565,"Doctor, I'm sensing some heat between us."
4241,0,0,13,13,1.0,0.08006407690254357,565,We won't have those test results until this fire goes out.
4241,0,0,13,13,1.0,0.08006407690254357,565,Here's your flaming remedy.
4241,0,0,13,13,1.0,0.08006407690254357,565,Let's take a look see at your char.
4241,0,0,13,13,1.0,0.08006407690254357,565,"Oops, looks like we didn't make the ransomware payment in time."
4241,0,0,13,13,1.0,0.08006407690254357,565,Perhaps the bill will help reignite that lost fire in your belly.
4241,0,0,13,13,1.0,0.08006407690254357,565,According to your chart you're burning up.
4241,0,0,13,13,1.0,0.08006407690254357,565,"Itching, hives, and spontaneous combustion may result from this prescription."
4241,0,0,13,13,1.0,0.08006407690254357,565,"First, we'll text your reflexes.... place this bag outside the door over there and knock as loud as you can."
4241,0,0,13,13,1.0,0.08006407690254357,565,"You're fine, but your bill has a fever."
4241,0,0,13,13,1.0,0.08006407690254357,565,You are not alone... many Americans have lost their digestive fire.
4241,0,0,13,13,1.0,0.08006407690254357,565,The test results confirm it: You have heartburn.
4241,0,0,14,14,1.0,0.07412493166611012,565,"Unfortunately, your test results are difficult to read."
4241,0,0,13,13,1.0,0.08006407690254357,565,The results are in: it's an inflammation.
4241,0,0,13,13,1.0,0.08006407690254357,565,I would like to start with the good news but...
4241,0,0,13,13,1.0,0.08006407690254357,565,It's a popular diagnosis.
4241,0,0,13,13,1.0,0.08006407690254357,565,I am pleased to see you're awake because your brand new colonoscopy report is now hot off the press!
4241,0,0,13,13,1.0,0.08006407690254357,565,I think you're right...I'll take the capsaicin off the regimen...
4241,0,0,13,13,1.0,0.08006407690254357,565,your tennis elbow is totally inflamed.
4241,0,0,13,13,1.0,0.08006407690254357,565,The biopsy confirms your pyrokinesis.
4241,0,0,13,13,1.0,0.08006407690254357,565,"This looks like it could be inflammatory, we need a crisper alternative."
4241,0,0,13,13,1.0,0.08006407690254357,565,good morning. I'm Dr. Faust....
4241,0,0,13,13,1.0,0.08006407690254357,565,I'm afraid you're burning up.
4241,0,0,13,13,1.0,0.08006407690254357,565,"I can't explain it, Mr. Nesbitt. I had no sooner recorded your most recent STD event when this happened."
4241,0,0,13,13,1.0,0.08006407690254357,565,Let's see the pharmacist read this script
4241,0,0,13,13,1.0,0.08006407690254357,565,Your managed care insurance company is mad at you
4241,0,0,13,13,1.0,0.08006407690254357,565,Take two ice cubes and call me in the morning
4241,0,0,13,13,1.0,0.08006407690254357,565,"Referring to my tablet's three dimensional representation of your condition, You have a mild fever."""
4241,0,0,13,13,1.0,0.08006407690254357,565,"Yes, Exercise is important but exercise your mind as well, currently I am prescribing the novel Fahrenheit 451."
4241,0,0,13,13,1.0,0.08006407690254357,565,Let's test your reflexes.
4241,0,0,13,13,1.0,0.08006407690254357,565,"Our lab prides itself on quick turnaround. Unfortunately, there's a down side."
4241,0,0,13,13,1.0,0.08006407690254357,565,Now. Now. No need to panic. Lab results are just suggestive.
4241,0,0,13,13,1.0,0.08006407690254357,565,Didn't I warn you about super-hot Mexican peppers?
4241,0,0,13,13,1.0,0.08006407690254357,565,"So Dan, do you choose to accept?"
4241,0,0,13,13,1.0,0.08006407690254357,565,"Can I put my pants back on now, Doc, or are they also on fire?"
4241,0,0,13,13,1.0,0.08006407690254357,565,i'm afraid your fever has gone off the charts.
4241,0,0,13,13,1.0,0.08006407690254357,565,HIPAA now requires us to burn all records to maintain patient confidentiality.
4241,0,0,13,13,1.0,0.08006407690254357,565,"Now, that does make you feel better."
4241,0,0,13,13,1.0,0.08006407690254357,565,It's these new HIPAA forms...
4241,0,0,13,13,1.0,0.08006407690254357,565,"Nothing to be alarmed about, Mr. MacReady."
4241,0,0,13,13,1.0,0.08006407690254357,565,"The good news is, the bad news self immolated."
4241,0,0,13,13,1.0,0.08006407690254357,565,Your records indicate you have the World's Greatest Healthcare Plan of 2017.
4241,0,0,13,13,1.0,0.08006407690254357,565,Your health care plan only covers primitive laser
4241,0,0,13,13,1.0,0.08006407690254357,565,"Don't worry, I'm just expunging all pre-existing conditions in your history."
4241,0,0,13,13,1.0,0.08006407690254357,565,You're Right! The tests show they are inflamed!
4241,0,0,13,13,1.0,0.08006407690254357,565,Our tests indicate you died 2 weeks ago!
4241,0,0,13,13,1.0,0.08006407690254357,565,I think it is time you make a new start.
4241,0,0,13,13,1.0,0.08006407690254357,565,We need to reduce your male hormone enhancement medication.
4241,0,0,13,13,1.0,0.08006407690254357,565,I think it's heartburn . . . but if you want a second opinion I'll go with heatstroke.
4241,0,0,13,13,1.0,0.08006407690254357,565,Privacy rules have gone too far! Now they self-destruct.
4241,0,0,13,13,1.0,0.08006407690254357,565,"No, sir, this appears to be hotter than you're typical UA..."
4241,0,0,13,13,1.0,0.08006407690254357,565,Sorry about that . . . we just updated to Fire 2.0.
4241,0,0,13,13,1.0,0.08006407690254357,565,"Does ""Fahrenheit 451"" mean anything to you?"
4241,0,0,13,13,1.0,0.08006407690254357,565,Your test results indicate an excess amount of 5 alarm chili.
4241,0,0,13,13,1.0,0.08006407690254357,565,Your lab results are a little more flammable than we generally like to see.
4241,0,0,13,13,1.0,0.08006407690254357,565,It's your blood pressure.
4241,0,0,13,13,1.0,0.08006407690254357,565,"Dude, your test results are so Fire!"
4241,0,0,13,13,1.0,0.08006407690254357,565,"Eye of newt, wing of bat, blood of the undead...there now, you're all better... Make your next appointment for a year.... if the newts come back, call sooner..."
4241,0,0,13,13,1.0,0.08006407690254357,565,"The burning question: Are you sick?"" ""No Mr. Smith, it's just heartburn."
4241,0,0,13,13,1.0,0.08006407690254357,565,It's that damn lithium ink.
4241,0,0,14,14,1.0,0.07412493166611012,565,Any questions?
4241,0,0,13,13,1.0,0.08006407690254357,565,"Your vitals indicate that you were ""HOT STUFF"" during the disco era but you are paying for it now."
4241,0,0,13,13,1.0,0.08006407690254357,565,The inflammation is worse than we thought.
4241,0,0,13,13,1.0,0.08006407690254357,565,"Your labs came back, let me just say TrumpCare takes individual responsibility very seriously."
4241,0,0,13,13,1.0,0.08006407690254357,565,Worst damn case of GERD I've ever seen.
4241,0,0,13,13,1.0,0.08006407690254357,565,"I knew the Federal Compliance girl was serious when she said there would be swift penalties for failing to utilize the new unsecured ""WebMedDoc"" platform but I never expected anything like this from that witch."
4241,0,0,13,13,1.0,0.08006407690254357,565,I'm going to recommend the acid reflux diet for you Bob.
4241,0,0,13,13,1.0,0.08006407690254357,565,Your tests show a particularly nasty case of heartburn.
4241,0,0,13,13,1.0,0.08006407690254357,565,"Well sir, that fire in your belly will trouble you no more."
4241,0,0,13,13,1.0,0.08006407690254357,565,"I call this one ""Lab Tests Be Damned""."
4241,0,0,13,13,1.0,0.08006407690254357,565,Should we accept this mission?
4241,0,0,13,13,1.0,0.08006407690254357,565,So what's your burning question?
4241,0,0,13,13,1.0,0.08006407690254357,565,"Mr. Kent, your physical was fine but we need to work on controlling your head vision."
4241,0,0,13,13,1.0,0.08006407690254357,565,About that experimental drug for heaartburn you've been taking ...we need to talk.
4241,0,0,13,13,1.0,0.08006407690254357,565,"So we are in agree, no record of your pre existing condition and no reporting me to the medical board."
4241,0,0,13,13,1.0,0.08006407690254357,565,Wow...you have Nephilim DNA.
4241,0,0,13,13,1.0,0.08006407690254357,565,"Oh, damn! Another one of those ""burn before reading"" documents."
4241,0,0,13,13,1.0,0.08006407690254357,565,"Oh right, inflammable, I always forget, and shoot, that positive result we were discussing, I indicated you tested positive, correct?"
4241,0,0,13,13,1.0,0.08006407690254357,565,Your test results show severely high levels of inflammation...
4241,0,0,13,13,1.0,0.08006407690254357,565,We gotta a hot one here.
4241,0,0,13,13,1.0,0.08006407690254357,565,Yes... I also feel a slight burning sensation
4241,0,0,13,13,1.0,0.08006407690254357,565,We really have to do something about that heart burn
4241,0,0,13,13,1.0,0.08006407690254357,565,The tests came back positive for severe heartburn.
4241,0,0,13,13,1.0,0.08006407690254357,565,"Sir, these are your pants. Now, for the last time, are you sure you caught it from the toilet seat?"
4241,0,0,13,13,1.0,0.08006407690254357,565,The results are in and boy there are hot hot hot!
4241,0,0,13,13,1.0,0.08006407690254357,565,We've found that emojis help patients understand their conditions better.
4241,0,0,14,14,1.0,0.07412493166611012,565,Might Be A Positive Negative
4241,0,0,13,13,1.0,0.08006407690254357,565,Have you been practicing spontaneous combustion?
4241,0,0,13,13,1.0,0.08006407690254357,565,"No, I'm afraid I can't prescribe a chill pill for hot flashes."
4241,0,0,13,13,1.0,0.08006407690254357,565,"If it feels like this, you need to see the proctologist."
4241,0,0,13,13,1.0,0.08006407690254357,565,These results are absolutely inflammatory.
4241,0,0,13,13,1.0,0.08006407690254357,565,And do your eyes burn when you start a fire?
4241,0,0,13,13,1.0,0.08006407690254357,565,Sometimes the insurance paperwork has a hard time acclimating after arriving from hell.
4241,0,0,13,13,1.0,0.08006407690254357,565,How many flames am I holding up?
4241,0,0,13,13,1.0,0.08006407690254357,565,Your diagnosis is severe heartburn.
4241,0,0,14,14,1.0,0.07412493166611012,565,"A little taste of what's to come,sir"
4241,0,0,13,13,1.0,0.08006407690254357,565,Hemorrhoids.
4241,0,0,13,13,1.0,0.08006407690254357,565,Your's is the hottest case I've ever handled.
4241,0,0,13,13,1.0,0.08006407690254357,565,"Your insurance company has a new, faster denial of coverage process."
4241,0,0,13,13,1.0,0.08006407690254357,565,"Don't be alarmed, confidentiality is a priority and we keep records only as long as the flame lasts."
4241,0,0,14,14,1.0,0.07412493166611012,565,You have the worst case of heart burn I've ever seen!
4241,0,0,13,13,1.0,0.08006407690254357,565,Dragon breath. It comes from binge watching Game of Thrones.
4241,0,0,13,13,1.0,0.08006407690254357,565,Eat less buffalo chicken.
4241,0,0,13,13,1.0,0.08006407690254357,565,"I'm sorry, but your electronic medical record has a short."
4241,0,0,13,13,1.0,0.08006407690254357,565,Your numbers are going all to hell!
4241,0,0,13,13,1.0,0.08006407690254357,565,Bring me an owl!
4241,0,0,13,13,1.0,0.08006407690254357,565,Your mission should you choose to accept it is to rescue American healthcare....
4241,0,0,13,13,1.0,0.08006407690254357,565,"You know, I always wanted to be a fireman when I grew up."
4241,0,0,13,13,1.0,0.08006407690254357,565,Your chart suggests either hemorrhoids or demons.
4241,0,0,13,13,1.0,0.08006407690254357,565,A letter of appreciation from the society of ball-fryers!
4241,0,0,13,13,1.0,0.08006407690254357,565,"Sorry, but that's the law. These results were paid for by your recently expired coverage."
4241,0,0,13,13,1.0,0.08006407690254357,565,"On a scale of 1 to 10, how would you describe these newfound mind-powers?"
4241,0,0,13,13,1.0,0.08006407690254357,565,Do you think this will help your cadency??
4241,0,0,13,13,1.0,0.08006407690254357,565,I told you to stay away from the wasabi!!!
4241,0,0,13,13,1.0,0.08006407690254357,565,"On paper, your heartburn looks pretty severe."
4241,0,0,13,13,1.0,0.08006407690254357,565,It says you have a new kind of STD.
4241,0,0,13,13,1.0,0.08006407690254357,565,Do you see any smoke?
4241,0,0,13,13,1.0,0.08006407690254357,565,Rectum? It killed him!
4241,0,0,13,13,1.0,0.08006407690254357,565,Maybe it's not hemorrhoids.
4241,0,0,13,13,1.0,0.08006407690254357,565,Your test results show you need to begin a regimen of antacids
4241,0,0,13,13,1.0,0.08006407690254357,565,Did you sign your HIPAA disclosure form?
4241,0,0,13,13,1.0,0.08006407690254357,565,My diagnosis is heartburn
4241,0,0,13,13,1.0,0.08006407690254357,565,"Yes, it does show bad inflammation. But this is not the X-ray; it's your bill."
4241,0,0,13,13,1.0,0.08006407690254357,565,Your diagnosis of being a fire breather is still on or digital records...
4241,0,0,13,13,1.0,0.08006407690254357,565,Your heartburn's worsened!
4241,0,0,13,13,1.0,0.08006407690254357,565,Oh.No
4241,0,0,13,13,1.0,0.08006407690254357,565,I give it about 19 seconds.
4241,0,0,13,13,1.0,0.08006407690254357,565,It's the GOP's new health care plan.
4241,0,0,13,13,1.0,0.08006407690254357,565,"How shall I put this...I'm reminded of the classic ""Burning Love"" by the late, great Elvis Presley..."
4241,0,0,13,13,1.0,0.08006407690254357,565,"So, if a blue paper is great news, and a red one is not so good..."
4241,0,0,13,13,1.0,0.08006407690254357,565,It may be mesothelioma
4241,0,0,13,13,1.0,0.08006407690254357,565,"As you can see, Mr. Fogarty, your test results show quite clearly you do have a predisposition for spontaneous combustion."
4241,0,0,13,13,1.0,0.08006407690254357,565,That burning sensation when you urinate? I have your test results...
4241,0,0,13,13,1.0,0.08006407690254357,565,"I have here, the answer to your burning question"
4241,0,0,13,13,1.0,0.08006407690254357,565,Under the new TrumpCare those lab results of yours are just too hot to handle.
4241,0,0,13,13,1.0,0.08006407690254357,565,I told you to stop smoking at your last visit!
4241,0,0,13,13,1.0,0.08006407690254357,565,"Malpractice? Well, this claim will self-destruct in five seconds."
4241,0,0,13,13,1.0,0.08006407690254357,565,I'm using the latest to store your records in the cloud.
4241,0,0,13,13,1.0,0.08006407690254357,565,"I'm afraid to tell you, but your lungs are on fire."
4241,0,0,13,13,1.0,0.08006407690254357,565,Your tests indicate you have an increased risk of wildfires.
4241,0,0,13,13,1.0,0.08006407690254357,565,I'm afraid there's a flare up on your chart.
4241,0,0,13,13,1.0,0.08006407690254357,565,"It might look bad on paper, but I can assure you..."
4241,0,0,13,13,1.0,0.08006407690254357,565,This report confirms your 'burning sensation' when you pee.
4241,0,0,13,13,1.0,0.08006407690254357,565,Want to choose the urn for your benefits now? Ivanka has a new line of vessels in bold fashion colors.
4241,0,0,13,13,1.0,0.08006407690254357,565,It could be a fever. You definitely seem hot.
4241,0,0,13,13,1.0,0.08006407690254357,565,"As you can see, Mr. Dingus, I've been up half the night going over your charred's."
4241,0,0,13,13,1.0,0.08006407690254357,565,I'm sorry Mr. Jeffreys but it appears that burning sensation is now inkborne
4241,0,0,13,13,1.0,0.08006407690254357,565,My diagnosis was correct. You do suffer from pyromania!
4241,0,0,13,13,1.0,0.08006407690254357,565,"I know the medicine man didn't help, so try this."
4241,0,0,13,13,1.0,0.08006407690254357,565,oh you got a fire and it burning baby!
4241,0,0,13,13,1.0,0.08006407690254357,565,I'd like you to put your stool sample in this container and just leave it in front of the charge nurses station.
4241,0,0,13,13,1.0,0.08006407690254357,565,"We haven't determined the cause, but we have managed to isolate your flare-ups."
4241,0,0,13,13,1.0,0.08006407690254357,565,Will you accept your surge diagnosis?
4241,0,0,13,13,1.0,0.08006407690254357,565,We're going to have to fire-proof you.
4241,0,0,13,13,1.0,0.08006407690254357,565,"Dang, Carl. Your EKG results are Fire!"
4241,0,0,13,13,1.0,0.08006407690254357,565,I'd say Preparation H and a lot fewer Habaneros will take care of your problem.
4241,0,0,13,13,1.0,0.08006407690254357,565,"um... mr. alexander, I asked for your medical records, not your mixtape."
4241,0,0,13,13,1.0,0.08006407690254357,565,"This usually works for my Obamacare patients. Once the diagnostic paperwork turns to ash, so too do your symptoms."
4241,0,0,13,13,1.0,0.08006407690254357,565,This lab report says it will self-destruct if you are allergic to fire ants.
4241,0,0,13,13,1.0,0.08006407690254357,565,Its from where your Headed!!!
4241,0,0,13,13,1.0,0.08006407690254357,565,Just as we were talking about heartburn...
4241,0,0,13,13,1.0,0.08006407690254357,565,I'm guessing you never read the 'Self Destruct' part when you signed your insurance papers.
4241,0,0,13,13,1.0,0.08006407690254357,565,Here's your latest insurance diagnosis.
4241,0,0,13,13,1.0,0.08006407690254357,565,Without question . . . heartburn.
4241,0,0,13,13,1.0,0.08006407690254357,565,Not good. Your Soul is departing early. And its not going upstairs.
4241,0,0,13,13,1.0,0.08006407690254357,565,"So Mr. Jones, your test results show no evidence of diabetes, but there is evidence of some inflammatory issues with your colon."
4241,0,0,13,13,1.0,0.08006407690254357,565,Let me guess. Heartburn?
4241,0,0,13,13,1.0,0.08006407690254357,565,"When I heard you worked miracles, this isn't what I had in mind."
4241,0,0,13,13,1.0,0.08006407690254357,565,"after your last visit, I would recommend you give the Jalapenos up"
4241,0,0,13,13,1.0,0.08006407690254357,565,Not that uncommon here in Santa Fe...
4241,0,0,13,13,1.0,0.08006407690254357,565,"Okay, we have the new commonsense health care reforms..."
4241,0,0,13,13,1.0,0.08006407690254357,565,"OK, Mr Kent. Your heat vision appears to be working fine. I don't think a prostate exam is necessary after all."
4241,0,0,14,14,1.0,0.07412493166611012,565,"Hey hey hey heyyy, smoke weed every -- oh shit"
4241,0,0,13,13,1.0,0.08006407690254357,565,Sorry to have to tell you we missed the smoke but found the fire!
4241,0,0,13,13,1.0,0.08006407690254357,565,I think you have heartburn.
4241,0,0,13,13,1.0,0.08006407690254357,565,I've never seen heartburn this severe.
4241,0,0,13,13,1.0,0.08006407690254357,565,"No, your insurance doesn't cover this procedure."
4241,0,0,13,13,1.0,0.08006407690254357,565,"Doc, I told you it flares up when you least expect it."
4241,0,0,14,14,1.0,0.07412493166611012,565,"I'm sorry, we can't seem to locate your medical records."
4241,0,0,13,13,1.0,0.08006407690254357,565,"I can read every other doctor's handwriting, but it's always tough to read a chart written by Dr. Satan."
4241,0,0,13,13,1.0,0.08006407690254357,565,Diagnosis: Spring fever. Prescription: Asbestos clothing.
4241,0,0,13,13,1.0,0.08006407690254357,565,Lab reports are in. Spontaneous combustion rates as stage 3. I'd lay off the hot wings for a while.
4241,0,0,13,13,1.0,0.08006407690254357,565,Yourt blood pressure is within range but your heartburn is off the charts.
4241,0,0,13,13,1.0,0.08006407690254357,565,Your testosterone is a little high.
4241,0,0,13,13,1.0,0.08006407690254357,565,It's that joker in the lab's way of telling us that you have a hot appendix!
4241,0,0,13,13,1.0,0.08006407690254357,565,Are you sure you aren't gay?
4241,0,0,13,13,1.0,0.08006407690254357,565,Would you hold this while I wash my hands?
4241,0,0,13,13,1.0,0.08006407690254357,565,"This provides a cure for all known ailments. I couldn't let it go farther."""
4241,0,0,13,13,1.0,0.08006407690254357,565,Your test results show that you're burning up.
4241,0,0,13,13,1.0,0.08006407690254357,565,The side effects include burning.
4241,0,0,13,13,1.0,0.08006407690254357,565,"Because we don't keep electronic medical records, your syphilis will never be known."
4241,0,0,13,13,1.0,0.08006407690254357,565,The diagnosis is more serious than simple x ray vision.
4241,0,0,13,13,1.0,0.08006407690254357,565,Your fever is extraordinary.
4241,0,0,13,13,1.0,0.08006407690254357,565,We've been able to confirm that you are a flaming caucasian.
4241,0,0,13,13,1.0,0.08006407690254357,565,Have you thought about quitting?
4241,0,0,13,13,1.0,0.08006407690254357,565,...and acetaminophen to reduce your temperature.
4241,0,0,13,13,1.0,0.08006407690254357,565,My diagnosis is inflammation of the copay.
4241,0,0,14,14,1.0,0.07412493166611012,565,Can you recommend a good burn doctor?
4241,0,0,13,13,1.0,0.08006407690254357,565,AI is now running the whole system. It is ensuring that tomorrow all the medical files will be electronic.
4241,0,0,13,13,1.0,0.08006407690254357,565,"Since you stated that you hadn’t experienced any burning sensation, I was wondering if you’d like to."
4241,0,0,13,13,1.0,0.08006407690254357,565,At least it doesn't burn when you pee.
4241,0,0,13,13,1.0,0.08006407690254357,565,"Lie down please, Mr. Dracut, I'm just going to check your reflexes."""
4241,0,0,14,14,1.0,0.07412493166611012,565,Feel like you're dragon?
4241,0,0,13,13,1.0,0.08006407690254357,565,No news is good news.
4241,0,0,13,13,1.0,0.08006407690254357,565,Take two aspirin and throw the water on me.
4241,0,0,13,13,1.0,0.08006407690254357,565,Dr. Beelzebub sent over his report.
4241,0,0,13,13,1.0,0.08006407690254357,565,"Close your eyes and say ""ahhh.""."
4241,0,0,13,13,1.0,0.08006407690254357,565,I have the results of your acid reflux exam.
4241,0,0,14,14,1.0,0.07412493166611012,565,Well that explains why your wife burned her tongue.
4241,0,0,13,13,1.0,0.08006407690254357,565,"Yes I think I'm God, and this is your burning bush."
4241,0,0,13,13,1.0,0.08006407690254357,565,"You need to drop your shorts for this procedure, Mr. Danzler."
4241,0,0,13,13,1.0,0.08006407690254357,565,Hey! There are kinder ways to request a second opinion.
4241,0,0,13,13,1.0,0.08006407690254357,565,"Why so glum, chum? Apparently, you are on fire."
4241,0,0,13,13,1.0,0.08006407690254357,565,"When it comes to your health, I'm not sure it's wise to fight fire with fire."
4241,0,0,14,14,1.0,0.07412493166611012,565,"Who are you, Olga, who who, who who?"
4241,0,0,13,13,1.0,0.08006407690254357,565,"Test results in Vegas, stays in Vegas."
4241,0,0,13,13,1.0,0.08006407690254357,565,"Well, Mr. Smith, you may disagree with my diagnoses, but this invitation was just delivered for you by a strange-looking man with horns."
4241,0,0,13,13,1.0,0.08006407690254357,565,"I fully understand why you would refer to such unfortunate news in that way, but the technical medical diagnosis is an inflamed stool sample."
4241,0,0,13,13,1.0,0.08006407690254357,565,Your policy is going up in smoke; that's health care reform.
4241,0,0,13,13,1.0,0.08006407690254357,565,Trumpcare destroyed your generic profile...
4241,0,0,13,13,1.0,0.08006407690254357,565,It's a diagnostic printout from Watson that self destructs after you read it three times.
4241,0,0,13,13,1.0,0.08006407690254357,565,Please don't look at me like that!
4241,0,0,13,13,1.0,0.08006407690254357,565,What DID you have for dinner last night?
4241,0,0,14,14,1.0,0.07412493166611012,565,How many flickers am I holding up?
4241,0,0,13,13,1.0,0.08006407690254357,565,This is fine.
4241,0,0,13,13,1.0,0.08006407690254357,565,The strain of gonorrhea is particularly contagious.
4241,0,0,13,13,1.0,0.08006407690254357,565,I'm having trouble interpreting your test results.
4241,0,0,13,13,1.0,0.08006407690254357,565,"""So you must be the smokin' hot doc my wife was telling me about""."
4241,0,0,13,13,1.0,0.08006407690254357,565,"Once we've finished with the diagnosis, the Fire Marshal would like to have a few words with you."
4241,0,0,13,13,1.0,0.08006407690254357,565,I Told Your Wife You Love Her !
4241,0,0,13,13,1.0,0.08006407690254357,565,I have a message here from your ex wife.
4241,0,0,13,13,1.0,0.08006407690254357,565,They haven't made enough rolaids to cure this chart burn!
4241,0,0,13,13,1.0,0.08006407690254357,565,I got chills but no fever.
4241,0,0,13,13,1.0,0.08006407690254357,565,"So, the results of your tests are in... your eye sight is 20/20, but everything seems to be inflamed."""
4241,0,0,13,13,1.0,0.08006407690254357,565,"Without price control, you bill now comes straight from hell."
4241,0,0,13,13,1.0,0.08006407690254357,565,Hopefully not a prophecy but I suppose it could be a preview of coming attractions.
4241,0,0,13,13,1.0,0.08006407690254357,565,"It's completely curable but your medication was just ""Schkrelied""."
4241,0,0,13,13,1.0,0.08006407690254357,565,"""Under the new administration's revised health care plan most of the CPT codes are resulting in this""."
4241,0,0,13,13,1.0,0.08006407690254357,565,The worst acid stomach I've ever treated.
4241,0,0,13,13,1.0,0.08006407690254357,565,Any chance you're telling me Ive still got it?
4241,0,0,13,13,1.0,0.08006407690254357,565,Does it happen only when you sneeze?
4241,0,0,13,13,1.0,0.08006407690254357,565,The laser surgery appears to have given you heat vision.
4241,0,0,13,13,1.0,0.08006407690254357,565,Take off your sandals first.
4241,0,0,13,13,1.0,0.08006407690254357,565,"Yes, Mr. Hunt, I have your I. M. F. annual physical report right here and it says... Wait! What the...!"
4241,0,0,13,13,1.0,0.08006407690254357,565,Just got your report hot from the lab.
4241,0,0,13,13,1.0,0.08006407690254357,565,Sorry to inform you Mr. Phelps that you too will self-destruct in five seconds
4241,0,0,13,13,1.0,0.08006407690254357,565,Normally I'd give you the good news first.
4241,0,0,13,13,1.0,0.08006407690254357,565,"Your insurer says ""Better not tell you now""!"
4241,0,0,13,13,1.0,0.08006407690254357,565,Now that we know what you have let's burn the evidence of how long it took me to figure it out.
4241,0,0,13,13,1.0,0.08006407690254357,565,"Oops, this must be the one for spontaneous combustion, not spontaneous healing."
4241,0,0,13,13,1.0,0.08006407690254357,565,"Well, I don't need to take your temperature to see that you're burning up."
4241,0,0,13,13,1.0,0.08006407690254357,565,You have too much oxygen.
4241,0,0,13,13,1.0,0.08006407690254357,565,... and the results of your urine test ..
4241,0,0,13,13,1.0,0.08006407690254357,565,I've been told I have evil handwriting.
4241,0,0,13,13,1.0,0.08006407690254357,565,Where there's fire there're smok-ers! Did you finally smother your craving?
4241,0,0,13,13,1.0,0.08006407690254357,565,You have a serious problem of heart burn.
4241,0,0,13,13,1.0,0.08006407690254357,565,"You can decide to accept the diagnosis or not, but it was self destruct in 5 seconds!"
4241,0,0,13,13,1.0,0.08006407690254357,565,Who knew that healthcare could be so flammable?
4241,0,0,13,13,1.0,0.08006407690254357,565,I guess you won't be coming back.
4241,0,0,13,13,1.0,0.08006407690254357,565,"Inflammation, but it's hard to tell exactly of what."
4241,0,0,13,13,1.0,0.08006407690254357,565,"""This is what I think of your ""Second opinion""!"
4241,0,0,13,13,1.0,0.08006407690254357,565,oh shit i'm gonna be rich
4241,0,0,13,13,1.0,0.08006407690254357,565,And you said this is what happened when you tried to lift the heavy box?
4241,0,0,13,13,1.0,0.08006407690254357,565,"Well, as you can see, it isn't good news."
4241,0,0,13,13,1.0,0.08006407690254357,565,This is the lab report on your inflamation problem. .Do I need to read it to you?
4241,0,0,13,13,1.0,0.08006407690254357,565,"With this paper being 9, what number would you give your reflux pain?"
4241,0,0,13,13,1.0,0.08006407690254357,565,Your tests point to heartburn.
4241,0,0,13,13,1.0,0.08006407690254357,565,"January 1st, 2018: As it turns out, this the only pre-existing condition that your new policy covers, so let's keep it between us."
4241,0,0,13,13,1.0,0.08006407690254357,565,Trumpodus: The story of the Burning Health Files
4241,0,0,13,13,1.0,0.08006407690254357,565,"Mr. Jones, have you ever considered registering your ""bad breath"" as a viable lethal weapon?"
4241,0,0,13,13,1.0,0.08006407690254357,565,Neither of us have much time.
4241,0,0,13,13,1.0,0.08006407690254357,565,Hmnn... A bill like this wouldn't happen in Canada.
4241,0,0,13,13,1.0,0.08006407690254357,565,"Because you voted for Trump, you're fired!"
4241,0,0,13,13,1.0,0.08006407690254357,565,"Yea, we're gonna have you just sit here for a bit while we hose down my staff and go over your containment with local police. By the way, that thing on your arm is nothing so that's good."
4241,0,0,13,13,1.0,0.08006407690254357,565,"Yes, it is a controlled substance."
4241,0,0,13,13,1.0,0.08006407690254357,565,"Looks like a mild case of ""Dragon's Breath."""
4241,0,0,13,13,1.0,0.08006407690254357,565,Are you sure it doesn't burn?
4241,0,0,13,13,1.0,0.08006407690254357,565,If you don't slow down you're going to burn yourself out.
4241,0,0,13,13,1.0,0.08006407690254357,565,Don't worry. It's just a mild depression.
4241,0,0,13,13,1.0,0.08006407690254357,565,"No more hot pepper eating contests, Senyor Chile Pants."
4241,0,0,13,13,1.0,0.08006407690254357,565,"I'm burning your pre-existing condition diagnosis, so you can qualify for Trumpcare."
4241,0,0,13,13,1.0,0.08006407690254357,565,You must be a Democrat
4241,0,0,13,13,1.0,0.08006407690254357,565,"Well, that takes care of the repeal…"
4241,0,0,13,13,1.0,0.08006407690254357,565,It's Friday...time for a happy owl?
4241,0,0,13,13,1.0,0.08006407690254357,565,Your test results are back... Where did you eat last night?
4241,0,0,13,13,1.0,0.08006407690254357,565,It looks like your inflammation has spread!
4241,0,0,13,13,1.0,0.08006407690254357,565,This time of year we're seeing a lot of inflamed tax returns.
4241,0,0,13,13,1.0,0.08006407690254357,565,"I have really bad news, you are going to die and go to hell."
4241,0,0,13,13,1.0,0.08006407690254357,565,"I'm sorry Mr. Ziffel, but I used your Prescription form to get an autograph from Drew Barrymore in the hallway."
4241,0,0,13,13,1.0,0.08006407690254357,565,Hmm...it looks like 'Repeal'
4241,0,0,13,13,1.0,0.08006407690254357,565,This treatment is covered by Trumpcare! Take it 3 times a day and call me in 4 years.
4241,0,0,13,13,1.0,0.08006407690254357,565,"To comply with the new HIPAA rules, we can no longer keep patient records. Each visit is your first and last."
4241,0,0,13,13,1.0,0.08006407690254357,565,I'm going to refer you to my colleagues at the fire station to treat your inflammation.
4241,0,0,13,13,1.0,0.08006407690254357,565,John what seems to be your problem? Seriously Doc bad gas!
4241,0,0,13,13,1.0,0.08006407690254357,565,Your hemorrhoids seem to be inflamed.
4241,0,0,14,14,1.0,0.07412493166611012,565,"Maybe we should meet outside the office to smoke medical marijuana, I get so clumsy, Jesus!"
4241,0,0,13,13,1.0,0.08006407690254357,565,It's another successful flaming liberalectomy
4241,0,0,13,13,1.0,0.08006407690254357,565,Let me give you the bad news first.
4241,0,0,13,13,1.0,0.08006407690254357,565,Bad lab tests but can't stop drinking & smoking ? Touch your cigarette to whiskey soaked paper......
4241,0,0,13,13,1.0,0.08006407690254357,565,"Well this is odd, I'm usually the one asking if there's a burning sensation."
4241,0,0,13,13,1.0,0.08006407690254357,565,These are the fake lab reports about your serious inflammation. So sad.
4241,0,0,13,13,1.0,0.08006407690254357,565,I'm afraid your PSA test came back positive.
4241,0,0,13,13,1.0,0.08006407690254357,565,Apparently your HMO denied your pre-approval request.
4241,0,0,13,13,1.0,0.08006407690254357,565,"We thought digital records would be safer, but they're just as likely to go up in flames."
4241,0,0,13,13,1.0,0.08006407690254357,565,Your colonoscopy results are back. Your bowel is extremely inflamed.
4241,0,0,13,13,1.0,0.08006407690254357,565,It looks like your appendix is in flame.
4241,0,0,13,13,1.0,0.08006407690254357,565,It seems like your allergies are flaming up again.
4241,0,0,13,13,1.0,0.08006407690254357,565,Your insurance asked that I reduce costs by setting you on fire.
4241,0,0,13,13,1.0,0.08006407690254357,565,Listen closely. We only get one shot at reviewing your results.
4241,0,0,13,13,1.0,0.08006407690254357,565,"Now you see, this wouldn't happen under Trumpcare."
4241,0,0,13,13,1.0,0.08006407690254357,565,I don't care what the commercial said! You shouldn't have asked me!
4241,0,0,13,13,1.0,0.08006407690254357,565,I'm concerned about your grease levels.
4241,0,0,14,14,1.0,0.07412493166611012,565,"Now Timmy, you were a very naughty boy to set your chart on fire, but... I suppose I share some of the blame for encouraging you to do it."
4241,0,0,13,13,1.0,0.08006407690254357,565,"Simply put, this bill will reflect your burning desire for treatment."
4241,0,0,13,13,1.0,0.08006407690254357,565,You can skip the small talk Doc.
4241,0,0,13,13,1.0,0.08006407690254357,565,"Okay, your insurance doesn't cover the standard x-rays and cast. But here, try this...if you put your hand in this fire, you won't even notice your broken leg."
4241,0,0,13,13,1.0,0.08006407690254357,565,"It's all online anyway, and besides, the Russians have all your vital info."
4241,0,0,13,13,1.0,0.08006407690254357,565,Sorry Dave - looks like your new provider won't cover laser eye surgery.
4241,0,0,13,13,1.0,0.08006407690254357,565,"Fever isn't such a new thing, fever started long time ago."
4241,0,0,13,13,1.0,0.08006407690254357,565,"Simply put, Mr. Doe, you are one hot mess."
4241,0,0,13,13,1.0,0.08006407690254357,565,Would you prefer to discuss your new co-pay after the colonoscopy? ...no metaphor intended.
4241,0,0,13,13,1.0,0.08006407690254357,565,I'll show them who's fired.
4241,0,0,13,13,1.0,0.08006407690254357,565,"I'm sorry, Bob, the inflammation has spread from your liver."
4241,0,0,13,13,1.0,0.08006407690254357,565,I hadn't realized my physician's assistant is your ex-wife.
4241,0,0,13,13,1.0,0.08006407690254357,565,You have 2 minutes to live.
4241,0,0,13,13,1.0,0.08006407690254357,565,"As this ancient parchment containing your diagnosis burns, your pain will disappear."
4241,0,0,13,13,1.0,0.08006407690254357,565,"That's not going to change your cholesterol results, Mr. Kent."
4241,0,0,13,13,1.0,0.08006407690254357,565,"The X-rays show a key, a small camera, and a diamond ring. We're burning the evidence."
4241,0,0,13,13,1.0,0.08006407690254357,565,New HIPAA regulation!
4241,0,0,13,13,1.0,0.08006407690254357,565,What's in your hot report Doctor?
4241,0,0,13,13,1.0,0.08006407690254357,565,Samsung is getting into the health insurance business.
4241,0,0,13,13,1.0,0.08006407690254357,565,"Your demonstration of a male hot-flash does not impress me, Doc."
4241,0,0,14,14,1.0,0.07412493166611012,565,Antacids don't work for dragon's breath.
4241,0,0,13,13,1.0,0.08006407690254357,565,"Oh boy. Did I say cancer, Mr. Mephistopheles? My mistake. I meant inflammation."
4241,0,0,13,13,1.0,0.08006407690254357,565,I don't give 9 hoots why you and Joanne are having difficulty working together. I need the report by Monday.
4241,0,0,13,13,1.0,0.08006407690254357,565,"Sir, you may have AIDS; this report shows that you're a flaming homosexual."
4241,0,0,13,13,1.0,0.08006407690254357,565,This test is lit.
4241,0,0,13,13,1.0,0.08006407690254357,565,"You don't mind if I burn this here, do you? I mean, it's only one emission. Can't change much."
4241,0,0,13,13,1.0,0.08006407690254357,565,Manage care now requires our notes to be a more graphic indication of the patients condition. Here is a prescription for penicillin.
4241,0,0,13,13,1.0,0.08006407690254357,565,This is what can happen with electronic medical records!
4241,0,0,13,13,1.0,0.08006407690254357,565,Your hemorrhoid surgery was a success.
4241,0,0,13,13,1.0,0.08006407690254357,565,We've got to give you something to bring this fever down!
4241,0,0,14,14,1.0,0.07412493166611012,565,your inflammation levels are off the chart!
4241,0,0,13,13,1.0,0.08006407690254357,565,"Don't worry you're in perfect health, this is the list of charges not covered by your insurance company."
4241,0,0,13,13,1.0,0.08006407690254357,565,What should you tell your wife?..........'oops would work'.
4241,0,0,13,13,1.0,0.08006407690254357,565,"Sorry, but it's $200 to reprint your records. Also we'll have to reschedule."
4241,0,0,13,13,1.0,0.08006407690254357,565,You have 4 alarm indigestion.
4241,0,0,13,13,1.0,0.08006407690254357,565,I thought healthcare exploding was a metaphor....
4241,0,0,13,13,1.0,0.08006407690254357,565,Your results are in and HOT off the press.
4241,0,0,13,13,1.0,0.08006407690254357,565,You better just walk if you think you are to hot to trot.
4241,0,0,13,13,1.0,0.08006407690254357,565,No doubt about it. Your co-pay is definitely inflamed.
4241,0,0,13,13,1.0,0.08006407690254357,565,The nurse's notes say your temperature has spiked to Fahrenheit 451.
4241,0,0,13,13,1.0,0.08006407690254357,565,"Trumpcare 2020: ""Hmmm...I see that you have a pre-existing condition."""
4241,0,0,13,13,1.0,0.08006407690254357,565,We analyzed your mixtape. It appears it's on fire
4241,0,0,13,13,1.0,0.08006407690254357,565,"To hell with the charts ... I'm burning, I'm burning, I'm burning for you."
4241,0,0,13,13,1.0,0.08006407690254357,565,This is our new medicsl records privacy policy.
4241,0,0,13,13,1.0,0.08006407690254357,565,"Let's try this again, Mr. Myers. Our heartburn scale only goes to 10, and can't seem to deal with ""11"" as a response."
4241,0,0,14,14,1.0,0.07412493166611012,565,....and the good news is that your chart's on fire.
4241,0,0,13,13,1.0,0.08006407690254357,565,I have an idea who wrote your HMO contract.
4241,0,0,13,13,1.0,0.08006407690254357,565,Would you feel better if I showed you the 'burn down' Chart?
4241,0,0,13,13,1.0,0.08006407690254357,565,Well... you passed with burning colors.
4241,0,0,13,13,1.0,0.08006407690254357,565,Drink one glass of water and call me in the morning
4241,0,0,14,14,1.0,0.07412493166611012,565,"No, not HEART burn. My diagnosis is CHART burn."
4241,0,0,13,13,1.0,0.08006407690254357,565,Our staff seems to have misinterpreted recent federal regulation regarding how long to retain medical records.
4241,0,0,13,13,1.0,0.08006407690254357,565,You tested hot.
4241,0,0,13,13,1.0,0.08006407690254357,565,When my doctors look at my health.
4241,0,0,13,13,1.0,0.08006407690254357,565,This is the Republican treatment for Raynaud's disease.
4241,0,0,13,13,1.0,0.08006407690254357,565,"I'm sorry but it appears that the ""burning"" sensation has spread to your bank account."
4241,0,0,13,13,1.0,0.08006407690254357,565,Good God man! I've never seen results like these!
4241,0,0,13,13,1.0,0.08006407690254357,565,Good news. It's only heartburn.
4241,0,0,13,13,1.0,0.08006407690254357,565,It is called the Trump Could Not Care Less Health Plan.
4241,0,0,13,13,1.0,0.08006407690254357,565,I'd say your health insurance provider has sent a decisive answer back about pre-approval for this procedure.
4241,0,0,13,13,1.0,0.08006407690254357,565,I have irritable owl syndrome.
4241,0,0,13,13,1.0,0.08006407690254357,565,These are the new administration's insurance forms.
4241,0,0,13,13,1.0,0.08006407690254357,565,Your laser vision is still 20/20.
4241,0,0,13,13,1.0,0.08006407690254357,565,Now do you believe that your ulcer is inflamed?
4241,0,0,13,13,1.0,0.08006407690254357,565,I'd say your labs are pretty lit.
4241,0,0,13,13,1.0,0.08006407690254357,565,We need to talk about your flaring diagnosis. You've got one which is the minimum.
4241,0,0,13,13,1.0,0.08006407690254357,565,"Let's try a homeopathic for your hemorrhoids, Mr. Jones."
4241,0,0,13,13,1.0,0.08006407690254357,565,HIPPA!
4241,0,0,13,13,1.0,0.08006407690254357,565,Your test results are in the normal range for a dybbuk.
4241,0,0,13,13,1.0,0.08006407690254357,565,I choose NOT to accept this mission.
4241,0,0,13,13,1.0,0.08006407690254357,565,"I'm sorry, Mr. Kent, but I don't think an ophthalmologist is going to be able to help you."
4241,0,0,13,13,1.0,0.08006407690254357,565,The test results in your medical records indicate that you should draft a will before you leave this office today.
4241,0,0,13,13,1.0,0.08006407690254357,565,YOUR LAB TESTS TELL ME YOU HAVE A BAD CASE OF INDIGESTION . DO YOU FEEL A BURNING SENSATION IN YOUR STOMACH ?
4241,0,0,13,13,1.0,0.08006407690254357,565,They've repealed and replaced the social contract.
4241,0,0,13,13,1.0,0.08006407690254357,565,"So, how long did you say you've been on this chili diet?"
4241,0,0,13,13,1.0,0.08006407690254357,565,"Are you seriously ill? No, but you're getting warmer!"
4241,0,0,13,13,1.0,0.08006407690254357,565,What were you telling me about that burning sensation?
4241,0,0,13,13,1.0,0.08006407690254357,565,it shows your burning sensation is contagious
4241,0,0,13,13,1.0,0.08006407690254357,565,It strongly suggests you give up smoking.
4241,0,0,13,13,1.0,0.08006407690254357,565,Physician-patient privilege is as serious as a heart attack.
4241,0,0,13,13,1.0,0.08006407690254357,565,"I'd tell you what it says, but then I'd have to kill you."
4241,0,0,13,13,1.0,0.08006407690254357,565,Wow! Your breath IS strong.
4241,0,0,13,13,1.0,0.08006407690254357,565,We heard back from your insurer.
4241,0,0,13,13,1.0,0.08006407690254357,565,I have results on your hot date encounter
4241,0,0,13,13,1.0,0.08006407690254357,565,I see from your chart that the side effects have started.
4241,0,0,13,13,1.0,0.08006407690254357,565,I thought you said it's an anti-inflammatory prescription.
4241,0,0,13,13,1.0,0.08006407690254357,565,"Your prescription? No, this is your credit rating."
4241,0,0,13,13,1.0,0.08006407690254357,565,"I know it's kind of old school, but when 'Obama-Care' self-destructs, you'll thank me."
4241,0,0,13,13,1.0,0.08006407690254357,565,Now we know what's causing your heartburn.
4241,0,0,13,13,1.0,0.08006407690254357,565,Who knew healthcare could be so flammable?
4241,0,0,13,13,1.0,0.08006407690254357,565,"The results from your ""mixed tape"" are back."
4241,0,0,13,13,1.0,0.08006407690254357,565,I wish I had less flammable news...
4241,0,0,13,13,1.0,0.08006407690254357,565,Chart burn is common after age 50.
4241,0,0,13,13,1.0,0.08006407690254357,565,It's a beta version of Trumpcare.
4241,0,0,13,13,1.0,0.08006407690254357,565,"Most people come in with a heavy chart and their heart on fire, niot the other way around."
4241,0,0,13,13,1.0,0.08006407690254357,565,Looks like your potassium level is a little on the high side.
4241,0,0,13,13,1.0,0.08006407690254357,565,Medicare wouldn't pay for those tests.
4241,0,0,13,13,1.0,0.08006407690254357,565,Sorry to burn the results but our lawyer aren't too keen on paper trails.
4241,0,0,13,13,1.0,0.08006407690254357,565,The health care bill went up in smoke.
4241,0,0,13,13,1.0,0.08006407690254357,565,"What's the verdict, Dr. Burns?"
4241,0,0,13,13,1.0,0.08006407690254357,565,"Yes, you are dying, but I'm sure these bars I wrote while running the tests will make you feel better."
4241,0,0,13,13,1.0,0.08006407690254357,565,"The folks on the internet say I have cold hands, so..."
4241,0,0,13,13,1.0,0.08006407690254357,565,"Yep, they said Obamacare would crash and burn."
4241,0,0,13,13,1.0,0.08006407690254357,565,"According to the nurse's report, your hemorrhoids are flaring up again."
4241,0,0,13,13,1.0,0.08006407690254357,565,"Everything on your chart indicates ""heartburn."""
4241,0,0,13,13,1.0,0.08006407690254357,565,And this 'breathing fire' is normal you say?
4241,0,0,13,13,1.0,0.08006407690254357,565,"Since the repeal of Obamacare, this is how I will do your rectal exam."
4241,0,0,13,13,1.0,0.08006407690254357,565,Hold this and I guarantee you'll chronic back pain will stop.
4241,0,0,13,13,1.0,0.08006407690254357,565,It's to take your mind off your diagnosis.
4241,0,0,13,13,1.0,0.08006407690254357,565,I've never seen Obamacare do THAT before.
4241,0,0,13,13,1.0,0.08006407690254357,565,Looks like you've got some inflammation.
4241,0,0,13,13,1.0,0.08006407690254357,565,"Apparently, its inflamed."
4241,0,0,13,13,1.0,0.08006407690254357,565,"I have your insurance information here....Ooop, it looks like they just repealed Obamacare!"
4241,0,0,13,13,1.0,0.08006407690254357,565,Nurse Davis dislikes you intensely. This is her way of saying that she would not piss on you if you were on fire.
4241,0,0,13,13,1.0,0.08006407690254357,565,I told them you're a really big mouse.
4241,0,0,13,13,1.0,0.08006407690254357,565,Take two Advil and call me in the morning.
4241,0,0,13,13,1.0,0.08006407690254357,565,What! This dazzling subterfuge is not good enough?
4241,0,0,13,13,1.0,0.08006407690254357,565,"Sorry, I cannot prescribe anything for heartburn."
4241,0,0,13,13,1.0,0.08006407690254357,565,"In looking over all your test results everything looks perfectly normal...really, trust me."
4241,0,0,13,13,1.0,0.08006407690254357,565,Your heartburn on paper mr smith seems to needs to be revisted
4241,0,0,13,13,1.0,0.08006407690254357,565,I blame Obama.
4241,0,0,13,13,1.0,0.08006407690254357,565,This is best.... for both of us
4241,0,0,13,13,1.0,0.08006407690254357,565,Is art that to which others respond more than it's progenitor(s)?
4241,0,0,13,13,1.0,0.08006407690254357,565,I'm afraid I'm going to need that urine sample sooner than we thought.
4241,0,0,13,13,1.0,0.08006407690254357,565,Worst case of Acid Re-flux I've every seen. Please keep your mouth shut until you are discharged.
4241,0,0,13,13,1.0,0.08006407690254357,565,It looks like your insurance is not covering the tests so I have to burn the results
4241,0,0,13,13,1.0,0.08006407690254357,565,Welcome to the hydration clinic.
4241,0,0,13,13,1.0,0.08006407690254357,565,I see that your insurance says that you have reached your limit on coverage.
4241,0,0,13,13,1.0,0.08006407690254357,565,"""According to your results, I'll be spending my next two vacations in the tropics""."
4241,0,0,13,13,1.0,0.08006407690254357,565,"""Yes, Mr. Smith, these lyrics from your mixtape are absolutely lit, but we should really talk about your smoking problem."" This is from my student Ihea Inyama. We are using The New Yorker as our text for a Jr year writing elective this spring."
4241,0,0,13,13,1.0,0.08006407690254357,565,"Sir, you appear to have a high temperature."
4241,0,0,13,13,1.0,0.08006407690254357,565,Infernal HIPAA law!
4241,0,0,13,13,1.0,0.08006407690254357,565,I'm prescribing an anti-inflammatory--immediately.
4241,0,0,13,13,1.0,0.08006407690254357,565,Let me hear the good news first.
4241,0,0,13,13,1.0,0.08006407690254357,565,You really should start using protection.
4241,0,0,13,13,1.0,0.08006407690254357,565,This is our new protocol for bad test results and we pass the healthcare savings on to you
4241,0,0,13,13,1.0,0.08006407690254357,565,Tell the auditors that I am ready to meet with them about the large charge to Hooters on my expense account.
4241,0,0,13,13,1.0,0.08006407690254357,565,Stop smoking.
4241,0,0,13,13,1.0,0.08006407690254357,565,The results are back on your hemorrhoids!
4241,0,0,13,13,1.0,0.08006407690254357,565,Our test confirm that you're a serial arsonist.
4241,0,0,13,13,1.0,0.08006407690254357,565,"Heart Burn? No, Just a case of ... Yes you twit. I told you to stop with the Hot Peppers."
4241,0,0,13,13,1.0,0.08006407690254357,565,Oh my! Your health insurance company has cancelled all policies retroactively.
4241,0,0,13,13,1.0,0.08006407690254357,565,Our lab found the source of your burning sensation.
4241,0,0,13,13,1.0,0.08006407690254357,565,"I'm sorry Tom, but it looks like your health insurance went to Hell."
4241,0,0,13,13,1.0,0.08006407690254357,565,Your hemorrhoid results are back.
4241,0,0,13,13,1.0,0.08006407690254357,565,I need your fire insurance ID card NOW!
4241,0,0,13,13,1.0,0.08006407690254357,565,It's better if I don't give you the results.
4241,0,0,13,13,1.0,0.08006407690254357,565,Fortunately for you I was making it all up anyway.
4241,0,0,13,13,1.0,0.08006407690254357,565,It's a new part of HIPPA - Spontaneously combustible medical records to prevent people from gaining your private medical information.
4241,0,0,13,13,1.0,0.08006407690254357,565,Healthcare is really heating up.
4241,0,0,13,13,1.0,0.08006407690254357,565,Hmm. Are you sure you aren't already dead?
4241,0,0,13,13,1.0,0.08006407690254357,565,Now do you understand why you want to opt out of paper copies?
4241,0,0,13,13,1.0,0.08006407690254357,565,Do you suffer from heartburn perchance?
4241,0,0,13,13,1.0,0.08006407690254357,565,Don't worry. It's nothing I haven't seen before.
4241,0,0,14,14,1.0,0.07412493166611012,565,DON'T ASK
4241,0,0,13,13,1.0,0.08006407690254357,565,It seems you will flame out shortly.
4241,0,0,13,13,1.0,0.08006407690254357,565,you look like the type who needs a burning bush.
4241,0,0,13,13,1.0,0.08006407690254357,565,Does it also burn when you pee?
4241,0,0,13,13,1.0,0.08006407690254357,565,I'm going to check with Dr. Beelzebub for a second opinion.
4241,0,0,13,13,1.0,0.08006407690254357,565,"We still don't know what's wrong, but we seem to be getting closer."
4241,0,0,13,13,1.0,0.08006407690254357,565,"Incoming! Male ,""-("
4241,0,0,13,13,1.0,0.08006407690254357,565,"See, if you stare at it long enough, this happens."
4241,0,0,14,14,1.0,0.07412493166611012,565,"Mr. Kent, your cholesterol levels are rather .... I really wish you would stop doing that."
4241,0,0,13,13,1.0,0.08006407690254357,565,"I'm not sure if she'll believe ""my doctor incinerated my homework."""
4241,0,0,13,13,1.0,0.08006407690254357,565,"Before we go over the results, have you paid yet?"
4241,0,0,13,13,1.0,0.08006407690254357,565,"In order to test your reflexes, I'm going to need to hold your feet to the fire"
4241,0,0,13,13,1.0,0.08006407690254357,565,Your tests show you definitely have heart burn.
4241,0,0,13,13,1.0,0.08006407690254357,565,Are you ready to go over the results of your Myers-Briggs test?
4241,0,0,13,13,1.0,0.08006407690254357,565,You're going to Hell
4241,0,0,13,13,1.0,0.08006407690254357,565,"Wow Mr. Kent, your vision exam is quite impressive!"
4241,0,0,13,13,1.0,0.08006407690254357,565,"Well Doc, is that good or bad?"
4241,0,0,13,13,1.0,0.08006407690254357,565,"Hell of a case Bob, you sure you want this treated?"
4241,0,0,13,13,1.0,0.08006407690254357,565,We're passionate about our diagnoses.
4241,0,0,13,13,1.0,0.08006407690254357,565,These test results indicate heartburn.
4241,0,0,13,13,1.0,0.08006407690254357,565,Does it burn when you illustrate?
4241,0,0,13,13,1.0,0.08006407690254357,565,I'm afraid your urine contained a bit too much acid.
4241,0,0,13,13,1.0,0.08006407690254357,565,"Sorry, your previously appointed doctor was on an overbooked flight."
4241,0,0,13,13,1.0,0.08006407690254357,565,Your diagnosis is hot off the press.
4241,0,0,13,13,1.0,0.08006407690254357,565,Don’t complain to me about your burning sensation.
4241,0,0,13,13,1.0,0.08006407690254357,565,"Sorry, your Obamacare just went up in smoke."
4241,0,0,13,13,1.0,0.08006407690254357,565,New government regulation mandates we use self-destructing medical records.
4241,0,0,13,13,1.0,0.08006407690254357,565,So when did you first notice this inflammation?
4241,0,0,13,13,1.0,0.08006407690254357,565,"Yes, I have other talents as well. I'm working out some new material."
4241,0,0,13,13,1.0,0.08006407690254357,565,"Mr. Long,"" ""You're running an extremely high fever today!"
4241,0,0,13,13,1.0,0.08006407690254357,565,Results are back. Extreme inflammation.
4241,0,0,13,13,1.0,0.08006407690254357,565,The test results do show some inflammation.
4241,0,0,13,13,1.0,0.08006407690254357,565,"Sorry, our privacy rules require this."
4241,0,0,13,13,1.0,0.08006407690254357,565,"I know it's dusk, Minerva, but I don't give a hoot."
4241,0,0,13,13,1.0,0.08006407690254357,565,I see your heartburn has flared up again.
4241,0,0,13,13,1.0,0.08006407690254357,565,Let's pick this up in the burn ward.
4241,0,0,13,13,1.0,0.08006407690254357,565,It looks like heartburn.
4241,0,0,13,13,1.0,0.08006407690254357,565,I call it the 'toasty digit' exam.
4241,0,0,13,13,1.0,0.08006407690254357,565,"OK, your medical records have been destroyed. But I still may be asked to testify in person at your confirmation hearing."
4241,0,0,13,13,1.0,0.08006407690254357,565,I told you it burns when I pee.
4241,0,0,13,13,1.0,0.08006407690254357,565,"First off, your 'Patient's Bill of Rights'."
4241,0,0,13,13,1.0,0.08006407690254357,565,But the good news is...
4241,0,0,13,13,1.0,0.08006407690254357,565,Does your bronze plan cover pilgrimages to Lourdes?
4241,0,0,13,13,1.0,0.08006407690254357,565,"The good news is, you no longer have anything as I know."
4241,0,0,13,13,1.0,0.08006407690254357,565,It's terminal.
4241,0,0,13,13,1.0,0.08006407690254357,565,But I'm telling you....this isn't the way to get rid of your health problems.
4241,0,0,13,13,1.0,0.08006407690254357,565,I THINK YOU NEED A SECOND OPINION.
4241,0,0,13,13,1.0,0.08006407690254357,565,Well it appears you are a homosexual.
4241,0,0,13,13,1.0,0.08006407690254357,565,You temperature is off the charts.
4241,0,0,13,13,1.0,0.08006407690254357,565,It's definitely heartburn.
4241,0,0,13,13,1.0,0.08006407690254357,565,"What's up doc? I say, ""You're fired!"" and look what happens!"
4241,0,0,13,13,1.0,0.08006407690254357,565,The inflammation has spread!
4241,0,0,13,13,1.0,0.08006407690254357,565,Turns out it's a little more worrisome than a bladder infection.
4241,0,0,13,13,1.0,0.08006407690254357,565,"Sir, you've got a burning fever."
4241,0,0,13,13,1.0,0.08006407690254357,565,Results of you hemorrhoid test.
4241,0,0,14,14,1.0,0.07412493166611012,565,"If I had to take an educated guess, I'd say it's heartburn."
4241,0,0,13,13,1.0,0.08006407690254357,565,"And for this, you wonder why mountain-people gave up office-hours drinking?!"
4241,0,0,13,13,1.0,0.08006407690254357,565,Looks like there's inflammation
4241,0,0,13,13,1.0,0.08006407690254357,565,I've got some bad news.
4241,0,0,13,13,1.0,0.08006407690254357,565,I'm afraid it doesn't look good.
4241,0,0,13,13,1.0,0.08006407690254357,565,The lab results show it's some type of inflammation.
4241,0,0,13,13,1.0,0.08006407690254357,565,Here are your test results -- hot off the press.
4241,0,0,13,13,1.0,0.08006407690254357,565,"Your mission - should you decide to accept it - is to stop smoking, avoid alcohol, eat right, sleep 8 hours every night and exercise vigorously every day."
4241,0,0,13,13,1.0,0.08006407690254357,565,have you ever heard of hyperthermia?
4241,0,0,13,13,1.0,0.08006407690254357,565,It says your condition is spreading like wildfire.
4241,0,0,13,13,1.0,0.08006407690254357,565,The lab results are troubling but there is no need to draw incendiary conclusions.
4241,0,0,13,13,1.0,0.08006407690254357,565,"It's not your diagnosis, it's your bill. I don't want another stroke."
4241,0,0,13,13,1.0,0.08006407690254357,565,"For your next appointment Mr. Summers, kindly remember your glasses."
4241,0,0,13,13,1.0,0.08006407690254357,565,"The finalists in our ""Give a Hoot"" contest just flew in."
4241,0,0,13,13,1.0,0.08006407690254357,565,"Before I put this out, I will need to check if you have fire coverage."
4241,0,0,13,13,1.0,0.08006407690254357,565,Quick! Piss on it
4241,0,0,13,13,1.0,0.08006407690254357,565,"No, it's not covered under the new policy."
4241,0,0,13,13,1.0,0.08006407690254357,565,Looks like a rare case of super-contagious flaming hemorrhoids.
4241,0,0,13,13,1.0,0.08006407690254357,565,I thought you said you were from Haiti.
4241,0,0,13,13,1.0,0.08006407690254357,565,This is new targeted treatment and will only felt in your wallet
4241,0,0,13,13,1.0,0.08006407690254357,565,It appears the lab results are still inconclusive.
4241,0,0,13,13,1.0,0.08006407690254357,565,Well it's not frostbite.
4241,0,0,13,13,1.0,0.08006407690254357,565,It appears there are new limits on your insurance coverage.
4241,0,0,13,13,1.0,0.08006407690254357,565,"Don't let our new firewall bother you, we take patient privacy seriously at the practice. So...about that heat rash..."
4241,0,0,13,13,1.0,0.08006407690254357,565,It's a virtual record!
4241,0,0,13,13,1.0,0.08006407690254357,565,Let me check your medical history in my Kindle Fire.
4241,0,0,13,13,1.0,0.08006407690254357,565,Any recent travel to the sun?
4241,0,0,13,13,1.0,0.08006407690254357,565,"The diagnosis says ""You're fired!"""
4241,0,0,13,13,1.0,0.08006407690254357,565,Your health insurance is about to expire.
4241,0,0,13,13,1.0,0.08006407690254357,565,Are you too sick to call 911?
4241,0,0,13,13,1.0,0.08006407690254357,565,"Well, Mr. Jones, the good news is that you still have healthcare."
4241,0,0,13,13,1.0,0.08006407690254357,565,Looks like inflammation.
4241,0,0,13,13,1.0,0.08006407690254357,565,"Have you ever read Stephen King's novel, ""The Stand?"""
4241,0,0,13,13,1.0,0.08006407690254357,565,I have good news and bad news.
4241,0,0,13,13,1.0,0.08006407690254357,565,The prognosis isn't good.
4241,0,0,13,13,1.0,0.08006407690254357,565,You seem to have a burning desire to improve. Let's go with that.
4241,0,0,13,13,1.0,0.08006407690254357,565,Everything seems in order here.
4241,0,0,13,13,1.0,0.08006407690254357,565,You definitely hve a fever
4241,0,0,13,13,1.0,0.08006407690254357,565,Even your bucket list is bad news.
4241,0,0,13,13,1.0,0.08006407690254357,565,"No, no! Not gloomy, per se..."
4241,0,0,13,13,1.0,0.08006407690254357,565,Wow. Wish I had done that.
4241,0,0,13,13,1.0,0.08006407690254357,565,Perhaps this will make it clear. Stop eating spicy foods!
4241,0,0,13,13,1.0,0.08006407690254357,565,I have some bad news about your test results.
4241,0,0,13,13,1.0,0.08006407690254357,565,"Next, I rub the ashes on my forearm and your diagnosis will appear!"
4241,0,0,13,13,1.0,0.08006407690254357,565,"The lab report indicates your inflammation is contagious,"
4241,0,0,13,13,1.0,0.08006407690254357,565,"Don't worry, I have straightened out your problem."
4241,0,0,13,13,1.0,0.08006407690254357,565,"""This is what I think of your ""Second opinion""!"
4241,0,0,13,13,1.0,0.08006407690254357,565,"Our ""Feel the Bern"" billing system need updating, but our ""Dump Trump"" stool sample kits are catching on."
4241,0,0,13,13,1.0,0.08006407690254357,565,You can see from this report that the inflammation appears to be spreading!
4241,0,0,13,13,1.0,0.08006407690254357,565,Yours is the worst case of heart burn I've ever encountered.
4241,0,0,13,13,1.0,0.08006407690254357,565,"Your results are back Mr Jenkins, looks like you have a fever."
4241,0,0,13,13,1.0,0.08006407690254357,565,I have your biopsy results.
4241,0,0,13,13,1.0,0.08006407690254357,565,Your workup shows that you have third degree heartburn.
4241,0,0,13,13,1.0,0.08006407690254357,565,Remember when I said it's not contagious? ...there's been a slight change...
4241,0,0,13,13,1.0,0.08006407690254357,565,We will not let you donate blood but no one need ever know about the heroin peccadillo.
4241,0,0,13,13,1.0,0.08006407690254357,565,Worse case of heart burn ever reported .
4241,0,0,13,13,1.0,0.08006407690254357,565,Damn HIPAA laws!
4241,0,0,13,13,1.0,0.08006407690254357,565,"Your lab test result just came back. It says you are ""hot stuff""."
4241,0,0,14,14,1.0,0.07412493166611012,565,...not to make light of the situation.
4241,0,0,13,13,1.0,0.08006407690254357,565,"And now the lab report on your lung biopsy, you may want a cigarette. Do you need a light?"
4241,0,0,13,13,1.0,0.08006407690254357,565,Congratulations! You've got the hottest new designer disease!
4241,0,0,13,13,1.0,0.08006407690254357,565,The good news is this is not a good news-bad news situation.
4241,0,0,13,13,1.0,0.08006407690254357,565,I'm afraid it's way past cirrhosis...
4241,0,0,13,13,1.0,0.08006407690254357,565,Your lab report is showing a high temperature.
4241,0,0,13,13,1.0,0.08006407690254357,565,"Yes, heart burn is correct."
4241,0,0,13,13,1.0,0.08006407690254357,565,Your new policy has some inflammatory fine print.
4241,0,0,14,14,1.0,0.07412493166611012,565,Your plan doesn't cover diagnoses. How about a hot take?
4241,0,0,13,13,1.0,0.08006407690254357,565,... or have you been feeling gaseous?
4241,0,0,13,13,1.0,0.08006407690254357,565,So I see you've been experiencing frequent heartburn?
4241,0,0,13,13,1.0,0.08006407690254357,565,I have some news for you that might be hard to handle.
4241,0,0,13,13,1.0,0.08006407690254357,565,I took an oath to do no harm. I took an oath to do no harm.
4241,0,0,13,13,1.0,0.08006407690254357,565,Any other tests available under this new health care plan?
4241,0,0,13,13,1.0,0.08006407690254357,565,"As part of our change to an electronic medical record system, ..."
4241,0,0,13,13,1.0,0.08006407690254357,565,Your Homeowners Insurance should cover this one.
4241,0,0,13,13,1.0,0.08006407690254357,565,Your tests identified what's causing that burning sensation......its' called work!
4241,0,0,13,13,1.0,0.08006407690254357,565,"I have to say, these HIPAA privacy rules are going too far."
4241,0,0,13,13,1.0,0.08006407690254357,565,You could've just told me your symptoms down there.
4241,0,0,13,13,1.0,0.08006407690254357,565,You have one month to live and going to hell.
4241,0,0,13,13,1.0,0.08006407690254357,565,It's just our self district option as the ultimate privacy of your medical records.
4241,0,0,13,13,1.0,0.08006407690254357,565,Do you want the good news first or the bad news? And please make up your mind in a hurry!
4241,0,0,13,13,1.0,0.08006407690254357,565,It's a new condition called Inflammatory Coverage Reform Syndrome. The good news is it's nothing old Dr. Seltzer can't handle.
4241,0,0,13,13,1.0,0.08006407690254357,565,"The paper trail ends right here! Which is handy—and we’re impressed with the new digital patient records’ lower carbon footprint. Unfortunately, I still can’t do anything about you coming up short in the jeans department."
4241,0,0,13,13,1.0,0.08006407690254357,565,"'Au contraire, Doctor, you are burning up'"
4241,0,0,13,13,1.0,0.08006407690254357,565,You've got a really bad HMO.
4241,0,0,13,13,1.0,0.08006407690254357,565,"No sir, I do not think ten would be cuter."
4241,0,0,14,14,1.0,0.07412493166611012,565,"It's new policy. After we unmask your diagnosis, we destroy it."
4241,0,0,13,13,1.0,0.08006407690254357,565,"As always, should anything go wrong during the procedure the Doctor and Hospital will disavow any knowledge. Your chart will self-destruct in five seconds. Good luck."
4241,0,0,13,13,1.0,0.08006407690254357,565,You're fine. I'm a little nervous.
4241,0,0,13,13,1.0,0.08006407690254357,565,How long have you felt feverish?
4241,0,0,13,13,1.0,0.08006407690254357,565,Pr[M(D)=S] < exp(epsilon)*Pr[M(D')=S]
4241,0,0,13,13,1.0,0.08006407690254357,565,We're HIPPA compliant.
4241,0,0,13,13,1.0,0.08006407690254357,565,"My mother told me, "" if you nothing good to say...say nothing."""
4241,0,0,13,13,1.0,0.08006407690254357,565,Where did you say that wart was?
4241,0,0,13,13,1.0,0.08006407690254357,565,I see where it asked you to rate your pain that you just lit the paper on fire.
4241,0,0,13,13,1.0,0.08006407690254357,565,Sorry but your injury has gotten inflammed
4241,0,0,13,13,1.0,0.08006407690254357,565,"So much for your ""second opinion."""
4241,0,0,13,13,1.0,0.08006407690254357,565,"Liar ,Liar... Your chart's on fire!"
4241,0,0,13,13,1.0,0.08006407690254357,565,Perhaps an old flame transmitted it.
4241,0,0,13,13,1.0,0.08006407690254357,565,I'm afraid you may have to cut down on the flambe' desserts.
4241,0,0,13,13,1.0,0.08006407690254357,565,Here is the deal: no more paper chart but I still take cash.
4241,0,0,13,13,1.0,0.08006407690254357,565,This represents the state of your liver.
4241,0,0,13,13,1.0,0.08006407690254357,565,I have good news and bad news.
4241,0,0,13,13,1.0,0.08006407690254357,565,"Yeah, I'd stop watching the news for a while."
4241,0,0,13,13,1.0,0.08006407690254357,565,Now a days most or prescriptions are just fire...expensive fire.
4241,0,0,13,13,1.0,0.08006407690254357,565,How we pay for it is debatable. 'Ashes to ashes' is not.
4241,0,0,13,13,1.0,0.08006407690254357,565,"According to the lab results here, you have the worst heartburn ever recorded."
4241,0,0,13,13,1.0,0.08006407690254357,565,You are taking The Game of Thrones too seriously. Seriously.
4241,0,0,13,13,1.0,0.08006407690254357,565,Don't worry you will be safe!
4241,0,0,13,13,1.0,0.08006407690254357,565,The results of your heart burn tests are back.
4241,0,0,13,13,1.0,0.08006407690254357,565,Apparently your heartburn is quite contagious.
4241,0,0,13,13,1.0,0.08006407690254357,565,My tests indicate the worst case of heartburn I've ever seen.
4241,0,0,13,13,1.0,0.08006407690254357,565,"Just to be clear, this is what your hemorrhoids feel like, right?"
4241,0,0,13,13,1.0,0.08006407690254357,565,Mission accomplished! The president's new executive order just caused the CDC to spontaneously combust.
4241,0,0,13,13,1.0,0.08006407690254357,565,We took care of the coughing and the sneezing. The burning? Not so much.
4241,0,0,13,13,1.0,0.08006407690254357,565,One of us is going to die soon.
4241,0,0,13,13,1.0,0.08006407690254357,565,"Next time you bring a list of questions for me from WebMD, I’ll light something else on fire"
4241,0,0,13,13,1.0,0.08006407690254357,565,Cheap ink infuriates the printer.
4241,0,0,13,13,1.0,0.08006407690254357,565,Well....you voted for him!
4241,0,0,13,13,1.0,0.08006407690254357,565,No more pre-xisting condition
4241,0,0,13,13,1.0,0.08006407690254357,565,"Unfortunately, you have the ultra high deductible plan from Burnham Health Care..."
4241,0,0,13,13,1.0,0.08006407690254357,565,I'll inform United Airlines this is what you thought of their first settlement offer.
4241,0,0,13,13,1.0,0.08006407690254357,565,You are about to witness good bedside manner like never before.
4241,0,0,14,14,1.0,0.07412493166611012,565,I hope you quit smoking because your lab results are on fire!
4241,0,0,13,13,1.0,0.08006407690254357,565,Your test results are safe with me.
4241,0,0,13,13,1.0,0.08006407690254357,565,"Hemorrhoids, I feel your pain."
4241,0,0,13,13,1.0,0.08006407690254357,565,It's all a part of the procedure!
4241,0,0,13,13,1.0,0.08006407690254357,565,"Whatever you do, don't WebMD THIS."
4241,0,0,13,13,1.0,0.08006407690254357,565,It's a helluva lab report.
4241,0,0,13,13,1.0,0.08006407690254357,565,This report confirms you have hemorrhoids.
4241,0,0,13,13,1.0,0.08006407690254357,565,I'm guessing that's not an invitation to Match.com
4241,0,0,13,13,1.0,0.08006407690254357,565,"I'm prescribing you one pack of Orbit, twice a day."
4241,0,0,13,13,1.0,0.08006407690254357,565,"A few months ago, Obamacare was working just fine."
4241,0,0,14,14,1.0,0.07412493166611012,565,"And, apparently, your heartburn is spreading too."
4241,0,0,13,13,1.0,0.08006407690254357,565,You have a hemorrhoid problem.
4241,0,0,13,13,1.0,0.08006407690254357,565,"DOCTOR: I'm trying to make a Bart Simpson mask, but . . . I just can't . . . seem to . . . get the hair right. AHHHH! It's frustrating, ya know? Yeesh. PATIENT: . . . I'm having thoughts of suicide."
4241,0,0,13,13,1.0,0.08006407690254357,565,Your bowel disease is fine. It's your bill that's inflammatory.
4241,0,0,13,13,1.0,0.08006407690254357,565,I've lost my glasses but I understand you have a burning sensation.
4241,0,0,13,13,1.0,0.08006407690254357,565,We'll keep doing this until I've ordered enough tests to pay back my med school loans
4241,0,0,13,13,1.0,0.08006407690254357,565,This might hurt a little bit.
4241,0,0,13,13,1.0,0.08006407690254357,565,Inflamed esophagus
4241,0,0,13,13,1.0,0.08006407690254357,565,"I'm sorry to inform you that your results came back ""heretical."
4241,0,0,13,13,1.0,0.08006407690254357,565,I would say the Lazar surgery on your eyes is a complete success.
4241,0,0,13,13,1.0,0.08006407690254357,565,"Your initial test results suggest pyromania, but we'll need to do some additional blood tests and diagnostic imaging for a more definitive diagnosis."
4241,0,0,13,13,1.0,0.08006407690254357,565,"Hyper-flexibility, speaking in tongues--oh. I'm afraid this may be a matter of spiritual health."
4241,0,0,13,13,1.0,0.08006407690254357,565,Your insurance company has a novel response to nonpayment of premium.
4241,0,0,13,13,1.0,0.08006407690254357,565,"Sorry Don. We can make your medical records go away, but you'll always be a narcissist."
4241,0,0,13,13,1.0,0.08006407690254357,565,"I had to do it ,but now your wife will never know that you are a robot"
4241,0,0,13,13,1.0,0.08006407690254357,565,"When I told you to eat lighter, didn't mean a Zippo."
4241,0,0,13,13,1.0,0.08006407690254357,565,"My apologies. Since we've gone over to electronic medical records, the oddest things are happening with our paper charts."
4241,0,0,13,13,1.0,0.08006407690254357,565,I wouldn't worry about it too much
4241,0,0,13,13,1.0,0.08006407690254357,565,"Okay,the implanted recorder, indicating Russian collusion, has been removed and destroyed. The flash paper medical report has been activated. You are good to go J.K."
4241,0,0,13,13,1.0,0.08006407690254357,565,"Samsung is calling them ""live charts,"" and yes, you're having a flare up."
4241,0,0,13,13,1.0,0.08006407690254357,565,I think we know what's causing that burning sensation.
4241,0,0,13,13,1.0,0.08006407690254357,565,"Yesireee, We'll need to keep a closer eye on that heartburn."
4241,0,0,13,13,1.0,0.08006407690254357,565,"Witchcraft, Trumpcare. Who knows if it will work?"
4241,0,0,13,13,1.0,0.08006407690254357,565,I'm recommending a good witchdoctor.
4241,0,0,13,13,1.0,0.08006407690254357,565,Have you been to Purgatory lately?
4241,0,0,13,13,1.0,0.08006407690254357,565,What's your expected value for having a p-fraction of the bits in your data leaked?
4241,0,0,13,13,1.0,0.08006407690254357,565,It's a FAX from Hippocrates of Kos.
4241,0,0,13,13,1.0,0.08006407690254357,565,Any other burning questions?
4241,0,0,13,13,1.0,0.08006407690254357,565,"As I'll show you momentarily, it says here I'm a certified proctologist."
4241,0,0,13,13,1.0,0.08006407690254357,565,Ad hoc privacy notions are vulnerable to reconstruction attacks
4241,0,0,13,13,1.0,0.08006407690254357,565,"It says here you think you might have a couple of hemorrhoids, is that right?"
4241,0,0,13,13,1.0,0.08006407690254357,565,I think I am going to have to go get the attending.
4241,0,0,13,13,1.0,0.08006407690254357,565,Let me tell you about your blood work. It's lit.
4241,0,0,13,13,1.0,0.08006407690254357,565,"For the most part, your test results are normal."
4241,0,0,13,13,1.0,0.08006407690254357,565,"No, nothing you should be worried about with these test results."
4241,0,0,13,13,1.0,0.08006407690254357,565,"Your mission, should you choose to accept it, . . ."
4241,0,0,13,13,1.0,0.08006407690254357,565,I'm afraid it was more than we thought.
4241,0,0,13,13,1.0,0.08006407690254357,565,"Well, this bill is sure gonna burn a hole in your pockets!"
4241,0,0,13,13,1.0,0.08006407690254357,565,"So for heart burn I recommend fighting fire with fire - bottoms up"" or ""your x-rays reveal severe heartburn"
4241,0,0,13,13,1.0,0.08006407690254357,565,the good news is that you are getting lit.
4241,0,0,13,13,1.0,0.08006407690254357,565,You can always just piss on it and keep eating heartburn inducing foods.
4241,0,0,13,13,1.0,0.08006407690254357,565,Your running a bit of a temperature
4241,0,0,13,13,1.0,0.08006407690254357,565,'Have you any acid reflux issues lately?'
4241,0,0,13,13,1.0,0.08006407690254357,565,"I might be wrong, but based on what I see here, it appears you may be suffering from general inflammation."
4241,0,0,13,13,1.0,0.08006407690254357,565,These are timed-release instructions for your new medication.
4241,0,0,13,13,1.0,0.08006407690254357,565,I'm pretty sure it's not contagious
4241,0,0,13,13,1.0,0.08006407690254357,565,"For small epsilon, you can think of it as (1+epsilon)"
4241,0,0,13,13,1.0,0.08006407690254357,565,I guarantee your health records are secure.
4241,0,0,13,13,1.0,0.08006407690254357,565,You do have heartburn
4241,0,0,13,13,1.0,0.08006407690254357,565,"I AM being completely honest with you, Mr. Jones. There's nothing unusual in your test results."
4241,0,0,13,13,1.0,0.08006407690254357,565,It seems to me that you have severe heart burn
4241,0,0,13,13,1.0,0.08006407690254357,565,"You're covered by the Medicare expansion, aren't you."
4241,0,0,13,13,1.0,0.08006407690254357,565,May I recommend a non-inflammable insurance policy?
4241,0,0,13,13,1.0,0.08006407690254357,565,"Patients rarely report moderate-to-intolerable, eyebrow-scorching pain."
4241,0,0,13,13,1.0,0.08006407690254357,565,oh no my sheet's on fire and my nose is sliding around
4241,0,0,13,13,1.0,0.08006407690254357,565,"You had the hots for that hottie. No wonder, you have a searing hot piping report of gonorrhea. I recommend you make her your old flame."
4241,0,0,13,13,1.0,0.08006407690254357,565,"We'll have to run the tests again, Mr. Karlsson."
4241,0,0,13,13,1.0,0.08006407690254357,565,"We find this approach is much more cost effective than Electronic Medical Records, and it is quite illuminating too."
4241,0,0,13,13,1.0,0.08006407690254357,565,My records indicate you're on a catastrophic plan.
4241,0,0,13,13,1.0,0.08006407690254357,565,Now where's the eye of newt?
4241,0,0,13,13,1.0,0.08006407690254357,565,"If you say your stomach felt like this, I'll give you a pre-existing condition."
4241,0,0,13,13,1.0,0.08006407690254357,565,Here's your prescription for that inflammation you're having.
4241,0,0,13,13,1.0,0.08006407690254357,565,It's a dramatization of what's about to happen to your coverage.
4241,0,0,13,13,1.0,0.08006407690254357,565,I've never seen a more fiery case of athlete's foot.
4241,0,0,13,13,1.0,0.08006407690254357,565,Trump just cancelled your insurance
4241,0,0,13,13,1.0,0.08006407690254357,565,The new HIPAA regulations are quite strict.
4241,0,0,13,13,1.0,0.08006407690254357,565,Your insurer's denying it as a pre-existing conflagration.
4241,0,0,13,13,1.0,0.08006407690254357,565,I think you've had too many MRI's
4241,0,0,14,14,1.0,0.07412493166611012,565,"Boy, are you lucky! While I can't treat you, your insurance allows me to destroy the record of your illness."
4241,0,0,13,13,1.0,0.08006407690254357,565,I see here that one of your symptoms is a burning sensation.
4241,0,0,13,13,1.0,0.08006407690254357,565,I have your test results and just as I suspected the hemorrhoid medication is not working.
4241,0,0,13,13,1.0,0.08006407690254357,565,I have been experiencing a burning sensation.
4241,0,0,13,13,1.0,0.08006407690254357,565,So...is it heartburn or hemorrhoids ?
4241,0,0,13,13,1.0,0.08006407690254357,565,"Acid re-flux is serious, damn it!"
4241,0,0,13,13,1.0,0.08006407690254357,565,Got any more burning questions?
4241,0,0,13,13,1.0,0.08006407690254357,565,Here's your enflamed colon!
4241,0,0,13,13,1.0,0.08006407690254357,565,And this is your heart on drugs.
4241,0,0,13,13,1.0,0.08006407690254357,565,Your diagnosis is hot off the charts.
4241,0,0,13,13,1.0,0.08006407690254357,565,That burning sensation turns out to be a real problem.
4241,0,0,13,13,1.0,0.08006407690254357,565,Guess this health care plan's gone.
4241,0,0,13,13,1.0,0.08006407690254357,565,Your potassium and phosphorus levels are a bit high.
4241,0,0,13,13,1.0,0.08006407690254357,565,"It’s heart burn, after all. Lab report clinches it."
4241,0,0,13,13,1.0,0.08006407690254357,565,It's a new HIPAA privacy act regulation.
4241,0,0,13,13,1.0,0.08006407690254357,565,You've got a better way to deal with the health care crisis?
4241,0,0,13,13,1.0,0.08006407690254357,565,"Oh, gees is there even a chance for a prognosis?"
4241,0,0,13,13,1.0,0.08006407690254357,565,Been sleeping around lately?
4241,0,0,13,13,1.0,0.08006407690254357,565,"Dante, your urinalysis results are fairly conclusive."
4241,0,0,13,13,1.0,0.08006407690254357,565,"Trust me, I'm a doctor--and a volunteer firefighter."
4241,0,0,13,13,1.0,0.08006407690254357,565,"The test results are in, you are part volcano!"
4241,0,0,13,13,1.0,0.08006407690254357,565,With this latest HIPPA regulation I've got to read fast and watch my fingers.
4241,0,0,13,13,1.0,0.08006407690254357,565,Your medical record is now safe from Russian hackers!
4241,0,0,13,13,1.0,0.08006407690254357,565,"So, uhh....do you want the good news about last night first? Or the bad news?!"
4241,0,0,13,13,1.0,0.08006407690254357,565,And you wanted to speak to whom?
4241,0,0,13,13,1.0,0.08006407690254357,565,Can't seem to find what's causing the burning sensation
4241,0,0,13,13,1.0,0.08006407690254357,565,I have some good news and bad news for you: Good News: I am burning up your $5000 bill that you owe me. Bad news: You have 2 months to live
4241,0,0,13,13,1.0,0.08006407690254357,565,Ah so I see you have Obamacare.
4241,0,0,13,13,1.0,0.08006407690254357,565,In some cases this prescription may cause mild burning or irritation.
4241,0,0,13,13,1.0,0.08006407690254357,565,"No, I am most assuredly NOT fomenting crises to distract attention from my small hands."
4241,0,0,13,13,1.0,0.08006407690254357,565,This Burning Report says you are my new urologist.
4241,0,0,13,13,1.0,0.08006407690254357,565,"Shoot, this isn't your chart, it's Mr. Mephisto's."
4241,0,0,13,13,1.0,0.08006407690254357,565,I'm afraid we got identical results for your personality test and your colonoscopy.
4241,0,0,13,13,1.0,0.08006407690254357,565,"I'm afraid, Congressman, this will substantially delay negotiation of your new payment schedule."
4241,0,0,13,13,1.0,0.08006407690254357,565,First the good news--as far as we know you are the only one in the world who has it.
4241,0,0,13,13,1.0,0.08006407690254357,565,I recommend anti-inflammatories
4241,0,0,13,13,1.0,0.08006407690254357,565,You have hot pants syndrome!
4241,0,0,13,13,1.0,0.08006407690254357,565,It's our new patient privacy policy.
4241,0,0,13,13,1.0,0.08006407690254357,565,Trumpcare 2.0 – Burn Before Reading
4241,0,0,13,13,1.0,0.08006407690254357,565,you have a very hot health issue.
4241,0,0,13,13,1.0,0.08006407690254357,565,It says you have a raging STD.
4241,0,0,13,13,1.0,0.08006407690254357,565,"Well, the results indicate that you're a flaming homosexual. Too bad, because treatment for that would have been covered under TrumpCare. (PS I'm gay if that makes it appear less homophobic)"
4241,0,0,14,14,1.0,0.07412493166611012,565,Vox wrote an explainer about this.
4241,0,0,13,13,1.0,0.08006407690254357,565,"""I respectfully disagree, WebMD and Stephen King are not your best sources of information on this one."
4241,0,0,13,13,1.0,0.08006407690254357,565,"We have to be quick, your health insurance policy is self-destructing in 10 seconds."
4241,0,0,13,13,1.0,0.08006407690254357,565,"My apologies for the delay, but I was trying to warm up some take-out 'Fried Susan Rice' and the napkin caught fire."
4241,0,0,13,13,1.0,0.08006407690254357,565,"Well, Mr. Kent, the bad news is it's myopia...the worse news is..."
4241,0,0,13,13,1.0,0.08006407690254357,565,The Afterlife Awaits
4241,0,0,13,13,1.0,0.08006407690254357,565,"Well, I guess it's good you're already siting down."
4241,0,0,13,13,1.0,0.08006407690254357,565,Your lab results seem to indicate that you are hot-blooded.
4241,0,0,13,13,1.0,0.08006407690254357,565,Your new exercise program is really burning up the charts.
4241,0,0,13,13,1.0,0.08006407690254357,565,Your policy has an annual ritual-rite provision. No co-pay!
4241,0,0,13,13,1.0,0.08006407690254357,565,You have got some inflammation.
4241,0,0,13,13,1.0,0.08006407690254357,565,This is the worst case of heartburn I've ever seen.
4241,0,0,13,13,1.0,0.08006407690254357,565,You seem to have an inflammatory disorder
4241,0,0,13,13,1.0,0.08006407690254357,565,"You know, last time this happened, I was just an intern. Long before the ED drugs. Yep, and we had to quarantine all known patient contacts for two weeks under U. S. Code Title 42."
4241,0,0,13,13,1.0,0.08006407690254357,565,These test results indicate a very inflamed liver
4241,0,0,13,13,1.0,0.08006407690254357,565,Your bloodwork –incoming!
4241,0,0,13,13,1.0,0.08006407690254357,565,"I apologize, but it seems you don't qualify for the installment plan."
4241,0,0,13,13,1.0,0.08006407690254357,565,"Clearly what you need, Mr. Faible, is some fire in the belly."
4241,0,0,13,13,1.0,0.08006407690254357,565,It's better to destroy the evidence rather than admit you have a problem.
4241,0,0,13,13,1.0,0.08006407690254357,565,This treatment doesn't take long.
4241,0,0,13,13,1.0,0.08006407690254357,565,I don't want to say that your heartburn's are critical but......
4241,0,0,13,13,1.0,0.08006407690254357,565,This is way beyond Heart Burn!
4241,0,0,13,13,1.0,0.08006407690254357,565,It's either about my refusal to go with Electronic Medical Records or a sign regarding your prognosis.
4241,0,0,13,13,1.0,0.08006407690254357,565,"First, the good news."
4241,0,0,13,13,1.0,0.08006407690254357,565,Modern Day Grim Fairy Tale: “Your co-pay and deductible are so small I’ll just write them off…”
4241,0,0,13,13,1.0,0.08006407690254357,565,There's no cause for alarm.
4241,0,0,13,13,1.0,0.08006407690254357,565,"if you'd rather, we're having a fire sale on livers."
4241,0,0,13,13,1.0,0.08006407690254357,565,Whoa. I can't even afford the drugs you need.
4241,0,0,13,13,1.0,0.08006407690254357,565,"Sorry for the diagnosis, but by the time you take this Rx to the pharmacy, you'll be a goner."
4241,0,0,13,13,1.0,0.08006407690254357,565,"We're not quite sure what it is, but we're pretty certain you picked it up last fall at Burning Man."
4241,0,0,13,13,1.0,0.08006407690254357,565,I'd suggest taking the anti-inflammatories with a lot of water.
4241,0,0,13,13,1.0,0.08006407690254357,565,"Don't worry, at least I can fix this"
4241,0,0,13,13,1.0,0.08006407690254357,565,Wow! What smokin' hot results.
4241,0,0,13,13,1.0,0.08006407690254357,565,"I can tell you, but I'd have to kill you after."
4241,0,0,13,13,1.0,0.08006407690254357,565,Your test results are printed on Snapchat paper.
4241,0,0,13,13,1.0,0.08006407690254357,565,"Your mission, should you decide to accept it, is to eat kale."
4241,0,0,13,13,1.0,0.08006407690254357,565,"I'm sorry Superman, but a colonoscopy is a routine part of an exam for someone your age."
4241,0,0,13,13,1.0,0.08006407690254357,565,"if I see lab result like yours again, I'm going into real estate!"
4241,0,0,13,13,1.0,0.08006407690254357,565,You really need to cut back on spicy foods...
4241,0,0,13,13,1.0,0.08006407690254357,565,"As you can see, I had a devil of a time getting your test results back from the lab."
4241,0,0,13,13,1.0,0.08006407690254357,565,Your test result suggest an inflammation.
4241,0,0,13,13,1.0,0.08006407690254357,565,I think it's a signal about medicare!
4241,0,0,13,13,1.0,0.08006407690254357,565,Your new insurance plan approved the genital warts treatment.
4241,0,0,13,13,1.0,0.08006407690254357,565,"I'm not certain what it is, so let'stry trial by fire?"
4241,0,0,13,13,1.0,0.08006407690254357,565,"So, how's the inflammation?"
4241,0,0,13,13,1.0,0.08006407690254357,565,"Good news, it was just a case of heartburn."
4241,0,0,13,13,1.0,0.08006407690254357,565,I've never seen a diagnosis with such inflammed symptoms.
4241,0,0,13,13,1.0,0.08006407690254357,565,Your lab results indicate a fire in the belly
4241,0,0,13,13,1.0,0.08006407690254357,565,Your test results are in. And frankly they're not good. On the bright side...
4241,0,0,13,13,1.0,0.08006407690254357,565,"Well Mr. Jones, the test results show that your heartburn is worse than I thought."
4241,0,0,13,13,1.0,0.08006407690254357,565,"Mr. Trump, Your mission is to replace Obama Care, you have 46 months to accept this mission....."
4241,0,0,13,13,1.0,0.08006407690254357,565,What you need is some fire in your belly.
4241,0,0,13,13,1.0,0.08006407690254357,565,The launch codes are inside the patient. Good luck!
4241,0,0,13,13,1.0,0.08006407690254357,565,"Ok, Now use your mind to put it out"
4241,0,0,13,13,1.0,0.08006407690254357,565,That was some hot results
4241,0,0,13,13,1.0,0.08006407690254357,565,"X-Ray? No, this is my kneecapping estimate from the Mob."
4241,0,0,13,13,1.0,0.08006407690254357,565,"If inhaling the vapors fails the cure, roast chestnuts over it come Yuletide."
4241,0,0,13,13,1.0,0.08006407690254357,565,"It would seem you're running a bit of a fever, Mr. Horton."
4241,0,0,13,13,1.0,0.08006407690254357,565,There's one item of concern on this round of tests.
4241,0,0,13,13,1.0,0.08006407690254357,565,Its the new Artificial Intelligence Report on your heartburn
4241,0,0,13,13,1.0,0.08006407690254357,565,I've had to make your chart compliant with the new HIPAA privacy regulations.
4241,0,0,13,13,1.0,0.08006407690254357,565,"Your diagnosiis, just like your coverage, is up in flames."
4241,0,0,13,13,1.0,0.08006407690254357,565,How long has it been since you haven't had sex?
4241,0,0,13,13,1.0,0.08006407690254357,565,You seem to have a fever or inflammation from a disease.
4241,0,0,13,13,1.0,0.08006407690254357,565,"To get this filled, you'll need to contact your local coven."
4241,0,0,13,13,1.0,0.08006407690254357,565,No worries - we can make another copay .....
4241,0,0,13,13,1.0,0.08006407690254357,565,"As you can see, I take the HIPAA very seriously."
4241,0,0,13,13,1.0,0.08006407690254357,565,"According to new HPPA privacy laws, we must destroy your medical records immediately before we can read them."
4241,0,0,13,13,1.0,0.08006407690254357,565,"In order to obtain a thorough medical history, I must ask you this burning question."
4241,0,0,13,13,1.0,0.08006407690254357,565,We're now using EMR — electrocuted medical records
4241,0,0,13,13,1.0,0.08006407690254357,565,"The test results are in, and you have a severe inflammation."
4241,0,0,14,14,1.0,0.07412493166611012,565,"Sorry to say, this is not the problem"
4241,0,0,13,13,1.0,0.08006407690254357,565,Looks like your inflammation is highly contagious.
4241,0,0,13,13,1.0,0.08006407690254357,565,Here's your results hot off the press.
4241,0,0,13,13,1.0,0.08006407690254357,565,This is our electronic medical record's version of Instagram.
4241,0,0,13,13,1.0,0.08006407690254357,565,"In my experience, Mr. Jones, a burning sensation is really quite common."
4241,0,0,13,13,1.0,0.08006407690254357,565,My prognosis is internal combustion.
4241,0,0,13,13,1.0,0.08006407690254357,565,"It's an impressive psychic power, but our billings are backed up in the cloud."
4241,0,0,13,13,1.0,0.08006407690254357,565,You did say that your arm was on fire...
4241,0,0,13,13,1.0,0.08006407690254357,565,Obamacare is going up in smoke as we speak.
4241,0,0,13,13,1.0,0.08006407690254357,565,"Sorry, Mr. Phelps. I'm having trouble with your diagnosis."
4241,0,0,13,13,1.0,0.08006407690254357,565,"Don, your gastric acid test results are in!"
4241,0,0,13,13,1.0,0.08006407690254357,565,How's this for a second opinion?
4241,0,0,13,13,1.0,0.08006407690254357,565,"Ok then, I'll give you the bad news first."
4241,0,0,13,13,1.0,0.08006407690254357,565,It seems as though your burning sensation is contagious.
4241,0,0,13,13,1.0,0.08006407690254357,565,I'm gonna burn all your shit. I'm a doctor without borders.
4241,0,0,13,13,1.0,0.08006407690254357,565,You're burning up
4241,0,0,13,13,1.0,0.08006407690254357,565,"You need spiritual help, not medical."
4241,0,0,13,13,1.0,0.08006407690254357,565,Front office came up with a new idea how to protect your privacy.
4241,0,0,13,13,1.0,0.08006407690254357,565,Do you have any other burning questions?
4241,0,0,13,13,1.0,0.08006407690254357,565,It seems you have the rare condition of contagious heartburn.
4241,0,0,13,13,1.0,0.08006407690254357,565,"Now is it air, water, fire or earth?"
4241,0,0,13,13,1.0,0.08006407690254357,565,Exxon has just patented your infection's bacteria and is suing you for patent infringement.
4241,0,0,13,13,1.0,0.08006407690254357,565,Call me in two days if your legarthy persists
4241,0,0,13,13,1.0,0.08006407690254357,565,Increase your water intake.
4241,0,0,13,13,1.0,0.08006407690254357,565,Congress must have just passed the American Health Care Act; you will have to go
4241,0,0,13,13,1.0,0.08006407690254357,565,To protect your privacy we now print all lab results on self immolating paper.
4241,0,0,13,13,1.0,0.08006407690254357,565,I see why your friends are calling you dragon breath.
4241,0,0,13,13,1.0,0.08006407690254357,565,"According to my examinations, you appear to have a very serious inflammation."
4241,0,0,13,13,1.0,0.08006407690254357,565,"Hemorrhoids, huh?"
4241,0,0,13,13,1.0,0.08006407690254357,565,Did you forget to do the Ice Bucket Challenge?
4241,0,0,13,13,1.0,0.08006407690254357,565,"Right, it seems there have been some changes to your insurance plan."
4241,0,0,13,13,1.0,0.08006407690254357,565,"Sir, unfortunately your insurance doesn't cover pyrokenesis"
4241,0,0,13,13,1.0,0.08006407690254357,565,I don't think much of my previous diagnosis.
4241,0,0,13,13,1.0,0.08006407690254357,565,Your temperature is 451 Fahrenheit.
4241,0,0,13,13,1.0,0.08006407690254357,565,"Mr. Ignis, it looks as though you have a serious case of arsonic poisoning."
4241,0,0,13,13,1.0,0.08006407690254357,565,"I've got the results back from your ""Colonoscopy""; cut back on the Hot Peppers."
4241,0,0,13,13,1.0,0.08006407690254357,565,``Is the widow outside?''
4241,0,0,13,13,1.0,0.08006407690254357,565,"Well yes, I can see that it's inflamed."
4241,0,0,14,14,1.0,0.07412493166611012,565,"Whatever you've got, it's contagious."
4241,0,0,13,13,1.0,0.08006407690254357,565,that's nothing'wait till you see the cost of the prescrptions
4241,0,0,13,13,1.0,0.08006407690254357,565,Errr...let's just say its not good news.
4241,0,0,13,13,1.0,0.08006407690254357,565,Have no doubt! My diagnosis comes from the highest authority.
4241,0,0,13,13,1.0,0.08006407690254357,565,It's your oxygen uptake numbers. I've never seen ones so high.
4241,0,0,13,13,1.0,0.08006407690254357,565,did you drink anything flammable recently?
4241,0,0,13,13,1.0,0.08006407690254357,565,We'll never fix your hot flashes until you stop burning up my prescriptions.
4241,0,0,13,13,1.0,0.08006407690254357,565,Our new lab works for the NSA.
4241,0,0,13,13,1.0,0.08006407690254357,565,"I'm beginning to understand why you've added ""Possible addiction to Carrie, and Fahrenheit 451"" to your medical profile."
4241,0,0,13,13,1.0,0.08006407690254357,565,"Of course, we still have no evidence that pyrokinesis exists, but here are your diagnostic fees..."
4241,0,0,13,13,1.0,0.08006407690254357,565,Thanks for waiting Mr. Jones. I just got your urinalysis results back from the lab. I can really see why it burns when you pee
4241,0,0,13,13,1.0,0.08006407690254357,565,Low reimbursements have forced me into doing magic tricks.
4241,0,0,13,13,1.0,0.08006407690254357,565,The nurse will be right with you.
4241,0,0,13,13,1.0,0.08006407690254357,565,In all my years.
4241,0,0,13,13,1.0,0.08006407690254357,565,It's just a sunburn.
4241,0,0,13,13,1.0,0.08006407690254357,565,"Yes, I'm the insurance doctor, I studied in yale, I mean he'll ,the pills you take are candy and the pain is all in your head."
4241,0,0,13,13,1.0,0.08006407690254357,565,I hope that's not my birth certificate.
4241,0,0,13,13,1.0,0.08006407690254357,565,"To control costs, your insurance has authorized a shamanic fire ritual to symbolically eradicate your symptoms."
4241,0,0,13,13,1.0,0.08006407690254357,565,You and I lost a lot of money betting on your cholesterol level.
4241,0,0,13,13,1.0,0.08006407690254357,565,I can't help it. My diagnoses are on fire these days.
4241,0,0,13,13,1.0,0.08006407690254357,565,"Your test results are back, Mr. Farnsworth. It seems you have hemorroids."
4241,0,0,13,13,1.0,0.08006407690254357,565,"As a politician you should know what ""inflammatory"" means."
4241,0,0,13,13,1.0,0.08006407690254357,565,You may want to cut back on the jalapenos and red peppers.
4241,0,0,13,13,1.0,0.08006407690254357,565,Those darn insurance companies are really playing hardball with our bills these days.
4241,0,0,13,13,1.0,0.08006407690254357,565,Your interior posterior seems to be inflamed.
4241,0,0,13,13,1.0,0.08006407690254357,565,My kid didn't make the lacrosse team. I'll be right back.
4241,0,0,13,13,1.0,0.08006407690254357,565,"I'm sorry, but What to Do When a Patient's Medical Record Spontaneously Combusts wasn't covered in med school."
4241,0,0,13,13,1.0,0.08006407690254357,565,Just kidding...you're fine.
4241,0,0,13,13,1.0,0.08006407690254357,565,I see that your heartburn has been flaring up again.
4241,0,0,13,13,1.0,0.08006407690254357,565,I guess it wasn't a wart.
4241,0,0,13,13,1.0,0.08006407690254357,565,I need to talk to you about your insurance plan.
4241,0,0,14,14,1.0,0.07412493166611012,565,Paperless office!
4241,0,0,13,13,1.0,0.08006407690254357,565,Ok - I'm not saying it's bad BUT...
4241,0,0,13,13,1.0,0.08006407690254357,565,This is the latest hot off the press.
4241,0,0,13,13,1.0,0.08006407690254357,565,You don't need this prescription anymore. You''l be fine.
4241,0,0,13,13,1.0,0.08006407690254357,565,Your chart says you have a bad case of heart burn.
4241,0,0,13,13,1.0,0.08006407690254357,565,Is this how you would describe the sensation?
4241,0,0,13,13,1.0,0.08006407690254357,565,"As you can see the ""fire in your belly"" is spreading."
4241,0,0,13,13,1.0,0.08006407690254357,565,Your test results are flammable.
4241,0,0,13,13,1.0,0.08006407690254357,565,I think the best medicine would be for you to forget this report ever happened.
4241,0,0,13,13,1.0,0.08006407690254357,565,I'm afraid your blood pressure numbers are flamingly high as the devil is in the details.
4241,0,0,13,13,1.0,0.08006407690254357,565,"Cripes, the ACA must finally have been repealed! Fire in the hole!"
4241,0,0,13,13,1.0,0.08006407690254357,565,Your glucose numbers are a little high
4241,0,0,13,13,1.0,0.08006407690254357,565,"Well, George, your labs are indicating an elevated thyroid . . ."
4241,0,0,13,13,1.0,0.08006407690254357,565,"Hmm, I see you've still got those spontaneous combustion issues."
4241,0,0,13,13,1.0,0.08006407690254357,565,Well when lab numbers are high we actually use a special non-flammable paper in our copier. I think you can probably guess how high your numbers were.....
4241,0,0,13,13,1.0,0.08006407690254357,565,"But you don't have insurance, so I'm just going to go ahead and burn these test results, urinate on them, and laugh myself home."
4241,0,0,13,13,1.0,0.08006407690254357,565,Can that be used when I go camping?
4241,0,0,13,13,1.0,0.08006407690254357,565,"Some side effects may include, but are not limited to, bursting into flames."
4241,0,0,13,13,1.0,0.08006407690254357,565,"It said you're middle initial, ""L,"" stood for Lucifer, and then. . ."
4241,0,0,13,13,1.0,0.08006407690254357,565,It looks like Trump's using weapons of mass destruction against your Obama care coverage.
4241,0,0,13,13,1.0,0.08006407690254357,565,Your lab results are in - you have total inflammation.
4241,0,0,13,13,1.0,0.08006407690254357,565,I don't like these test results. We're going to start right over.
4241,0,0,13,13,1.0,0.08006407690254357,565,It must really burn when you pee.
4241,0,0,13,13,1.0,0.08006407690254357,565,Malicious hackers can not access your personal medical data. It will never leave this room.
4241,0,0,13,13,1.0,0.08006407690254357,565,Let's just pretend this never happened.
4241,0,0,13,13,1.0,0.08006407690254357,565,You might feel a slight burning sensation in you wallet after you take this bill.
4241,0,0,13,13,1.0,0.08006407690254357,565,The results will remain confidential.
4241,0,0,13,13,1.0,0.08006407690254357,565,"Mr. Gorham, you have no genetic history."
4241,0,0,13,13,1.0,0.08006407690254357,565,"As you can see, your fever is contagious."
4241,0,0,13,13,1.0,0.08006407690254357,565,We're studying how patients react to fake news.
4241,0,0,13,13,1.0,0.08006407690254357,565,"Well look at it this way, at least you got rid of the burning sensation."
4241,0,0,13,13,1.0,0.08006407690254357,565,These darn MEDICAID forms look so much like our Patient Registrations! Sorry. This office does not accept MEDICAID.
4241,0,0,13,13,1.0,0.08006407690254357,565,Only your lab results spontaneously combust but your are fine.
4241,0,0,13,13,1.0,0.08006407690254357,565,Your lab results are in. You have one of the hot new disorders.
4241,0,0,13,13,1.0,0.08006407690254357,565,Your HMO is willing to pay for your treatment as long as there is no record of it.
4241,0,0,13,13,1.0,0.08006407690254357,565,"Well, Mr. Johnson, you Do have a fever. The bad news: The only cure is more cowbell."
4241,0,0,13,13,1.0,0.08006407690254357,565,It's a new paperwork reduction policy.
4241,0,0,13,13,1.0,0.08006407690254357,565,"Well, it's definitely inflamed."
4241,0,0,13,13,1.0,0.08006407690254357,565,It says you have super AIDS.
4241,0,0,13,13,1.0,0.08006407690254357,565,We can't let a patient as sick as you look at his bill.
4241,0,0,13,13,1.0,0.08006407690254357,565,"Oh this, it's just your bill, your fine"
4241,0,0,13,13,1.0,0.08006407690254357,565,"Wow! You were not kidding when you said ""Burning Sensation""."
4241,0,0,13,13,1.0,0.08006407690254357,565,"""Remember my warning if you failed to pay your bill?"
4241,0,0,13,13,1.0,0.08006407690254357,565,"I don't really have to tell you, do I?"
4241,0,0,13,13,1.0,0.08006407690254357,565,The results of your stress test are showing some concerns.
4241,0,0,13,13,1.0,0.08006407690254357,565,Listen quickly before your insurance runs out
4241,0,0,13,13,1.0,0.08006407690254357,565,"You see now, Mr. Brown, the M.D. stands for Magic Doctor."
4241,0,0,13,13,1.0,0.08006407690254357,565,"Actually, I didn't find that you have hemorrhoids, but I find this flaming bag of poo."
4241,0,0,14,14,1.0,0.07412493166611012,565,"Don't be alarmed, Trumpcare coverage also includes marshmallows."
4241,0,0,13,13,1.0,0.08006407690254357,565,"So, you've been sitting on this Health Care bill since last Wednesday. No wonder you have heart burn."
4241,0,0,13,13,1.0,0.08006407690254357,565,"Oh, it's Bieber fever alright. If the results are burning, your heart is yearning..."
4241,0,0,13,13,1.0,0.08006407690254357,565,I'd say the diagnosis is heartburn!
4241,0,0,13,13,1.0,0.08006407690254357,565,"Your insurance company says, 'Hell no.'"
4241,0,0,13,13,1.0,0.08006407690254357,565,"Now that we've tackled your diet, I think we should talk about the arson."
4241,0,0,13,13,1.0,0.08006407690254357,565,"Sick burn, alright."
4241,0,0,13,13,1.0,0.08006407690254357,565,Short circuits were never a concern until we switched to electronic medical records!
4241,0,0,13,13,1.0,0.08006407690254357,565,I'm very sorry sir. This happens every time a patient chooses a chaplain from the Church of Satan.
4241,0,0,13,13,1.0,0.08006407690254357,565,Apparently your Obamacare has expired.
4241,0,0,13,13,1.0,0.08006407690254357,565,Your insurance company did not care for the findings on this pathology report.
4241,0,0,13,13,1.0,0.08006407690254357,565,Why don't I up your dose of anti-inflammatories while I'm at it.
4241,0,0,13,13,1.0,0.08006407690254357,565,I'm not so sure you even have time to get dressed.
4241,0,0,13,13,1.0,0.08006407690254357,565,This is the stool sample from hell.
4241,0,0,13,13,1.0,0.08006407690254357,565,These HIPAA privacy safeguards are getting out of hand!
4241,0,0,13,13,1.0,0.08006407690254357,565,Well I think your report is slightly inflamed
4241,0,0,13,13,1.0,0.08006407690254357,565,Your cholesterol has spiked.
4241,0,0,13,13,1.0,0.08006407690254357,565,This paper is on fire.
4241,0,0,13,13,1.0,0.08006407690254357,565,frankly I'm worried about your combustibles
4241,0,0,13,13,1.0,0.08006407690254357,565,"Now tell me Mr. Buckley, when did you first notice these symptoms of dragon-breath?"
4241,0,0,13,13,1.0,0.08006407690254357,565,"Don't read this out loud,but he looks like Jerry signfield father,he has flaming hemroids,and his wife wants to move to Florida his son is a comedian, and his girlfriend looks exactly like him and he wants to by me a cadillac."
4241,0,0,13,13,1.0,0.08006407690254357,565,This diagnosis is a hot issue.
4241,0,0,13,13,1.0,0.08006407690254357,565,"Obviously, your Scoville Units are off the chart!"
4241,0,0,13,13,1.0,0.08006407690254357,565,Your insurance is exploding.
4241,0,0,13,13,1.0,0.08006407690254357,565,a little feverish are we?
4241,0,0,13,13,1.0,0.08006407690254357,565,Looks like the lab misunderstood my request for CRISPR results.
4241,0,0,13,13,1.0,0.08006407690254357,565,I don't think your burning sensation was purely psychosomatic.
4241,0,0,13,13,1.0,0.08006407690254357,565,Don't worry. It's the cure for your cold.
4241,0,0,13,13,1.0,0.08006407690254357,565,"Quack, quack quack, quack."
4241,0,0,13,13,1.0,0.08006407690254357,565,"Like your politics, your condition is highly inflammatory."
4241,0,0,13,13,1.0,0.08006407690254357,565,I call it my three alarm heartburn prescription.
4241,0,0,13,13,1.0,0.08006407690254357,565,"It says here, you're paranoid of spontaneous combustion?"
4241,0,0,13,13,1.0,0.08006407690254357,565,"Worst bladder infection I've ever seen! They finally got the fire in the lab out after your urine test, but it's still smoldering."
4241,0,0,13,13,1.0,0.08006407690254357,565,"""Inflammation of your psyche is suggested by this report""."
4241,0,0,13,13,1.0,0.08006407690254357,565,You've got a bad case of chartburn.
4241,0,0,13,13,1.0,0.08006407690254357,565,Did you have Mexican for lunch?
4241,0,0,13,13,1.0,0.08006407690254357,565,"I'd normally offer you the choice, but the good news is burning away."
4241,0,0,13,13,1.0,0.08006407690254357,565,Wow! Obamacare is really going up in flames!
4241,0,0,13,13,1.0,0.08006407690254357,565,"When I asked, ""can you describe the sensation when you pee?"" this was not what I meant!"
4241,0,0,13,13,1.0,0.08006407690254357,565,"But the good news is, your constituents won't see this either!"
4241,0,0,14,14,1.0,0.07412493166611012,565,Your results do not look good
4241,0,0,13,13,1.0,0.08006407690254357,565,These emojis are getting out of control.
4241,0,0,13,13,1.0,0.08006407690254357,565,It's from your lawyer.
4241,0,0,13,13,1.0,0.08006407690254357,565,The rash is catching.
4241,0,0,13,13,1.0,0.08006407690254357,565,Your inflammation markers are off the chart!
4241,0,0,13,13,1.0,0.08006407690254357,565,Sometimes it doesn't stay in Vegas.
4241,0,0,13,13,1.0,0.08006407690254357,565,I think I just burned my nose off.
4241,0,0,13,13,1.0,0.08006407690254357,565,Your medical insurance policy is self destructing which means no more coverage!
4241,0,0,13,13,1.0,0.08006407690254357,565,It looks like we'll need to test you for sexually transmitted diseases.
4241,0,0,13,13,1.0,0.08006407690254357,565,Not to worry. This is just a second opinion from that specialist with the hot temper.
4241,0,0,13,13,1.0,0.08006407690254357,565,Your DNA analysis indicates you're part dragon.
4241,0,0,13,13,1.0,0.08006407690254357,565,A new price list is being faxed from Washington
4241,0,0,13,13,1.0,0.08006407690254357,565,Your PSA test has sent your your male gigalo sidegig plans up in smoke.
4241,0,0,13,13,1.0,0.08006407690254357,565,"Now might be the perfect time to take your blood pressure, Mr. Jenkins, to see if the meds are helping your hypertension."
4241,0,0,13,13,1.0,0.08006407690254357,565,That's one hell of a serum rhubarb level!
4241,0,0,13,13,1.0,0.08006407690254357,565,They've tightened HIPPA regulations again
4241,0,0,13,13,1.0,0.08006407690254357,565,Let's pretend this test result represents your life expectancy.
4241,0,0,13,13,1.0,0.08006407690254357,565,"Move back, Charles...Your cholesterol levels have spontaneously combustion!"
4241,0,0,13,13,1.0,0.08006407690254357,565,"Those results are unacceptable, doctor."
4241,0,0,13,13,1.0,0.08006407690254357,565,I'll only drink it if it turns me into a unicorn
4241,0,0,14,14,1.0,0.07412493166611012,565,It's gonna take me a minute to figure out if this is good or if this is bad.
4241,0,0,13,13,1.0,0.08006407690254357,565,"Sir, this is not an appropriate way to handle rising healthcare costs."
4241,0,0,13,13,1.0,0.08006407690254357,565,"You had pneumonia, frostbite and now only a slight cold. But if any of it flares up again, take one of these and call me in the morning!"
4241,0,0,13,13,1.0,0.08006407690254357,565,"...fine, but sharing a few chromosomes does not mean you're a ""Trump""."
4241,0,0,13,13,1.0,0.08006407690254357,565,It asked you to rate your burning sensation on a scale of 1 to 10.
4241,0,0,13,13,1.0,0.08006407690254357,565,You may be in the running for a high office !
4241,0,0,13,13,1.0,0.08006407690254357,565,Here's your diagnosis Mr. Hunt.
4241,0,0,13,13,1.0,0.08006407690254357,565,Your tests how that it's heartburn.
4241,0,0,13,13,1.0,0.08006407690254357,565,...It's required by HIPPA to keep your information secure...
4241,0,0,13,13,1.0,0.08006407690254357,565,Not to worry. It'll burnout.
4241,0,0,13,13,1.0,0.08006407690254357,565,"If there's no proof, it's not true."
4241,0,0,13,13,1.0,0.08006407690254357,565,Your heartburn appears to be off the charts.
4241,0,0,13,13,1.0,0.08006407690254357,565,It looks like your insurance does cover inflammation
4241,0,0,13,13,1.0,0.08006407690254357,565,They decided torching it is easier than repealing it.
4241,0,0,13,13,1.0,0.08006407690254357,565,"Please stop using your heat vision on my bills, Superman."
4241,0,0,13,13,1.0,0.08006407690254357,565,"Trust me, I don't need a degree to prove I'm a doctor."
4241,0,0,13,13,1.0,0.08006407690254357,565,Since you have a high fever you are going to need a humidi-fire.
4241,0,0,13,13,1.0,0.08006407690254357,565,Burning sensation?
4241,0,0,13,13,1.0,0.08006407690254357,565,"I got as far as your name, Ethan Hunt, and then this happend."
4241,0,0,13,13,1.0,0.08006407690254357,565,I was gonna say you're not doing too hot...but I changed my mind
4241,0,0,13,13,1.0,0.08006407690254357,565,Is it like this?
4241,0,0,13,13,1.0,0.08006407690254357,565,I'm actually just a medical student—your doctor's flight was overbooked last night so he's running a bit late.
4241,0,0,13,13,1.0,0.08006407690254357,565,"Well, it looks like you've had quite the hot streak."
